1,1,25,166,0,4,0,0,67.59,38928341,54.422,18.6,2.581,1803.987,597.029,9.59,0.498,4
1,2,26,192,0,4,0,0,67.59,38928341,54.422,18.6,2.581,1803.987,597.029,9.59,0.498,4
1,3,43,235,0,4,0,0,67.59,38928341,54.422,18.6,2.581,1803.987,597.029,9.59,0.498,4
1,4,0,235,0,4,0,0,67.59,38928341,54.422,18.6,2.581,1803.987,597.029,9.59,0.498,4
1,5,35,270,1,5,0,0,78.7,38928341,54.422,18.6,2.581,1803.987,597.029,9.59,0.498,4
1,6,29,299,2,7,0,0,78.7,38928341,54.422,18.6,2.581,1803.987,597.029,9.59,0.498,4
1,7,38,337,0,7,0,0,78.7,38928341,54.422,18.6,2.581,1803.987,597.029,9.59,0.498,4
1,8,30,367,4,11,0,0,78.7,38928341,54.422,18.6,2.581,1803.987,597.029,9.59,0.498,4
1,9,56,423,3,14,0,0,78.7,38928341,54.422,18.6,2.581,1803.987,597.029,9.59,0.498,4
1,10,61,484,1,15,0,0,78.7,38928341,54.422,18.6,2.581,1803.987,597.029,9.59,0.498,4
1,11,37,521,0,15,0,0,78.7,38928341,54.422,18.6,2.581,1803.987,597.029,9.59,0.498,4
1,12,34,555,3,18,0,0,84.26,38928341,54.422,18.6,2.581,1803.987,597.029,9.59,0.498,4
1,13,52,607,0,18,0,0,84.26,38928341,54.422,18.6,2.581,1803.987,597.029,9.59,0.498,4
1,14,58,665,3,21,0,0,84.26,38928341,54.422,18.6,2.581,1803.987,597.029,9.59,0.498,4
1,15,49,714,2,23,0,0,84.26,38928341,54.422,18.6,2.581,1803.987,597.029,9.59,0.498,4
1,16,70,784,2,25,0,0,84.26,38928341,54.422,18.6,2.581,1803.987,597.029,9.59,0.498,4
1,17,10,794,4,29,0,0,84.26,38928341,54.422,18.6,2.581,1803.987,597.029,9.59,0.498,4
1,18,51,845,1,30,0,0,84.26,38928341,54.422,18.6,2.581,1803.987,597.029,9.59,0.498,4
1,19,63,908,0,30,0,0,84.26,38928341,54.422,18.6,2.581,1803.987,597.029,9.59,0.498,4
1,20,88,996,3,33,0,0,84.26,38928341,54.422,18.6,2.581,1803.987,597.029,9.59,0.498,4
1,21,35,1031,2,35,0,0,84.26,38928341,54.422,18.6,2.581,1803.987,597.029,9.59,0.498,4
1,22,61,1092,1,36,0,0,84.26,38928341,54.422,18.6,2.581,1803.987,597.029,9.59,0.498,4
1,23,84,1176,4,40,0,0,84.26,38928341,54.422,18.6,2.581,1803.987,597.029,9.59,0.498,4
1,24,105,1281,2,42,0,0,84.26,38928341,54.422,18.6,2.581,1803.987,597.029,9.59,0.498,4
1,25,70,1351,1,43,0,0,84.26,38928341,54.422,18.6,2.581,1803.987,597.029,9.59,0.498,4
1,26,112,1463,4,47,0,0,84.26,38928341,54.422,18.6,2.581,1803.987,597.029,9.59,0.498,4
1,27,68,1531,10,57,0,0,84.26,38928341,54.422,18.6,2.581,1803.987,597.029,9.59,0.498,4
1,28,172,1703,0,57,0,0,84.26,38928341,54.422,18.6,2.581,1803.987,597.029,9.59,0.498,4
1,29,124,1827,3,60,0,0,84.26,38928341,54.422,18.6,2.581,1803.987,597.029,9.59,0.498,4
1,30,122,1949,0,60,0,0,84.26,38928341,54.422,18.6,2.581,1803.987,597.029,9.59,0.498,4
1,31,222,2171,4,64,0,0,84.26,38928341,54.422,18.6,2.581,1803.987,597.029,9.59,0.498,4
1,32,164,2335,4,68,0,0,84.26,38928341,54.422,18.6,2.581,1803.987,597.029,9.59,0.498,4
1,33,134,2469,4,72,0,0,84.26,38928341,54.422,18.6,2.581,1803.987,597.029,9.59,0.498,4
1,34,235,2704,13,85,0,0,84.26,38928341,54.422,18.6,2.581,1803.987,597.029,9.59,0.498,4
1,35,190,2894,5,90,0,0,84.26,38928341,54.422,18.6,2.581,1803.987,597.029,9.59,0.498,4
1,36,330,3224,5,95,0,0,84.26,38928341,54.422,18.6,2.581,1803.987,597.029,9.59,0.498,4
1,37,168,3392,9,104,0,0,84.26,38928341,54.422,18.6,2.581,1803.987,597.029,9.59,0.498,4
1,38,171,3563,2,106,0,0,84.26,38928341,54.422,18.6,2.581,1803.987,597.029,9.59,0.498,4
1,39,215,3778,3,109,0,0,84.26,38928341,54.422,18.6,2.581,1803.987,597.029,9.59,0.498,4
1,40,255,4033,6,115,0,0,84.26,38928341,54.422,18.6,2.581,1803.987,597.029,9.59,0.498,4
1,41,369,4402,5,120,0,0,84.26,38928341,54.422,18.6,2.581,1803.987,597.029,9.59,0.498,4
1,42,285,4687,2,122,0,0,84.26,38928341,54.422,18.6,2.581,1803.987,597.029,9.59,0.498,4
1,43,280,4967,5,127,0,0,84.26,38928341,54.422,18.6,2.581,1803.987,597.029,9.59,0.498,4
1,44,259,5226,3,130,0,0,84.26,38928341,54.422,18.6,2.581,1803.987,597.029,9.59,0.498,4
1,45,113,5339,6,136,0,0,84.26,38928341,54.422,18.6,2.581,1803.987,597.029,9.59,0.498,4
1,46,1063,6402,32,168,0,0,84.26,38928341,54.422,18.6,2.581,1803.987,597.029,9.59,0.498,4
1,47,0,6402,0,168,0,0,84.26,38928341,54.422,18.6,2.581,1803.987,597.029,9.59,0.498,4
1,48,262,6664,1,169,0,0,84.26,38928341,54.422,18.6,2.581,1803.987,597.029,9.59,0.498,4
1,49,408,7072,4,173,0,0,84.26,38928341,54.422,18.6,2.581,1803.987,597.029,9.59,0.498,4
1,50,581,7653,5,178,0,0,84.26,38928341,54.422,18.6,2.581,1803.987,597.029,9.59,0.498,4
1,51,492,8145,9,187,0,0,84.26,38928341,54.422,18.6,2.581,1803.987,597.029,9.59,0.498,4
1,52,531,8676,6,193,0,0,84.26,38928341,54.422,18.6,2.581,1803.987,597.029,9.59,0.498,4
1,53,540,9216,12,205,0,0,84.26,38928341,54.422,18.6,2.581,1803.987,597.029,9.59,0.498,4
1,54,782,9998,11,216,0,0,84.26,38928341,54.422,18.6,2.581,1803.987,597.029,9.59,0.498,4
1,55,584,10582,2,218,0,0,84.26,38928341,54.422,18.6,2.581,1803.987,597.029,9.59,0.498,4
1,56,591,11173,1,219,0,0,84.26,38928341,54.422,18.6,2.581,1803.987,597.029,9.59,0.498,4
1,57,658,11831,1,220,0,0,84.26,38928341,54.422,18.6,2.581,1803.987,597.029,9.59,0.498,4
1,58,625,12456,7,227,0,0,84.26,38928341,54.422,18.6,2.581,1803.987,597.029,9.59,0.498,4
1,59,580,13036,8,235,0,0,84.26,38928341,54.422,18.6,2.581,1803.987,597.029,9.59,0.498,4
1,60,623,13659,11,246,0,0,84.26,38928341,54.422,18.6,2.581,1803.987,597.029,9.59,0.498,4
1,61,866,14525,3,249,0,0,84.26,38928341,54.422,18.6,2.581,1803.987,597.029,9.59,0.498,4
1,62,680,15205,8,257,0,0,84.26,38928341,54.422,18.6,2.581,1803.987,597.029,9.59,0.498,4
1,63,545,15750,8,265,0,0,84.26,38928341,54.422,18.6,2.581,1803.987,597.029,9.59,0.498,4
1,64,759,16509,5,270,0,0,84.26,38928341,54.422,18.6,2.581,1803.987,597.029,9.59,0.498,4
1,65,758,17267,24,294,0,0,84.26,38928341,54.422,18.6,2.581,1803.987,597.029,9.59,0.498,4
1,66,787,18054,6,300,0,0,84.26,38928341,54.422,18.6,2.581,1803.987,597.029,9.59,0.498,4
1,67,915,18969,9,309,0,0,84.26,38928341,54.422,18.6,2.581,1803.987,597.029,9.59,0.498,4
1,68,582,19551,18,327,0,0,84.26,38928341,54.422,18.6,2.581,1803.987,597.029,9.59,0.498,4
1,69,791,20342,30,357,0,0,84.26,38928341,54.422,18.6,2.581,1803.987,597.029,9.59,0.498,4
1,70,575,20917,12,369,0,0,78.7,38928341,54.422,18.6,2.581,1803.987,597.029,9.59,0.498,4
1,71,542,21459,15,384,0,0,78.7,38928341,54.422,18.6,2.581,1803.987,597.029,9.59,0.498,4
1,72,684,22143,21,405,0,0,78.7,38928341,54.422,18.6,2.581,1803.987,597.029,9.59,0.498,4
1,73,747,22890,21,426,0,0,78.7,38928341,54.422,18.6,2.581,1803.987,597.029,9.59,0.498,4
1,74,656,23546,20,446,0,0,78.7,38928341,54.422,18.6,2.581,1803.987,597.029,9.59,0.498,4
1,75,556,24102,5,451,0,0,78.7,38928341,54.422,18.6,2.581,1803.987,597.029,9.59,0.498,4
1,76,664,24766,20,471,0,0,78.7,38928341,54.422,18.6,2.581,1803.987,597.029,9.59,0.498,4
1,77,761,25527,7,478,0,0,78.7,38928341,54.422,18.6,2.581,1803.987,597.029,9.59,0.498,4
1,78,783,26310,13,491,0,0,78.7,38928341,54.422,18.6,2.581,1803.987,597.029,9.59,0.498,4
1,79,564,26874,13,504,0,0,78.7,38928341,54.422,18.6,2.581,1803.987,597.029,9.59,0.498,4
1,80,658,27532,42,546,0,0,78.7,38928341,54.422,18.6,2.581,1803.987,597.029,9.59,0.498,4
1,81,346,27878,2,548,0,0,78.7,38928341,54.422,18.6,2.581,1803.987,597.029,9.59,0.498,4
1,82,546,28424,21,569,0,0,78.7,38928341,54.422,18.6,2.581,1803.987,597.029,9.59,0.498,4
1,83,409,28833,12,581,0,0,78.7,38928341,54.422,18.6,2.581,1803.987,597.029,9.59,0.498,4
1,84,310,29143,17,598,0,0,78.7,38928341,54.422,18.6,2.581,1803.987,597.029,9.59,0.498,4
1,85,338,29481,20,618,0,0,78.7,38928341,54.422,18.6,2.581,1803.987,597.029,9.59,0.498,4
1,86,234,29715,21,639,0,0,78.7,38928341,54.422,18.6,2.581,1803.987,597.029,9.59,0.498,4
1,87,460,30175,36,675,0,0,78.7,38928341,54.422,18.6,2.581,1803.987,597.029,9.59,0.498,4
1,88,276,30451,8,683,0,0,78.7,38928341,54.422,18.6,2.581,1803.987,597.029,9.59,0.498,4
1,89,165,30616,20,703,0,0,78.7,38928341,54.422,18.6,2.581,1803.987,597.029,9.59,0.498,4
1,90,351,30967,18,721,0,0,78.7,38928341,54.422,18.6,2.581,1803.987,597.029,9.59,0.498,4
1,91,271,31238,12,733,0,0,78.7,38928341,54.422,18.6,2.581,1803.987,597.029,9.59,0.498,4
1,92,279,31517,13,746,0,0,78.7,38928341,54.422,18.6,2.581,1803.987,597.029,9.59,0.498,4
1,93,319,31836,28,774,0,0,78.7,38928341,54.422,18.6,2.581,1803.987,597.029,9.59,0.498,4
1,94,186,32022,33,807,0,0,78.7,38928341,54.422,18.6,2.581,1803.987,597.029,9.59,0.498,4
1,95,302,32324,12,819,0,0,78.7,38928341,54.422,18.6,2.581,1803.987,597.029,9.59,0.498,4
1,96,348,32672,7,826,0,0,78.7,38928341,54.422,18.6,2.581,1803.987,597.029,9.59,0.498,4
1,97,279,32951,38,864,0,0,78.7,38928341,54.422,18.6,2.581,1803.987,597.029,9.59,0.498,4
1,98,433,33384,56,920,0,0,78.7,38928341,54.422,18.6,2.581,1803.987,597.029,9.59,0.498,4
1,99,210,33594,16,936,0,0,78.7,38928341,54.422,18.6,2.581,1803.987,597.029,9.59,0.498,4
1,100,59,33653,1,937,0,0,78.7,38928341,54.422,18.6,2.581,1803.987,597.029,9.59,0.498,4
1,101,255,33908,20,957,0,0,78.7,38928341,54.422,18.6,2.581,1803.987,597.029,9.59,0.498,4
1,102,458,34366,37,994,0,0,78.7,38928341,54.422,18.6,2.581,1803.987,597.029,9.59,0.498,4
1,103,85,34451,16,1010,0,0,78.7,38928341,54.422,18.6,2.581,1803.987,597.029,9.59,0.498,4
1,104,0,34451,0,1010,0,0,78.7,38928341,54.422,18.6,2.581,1803.987,597.029,9.59,0.498,4
1,105,4,34455,2,1012,0,0,78.7,38928341,54.422,18.6,2.581,1803.987,597.029,9.59,0.498,4
1,106,285,34740,33,1045,0,0,78.7,38928341,54.422,18.6,2.581,1803.987,597.029,9.59,0.498,4
1,107,254,34994,49,1094,0,0,78.7,38928341,54.422,18.6,2.581,1803.987,597.029,9.59,0.498,4
1,108,76,35070,21,1115,0,0,78.7,38928341,54.422,18.6,2.581,1803.987,597.029,9.59,0.498,4
1,109,219,35289,32,1147,0,0,78.7,38928341,54.422,18.6,2.581,1803.987,597.029,9.59,0.498,4
1,110,12,35301,17,1164,0,0,78.7,38928341,54.422,18.6,2.581,1803.987,597.029,9.59,0.498,4
1,111,174,35475,17,1181,0,0,78.7,38928341,54.422,18.6,2.581,1803.987,597.029,9.59,0.498,4
1,112,140,35615,5,1186,0,0,78.7,38928341,54.422,18.6,2.581,1803.987,597.029,9.59,0.498,4
1,113,112,35727,4,1190,0,0,78.7,38928341,54.422,18.6,2.581,1803.987,597.029,9.59,0.498,4
1,114,188,35915,21,1211,0,0,78.7,38928341,54.422,18.6,2.581,1803.987,597.029,9.59,0.498,4
1,115,13,35928,0,1211,0,0,78.7,38928341,54.422,18.6,2.581,1803.987,597.029,9.59,0.498,4
1,116,108,36036,35,1246,0,0,78.7,38928341,54.422,18.6,2.581,1803.987,597.029,9.59,0.498,4
1,117,121,36157,13,1259,0,0,78.7,38928341,54.422,18.6,2.581,1803.987,597.029,9.59,0.498,4
1,118,106,36263,10,1269,0,0,78.7,38928341,54.422,18.6,2.581,1803.987,597.029,9.59,0.498,4
1,119,105,36368,1,1270,0,0,78.7,38928341,54.422,18.6,2.581,1803.987,597.029,9.59,0.498,4
1,120,103,36471,1,1271,0,0,78.7,38928341,54.422,18.6,2.581,1803.987,597.029,9.59,0.498,4
1,121,0,36471,0,1271,0,0,78.7,38928341,54.422,18.6,2.581,1803.987,597.029,9.59,0.498,4
1,122,71,36542,0,1271,0,0,78.7,38928341,54.422,18.6,2.581,1803.987,597.029,9.59,0.498,4
1,123,168,36710,12,1283,0,0,78.7,38928341,54.422,18.6,2.581,1803.987,597.029,9.59,0.498,4
1,124,0,36710,0,1283,0,0,78.7,38928341,54.422,18.6,2.581,1803.987,597.029,9.59,0.498,4
1,125,0,36710,1,1284,0,0,78.7,38928341,54.422,18.6,2.581,1803.987,597.029,9.59,0.498,4
1,126,37,36747,4,1288,0,0,75,38928341,54.422,18.6,2.581,1803.987,597.029,9.59,0.498,4
1,127,82,36829,6,1294,0,0,71.3,38928341,54.422,18.6,2.581,1803.987,597.029,9.59,0.498,4
1,128,67,36896,4,1298,0,0,71.3,38928341,54.422,18.6,2.581,1803.987,597.029,9.59,0.498,4
1,129,41,36937,0,1298,0,0,71.3,38928341,54.422,18.6,2.581,1803.987,597.029,9.59,0.498,4
1,130,78,37015,9,1307,0,0,71.3,38928341,54.422,18.6,2.581,1803.987,597.029,9.59,0.498,4
1,131,39,37054,5,1312,0,0,71.3,38928341,54.422,18.6,2.581,1803.987,597.029,9.59,0.498,4
1,132,0,37054,0,1312,0,0,71.3,38928341,54.422,18.6,2.581,1803.987,597.029,9.59,0.498,4
1,133,0,37054,0,1312,0,0,71.3,38928341,54.422,18.6,2.581,1803.987,597.029,9.59,0.498,4
1,134,215,37269,32,1344,0,0,71.3,38928341,54.422,18.6,2.581,1803.987,597.029,9.59,0.498,4
1,135,76,37345,10,1354,0,0,71.3,38928341,54.422,18.6,2.581,1803.987,597.029,9.59,0.498,4
1,136,79,37424,9,1363,0,0,71.3,38928341,54.422,18.6,2.581,1803.987,597.029,9.59,0.498,4
1,137,7,37431,0,1363,0,0,60.19,38928341,54.422,18.6,2.581,1803.987,597.029,9.59,0.498,4
1,138,120,37551,7,1370,0,0,60.19,38928341,54.422,18.6,2.581,1803.987,597.029,9.59,0.498,4
1,139,45,37596,5,1375,0,0,60.19,38928341,54.422,18.6,2.581,1803.987,597.029,9.59,0.498,4
1,140,3,37599,0,1375,0,0,48.15,38928341,54.422,18.6,2.581,1803.987,597.029,9.59,0.498,4
1,141,0,37599,0,1375,0,0,48.15,38928341,54.422,18.6,2.581,1803.987,597.029,9.59,0.498,4
1,142,160,37759,8,1383,0,0,48.15,38928341,54.422,18.6,2.581,1803.987,597.029,9.59,0.498,4
1,143,97,37856,2,1385,0,0,48.15,38928341,54.422,18.6,2.581,1803.987,597.029,9.59,0.498,4
1,144,38,37894,0,1385,0,0,48.15,38928341,54.422,18.6,2.581,1803.987,597.029,9.59,0.498,4
1,145,105,37999,2,1387,0,0,48.15,38928341,54.422,18.6,2.581,1803.987,597.029,9.59,0.498,4
1,146,0,37999,0,1387,0,0,48.15,38928341,54.422,18.6,2.581,1803.987,597.029,9.59,0.498,4
1,147,71,38070,10,1397,0,0,48.15,38928341,54.422,18.6,2.581,1803.987,597.029,9.59,0.498,4
1,148,1,38071,0,1397,0,0,21.3,38928341,54.422,18.6,2.581,1803.987,597.029,9.59,0.498,4
1,149,55,38126,4,1401,0,0,21.3,38928341,54.422,18.6,2.581,1803.987,597.029,9.59,0.498,4
1,150,3,38129,0,1401,0,0,21.3,38928341,54.422,18.6,2.581,1803.987,597.029,9.59,0.498,4
1,151,11,38140,1,1402,0,0,21.3,38928341,54.422,18.6,2.581,1803.987,597.029,9.59,0.498,4
1,152,3,38143,0,1402,0,0,21.3,38928341,54.422,18.6,2.581,1803.987,597.029,9.59,0.498,4
1,153,19,38162,0,1402,0,0,21.3,38928341,54.422,18.6,2.581,1803.987,597.029,9.59,0.498,4
1,154,34,38196,4,1406,0,0,21.3,38928341,54.422,18.6,2.581,1803.987,597.029,9.59,0.498,4
1,155,9,38205,0,1406,0,0,21.3,38928341,54.422,18.6,2.581,1803.987,597.029,9.59,0.498,4
1,156,38,38243,3,1409,0,0,21.3,38928341,54.422,18.6,2.581,1803.987,597.029,9.59,0.498,4
1,157,45,38288,1,1410,0,0,21.3,38928341,54.422,18.6,2.581,1803.987,597.029,9.59,0.498,4
1,158,16,38304,0,1410,0,0,21.3,38928341,54.422,18.6,2.581,1803.987,597.029,9.59,0.498,4
1,159,20,38324,0,1410,0,0,21.3,38928341,54.422,18.6,2.581,1803.987,597.029,9.59,0.498,4
1,160,74,38398,2,1412,0,0,21.3,38928341,54.422,18.6,2.581,1803.987,597.029,9.59,0.498,4
1,161,96,38494,3,1415,0,0,21.3,38928341,54.422,18.6,2.581,1803.987,597.029,9.59,0.498,4
1,162,26,38520,3,1418,0,0,21.3,38928341,54.422,18.6,2.581,1803.987,597.029,9.59,0.498,4
1,163,24,38544,2,1420,0,0,21.3,38928341,54.422,18.6,2.581,1803.987,597.029,9.59,0.498,4
1,164,28,38572,0,1420,0,0,21.3,38928341,54.422,18.6,2.581,1803.987,597.029,9.59,0.498,4
1,165,34,38606,0,1420,0,0,21.3,38928341,54.422,18.6,2.581,1803.987,597.029,9.59,0.498,4
1,166,35,38641,0,1420,0,0,21.3,38928341,54.422,18.6,2.581,1803.987,597.029,9.59,0.498,4
1,167,75,38716,0,1420,0,0,21.3,38928341,54.422,18.6,2.581,1803.987,597.029,9.59,0.498,4
1,168,99,38815,6,1426,0,0,21.3,38928341,54.422,18.6,2.581,1803.987,597.029,9.59,0.498,4
1,169,40,38855,10,1436,0,0,21.3,38928341,54.422,18.6,2.581,1803.987,597.029,9.59,0.498,4
1,170,17,38872,0,1436,0,0,21.3,38928341,54.422,18.6,2.581,1803.987,597.029,9.59,0.498,4
1,171,0,38872,0,1436,0,0,21.3,38928341,54.422,18.6,2.581,1803.987,597.029,9.59,0.498,4
1,172,47,38919,1,1437,0,0,21.3,38928341,54.422,18.6,2.581,1803.987,597.029,9.59,0.498,4
1,173,125,39044,4,1441,0,0,21.3,38928341,54.422,18.6,2.581,1803.987,597.029,9.59,0.498,4
1,174,0,39044,0,1441,0,0,21.3,38928341,54.422,18.6,2.581,1803.987,597.029,9.59,0.498,4
1,175,30,39074,3,1444,0,0,28.7,38928341,54.422,18.6,2.581,1803.987,597.029,9.59,0.498,4
1,176,71,39145,2,1446,0,0,28.7,38928341,54.422,18.6,2.581,1803.987,597.029,9.59,0.498,4
1,177,25,39170,5,1451,0,0,28.7,38928341,54.422,18.6,2.581,1803.987,597.029,9.59,0.498,4
1,178,16,39186,0,1451,0,0,28.7,38928341,54.422,18.6,2.581,1803.987,597.029,9.59,0.498,4
1,179,6,39192,2,1453,0,0,28.7,38928341,54.422,18.6,2.581,1803.987,597.029,9.59,0.498,4
1,180,35,39227,0,1453,0,0,28.7,38928341,54.422,18.6,2.581,1803.987,597.029,9.59,0.498,4
1,181,0,39227,0,1453,0,0,28.7,38928341,54.422,18.6,2.581,1803.987,597.029,9.59,0.498,4
1,182,12,39239,3,1456,0,0,28.7,38928341,54.422,18.6,2.581,1803.987,597.029,9.59,0.498,4
1,183,15,39254,2,1458,0,0,28.7,38928341,54.422,18.6,2.581,1803.987,597.029,9.59,0.498,4
1,184,14,39268,0,1458,0,0,28.7,38928341,54.422,18.6,2.581,1803.987,597.029,9.59,0.498,4
1,185,17,39285,0,1458,0,0,28.7,38928341,54.422,18.6,2.581,1803.987,597.029,9.59,0.498,4
1,186,5,39290,0,1458,0,0,25,38928341,54.422,18.6,2.581,1803.987,597.029,9.59,0.498,4
1,187,7,39297,4,1462,0,0,25,38928341,54.422,18.6,2.581,1803.987,597.029,9.59,0.498,4
1,188,44,39341,0,1462,0,0,25,38928341,54.422,18.6,2.581,1803.987,597.029,9.59,0.498,4
1,189,145,39486,5,1467,0,0,25,38928341,54.422,18.6,2.581,1803.987,597.029,9.59,0.498,4
1,190,62,39548,2,1469,0,0,25,38928341,54.422,18.6,2.581,1803.987,597.029,9.59,0.498,4
1,191,68,39616,1,1470,0,0,25,38928341,54.422,18.6,2.581,1803.987,597.029,9.59,0.498,4
1,192,77,39693,2,1472,0,0,25,38928341,54.422,18.6,2.581,1803.987,597.029,9.59,0.498,4
1,193,10,39703,1,1473,0,0,25,38928341,54.422,18.6,2.581,1803.987,597.029,9.59,0.498,4
1,194,0,39703,0,1473,0,0,25,38928341,54.422,18.6,2.581,1803.987,597.029,9.59,0.498,4
1,195,96,39799,4,1477,0,0,25,38928341,54.422,18.6,2.581,1803.987,597.029,9.59,0.498,4
1,196,129,39928,3,1480,0,0,25,38928341,54.422,18.6,2.581,1803.987,597.029,9.59,0.498,4
1,197,66,39994,0,1480,0,0,25,38928341,54.422,18.6,2.581,1803.987,597.029,9.59,0.498,4
1,198,32,40026,1,1481,0,0,25,38928341,54.422,18.6,2.581,1803.987,597.029,9.59,0.498,4
1,199,0,40026,0,1481,0,0,25,38928341,54.422,18.6,2.581,1803.987,597.029,9.59,0.498,4
1,200,47,40073,4,1485,0,0,25,38928341,54.422,18.6,2.581,1803.987,597.029,9.59,0.498,4
1,201,68,40141,3,1488,0,0,25,38928341,54.422,18.6,2.581,1803.987,597.029,9.59,0.498,4
1,202,59,40200,4,1492,0,0,25,38928341,54.422,18.6,2.581,1803.987,597.029,9.59,0.498,4
1,203,87,40287,5,1497,0,0,25,38928341,54.422,18.6,2.581,1803.987,597.029,9.59,0.498,4
1,204,88,40375,2,1499,0,0,25,38928341,54.422,18.6,2.581,1803.987,597.029,9.59,0.498,4
2,1,20,243,3,15,0,0,84.26,2877800,104.871,38,13.188,11803.431,304.195,10.08,0.785,0
2,2,16,259,0,15,0,0,84.26,2877800,104.871,38,13.188,11803.431,304.195,10.08,0.785,0
2,3,18,277,1,16,0,0,84.26,2877800,104.871,38,13.188,11803.431,304.195,10.08,0.785,0
2,4,27,304,1,17,0,0,84.26,2877800,104.871,38,13.188,11803.431,304.195,10.08,0.785,0
2,5,29,333,2,19,0,0,84.26,2877800,104.871,38,13.188,11803.431,304.195,10.08,0.785,0
2,6,28,361,2,21,0,0,84.26,2877800,104.871,38,13.188,11803.431,304.195,10.08,0.785,0
2,7,16,377,1,22,0,0,84.26,2877800,104.871,38,13.188,11803.431,304.195,10.08,0.785,0
2,8,6,383,0,22,0,0,84.26,2877800,104.871,38,13.188,11803.431,304.195,10.08,0.785,0
2,9,17,400,0,22,0,0,84.26,2877800,104.871,38,13.188,11803.431,304.195,10.08,0.785,0
2,10,9,409,1,23,0,0,84.26,2877800,104.871,38,13.188,11803.431,304.195,10.08,0.785,0
2,11,7,416,0,23,0,0,84.26,2877800,104.871,38,13.188,11803.431,304.195,10.08,0.785,0
2,12,17,433,0,23,0,0,84.26,2877800,104.871,38,13.188,11803.431,304.195,10.08,0.785,0
2,13,13,446,0,23,0,0,84.26,2877800,104.871,38,13.188,11803.431,304.195,10.08,0.785,0
2,14,21,467,0,23,0,0,84.26,2877800,104.871,38,13.188,11803.431,304.195,10.08,0.785,0
2,15,8,475,1,24,0,0,84.26,2877800,104.871,38,13.188,11803.431,304.195,10.08,0.785,0
2,16,19,494,1,25,0,0,84.26,2877800,104.871,38,13.188,11803.431,304.195,10.08,0.785,0
2,17,24,518,1,26,0,0,84.26,2877800,104.871,38,13.188,11803.431,304.195,10.08,0.785,0
2,18,21,539,0,26,0,0,89.81,2877800,104.871,38,13.188,11803.431,304.195,10.08,0.785,0
2,19,9,548,0,26,0,0,89.81,2877800,104.871,38,13.188,11803.431,304.195,10.08,0.785,0
2,20,14,562,0,26,0,0,89.81,2877800,104.871,38,13.188,11803.431,304.195,10.08,0.785,0
2,21,22,584,0,26,0,0,89.81,2877800,104.871,38,13.188,11803.431,304.195,10.08,0.785,0
2,22,25,609,0,26,0,0,89.81,2877800,104.871,38,13.188,11803.431,304.195,10.08,0.785,0
2,23,25,634,1,27,0,0,89.81,2877800,104.871,38,13.188,11803.431,304.195,10.08,0.785,0
2,24,29,663,0,27,0,0,89.81,2877800,104.871,38,13.188,11803.431,304.195,10.08,0.785,0
2,25,15,678,0,27,0,0,89.81,2877800,104.871,38,13.188,11803.431,304.195,10.08,0.785,0
2,26,34,712,0,27,0,0,89.81,2877800,104.871,38,13.188,11803.431,304.195,10.08,0.785,0
2,27,14,726,1,28,0,0,89.81,2877800,104.871,38,13.188,11803.431,304.195,10.08,0.785,0
2,28,10,736,0,28,0,0,89.81,2877800,104.871,38,13.188,11803.431,304.195,10.08,0.785,0
2,29,14,750,2,30,0,0,89.81,2877800,104.871,38,13.188,11803.431,304.195,10.08,0.785,0
2,30,16,766,1,31,0,0,89.81,2877800,104.871,38,13.188,11803.431,304.195,10.08,0.785,0
2,31,7,773,0,31,0,0,89.81,2877800,104.871,38,13.188,11803.431,304.195,10.08,0.785,0
2,32,9,782,0,31,0,0,89.81,2877800,104.871,38,13.188,11803.431,304.195,10.08,0.785,0
2,33,7,789,0,31,0,0,89.81,2877800,104.871,38,13.188,11803.431,304.195,10.08,0.785,0
2,34,6,795,0,31,0,0,89.81,2877800,104.871,38,13.188,11803.431,304.195,10.08,0.785,0
2,35,8,803,0,31,0,0,89.81,2877800,104.871,38,13.188,11803.431,304.195,10.08,0.785,0
2,36,17,820,0,31,0,0,89.81,2877800,104.871,38,13.188,11803.431,304.195,10.08,0.785,0
2,37,12,832,0,31,0,0,89.81,2877800,104.871,38,13.188,11803.431,304.195,10.08,0.785,0
2,38,10,842,0,31,0,0,89.81,2877800,104.871,38,13.188,11803.431,304.195,10.08,0.785,0
2,39,8,850,0,31,0,0,89.81,2877800,104.871,38,13.188,11803.431,304.195,10.08,0.785,0
2,40,6,856,0,31,0,0,89.81,2877800,104.871,38,13.188,11803.431,304.195,10.08,0.785,0
2,41,12,868,0,31,0,0,89.81,2877800,104.871,38,13.188,11803.431,304.195,10.08,0.785,0
2,42,4,872,0,31,0,0,89.81,2877800,104.871,38,13.188,11803.431,304.195,10.08,0.785,0
2,43,4,876,0,31,0,0,89.81,2877800,104.871,38,13.188,11803.431,304.195,10.08,0.785,0
2,44,4,880,0,31,0,0,89.81,2877800,104.871,38,13.188,11803.431,304.195,10.08,0.785,0
2,45,18,898,0,31,0,0,89.81,2877800,104.871,38,13.188,11803.431,304.195,10.08,0.785,0
2,46,18,916,0,31,0,0,89.81,2877800,104.871,38,13.188,11803.431,304.195,10.08,0.785,0
2,47,17,933,0,31,0,0,89.81,2877800,104.871,38,13.188,11803.431,304.195,10.08,0.785,0
2,48,13,946,0,31,0,0,83.33,2877800,104.871,38,13.188,11803.431,304.195,10.08,0.785,0
2,49,2,948,0,31,0,0,83.33,2877800,104.871,38,13.188,11803.431,304.195,10.08,0.785,0
2,50,1,949,0,31,0,0,83.33,2877800,104.871,38,13.188,11803.431,304.195,10.08,0.785,0
2,51,15,964,0,31,0,0,83.33,2877800,104.871,38,13.188,11803.431,304.195,10.08,0.785,0
2,52,5,969,0,31,0,0,83.33,2877800,104.871,38,13.188,11803.431,304.195,10.08,0.785,0
2,53,12,981,0,31,0,0,83.33,2877800,104.871,38,13.188,11803.431,304.195,10.08,0.785,0
2,54,8,989,0,31,0,0,83.33,2877800,104.871,38,13.188,11803.431,304.195,10.08,0.785,0
2,55,9,998,1,32,0,0,83.33,2877800,104.871,38,13.188,11803.431,304.195,10.08,0.785,0
2,56,6,1004,0,32,0,0,86.11,2877800,104.871,38,13.188,11803.431,304.195,10.08,0.785,0
2,57,25,1029,1,33,0,0,86.11,2877800,104.871,38,13.188,11803.431,304.195,10.08,0.785,0
2,58,21,1050,0,33,0,0,86.11,2877800,104.871,38,13.188,11803.431,304.195,10.08,0.785,0
2,59,26,1076,0,33,0,0,86.11,2877800,104.871,38,13.188,11803.431,304.195,10.08,0.785,0
2,60,23,1099,0,33,0,0,86.11,2877800,104.871,38,13.188,11803.431,304.195,10.08,0.785,0
2,61,23,1122,0,33,0,0,86.11,2877800,104.871,38,13.188,11803.431,304.195,10.08,0.785,0
2,62,15,1137,0,33,0,0,67.59,2877800,104.871,38,13.188,11803.431,304.195,10.08,0.785,0
2,63,6,1143,0,33,0,0,67.59,2877800,104.871,38,13.188,11803.431,304.195,10.08,0.785,0
2,64,21,1164,0,33,0,0,67.59,2877800,104.871,38,13.188,11803.431,304.195,10.08,0.785,0
2,65,20,1184,0,33,0,0,67.59,2877800,104.871,38,13.188,11803.431,304.195,10.08,0.785,0
2,66,13,1197,0,33,0,0,67.59,2877800,104.871,38,13.188,11803.431,304.195,10.08,0.785,0
2,67,15,1212,0,33,0,0,67.59,2877800,104.871,38,13.188,11803.431,304.195,10.08,0.785,0
2,68,20,1232,1,34,0,0,67.59,2877800,104.871,38,13.188,11803.431,304.195,10.08,0.785,0
2,69,14,1246,0,34,0,0,67.59,2877800,104.871,38,13.188,11803.431,304.195,10.08,0.785,0
2,70,17,1263,0,34,0,0,67.59,2877800,104.871,38,13.188,11803.431,304.195,10.08,0.785,0
2,71,36,1299,0,34,0,0,67.59,2877800,104.871,38,13.188,11803.431,304.195,10.08,0.785,0
2,72,42,1341,0,34,0,0,67.59,2877800,104.871,38,13.188,11803.431,304.195,10.08,0.785,0
2,73,44,1385,1,35,0,0,67.59,2877800,104.871,38,13.188,11803.431,304.195,10.08,0.785,0
2,74,31,1416,1,36,0,0,67.59,2877800,104.871,38,13.188,11803.431,304.195,10.08,0.785,0
2,75,48,1464,0,36,0,0,67.59,2877800,104.871,38,13.188,11803.431,304.195,10.08,0.785,0
2,76,57,1521,0,36,0,0,67.59,2877800,104.871,38,13.188,11803.431,304.195,10.08,0.785,0
2,77,69,1590,0,36,0,0,67.59,2877800,104.871,38,13.188,11803.431,304.195,10.08,0.785,0
2,78,82,1672,1,37,0,0,67.59,2877800,104.871,38,13.188,11803.431,304.195,10.08,0.785,0
2,79,50,1722,1,38,0,0,67.59,2877800,104.871,38,13.188,11803.431,304.195,10.08,0.785,0
2,80,66,1788,1,39,0,0,67.59,2877800,104.871,38,13.188,11803.431,304.195,10.08,0.785,0
2,81,50,1838,3,42,0,0,67.59,2877800,104.871,38,13.188,11803.431,304.195,10.08,0.785,0
2,82,53,1891,1,43,0,0,67.59,2877800,104.871,38,13.188,11803.431,304.195,10.08,0.785,0
2,83,36,1927,1,44,0,0,64.81,2877800,104.871,38,13.188,11803.431,304.195,10.08,0.785,0
2,84,68,1995,0,44,0,0,64.81,2877800,104.871,38,13.188,11803.431,304.195,10.08,0.785,0
2,85,52,2047,1,45,0,0,64.81,2877800,104.871,38,13.188,11803.431,304.195,10.08,0.785,0
2,86,67,2114,2,47,0,0,64.81,2877800,104.871,38,13.188,11803.431,304.195,10.08,0.785,0
2,87,78,2192,2,49,0,0,64.81,2877800,104.871,38,13.188,11803.431,304.195,10.08,0.785,0
2,88,77,2269,2,51,0,0,64.81,2877800,104.871,38,13.188,11803.431,304.195,10.08,0.785,0
2,89,61,2330,2,53,0,0,64.81,2877800,104.871,38,13.188,11803.431,304.195,10.08,0.785,0
2,90,72,2402,2,55,0,0,64.81,2877800,104.871,38,13.188,11803.431,304.195,10.08,0.785,0
2,91,64,2466,3,58,0,0,64.81,2877800,104.871,38,13.188,11803.431,304.195,10.08,0.785,0
2,92,69,2535,4,62,0,0,64.81,2877800,104.871,38,13.188,11803.431,304.195,10.08,0.785,0
2,93,45,2580,3,65,0,0,64.81,2877800,104.871,38,13.188,11803.431,304.195,10.08,0.785,0
2,94,82,2662,4,69,0,0,64.81,2877800,104.871,38,13.188,11803.431,304.195,10.08,0.785,0
2,95,90,2752,3,72,0,0,64.81,2877800,104.871,38,13.188,11803.431,304.195,10.08,0.785,0
2,96,67,2819,2,74,0,0,64.81,2877800,104.871,38,13.188,11803.431,304.195,10.08,0.785,0
2,97,74,2893,2,76,0,0,59.26,2877800,104.871,38,13.188,11803.431,304.195,10.08,0.785,0
2,98,71,2964,3,79,0,0,59.26,2877800,104.871,38,13.188,11803.431,304.195,10.08,0.785,0
2,99,74,3038,2,81,0,0,59.26,2877800,104.871,38,13.188,11803.431,304.195,10.08,0.785,0
2,100,68,3106,2,83,0,0,59.26,2877800,104.871,38,13.188,11803.431,304.195,10.08,0.785,0
2,101,82,3188,0,83,0,0,59.26,2877800,104.871,38,13.188,11803.431,304.195,10.08,0.785,0
2,102,90,3278,2,85,0,0,59.26,2877800,104.871,38,13.188,11803.431,304.195,10.08,0.785,0
2,103,93,3371,4,89,0,0,59.26,2877800,104.871,38,13.188,11803.431,304.195,10.08,0.785,0
2,104,83,3454,4,93,0,0,59.26,2877800,104.871,38,13.188,11803.431,304.195,10.08,0.785,0
2,105,117,3571,2,95,0,0,59.26,2877800,104.871,38,13.188,11803.431,304.195,10.08,0.785,0
2,106,96,3667,2,97,0,0,59.26,2877800,104.871,38,13.188,11803.431,304.195,10.08,0.785,0
2,107,85,3752,4,101,0,0,59.26,2877800,104.871,38,13.188,11803.431,304.195,10.08,0.785,0
2,108,99,3851,3,104,0,0,59.26,2877800,104.871,38,13.188,11803.431,304.195,10.08,0.785,0
2,109,55,3906,3,107,0,0,59.26,2877800,104.871,38,13.188,11803.431,304.195,10.08,0.785,0
2,110,102,4008,4,111,0,0,59.26,2877800,104.871,38,13.188,11803.431,304.195,10.08,0.785,0
2,111,82,4090,1,112,0,0,59.26,2877800,104.871,38,13.188,11803.431,304.195,10.08,0.785,0
2,112,81,4171,1,113,0,0,59.26,2877800,104.871,38,13.188,11803.431,304.195,10.08,0.785,0
2,113,119,4290,4,117,0,0,59.26,2877800,104.871,38,13.188,11803.431,304.195,10.08,0.785,0
2,114,68,4358,3,120,0,0,59.26,2877800,104.871,38,13.188,11803.431,304.195,10.08,0.785,0
2,115,108,4466,3,123,0,0,59.26,2877800,104.871,38,13.188,11803.431,304.195,10.08,0.785,0
2,116,104,4570,5,128,0,0,59.26,2877800,104.871,38,13.188,11803.431,304.195,10.08,0.785,0
2,117,67,4637,6,134,0,0,59.26,2877800,104.871,38,13.188,11803.431,304.195,10.08,0.785,0
2,118,126,4763,4,138,0,0,59.26,2877800,104.871,38,13.188,11803.431,304.195,10.08,0.785,0
2,119,117,4880,6,144,0,0,59.26,2877800,104.871,38,13.188,11803.431,304.195,10.08,0.785,0
2,120,117,4997,4,148,0,0,59.26,2877800,104.871,38,13.188,11803.431,304.195,10.08,0.785,0
2,121,108,5105,2,150,0,0,59.26,2877800,104.871,38,13.188,11803.431,304.195,10.08,0.785,0
2,122,92,5197,4,154,0,0,59.26,2877800,104.871,38,13.188,11803.431,304.195,10.08,0.785,0
2,123,79,5276,3,157,0,0,59.26,2877800,104.871,38,13.188,11803.431,304.195,10.08,0.785,0
2,124,120,5396,4,161,0,0,59.26,2877800,104.871,38,13.188,11803.431,304.195,10.08,0.785,0
2,125,123,5519,5,166,0,0,59.26,2877800,104.871,38,13.188,11803.431,304.195,10.08,0.785,0
2,126,101,5620,6,172,0,0,59.26,2877800,104.871,38,13.188,11803.431,304.195,10.08,0.785,0
2,127,130,5750,4,176,0,0,59.26,2877800,104.871,38,13.188,11803.431,304.195,10.08,0.785,0
2,128,139,5889,6,182,0,0,59.26,2877800,104.871,38,13.188,11803.431,304.195,10.08,0.785,0
2,129,127,6016,6,188,0,0,53.7,2877800,104.871,38,13.188,11803.431,304.195,10.08,0.785,0
2,130,135,6151,1,189,0,0,53.7,2877800,104.871,38,13.188,11803.431,304.195,10.08,0.785,0
2,131,124,6275,4,193,0,0,53.7,2877800,104.871,38,13.188,11803.431,304.195,10.08,0.785,0
2,132,136,6411,6,199,0,0,53.7,2877800,104.871,38,13.188,11803.431,304.195,10.08,0.785,0
2,133,125,6536,1,200,0,0,53.7,2877800,104.871,38,13.188,11803.431,304.195,10.08,0.785,0
2,134,140,6676,5,205,0,0,53.7,2877800,104.871,38,13.188,11803.431,304.195,10.08,0.785,0
2,135,141,6817,3,208,0,0,53.7,2877800,104.871,38,13.188,11803.431,304.195,10.08,0.785,0
2,136,154,6971,5,213,0,0,53.7,2877800,104.871,38,13.188,11803.431,304.195,10.08,0.785,0
2,137,146,7117,6,219,0,0,53.7,2877800,104.871,38,13.188,11803.431,304.195,10.08,0.785,0
2,138,143,7260,6,225,0,0,53.7,2877800,104.871,38,13.188,11803.431,304.195,10.08,0.785,0
2,139,120,7380,3,228,0,0,53.7,2877800,104.871,38,13.188,11803.431,304.195,10.08,0.785,0
2,140,119,7499,2,230,0,0,53.7,2877800,104.871,38,13.188,11803.431,304.195,10.08,0.785,0
2,141,155,7654,2,232,0,0,53.7,2877800,104.871,38,13.188,11803.431,304.195,10.08,0.785,0
2,142,158,7812,2,234,0,0,53.7,2877800,104.871,38,13.188,11803.431,304.195,10.08,0.785,0
2,143,155,7967,4,238,0,0,53.7,2877800,104.871,38,13.188,11803.431,304.195,10.08,0.785,0
2,144,152,8119,2,240,0,0,53.7,2877800,104.871,38,13.188,11803.431,304.195,10.08,0.785,0
2,145,156,8275,5,245,0,0,53.7,2877800,104.871,38,13.188,11803.431,304.195,10.08,0.785,0
2,146,152,8427,5,250,0,0,53.7,2877800,104.871,38,13.188,11803.431,304.195,10.08,0.785,0
2,147,178,8605,4,254,0,0,53.7,2877800,104.871,38,13.188,11803.431,304.195,10.08,0.785,0
2,148,154,8759,5,259,0,0,53.7,2877800,104.871,38,13.188,11803.431,304.195,10.08,0.785,0
2,149,168,8927,4,263,0,0,53.7,2877800,104.871,38,13.188,11803.431,304.195,10.08,0.785,0
2,150,156,9083,3,266,0,0,54.63,2877800,104.871,38,13.188,11803.431,304.195,10.08,0.785,0
2,151,112,9195,5,271,0,0,54.63,2877800,104.871,38,13.188,11803.431,304.195,10.08,0.785,0
2,152,84,9279,4,275,0,0,54.63,2877800,104.871,38,13.188,11803.431,304.195,10.08,0.785,0
2,153,101,9380,5,280,0,0,54.63,2877800,104.871,38,13.188,11803.431,304.195,10.08,0.785,0
2,154,133,9513,4,284,0,0,54.63,2877800,104.871,38,13.188,11803.431,304.195,10.08,0.785,0
2,155,93,9606,6,290,0,0,54.63,2877800,104.871,38,13.188,11803.431,304.195,10.08,0.785,0
2,156,122,9728,6,296,0,0,54.63,2877800,104.871,38,13.188,11803.431,304.195,10.08,0.785,0
2,157,116,9844,5,301,0,0,54.63,2877800,104.871,38,13.188,11803.431,304.195,10.08,0.785,0
2,158,123,9967,5,306,0,0,54.63,2877800,104.871,38,13.188,11803.431,304.195,10.08,0.785,0
2,159,135,10102,6,312,0,0,54.63,2877800,104.871,38,13.188,11803.431,304.195,10.08,0.785,0
2,160,153,10255,4,316,0,0,54.63,2877800,104.871,38,13.188,11803.431,304.195,10.08,0.785,0
2,161,151,10406,3,319,0,0,54.63,2877800,104.871,38,13.188,11803.431,304.195,10.08,0.785,0
2,162,147,10553,2,321,0,0,54.63,2877800,104.871,38,13.188,11803.431,304.195,10.08,0.785,0
2,163,151,10704,1,322,0,0,54.63,2877800,104.871,38,13.188,11803.431,304.195,10.08,0.785,0
2,164,156,10860,2,324,0,0,54.63,2877800,104.871,38,13.188,11803.431,304.195,10.08,0.785,0
2,165,161,11021,3,327,0,0,54.63,2877800,104.871,38,13.188,11803.431,304.195,10.08,0.785,0
2,166,164,11185,3,330,0,0,54.63,2877800,104.871,38,13.188,11803.431,304.195,10.08,0.785,0
2,167,168,11353,4,334,0,0,43.52,2877800,104.871,38,13.188,11803.431,304.195,10.08,0.785,0
2,168,167,11520,4,338,0,0,43.52,2877800,104.871,38,13.188,11803.431,304.195,10.08,0.785,0
2,169,152,11672,2,340,0,0,43.52,2877800,104.871,38,13.188,11803.431,304.195,10.08,0.785,0
2,170,144,11816,3,343,0,0,43.52,2877800,104.871,38,13.188,11803.431,304.195,10.08,0.785,0
2,171,132,11948,5,348,0,0,43.52,2877800,104.871,38,13.188,11803.431,304.195,10.08,0.785,0
2,172,125,12073,5,353,0,0,43.52,2877800,104.871,38,13.188,11803.431,304.195,10.08,0.785,0
2,173,153,12226,5,358,0,0,43.52,2877800,104.871,38,13.188,11803.431,304.195,10.08,0.785,0
2,174,159,12385,4,362,0,0,43.52,2877800,104.871,38,13.188,11803.431,304.195,10.08,0.785,0
2,175,150,12535,2,364,0,0,43.52,2877800,104.871,38,13.188,11803.431,304.195,10.08,0.785,0
2,176,131,12666,3,367,0,0,43.52,2877800,104.871,38,13.188,11803.431,304.195,10.08,0.785,0
2,177,121,12787,3,370,0,0,43.52,2877800,104.871,38,13.188,11803.431,304.195,10.08,0.785,0
2,178,134,12921,0,370,0,0,43.52,2877800,104.871,38,13.188,11803.431,304.195,10.08,0.785,0
2,179,124,13045,3,373,0,0,43.52,2877800,104.871,38,13.188,11803.431,304.195,10.08,0.785,0
2,180,108,13153,2,375,0,0,43.52,2877800,104.871,38,13.188,11803.431,304.195,10.08,0.785,0
2,181,106,13259,2,377,0,0,43.52,2877800,104.871,38,13.188,11803.431,304.195,10.08,0.785,0
2,182,132,13391,3,380,0,0,43.52,2877800,104.871,38,13.188,11803.431,304.195,10.08,0.785,0
2,183,127,13518,4,384,0,0,43.52,2877800,104.871,38,13.188,11803.431,304.195,10.08,0.785,0
2,184,131,13649,3,387,0,0,43.52,2877800,104.871,38,13.188,11803.431,304.195,10.08,0.785,0
2,185,157,13806,1,388,0,0,43.52,2877800,104.871,38,13.188,11803.431,304.195,10.08,0.785,0
2,186,159,13965,1,389,0,0,43.52,2877800,104.871,38,13.188,11803.431,304.195,10.08,0.785,0
2,187,152,14117,3,392,0,0,43.52,2877800,104.871,38,13.188,11803.431,304.195,10.08,0.785,0
2,188,149,14266,4,396,0,0,43.52,2877800,104.871,38,13.188,11803.431,304.195,10.08,0.785,0
2,189,144,14410,4,400,0,0,43.52,2877800,104.871,38,13.188,11803.431,304.195,10.08,0.785,0
2,190,158,14568,3,403,0,0,43.52,2877800,104.871,38,13.188,11803.431,304.195,10.08,0.785,0
2,191,162,14730,4,407,0,0,43.52,2877800,104.871,38,13.188,11803.431,304.195,10.08,0.785,0
2,192,169,14899,4,411,0,0,43.52,2877800,104.871,38,13.188,11803.431,304.195,10.08,0.785,0
2,193,167,15066,2,413,0,0,43.52,2877800,104.871,38,13.188,11803.431,304.195,10.08,0.785,0
2,194,165,15231,3,416,0,0,43.52,2877800,104.871,38,13.188,11803.431,304.195,10.08,0.785,0
2,195,168,15399,4,420,0,0,43.52,2877800,104.871,38,13.188,11803.431,304.195,10.08,0.785,0
2,196,171,15570,4,424,0,0,43.52,2877800,104.871,38,13.188,11803.431,304.195,10.08,0.785,0
2,197,182,15752,5,429,0,0,43.52,2877800,104.871,38,13.188,11803.431,304.195,10.08,0.785,0
2,198,203,15955,5,434,0,0,43.52,2877800,104.871,38,13.188,11803.431,304.195,10.08,0.785,0
2,199,257,16212,5,439,0,0,43.52,2877800,104.871,38,13.188,11803.431,304.195,10.08,0.785,0
2,200,289,16501,4,443,0,0,43.52,2877800,104.871,38,13.188,11803.431,304.195,10.08,0.785,0
2,201,273,16774,5,448,0,0,43.52,2877800,104.871,38,13.188,11803.431,304.195,10.08,0.785,0
2,202,281,17055,3,451,0,0,43.52,2877800,104.871,38,13.188,11803.431,304.195,10.08,0.785,0
2,203,295,17350,3,454,0,0,43.52,2877800,104.871,38,13.188,11803.431,304.195,10.08,0.785,0
2,204,301,17651,4,458,0,0,43.52,2877800,104.871,38,13.188,11803.431,304.195,10.08,0.785,0
3,1,132,716,9,44,0,0,86.57,43851043,17.348,29.1,6.211,13913.839,278.364,6.73,0.754,4
3,2,131,847,14,58,0,0,86.57,43851043,17.348,29.1,6.211,13913.839,278.364,6.73,0.754,4
3,3,139,986,5,63,0,0,86.57,43851043,17.348,29.1,6.211,13913.839,278.364,6.73,0.754,4
3,4,185,1171,42,105,0,0,86.57,43851043,17.348,29.1,6.211,13913.839,278.364,6.73,0.754,4
3,5,80,1251,25,130,0,0,86.57,43851043,17.348,29.1,6.211,13913.839,278.364,6.73,0.754,4
3,6,69,1320,22,152,0,0,86.57,43851043,17.348,29.1,6.211,13913.839,278.364,6.73,0.754,4
3,7,103,1423,21,173,0,0,86.57,43851043,17.348,29.1,6.211,13913.839,278.364,6.73,0.754,4
3,8,45,1468,20,193,0,0,86.57,43851043,17.348,29.1,6.211,13913.839,278.364,6.73,0.754,4
3,9,104,1572,12,205,0,0,86.57,43851043,17.348,29.1,6.211,13913.839,278.364,6.73,0.754,4
3,10,94,1666,30,235,0,0,86.57,43851043,17.348,29.1,6.211,13913.839,278.364,6.73,0.754,4
3,11,95,1761,21,256,0,0,86.57,43851043,17.348,29.1,6.211,13913.839,278.364,6.73,0.754,4
3,12,64,1825,19,275,0,0,86.57,43851043,17.348,29.1,6.211,13913.839,278.364,6.73,0.754,4
3,13,89,1914,18,293,0,0,86.57,43851043,17.348,29.1,6.211,13913.839,278.364,6.73,0.754,4
3,14,69,1983,20,313,0,0,92.13,43851043,17.348,29.1,6.211,13913.839,278.364,6.73,0.754,4
3,15,87,2070,12,325,0,0,92.13,43851043,17.348,29.1,6.211,13913.839,278.364,6.73,0.754,4
3,16,90,2160,11,336,0,0,92.13,43851043,17.348,29.1,6.211,13913.839,278.364,6.73,0.754,4
3,17,108,2268,12,348,0,0,92.13,43851043,17.348,29.1,6.211,13913.839,278.364,6.73,0.754,4
3,18,150,2418,16,364,0,0,92.13,43851043,17.348,29.1,6.211,13913.839,278.364,6.73,0.754,4
3,19,117,2535,3,367,0,0,92.13,43851043,17.348,29.1,6.211,13913.839,278.364,6.73,0.754,4
3,20,94,2629,8,375,0,0,92.13,43851043,17.348,29.1,6.211,13913.839,278.364,6.73,0.754,4
3,21,89,2718,9,384,0,0,92.13,43851043,17.348,29.1,6.211,13913.839,278.364,6.73,0.754,4
3,22,93,2811,8,392,0,0,92.13,43851043,17.348,29.1,6.211,13913.839,278.364,6.73,0.754,4
3,23,99,2910,10,402,0,0,92.13,43851043,17.348,29.1,6.211,13913.839,278.364,6.73,0.754,4
3,24,97,3007,5,407,0,0,76.85,43851043,17.348,29.1,6.211,13913.839,278.364,6.73,0.754,4
3,25,120,3127,8,415,0,0,76.85,43851043,17.348,29.1,6.211,13913.839,278.364,6.73,0.754,4
3,26,129,3256,4,419,0,0,76.85,43851043,17.348,29.1,6.211,13913.839,278.364,6.73,0.754,4
3,27,126,3382,6,425,0,0,76.85,43851043,17.348,29.1,6.211,13913.839,278.364,6.73,0.754,4
3,28,135,3517,7,432,0,0,76.85,43851043,17.348,29.1,6.211,13913.839,278.364,6.73,0.754,4
3,29,132,3649,5,437,0,0,76.85,43851043,17.348,29.1,6.211,13913.839,278.364,6.73,0.754,4
3,30,199,3848,7,444,0,0,76.85,43851043,17.348,29.1,6.211,13913.839,278.364,6.73,0.754,4
3,31,158,4006,6,450,0,0,76.85,43851043,17.348,29.1,6.211,13913.839,278.364,6.73,0.754,4
3,32,148,4154,3,453,0,0,76.85,43851043,17.348,29.1,6.211,13913.839,278.364,6.73,0.754,4
3,33,141,4295,6,459,0,0,76.85,43851043,17.348,29.1,6.211,13913.839,278.364,6.73,0.754,4
3,34,179,4474,4,463,0,0,76.85,43851043,17.348,29.1,6.211,13913.839,278.364,6.73,0.754,4
3,35,174,4648,2,465,0,0,76.85,43851043,17.348,29.1,6.211,13913.839,278.364,6.73,0.754,4
3,36,190,4838,5,470,0,0,76.85,43851043,17.348,29.1,6.211,13913.839,278.364,6.73,0.754,4
3,37,159,4997,6,476,0,0,76.85,43851043,17.348,29.1,6.211,13913.839,278.364,6.73,0.754,4
3,38,185,5182,7,483,0,0,76.85,43851043,17.348,29.1,6.211,13913.839,278.364,6.73,0.754,4
3,39,187,5369,5,488,0,0,76.85,43851043,17.348,29.1,6.211,13913.839,278.364,6.73,0.754,4
3,40,189,5558,6,494,0,0,76.85,43851043,17.348,29.1,6.211,13913.839,278.364,6.73,0.754,4
3,41,165,5723,8,502,0,0,76.85,43851043,17.348,29.1,6.211,13913.839,278.364,6.73,0.754,4
3,42,168,5891,5,507,0,0,87.96,43851043,17.348,29.1,6.211,13913.839,278.364,6.73,0.754,4
3,43,176,6067,8,515,0,0,87.96,43851043,17.348,29.1,6.211,13913.839,278.364,6.73,0.754,4
3,44,186,6253,7,522,0,0,76.85,43851043,17.348,29.1,6.211,13913.839,278.364,6.73,0.754,4
3,45,189,6442,7,529,0,0,76.85,43851043,17.348,29.1,6.211,13913.839,278.364,6.73,0.754,4
3,46,187,6629,7,536,0,0,76.85,43851043,17.348,29.1,6.211,13913.839,278.364,6.73,0.754,4
3,47,192,6821,6,542,0,0,76.85,43851043,17.348,29.1,6.211,13913.839,278.364,6.73,0.754,4
3,48,198,7019,6,548,0,0,76.85,43851043,17.348,29.1,6.211,13913.839,278.364,6.73,0.754,4
3,49,182,7201,7,555,0,0,76.85,43851043,17.348,29.1,6.211,13913.839,278.364,6.73,0.754,4
3,50,176,7377,6,561,0,0,76.85,43851043,17.348,29.1,6.211,13913.839,278.364,6.73,0.754,4
3,51,165,7542,7,568,0,0,76.85,43851043,17.348,29.1,6.211,13913.839,278.364,6.73,0.754,4
3,52,186,7728,7,575,0,0,76.85,43851043,17.348,29.1,6.211,13913.839,278.364,6.73,0.754,4
3,53,190,7918,7,582,0,0,76.85,43851043,17.348,29.1,6.211,13913.839,278.364,6.73,0.754,4
3,54,195,8113,10,592,0,0,76.85,43851043,17.348,29.1,6.211,13913.839,278.364,6.73,0.754,4
3,55,193,8306,8,600,0,0,76.85,43851043,17.348,29.1,6.211,13913.839,278.364,6.73,0.754,4
3,56,197,8503,9,609,0,0,76.85,43851043,17.348,29.1,6.211,13913.839,278.364,6.73,0.754,4
3,57,194,8697,8,617,0,0,76.85,43851043,17.348,29.1,6.211,13913.839,278.364,6.73,0.754,4
3,58,160,8857,6,623,0,0,76.85,43851043,17.348,29.1,6.211,13913.839,278.364,6.73,0.754,4
3,59,140,8997,7,630,0,0,76.85,43851043,17.348,29.1,6.211,13913.839,278.364,6.73,0.754,4
3,60,137,9134,8,638,0,0,76.85,43851043,17.348,29.1,6.211,13913.839,278.364,6.73,0.754,4
3,61,133,9267,8,646,0,0,76.85,43851043,17.348,29.1,6.211,13913.839,278.364,6.73,0.754,4
3,62,127,9394,7,653,0,0,76.85,43851043,17.348,29.1,6.211,13913.839,278.364,6.73,0.754,4
3,63,119,9513,8,661,0,0,76.85,43851043,17.348,29.1,6.211,13913.839,278.364,6.73,0.754,4
3,64,113,9626,6,667,0,0,76.85,43851043,17.348,29.1,6.211,13913.839,278.364,6.73,0.754,4
3,65,0,9626,0,667,0,0,76.85,43851043,17.348,29.1,6.211,13913.839,278.364,6.73,0.754,4
3,66,205,9831,14,681,0,0,76.85,43851043,17.348,29.1,6.211,13913.839,278.364,6.73,0.754,4
3,67,104,9935,9,690,0,0,76.85,43851043,17.348,29.1,6.211,13913.839,278.364,6.73,0.754,4
3,68,115,10050,8,698,0,0,76.85,43851043,17.348,29.1,6.211,13913.839,278.364,6.73,0.754,4
3,69,104,10154,9,707,0,0,76.85,43851043,17.348,29.1,6.211,13913.839,278.364,6.73,0.754,4
3,70,111,10265,8,715,0,0,76.85,43851043,17.348,29.1,6.211,13913.839,278.364,6.73,0.754,4
3,71,117,10382,9,724,0,0,76.85,43851043,17.348,29.1,6.211,13913.839,278.364,6.73,0.754,4
3,72,102,10484,8,732,0,0,76.85,43851043,17.348,29.1,6.211,13913.839,278.364,6.73,0.754,4
3,73,105,10589,9,741,0,0,76.85,43851043,17.348,29.1,6.211,13913.839,278.364,6.73,0.754,4
3,74,109,10698,10,751,0,0,76.85,43851043,17.348,29.1,6.211,13913.839,278.364,6.73,0.754,4
3,75,112,10810,9,760,0,0,65.74,43851043,17.348,29.1,6.211,13913.839,278.364,6.73,0.754,4
3,76,109,10919,7,767,0,0,65.74,43851043,17.348,29.1,6.211,13913.839,278.364,6.73,0.754,4
3,77,112,11031,10,777,0,0,65.74,43851043,17.348,29.1,6.211,13913.839,278.364,6.73,0.754,4
3,78,116,11147,11,788,0,0,65.74,43851043,17.348,29.1,6.211,13913.839,278.364,6.73,0.754,4
3,79,121,11268,11,799,0,0,65.74,43851043,17.348,29.1,6.211,13913.839,278.364,6.73,0.754,4
3,80,117,11385,12,811,0,0,65.74,43851043,17.348,29.1,6.211,13913.839,278.364,6.73,0.754,4
3,81,119,11504,14,825,0,0,65.74,43851043,17.348,29.1,6.211,13913.839,278.364,6.73,0.754,4
3,82,127,11631,12,837,0,0,65.74,43851043,17.348,29.1,6.211,13913.839,278.364,6.73,0.754,4
3,83,140,11771,8,845,0,0,65.74,43851043,17.348,29.1,6.211,13913.839,278.364,6.73,0.754,4
3,84,149,11920,7,852,0,0,65.74,43851043,17.348,29.1,6.211,13913.839,278.364,6.73,0.754,4
3,85,156,12076,9,861,0,0,65.74,43851043,17.348,29.1,6.211,13913.839,278.364,6.73,0.754,4
3,86,172,12248,8,869,0,0,65.74,43851043,17.348,29.1,6.211,13913.839,278.364,6.73,0.754,4
3,87,197,12445,9,878,0,0,65.74,43851043,17.348,29.1,6.211,13913.839,278.364,6.73,0.754,4
3,88,240,12685,7,885,0,0,65.74,43851043,17.348,29.1,6.211,13913.839,278.364,6.73,0.754,4
3,89,283,12968,7,892,0,0,65.74,43851043,17.348,29.1,6.211,13913.839,278.364,6.73,0.754,4
3,90,305,13273,5,897,0,0,65.74,43851043,17.348,29.1,6.211,13913.839,278.364,6.73,0.754,4
3,91,298,13571,8,905,0,0,65.74,43851043,17.348,29.1,6.211,13913.839,278.364,6.73,0.754,4
3,92,336,13907,7,912,0,0,65.74,43851043,17.348,29.1,6.211,13913.839,278.364,6.73,0.754,4
3,93,365,14272,8,920,0,0,65.74,43851043,17.348,29.1,6.211,13913.839,278.364,6.73,0.754,4
3,94,385,14657,8,928,0,0,65.74,43851043,17.348,29.1,6.211,13913.839,278.364,6.73,0.754,4
3,95,413,15070,9,937,0,0,65.74,43851043,17.348,29.1,6.211,13913.839,278.364,6.73,0.754,4
3,96,430,15500,9,946,0,0,65.74,43851043,17.348,29.1,6.211,13913.839,278.364,6.73,0.754,4
3,97,441,15941,6,952,0,0,65.74,43851043,17.348,29.1,6.211,13913.839,278.364,6.73,0.754,4
3,98,463,16404,7,959,0,0,65.74,43851043,17.348,29.1,6.211,13913.839,278.364,6.73,0.754,4
3,99,475,16879,9,968,0,0,65.74,43851043,17.348,29.1,6.211,13913.839,278.364,6.73,0.754,4
3,100,469,17348,10,978,0,0,65.74,43851043,17.348,29.1,6.211,13913.839,278.364,6.73,0.754,4
3,101,460,17808,10,988,0,0,74.07,43851043,17.348,29.1,6.211,13913.839,278.364,6.73,0.754,4
3,102,434,18242,8,996,0,0,74.07,43851043,17.348,29.1,6.211,13913.839,278.364,6.73,0.754,4
3,103,470,18712,8,1004,0,0,74.07,43851043,17.348,29.1,6.211,13913.839,278.364,6.73,0.754,4
3,104,483,19195,7,1011,0,0,74.07,43851043,17.348,29.1,6.211,13913.839,278.364,6.73,0.754,4
3,105,494,19689,7,1018,0,0,74.07,43851043,17.348,29.1,6.211,13913.839,278.364,6.73,0.754,4
3,106,527,20216,10,1028,0,0,74.07,43851043,17.348,29.1,6.211,13913.839,278.364,6.73,0.754,4
3,107,554,20770,12,1040,0,0,74.07,43851043,17.348,29.1,6.211,13913.839,278.364,6.73,0.754,4
3,108,585,21355,12,1052,0,0,74.07,43851043,17.348,29.1,6.211,13913.839,278.364,6.73,0.754,4
3,109,593,21948,5,1057,0,0,74.07,43851043,17.348,29.1,6.211,13913.839,278.364,6.73,0.754,4
3,110,601,22549,11,1068,0,0,74.07,43851043,17.348,29.1,6.211,13913.839,278.364,6.73,0.754,4
3,111,535,23084,10,1078,0,0,74.07,43851043,17.348,29.1,6.211,13913.839,278.364,6.73,0.754,4
3,112,607,23691,9,1087,0,0,74.07,43851043,17.348,29.1,6.211,13913.839,278.364,6.73,0.754,4
3,113,587,24278,13,1100,0,0,74.07,43851043,17.348,29.1,6.211,13913.839,278.364,6.73,0.754,4
3,114,594,24872,11,1111,0,0,74.07,43851043,17.348,29.1,6.211,13913.839,278.364,6.73,0.754,4
3,115,612,25484,13,1124,0,0,74.07,43851043,17.348,29.1,6.211,13913.839,278.364,6.73,0.754,4
3,116,675,26159,12,1136,0,0,74.07,43851043,17.348,29.1,6.211,13913.839,278.364,6.73,0.754,4
3,117,605,26764,10,1146,0,0,74.07,43851043,17.348,29.1,6.211,13913.839,278.364,6.73,0.754,4
3,118,593,27357,9,1155,0,0,79.63,43851043,17.348,29.1,6.211,13913.839,278.364,6.73,0.754,4
3,119,616,27973,8,1163,0,0,79.63,43851043,17.348,29.1,6.211,13913.839,278.364,6.73,0.754,4
3,120,642,28615,11,1174,0,0,79.63,43851043,17.348,29.1,6.211,13913.839,278.364,6.73,0.754,4
3,121,614,29229,12,1186,0,0,79.63,43851043,17.348,29.1,6.211,13913.839,278.364,6.73,0.754,4
3,122,602,29831,14,1200,0,0,79.63,43851043,17.348,29.1,6.211,13913.839,278.364,6.73,0.754,4
3,123,563,30394,10,1210,0,0,79.63,43851043,17.348,29.1,6.211,13913.839,278.364,6.73,0.754,4
3,124,556,30950,13,1223,0,0,79.63,43851043,17.348,29.1,6.211,13913.839,278.364,6.73,0.754,4
3,125,515,31465,8,1231,0,0,79.63,43851043,17.348,29.1,6.211,13913.839,278.364,6.73,0.754,4
3,126,507,31972,8,1239,0,0,79.63,43851043,17.348,29.1,6.211,13913.839,278.364,6.73,0.754,4
3,127,532,32504,9,1248,0,0,79.63,43851043,17.348,29.1,6.211,13913.839,278.364,6.73,0.754,4
3,128,551,33055,13,1261,0,0,79.63,43851043,17.348,29.1,6.211,13913.839,278.364,6.73,0.754,4
3,129,571,33626,12,1273,0,0,79.63,43851043,17.348,29.1,6.211,13913.839,278.364,6.73,0.754,4
3,130,529,34155,9,1282,0,0,87.96,43851043,17.348,29.1,6.211,13913.839,278.364,6.73,0.754,4
3,131,538,34693,11,1293,0,0,87.96,43851043,17.348,29.1,6.211,13913.839,278.364,6.73,0.754,4
3,132,521,35214,9,1302,0,0,85.19,43851043,17.348,29.1,6.211,13913.839,278.364,6.73,0.754,4
3,133,498,35712,10,1312,0,0,85.19,43851043,17.348,29.1,6.211,13913.839,278.364,6.73,0.754,4
3,134,492,36204,10,1322,0,0,85.19,43851043,17.348,29.1,6.211,13913.839,278.364,6.73,0.754,4
3,135,495,36699,11,1333,0,0,85.19,43851043,17.348,29.1,6.211,13913.839,278.364,6.73,0.754,4
3,136,488,37187,8,1341,0,0,85.19,43851043,17.348,29.1,6.211,13913.839,278.364,6.73,0.754,4
3,137,477,37664,10,1351,0,0,68.52,43851043,17.348,29.1,6.211,13913.839,278.364,6.73,0.754,4
3,138,469,38133,9,1360,0,0,68.52,43851043,17.348,29.1,6.211,13913.839,278.364,6.73,0.754,4
3,139,450,38583,10,1370,0,0,68.52,43851043,17.348,29.1,6.211,13913.839,278.364,6.73,0.754,4
3,140,442,39025,9,1379,0,0,79.63,43851043,17.348,29.1,6.211,13913.839,278.364,6.73,0.754,4
3,141,419,39444,12,1391,0,0,79.63,43851043,17.348,29.1,6.211,13913.839,278.364,6.73,0.754,4
3,142,403,39847,11,1402,0,0,79.63,43851043,17.348,29.1,6.211,13913.839,278.364,6.73,0.754,4
3,143,411,40258,9,1411,0,0,79.63,43851043,17.348,29.1,6.211,13913.839,278.364,6.73,0.754,4
3,144,409,40667,7,1418,0,0,79.63,43851043,17.348,29.1,6.211,13913.839,278.364,6.73,0.754,4
3,145,401,41068,6,1424,0,0,79.63,43851043,17.348,29.1,6.211,13913.839,278.364,6.73,0.754,4
3,146,392,41460,11,1435,0,0,79.63,43851043,17.348,29.1,6.211,13913.839,278.364,6.73,0.754,4
3,147,398,41858,11,1446,0,0,79.63,43851043,17.348,29.1,6.211,13913.839,278.364,6.73,0.754,4
3,148,370,42228,10,1456,0,0,79.63,43851043,17.348,29.1,6.211,13913.839,278.364,6.73,0.754,4
3,149,391,42619,9,1465,0,0,79.63,43851043,17.348,29.1,6.211,13913.839,278.364,6.73,0.754,4
3,150,397,43016,10,1475,0,0,79.63,43851043,17.348,29.1,6.211,13913.839,278.364,6.73,0.754,4
3,151,387,43403,8,1483,0,0,79.63,43851043,17.348,29.1,6.211,13913.839,278.364,6.73,0.754,4
3,152,379,43782,8,1491,0,0,79.63,43851043,17.348,29.1,6.211,13913.839,278.364,6.73,0.754,4
3,153,364,44146,10,1501,0,0,79.63,43851043,17.348,29.1,6.211,13913.839,278.364,6.73,0.754,4
3,154,348,44494,9,1510,0,0,75.93,43851043,17.348,29.1,6.211,13913.839,278.364,6.73,0.754,4
3,155,339,44833,8,1518,0,0,75.93,43851043,17.348,29.1,6.211,13913.839,278.364,6.73,0.754,4
3,156,325,45158,7,1525,0,0,75.93,43851043,17.348,29.1,6.211,13913.839,278.364,6.73,0.754,4
3,157,311,45469,6,1531,0,0,75.93,43851043,17.348,29.1,6.211,13913.839,278.364,6.73,0.754,4
3,158,304,45773,8,1539,0,0,75.93,43851043,17.348,29.1,6.211,13913.839,278.364,6.73,0.754,4
3,159,298,46071,10,1549,0,0,75.93,43851043,17.348,29.1,6.211,13913.839,278.364,6.73,0.754,4
3,160,293,46364,7,1556,0,0,75.93,43851043,17.348,29.1,6.211,13913.839,278.364,6.73,0.754,4
3,161,289,46653,6,1562,0,0,75.93,43851043,17.348,29.1,6.211,13913.839,278.364,6.73,0.754,4
3,162,285,46938,9,1571,0,0,75.93,43851043,17.348,29.1,6.211,13913.839,278.364,6.73,0.754,4
3,163,278,47216,10,1581,0,0,75.93,43851043,17.348,29.1,6.211,13913.839,278.364,6.73,0.754,4
3,164,272,47488,10,1591,0,0,75.93,43851043,17.348,29.1,6.211,13913.839,278.364,6.73,0.754,4
3,165,264,47752,8,1599,0,0,75.93,43851043,17.348,29.1,6.211,13913.839,278.364,6.73,0.754,4
3,166,255,48007,6,1605,0,0,75.93,43851043,17.348,29.1,6.211,13913.839,278.364,6.73,0.754,4
3,167,247,48254,7,1612,0,0,75.93,43851043,17.348,29.1,6.211,13913.839,278.364,6.73,0.754,4
3,168,242,48496,8,1620,0,0,75.93,43851043,17.348,29.1,6.211,13913.839,278.364,6.73,0.754,4
3,169,238,48734,12,1632,0,0,75.93,43851043,17.348,29.1,6.211,13913.839,278.364,6.73,0.754,4
3,170,232,48966,13,1645,0,0,75.93,43851043,17.348,29.1,6.211,13913.839,278.364,6.73,0.754,4
3,171,228,49194,9,1654,0,0,75.93,43851043,17.348,29.1,6.211,13913.839,278.364,6.73,0.754,4
3,172,219,49413,5,1659,0,0,75.93,43851043,17.348,29.1,6.211,13913.839,278.364,6.73,0.754,4
3,173,210,49623,6,1665,0,0,75.93,43851043,17.348,29.1,6.211,13913.839,278.364,6.73,0.754,4
3,174,203,49826,7,1672,0,0,75.93,43851043,17.348,29.1,6.211,13913.839,278.364,6.73,0.754,4
3,175,197,50023,7,1679,0,0,75.93,43851043,17.348,29.1,6.211,13913.839,278.364,6.73,0.754,4
3,176,191,50214,10,1689,0,0,75.93,43851043,17.348,29.1,6.211,13913.839,278.364,6.73,0.754,4
3,177,186,50400,9,1698,0,0,75.93,43851043,17.348,29.1,6.211,13913.839,278.364,6.73,0.754,4
3,178,179,50579,5,1703,0,0,75.93,43851043,17.348,29.1,6.211,13913.839,278.364,6.73,0.754,4
3,179,175,50754,4,1707,0,0,75.93,43851043,17.348,29.1,6.211,13913.839,278.364,6.73,0.754,4
3,180,160,50914,4,1711,0,0,75.93,43851043,17.348,29.1,6.211,13913.839,278.364,6.73,0.754,4
3,181,153,51067,3,1714,0,0,75.93,43851043,17.348,29.1,6.211,13913.839,278.364,6.73,0.754,4
3,182,146,51213,5,1719,0,0,75.93,43851043,17.348,29.1,6.211,13913.839,278.364,6.73,0.754,4
3,183,155,51368,7,1726,0,0,75.93,43851043,17.348,29.1,6.211,13913.839,278.364,6.73,0.754,4
3,184,162,51530,8,1734,0,0,75.93,43851043,17.348,29.1,6.211,13913.839,278.364,6.73,0.754,4
3,185,160,51690,7,1741,0,0,75.93,43851043,17.348,29.1,6.211,13913.839,278.364,6.73,0.754,4
3,186,157,51847,8,1749,0,0,75.93,43851043,17.348,29.1,6.211,13913.839,278.364,6.73,0.754,4
3,187,148,51995,7,1756,0,0,75.93,43851043,17.348,29.1,6.211,13913.839,278.364,6.73,0.754,4
3,188,141,52136,4,1760,0,0,75.93,43851043,17.348,29.1,6.211,13913.839,278.364,6.73,0.754,4
3,189,134,52270,8,1768,0,0,75.93,43851043,17.348,29.1,6.211,13913.839,278.364,6.73,0.754,4
3,190,129,52399,5,1773,0,0,75.93,43851043,17.348,29.1,6.211,13913.839,278.364,6.73,0.754,4
3,191,121,52520,6,1779,0,0,75.93,43851043,17.348,29.1,6.211,13913.839,278.364,6.73,0.754,4
3,192,138,52658,4,1783,0,0,75.93,43851043,17.348,29.1,6.211,13913.839,278.364,6.73,0.754,4
3,193,146,52804,6,1789,0,0,75.93,43851043,17.348,29.1,6.211,13913.839,278.364,6.73,0.754,4
3,194,136,52940,6,1795,0,0,75.93,43851043,17.348,29.1,6.211,13913.839,278.364,6.73,0.754,4
3,195,132,53072,6,1801,0,0,75.93,43851043,17.348,29.1,6.211,13913.839,278.364,6.73,0.754,4
3,196,153,53225,8,1809,0,0,75.93,43851043,17.348,29.1,6.211,13913.839,278.364,6.73,0.754,4
3,197,174,53399,9,1818,0,0,75.93,43851043,17.348,29.1,6.211,13913.839,278.364,6.73,0.754,4
3,198,185,53584,9,1827,0,0,75.93,43851043,17.348,29.1,6.211,13913.839,278.364,6.73,0.754,4
3,199,193,53777,9,1836,0,0,75.93,43851043,17.348,29.1,6.211,13913.839,278.364,6.73,0.754,4
3,200,211,53988,5,1841,0,0,75.93,43851043,17.348,29.1,6.211,13913.839,278.364,6.73,0.754,4
3,201,215,54203,5,1846,0,0,75.93,43851043,17.348,29.1,6.211,13913.839,278.364,6.73,0.754,4
3,202,199,54402,10,1856,0,0,75.93,43851043,17.348,29.1,6.211,13913.839,278.364,6.73,0.754,4
3,203,214,54616,9,1865,0,0,75.93,43851043,17.348,29.1,6.211,13913.839,278.364,6.73,0.754,4
3,204,223,54839,0,1865,0,0,75.93,43851043,17.348,29.1,6.211,13913.839,278.364,6.73,0.754,4
5,1,0,7,0,2,0,0,90.74,32866268,23.89,16.8,2.405,5819.495,276.045,3.94,0.581,4
5,2,1,8,0,2,0,0,90.74,32866268,23.89,16.8,2.405,5819.495,276.045,3.94,0.581,4
5,3,0,8,0,2,0,0,90.74,32866268,23.89,16.8,2.405,5819.495,276.045,3.94,0.581,4
5,4,0,8,0,2,0,0,90.74,32866268,23.89,16.8,2.405,5819.495,276.045,3.94,0.581,4
5,5,2,10,0,2,0,0,90.74,32866268,23.89,16.8,2.405,5819.495,276.045,3.94,0.581,4
5,6,4,14,0,2,0,0,90.74,32866268,23.89,16.8,2.405,5819.495,276.045,3.94,0.581,4
5,7,2,16,0,2,0,0,90.74,32866268,23.89,16.8,2.405,5819.495,276.045,3.94,0.581,4
5,8,1,17,0,2,0,0,90.74,32866268,23.89,16.8,2.405,5819.495,276.045,3.94,0.581,4
5,9,2,19,0,2,0,0,90.74,32866268,23.89,16.8,2.405,5819.495,276.045,3.94,0.581,4
5,10,0,19,0,2,0,0,90.74,32866268,23.89,16.8,2.405,5819.495,276.045,3.94,0.581,4
5,11,0,19,0,2,0,0,90.74,32866268,23.89,16.8,2.405,5819.495,276.045,3.94,0.581,4
5,12,0,19,0,2,0,0,90.74,32866268,23.89,16.8,2.405,5819.495,276.045,3.94,0.581,4
5,13,0,19,0,2,0,0,90.74,32866268,23.89,16.8,2.405,5819.495,276.045,3.94,0.581,4
5,14,0,19,0,2,0,0,90.74,32866268,23.89,16.8,2.405,5819.495,276.045,3.94,0.581,4
5,15,0,19,0,2,0,0,90.74,32866268,23.89,16.8,2.405,5819.495,276.045,3.94,0.581,4
5,16,0,19,0,2,0,0,90.74,32866268,23.89,16.8,2.405,5819.495,276.045,3.94,0.581,4
5,17,0,19,0,2,0,0,90.74,32866268,23.89,16.8,2.405,5819.495,276.045,3.94,0.581,4
5,18,0,19,0,2,0,0,90.74,32866268,23.89,16.8,2.405,5819.495,276.045,3.94,0.581,4
5,19,5,24,0,2,0,0,90.74,32866268,23.89,16.8,2.405,5819.495,276.045,3.94,0.581,4
5,20,0,24,0,2,0,0,90.74,32866268,23.89,16.8,2.405,5819.495,276.045,3.94,0.581,4
5,21,0,24,0,2,0,0,90.74,32866268,23.89,16.8,2.405,5819.495,276.045,3.94,0.581,4
5,22,0,24,0,2,0,0,90.74,32866268,23.89,16.8,2.405,5819.495,276.045,3.94,0.581,4
5,23,0,24,0,2,0,0,78.7,32866268,23.89,16.8,2.405,5819.495,276.045,3.94,0.581,4
5,24,1,25,0,2,0,0,78.7,32866268,23.89,16.8,2.405,5819.495,276.045,3.94,0.581,4
5,25,0,25,0,2,0,0,78.7,32866268,23.89,16.8,2.405,5819.495,276.045,3.94,0.581,4
5,26,0,25,0,2,0,0,78.7,32866268,23.89,16.8,2.405,5819.495,276.045,3.94,0.581,4
5,27,1,26,0,2,0,0,78.7,32866268,23.89,16.8,2.405,5819.495,276.045,3.94,0.581,4
5,28,1,27,0,2,0,0,78.7,32866268,23.89,16.8,2.405,5819.495,276.045,3.94,0.581,4
5,29,0,27,0,2,0,0,78.7,32866268,23.89,16.8,2.405,5819.495,276.045,3.94,0.581,4
5,30,0,27,0,2,0,0,78.7,32866268,23.89,16.8,2.405,5819.495,276.045,3.94,0.581,4
5,31,0,27,0,2,0,0,78.7,32866268,23.89,16.8,2.405,5819.495,276.045,3.94,0.581,4
5,32,2,29,0,2,0,0,78.7,32866268,23.89,16.8,2.405,5819.495,276.045,3.94,0.581,4
5,33,6,35,0,2,0,0,78.7,32866268,23.89,16.8,2.405,5819.495,276.045,3.94,0.581,4
5,34,0,35,0,2,0,0,78.7,32866268,23.89,16.8,2.405,5819.495,276.045,3.94,0.581,4
5,35,0,35,0,2,0,0,78.7,32866268,23.89,16.8,2.405,5819.495,276.045,3.94,0.581,4
5,36,1,36,0,2,0,0,78.7,32866268,23.89,16.8,2.405,5819.495,276.045,3.94,0.581,4
5,37,0,36,0,2,0,0,78.7,32866268,23.89,16.8,2.405,5819.495,276.045,3.94,0.581,4
5,38,0,36,0,2,0,0,75.93,32866268,23.89,16.8,2.405,5819.495,276.045,3.94,0.581,4
5,39,7,43,0,2,0,0,75.93,32866268,23.89,16.8,2.405,5819.495,276.045,3.94,0.581,4
5,40,0,43,0,2,0,0,75.93,32866268,23.89,16.8,2.405,5819.495,276.045,3.94,0.581,4
5,41,2,45,0,2,0,0,75.93,32866268,23.89,16.8,2.405,5819.495,276.045,3.94,0.581,4
5,42,0,45,0,2,0,0,75.93,32866268,23.89,16.8,2.405,5819.495,276.045,3.94,0.581,4
5,43,0,45,0,2,0,0,75.93,32866268,23.89,16.8,2.405,5819.495,276.045,3.94,0.581,4
5,44,0,45,0,2,0,0,75.93,32866268,23.89,16.8,2.405,5819.495,276.045,3.94,0.581,4
5,45,3,48,0,2,0,0,75.93,32866268,23.89,16.8,2.405,5819.495,276.045,3.94,0.581,4
5,46,0,48,0,2,0,0,75.93,32866268,23.89,16.8,2.405,5819.495,276.045,3.94,0.581,4
5,47,0,48,0,2,0,0,81.48,32866268,23.89,16.8,2.405,5819.495,276.045,3.94,0.581,4
5,48,0,48,0,2,0,0,81.48,32866268,23.89,16.8,2.405,5819.495,276.045,3.94,0.581,4
5,49,0,48,0,2,0,0,81.48,32866268,23.89,16.8,2.405,5819.495,276.045,3.94,0.581,4
5,50,2,50,0,2,0,0,81.48,32866268,23.89,16.8,2.405,5819.495,276.045,3.94,0.581,4
5,51,2,52,1,3,0,0,81.48,32866268,23.89,16.8,2.405,5819.495,276.045,3.94,0.581,4
5,52,6,58,0,3,0,0,81.48,32866268,23.89,16.8,2.405,5819.495,276.045,3.94,0.581,4
5,53,2,60,0,3,0,0,81.48,32866268,23.89,16.8,2.405,5819.495,276.045,3.94,0.581,4
5,54,0,60,0,3,0,0,81.48,32866268,23.89,16.8,2.405,5819.495,276.045,3.94,0.581,4
5,55,9,69,1,4,0,0,81.48,32866268,23.89,16.8,2.405,5819.495,276.045,3.94,0.581,4
5,56,0,69,0,4,0,0,77.78,32866268,23.89,16.8,2.405,5819.495,276.045,3.94,0.581,4
5,57,2,71,0,4,0,0,77.78,32866268,23.89,16.8,2.405,5819.495,276.045,3.94,0.581,4
5,58,0,71,0,4,0,0,77.78,32866268,23.89,16.8,2.405,5819.495,276.045,3.94,0.581,4
5,59,2,73,0,4,0,0,77.78,32866268,23.89,16.8,2.405,5819.495,276.045,3.94,0.581,4
5,60,4,77,0,4,0,0,77.78,32866268,23.89,16.8,2.405,5819.495,276.045,3.94,0.581,4
5,61,7,84,0,4,0,0,77.78,32866268,23.89,16.8,2.405,5819.495,276.045,3.94,0.581,4
5,62,2,86,0,4,0,0,77.78,32866268,23.89,16.8,2.405,5819.495,276.045,3.94,0.581,4
5,63,0,86,0,4,0,0,77.78,32866268,23.89,16.8,2.405,5819.495,276.045,3.94,0.581,4
5,64,0,86,0,4,0,0,77.78,32866268,23.89,16.8,2.405,5819.495,276.045,3.94,0.581,4
5,65,0,86,0,4,0,0,77.78,32866268,23.89,16.8,2.405,5819.495,276.045,3.94,0.581,4
5,66,0,86,0,4,0,0,77.78,32866268,23.89,16.8,2.405,5819.495,276.045,3.94,0.581,4
5,67,0,86,0,4,0,0,77.78,32866268,23.89,16.8,2.405,5819.495,276.045,3.94,0.581,4
5,68,0,86,0,4,0,0,77.78,32866268,23.89,16.8,2.405,5819.495,276.045,3.94,0.581,4
5,69,5,91,0,4,0,0,75.93,32866268,23.89,16.8,2.405,5819.495,276.045,3.94,0.581,4
5,70,1,92,0,4,0,0,75.93,32866268,23.89,16.8,2.405,5819.495,276.045,3.94,0.581,4
5,71,4,96,0,4,0,0,75.93,32866268,23.89,16.8,2.405,5819.495,276.045,3.94,0.581,4
5,72,17,113,0,4,0,0,75.93,32866268,23.89,16.8,2.405,5819.495,276.045,3.94,0.581,4
5,73,5,118,1,5,0,0,75.93,32866268,23.89,16.8,2.405,5819.495,276.045,3.94,0.581,4
5,74,12,130,0,5,0,0,75.93,32866268,23.89,16.8,2.405,5819.495,276.045,3.94,0.581,4
5,75,8,138,1,6,0,0,75.93,32866268,23.89,16.8,2.405,5819.495,276.045,3.94,0.581,4
5,76,2,140,0,6,0,0,75.93,32866268,23.89,16.8,2.405,5819.495,276.045,3.94,0.581,4
5,77,2,142,0,6,0,0,75.93,32866268,23.89,16.8,2.405,5819.495,276.045,3.94,0.581,4
5,78,0,142,0,6,0,0,75.93,32866268,23.89,16.8,2.405,5819.495,276.045,3.94,0.581,4
5,79,13,155,1,7,0,0,75.93,32866268,23.89,16.8,2.405,5819.495,276.045,3.94,0.581,4
5,80,0,155,0,7,0,0,75.93,32866268,23.89,16.8,2.405,5819.495,276.045,3.94,0.581,4
5,81,11,166,1,8,0,0,75.93,32866268,23.89,16.8,2.405,5819.495,276.045,3.94,0.581,4
5,82,6,172,0,8,0,0,75.93,32866268,23.89,16.8,2.405,5819.495,276.045,3.94,0.581,4
5,83,4,176,1,9,0,0,75.93,32866268,23.89,16.8,2.405,5819.495,276.045,3.94,0.581,4
5,84,7,183,0,9,0,0,75.93,32866268,23.89,16.8,2.405,5819.495,276.045,3.94,0.581,4
5,85,3,186,1,10,0,0,75.93,32866268,23.89,16.8,2.405,5819.495,276.045,3.94,0.581,4
5,86,3,189,0,10,0,0,75.93,32866268,23.89,16.8,2.405,5819.495,276.045,3.94,0.581,4
5,87,8,197,0,10,0,0,75.93,32866268,23.89,16.8,2.405,5819.495,276.045,3.94,0.581,4
5,88,15,212,0,10,0,0,75.93,32866268,23.89,16.8,2.405,5819.495,276.045,3.94,0.581,4
5,89,32,244,0,10,0,0,75.93,32866268,23.89,16.8,2.405,5819.495,276.045,3.94,0.581,4
5,90,23,267,1,11,0,0,75.93,32866268,23.89,16.8,2.405,5819.495,276.045,3.94,0.581,4
5,91,9,276,0,11,0,0,75.93,32866268,23.89,16.8,2.405,5819.495,276.045,3.94,0.581,4
5,92,8,284,2,13,0,0,75.93,32866268,23.89,16.8,2.405,5819.495,276.045,3.94,0.581,4
5,93,7,291,2,15,0,0,75.93,32866268,23.89,16.8,2.405,5819.495,276.045,3.94,0.581,4
5,94,24,315,2,17,0,0,75.93,32866268,23.89,16.8,2.405,5819.495,276.045,3.94,0.581,4
5,95,13,328,1,18,0,0,75.93,32866268,23.89,16.8,2.405,5819.495,276.045,3.94,0.581,4
5,96,18,346,1,19,0,0,75.93,32866268,23.89,16.8,2.405,5819.495,276.045,3.94,0.581,4
5,97,0,346,0,19,0,0,75.93,32866268,23.89,16.8,2.405,5819.495,276.045,3.94,0.581,4
5,98,7,353,0,19,0,0,75.93,32866268,23.89,16.8,2.405,5819.495,276.045,3.94,0.581,4
5,99,0,353,0,19,0,0,75.93,32866268,23.89,16.8,2.405,5819.495,276.045,3.94,0.581,4
5,100,33,386,2,21,0,0,76.39,32866268,23.89,16.8,2.405,5819.495,276.045,3.94,0.581,4
5,101,10,396,1,22,0,0,76.39,32866268,23.89,16.8,2.405,5819.495,276.045,3.94,0.581,4
5,102,62,458,1,23,0,0,76.39,32866268,23.89,16.8,2.405,5819.495,276.045,3.94,0.581,4
5,103,25,483,2,25,0,0,76.39,32866268,23.89,16.8,2.405,5819.495,276.045,3.94,0.581,4
5,104,23,506,1,26,0,0,76.39,32866268,23.89,16.8,2.405,5819.495,276.045,3.94,0.581,4
5,105,0,506,0,26,0,0,76.39,32866268,23.89,16.8,2.405,5819.495,276.045,3.94,0.581,4
5,106,19,525,0,26,0,0,76.39,32866268,23.89,16.8,2.405,5819.495,276.045,3.94,0.581,4
5,107,51,576,1,27,0,0,76.39,32866268,23.89,16.8,2.405,5819.495,276.045,3.94,0.581,4
5,108,31,607,1,28,0,0,76.39,32866268,23.89,16.8,2.405,5819.495,276.045,3.94,0.581,4
5,109,31,638,1,29,0,0,76.39,32866268,23.89,16.8,2.405,5819.495,276.045,3.94,0.581,4
5,110,49,687,0,29,0,0,76.39,32866268,23.89,16.8,2.405,5819.495,276.045,3.94,0.581,4
5,111,18,705,0,29,0,0,76.39,32866268,23.89,16.8,2.405,5819.495,276.045,3.94,0.581,4
5,112,44,749,0,29,0,0,76.39,32866268,23.89,16.8,2.405,5819.495,276.045,3.94,0.581,4
5,113,0,749,0,29,0,0,76.39,32866268,23.89,16.8,2.405,5819.495,276.045,3.94,0.581,4
5,114,30,779,1,30,0,0,76.39,32866268,23.89,16.8,2.405,5819.495,276.045,3.94,0.581,4
5,115,33,812,3,33,0,0,76.39,32866268,23.89,16.8,2.405,5819.495,276.045,3.94,0.581,4
5,116,39,851,0,33,0,0,76.39,32866268,23.89,16.8,2.405,5819.495,276.045,3.94,0.581,4
5,117,29,880,2,35,0,0,76.39,32866268,23.89,16.8,2.405,5819.495,276.045,3.94,0.581,4
5,118,50,930,5,40,0,0,76.39,32866268,23.89,16.8,2.405,5819.495,276.045,3.94,0.581,4
5,119,2,932,0,40,0,0,76.39,32866268,23.89,16.8,2.405,5819.495,276.045,3.94,0.581,4
5,120,18,950,1,41,0,0,76.39,32866268,23.89,16.8,2.405,5819.495,276.045,3.94,0.581,4
5,121,50,1000,6,47,0,0,79.17,32866268,23.89,16.8,2.405,5819.495,276.045,3.94,0.581,4
5,122,78,1078,1,48,0,0,79.17,32866268,23.89,16.8,2.405,5819.495,276.045,3.94,0.581,4
5,123,31,1109,3,51,0,0,79.17,32866268,23.89,16.8,2.405,5819.495,276.045,3.94,0.581,4
5,124,5,1114,1,52,0,0,79.17,32866268,23.89,16.8,2.405,5819.495,276.045,3.94,0.581,4
5,125,34,1148,0,52,0,0,79.17,32866268,23.89,16.8,2.405,5819.495,276.045,3.94,0.581,4
5,126,16,1164,2,54,0,0,79.17,32866268,23.89,16.8,2.405,5819.495,276.045,3.94,0.581,4
5,127,0,1164,0,54,0,0,79.17,32866268,23.89,16.8,2.405,5819.495,276.045,3.94,0.581,4
5,128,180,1344,5,59,0,0,79.17,32866268,23.89,16.8,2.405,5819.495,276.045,3.94,0.581,4
5,129,51,1395,3,62,0,0,79.17,32866268,23.89,16.8,2.405,5819.495,276.045,3.94,0.581,4
5,130,88,1483,2,64,0,0,79.17,32866268,23.89,16.8,2.405,5819.495,276.045,3.94,0.581,4
5,131,0,1483,0,64,0,0,79.17,32866268,23.89,16.8,2.405,5819.495,276.045,3.94,0.581,4
5,132,89,1572,6,70,0,0,79.17,32866268,23.89,16.8,2.405,5819.495,276.045,3.94,0.581,4
5,133,100,1672,5,75,0,0,79.17,32866268,23.89,16.8,2.405,5819.495,276.045,3.94,0.581,4
5,134,7,1679,3,78,0,0,79.17,32866268,23.89,16.8,2.405,5819.495,276.045,3.94,0.581,4
5,135,56,1735,2,80,0,0,79.17,32866268,23.89,16.8,2.405,5819.495,276.045,3.94,0.581,4
5,136,27,1762,0,80,0,0,79.17,32866268,23.89,16.8,2.405,5819.495,276.045,3.94,0.581,4
5,137,53,1815,3,83,0,0,79.17,32866268,23.89,16.8,2.405,5819.495,276.045,3.94,0.581,4
5,138,37,1852,3,86,0,0,79.17,32866268,23.89,16.8,2.405,5819.495,276.045,3.94,0.581,4
5,139,27,1879,0,86,0,0,79.17,32866268,23.89,16.8,2.405,5819.495,276.045,3.94,0.581,4
5,140,27,1906,2,88,0,0,79.17,32866268,23.89,16.8,2.405,5819.495,276.045,3.94,0.581,4
5,141,60,1966,2,90,0,0,79.17,32866268,23.89,16.8,2.405,5819.495,276.045,3.94,0.581,4
5,142,0,1966,0,90,0,0,79.17,32866268,23.89,16.8,2.405,5819.495,276.045,3.94,0.581,4
5,143,49,2015,2,92,0,0,76.39,32866268,23.89,16.8,2.405,5819.495,276.045,3.94,0.581,4
5,144,29,2044,1,93,0,0,76.39,32866268,23.89,16.8,2.405,5819.495,276.045,3.94,0.581,4
5,145,24,2068,1,94,0,0,76.39,32866268,23.89,16.8,2.405,5819.495,276.045,3.94,0.581,4
5,146,103,2171,2,96,0,0,76.39,32866268,23.89,16.8,2.405,5819.495,276.045,3.94,0.581,4
5,147,51,2222,4,100,0,0,76.39,32866268,23.89,16.8,2.405,5819.495,276.045,3.94,0.581,4
5,148,61,2283,2,102,0,0,76.39,32866268,23.89,16.8,2.405,5819.495,276.045,3.94,0.581,4
5,149,49,2332,1,103,0,0,76.39,32866268,23.89,16.8,2.405,5819.495,276.045,3.94,0.581,4
5,150,83,2415,2,105,0,0,76.39,32866268,23.89,16.8,2.405,5819.495,276.045,3.94,0.581,4
5,151,56,2471,1,106,0,0,76.39,32866268,23.89,16.8,2.405,5819.495,276.045,3.94,0.581,4
5,152,80,2551,1,107,0,0,76.39,32866268,23.89,16.8,2.405,5819.495,276.045,3.94,0.581,4
5,153,73,2624,0,107,0,0,76.39,32866268,23.89,16.8,2.405,5819.495,276.045,3.94,0.581,4
5,154,0,2624,0,107,0,0,81.02,32866268,23.89,16.8,2.405,5819.495,276.045,3.94,0.581,4
5,155,30,2654,1,108,0,0,81.02,32866268,23.89,16.8,2.405,5819.495,276.045,3.94,0.581,4
5,156,75,2729,1,109,0,0,81.02,32866268,23.89,16.8,2.405,5819.495,276.045,3.94,0.581,4
5,157,48,2777,3,112,0,0,81.02,32866268,23.89,16.8,2.405,5819.495,276.045,3.94,0.581,4
5,158,28,2805,1,113,0,0,81.02,32866268,23.89,16.8,2.405,5819.495,276.045,3.94,0.581,4
5,159,71,2876,2,115,0,0,81.02,32866268,23.89,16.8,2.405,5819.495,276.045,3.94,0.581,4
5,160,59,2935,2,117,0,0,81.02,32866268,23.89,16.8,2.405,5819.495,276.045,3.94,0.581,4
5,161,30,2965,0,117,0,0,81.02,32866268,23.89,16.8,2.405,5819.495,276.045,3.94,0.581,4
5,162,16,2981,3,120,0,0,81.02,32866268,23.89,16.8,2.405,5819.495,276.045,3.94,0.581,4
5,163,52,3033,4,124,0,0,81.02,32866268,23.89,16.8,2.405,5819.495,276.045,3.94,0.581,4
5,164,59,3092,2,126,0,0,81.02,32866268,23.89,16.8,2.405,5819.495,276.045,3.94,0.581,4
5,165,125,3217,4,130,0,0,81.02,32866268,23.89,16.8,2.405,5819.495,276.045,3.94,0.581,4
5,166,62,3279,1,131,0,0,81.02,32866268,23.89,16.8,2.405,5819.495,276.045,3.94,0.581,4
5,167,56,3335,1,132,0,0,81.02,32866268,23.89,16.8,2.405,5819.495,276.045,3.94,0.581,4
5,168,53,3388,2,134,0,0,81.02,32866268,23.89,16.8,2.405,5819.495,276.045,3.94,0.581,4
5,169,51,3439,0,134,0,0,75,32866268,23.89,16.8,2.405,5819.495,276.045,3.94,0.581,4
5,170,130,3569,5,139,0,0,75,32866268,23.89,16.8,2.405,5819.495,276.045,3.94,0.581,4
5,171,180,3749,5,144,0,0,75,32866268,23.89,16.8,2.405,5819.495,276.045,3.94,0.581,4
5,172,40,3789,0,144,0,0,75,32866268,23.89,16.8,2.405,5819.495,276.045,3.94,0.581,4
5,173,112,3901,0,144,0,0,75,32866268,23.89,16.8,2.405,5819.495,276.045,3.94,0.581,4
5,174,90,3991,8,152,0,0,75,32866268,23.89,16.8,2.405,5819.495,276.045,3.94,0.581,4
5,175,126,4117,2,154,0,0,75,32866268,23.89,16.8,2.405,5819.495,276.045,3.94,0.581,4
5,176,119,4236,1,155,0,0,75,32866268,23.89,16.8,2.405,5819.495,276.045,3.94,0.581,4
5,177,0,4236,0,155,0,0,75,32866268,23.89,16.8,2.405,5819.495,276.045,3.94,0.581,4
5,178,127,4363,4,159,0,0,75,32866268,23.89,16.8,2.405,5819.495,276.045,3.94,0.581,4
5,179,112,4475,3,162,0,0,75,32866268,23.89,16.8,2.405,5819.495,276.045,3.94,0.581,4
5,180,115,4590,5,167,0,0,75,32866268,23.89,16.8,2.405,5819.495,276.045,3.94,0.581,4
5,181,82,4672,4,171,0,0,75,32866268,23.89,16.8,2.405,5819.495,276.045,3.94,0.581,4
5,182,125,4797,5,176,0,0,75,32866268,23.89,16.8,2.405,5819.495,276.045,3.94,0.581,4
5,183,108,4905,3,179,0,0,75,32866268,23.89,16.8,2.405,5819.495,276.045,3.94,0.581,4
5,184,67,4972,3,182,0,0,75,32866268,23.89,16.8,2.405,5819.495,276.045,3.94,0.581,4
5,185,0,4972,1,183,0,0,75,32866268,23.89,16.8,2.405,5819.495,276.045,3.94,0.581,4
5,186,142,5114,2,185,0,0,75,32866268,23.89,16.8,2.405,5819.495,276.045,3.94,0.581,4
5,187,97,5211,4,189,0,0,75,32866268,23.89,16.8,2.405,5819.495,276.045,3.94,0.581,4
5,188,159,5370,4,193,0,0,71.3,32866268,23.89,16.8,2.405,5819.495,276.045,3.94,0.581,4
5,189,0,5370,0,193,0,0,71.3,32866268,23.89,16.8,2.405,5819.495,276.045,3.94,0.581,4
5,190,355,5725,13,206,0,0,71.3,32866268,23.89,16.8,2.405,5819.495,276.045,3.94,0.581,4
5,191,0,5725,0,206,0,0,71.3,32866268,23.89,16.8,2.405,5819.495,276.045,3.94,0.581,4
5,192,138,5863,0,206,0,0,71.3,32866268,23.89,16.8,2.405,5819.495,276.045,3.94,0.581,4
5,193,95,5958,2,208,0,0,71.3,32866268,23.89,16.8,2.405,5819.495,276.045,3.94,0.581,4
5,194,73,6031,4,212,0,0,71.3,32866268,23.89,16.8,2.405,5819.495,276.045,3.94,0.581,4
5,195,215,6246,6,218,0,0,71.3,32866268,23.89,16.8,2.405,5819.495,276.045,3.94,0.581,4
5,196,120,6366,0,218,0,0,71.3,32866268,23.89,16.8,2.405,5819.495,276.045,3.94,0.581,4
5,197,122,6488,1,219,0,0,71.3,32866268,23.89,16.8,2.405,5819.495,276.045,3.94,0.581,4
5,198,192,6680,3,222,0,0,71.3,32866268,23.89,16.8,2.405,5819.495,276.045,3.94,0.581,4
5,199,166,6846,5,227,0,0,71.3,32866268,23.89,16.8,2.405,5819.495,276.045,3.94,0.581,4
5,200,250,7096,1,228,0,0,71.3,32866268,23.89,16.8,2.405,5819.495,276.045,3.94,0.581,4
5,201,126,7222,6,234,0,0,71.3,32866268,23.89,16.8,2.405,5819.495,276.045,3.94,0.581,4
5,202,240,7462,7,241,0,0,71.3,32866268,23.89,16.8,2.405,5819.495,276.045,3.94,0.581,4
5,203,160,7622,6,247,0,0,71.3,32866268,23.89,16.8,2.405,5819.495,276.045,3.94,0.581,4
5,204,207,7829,1,248,0,0,71.3,32866268,23.89,16.8,2.405,5819.495,276.045,3.94,0.581,4
7,1,0,7,0,0,0,0,0,97928,231.845,32.1,6.933,21490.943,191.511,13.17,0.78,0
7,2,0,7,0,0,0,0,0,97928,231.845,32.1,6.933,21490.943,191.511,13.17,0.78,0
7,3,2,9,0,0,0,0,0,97928,231.845,32.1,6.933,21490.943,191.511,13.17,0.78,0
7,4,6,15,0,0,0,0,0,97928,231.845,32.1,6.933,21490.943,191.511,13.17,0.78,0
7,5,0,15,0,0,0,0,0,97928,231.845,32.1,6.933,21490.943,191.511,13.17,0.78,0
7,6,0,15,0,0,0,0,0,97928,231.845,32.1,6.933,21490.943,191.511,13.17,0.78,0
7,7,0,15,0,0,0,0,0,97928,231.845,32.1,6.933,21490.943,191.511,13.17,0.78,0
7,8,0,15,0,0,0,0,0,97928,231.845,32.1,6.933,21490.943,191.511,13.17,0.78,0
7,9,0,15,0,0,0,0,0,97928,231.845,32.1,6.933,21490.943,191.511,13.17,0.78,0
7,10,4,19,2,2,0,0,0,97928,231.845,32.1,6.933,21490.943,191.511,13.17,0.78,0
7,11,2,21,0,2,0,0,0,97928,231.845,32.1,6.933,21490.943,191.511,13.17,0.78,0
7,12,0,21,0,2,0,0,0,97928,231.845,32.1,6.933,21490.943,191.511,13.17,0.78,0
7,13,0,21,0,2,0,0,0,97928,231.845,32.1,6.933,21490.943,191.511,13.17,0.78,0
7,14,2,23,0,2,0,0,0,97928,231.845,32.1,6.933,21490.943,191.511,13.17,0.78,0
7,15,0,23,0,2,0,0,0,97928,231.845,32.1,6.933,21490.943,191.511,13.17,0.78,0
7,16,0,23,0,2,0,0,0,97928,231.845,32.1,6.933,21490.943,191.511,13.17,0.78,0
7,17,0,23,0,2,0,0,0,97928,231.845,32.1,6.933,21490.943,191.511,13.17,0.78,0
7,18,0,23,0,2,0,0,0,97928,231.845,32.1,6.933,21490.943,191.511,13.17,0.78,0
7,19,0,23,0,2,0,0,0,97928,231.845,32.1,6.933,21490.943,191.511,13.17,0.78,0
7,20,0,23,0,2,0,0,0,97928,231.845,32.1,6.933,21490.943,191.511,13.17,0.78,0
7,21,0,23,1,3,0,0,0,97928,231.845,32.1,6.933,21490.943,191.511,13.17,0.78,0
7,22,1,24,0,3,0,0,0,97928,231.845,32.1,6.933,21490.943,191.511,13.17,0.78,0
7,23,0,24,0,3,0,0,0,97928,231.845,32.1,6.933,21490.943,191.511,13.17,0.78,0
7,24,0,24,0,3,0,0,0,97928,231.845,32.1,6.933,21490.943,191.511,13.17,0.78,0
7,25,0,24,0,3,0,0,0,97928,231.845,32.1,6.933,21490.943,191.511,13.17,0.78,0
7,26,0,24,0,3,0,0,0,97928,231.845,32.1,6.933,21490.943,191.511,13.17,0.78,0
7,27,0,24,0,3,0,0,0,97928,231.845,32.1,6.933,21490.943,191.511,13.17,0.78,0
7,28,0,24,0,3,0,0,0,97928,231.845,32.1,6.933,21490.943,191.511,13.17,0.78,0
7,29,0,24,0,3,0,0,0,97928,231.845,32.1,6.933,21490.943,191.511,13.17,0.78,0
7,30,0,24,0,3,0,0,0,97928,231.845,32.1,6.933,21490.943,191.511,13.17,0.78,0
7,31,0,24,0,3,0,0,0,97928,231.845,32.1,6.933,21490.943,191.511,13.17,0.78,0
7,32,1,25,0,3,0,0,0,97928,231.845,32.1,6.933,21490.943,191.511,13.17,0.78,0
7,33,0,25,0,3,0,0,0,97928,231.845,32.1,6.933,21490.943,191.511,13.17,0.78,0
7,34,0,25,0,3,0,0,0,97928,231.845,32.1,6.933,21490.943,191.511,13.17,0.78,0
7,35,0,25,0,3,0,0,0,97928,231.845,32.1,6.933,21490.943,191.511,13.17,0.78,0
7,36,0,25,0,3,0,0,0,97928,231.845,32.1,6.933,21490.943,191.511,13.17,0.78,0
7,37,0,25,0,3,0,0,0,97928,231.845,32.1,6.933,21490.943,191.511,13.17,0.78,0
7,38,0,25,0,3,0,0,0,97928,231.845,32.1,6.933,21490.943,191.511,13.17,0.78,0
7,39,0,25,0,3,0,0,0,97928,231.845,32.1,6.933,21490.943,191.511,13.17,0.78,0
7,40,0,25,0,3,0,0,0,97928,231.845,32.1,6.933,21490.943,191.511,13.17,0.78,0
7,41,0,25,0,3,0,0,0,97928,231.845,32.1,6.933,21490.943,191.511,13.17,0.78,0
7,42,0,25,0,3,0,0,0,97928,231.845,32.1,6.933,21490.943,191.511,13.17,0.78,0
7,43,0,25,0,3,0,0,0,97928,231.845,32.1,6.933,21490.943,191.511,13.17,0.78,0
7,44,0,25,0,3,0,0,0,97928,231.845,32.1,6.933,21490.943,191.511,13.17,0.78,0
7,45,0,25,0,3,0,0,0,97928,231.845,32.1,6.933,21490.943,191.511,13.17,0.78,0
7,46,0,25,0,3,0,0,0,97928,231.845,32.1,6.933,21490.943,191.511,13.17,0.78,0
7,47,0,25,0,3,0,0,0,97928,231.845,32.1,6.933,21490.943,191.511,13.17,0.78,0
7,48,0,25,0,3,0,0,0,97928,231.845,32.1,6.933,21490.943,191.511,13.17,0.78,0
7,49,0,25,0,3,0,0,0,97928,231.845,32.1,6.933,21490.943,191.511,13.17,0.78,0
7,50,0,25,0,3,0,0,0,97928,231.845,32.1,6.933,21490.943,191.511,13.17,0.78,0
7,51,0,25,0,3,0,0,0,97928,231.845,32.1,6.933,21490.943,191.511,13.17,0.78,0
7,52,0,25,0,3,0,0,0,97928,231.845,32.1,6.933,21490.943,191.511,13.17,0.78,0
7,53,0,25,0,3,0,0,0,97928,231.845,32.1,6.933,21490.943,191.511,13.17,0.78,0
7,54,0,25,0,3,0,0,0,97928,231.845,32.1,6.933,21490.943,191.511,13.17,0.78,0
7,55,0,25,0,3,0,0,0,97928,231.845,32.1,6.933,21490.943,191.511,13.17,0.78,0
7,56,0,25,0,3,0,0,0,97928,231.845,32.1,6.933,21490.943,191.511,13.17,0.78,0
7,57,0,25,0,3,0,0,0,97928,231.845,32.1,6.933,21490.943,191.511,13.17,0.78,0
7,58,0,25,0,3,0,0,0,97928,231.845,32.1,6.933,21490.943,191.511,13.17,0.78,0
7,59,0,25,0,3,0,0,0,97928,231.845,32.1,6.933,21490.943,191.511,13.17,0.78,0
7,60,0,25,0,3,0,0,0,97928,231.845,32.1,6.933,21490.943,191.511,13.17,0.78,0
7,61,0,25,0,3,0,0,0,97928,231.845,32.1,6.933,21490.943,191.511,13.17,0.78,0
7,62,0,25,0,3,0,0,0,97928,231.845,32.1,6.933,21490.943,191.511,13.17,0.78,0
7,63,0,25,0,3,0,0,0,97928,231.845,32.1,6.933,21490.943,191.511,13.17,0.78,0
7,64,0,25,0,3,0,0,0,97928,231.845,32.1,6.933,21490.943,191.511,13.17,0.78,0
7,65,1,26,0,3,0,0,0,97928,231.845,32.1,6.933,21490.943,191.511,13.17,0.78,0
7,66,0,26,0,3,0,0,0,97928,231.845,32.1,6.933,21490.943,191.511,13.17,0.78,0
7,67,0,26,0,3,0,0,0,97928,231.845,32.1,6.933,21490.943,191.511,13.17,0.78,0
7,68,0,26,0,3,0,0,0,97928,231.845,32.1,6.933,21490.943,191.511,13.17,0.78,0
7,69,0,26,0,3,0,0,0,97928,231.845,32.1,6.933,21490.943,191.511,13.17,0.78,0
7,70,0,26,0,3,0,0,0,97928,231.845,32.1,6.933,21490.943,191.511,13.17,0.78,0
7,71,0,26,0,3,0,0,0,97928,231.845,32.1,6.933,21490.943,191.511,13.17,0.78,0
7,72,0,26,0,3,0,0,0,97928,231.845,32.1,6.933,21490.943,191.511,13.17,0.78,0
7,73,0,26,0,3,0,0,0,97928,231.845,32.1,6.933,21490.943,191.511,13.17,0.78,0
7,74,0,26,0,3,0,0,0,97928,231.845,32.1,6.933,21490.943,191.511,13.17,0.78,0
7,75,0,26,0,3,0,0,0,97928,231.845,32.1,6.933,21490.943,191.511,13.17,0.78,0
7,76,0,26,0,3,0,0,0,97928,231.845,32.1,6.933,21490.943,191.511,13.17,0.78,0
7,77,0,26,0,3,0,0,0,97928,231.845,32.1,6.933,21490.943,191.511,13.17,0.78,0
7,78,0,26,0,3,0,0,0,97928,231.845,32.1,6.933,21490.943,191.511,13.17,0.78,0
7,79,0,26,0,3,0,0,0,97928,231.845,32.1,6.933,21490.943,191.511,13.17,0.78,0
7,80,0,26,0,3,0,0,0,97928,231.845,32.1,6.933,21490.943,191.511,13.17,0.78,0
7,81,0,26,0,3,0,0,0,97928,231.845,32.1,6.933,21490.943,191.511,13.17,0.78,0
7,82,0,26,0,3,0,0,0,97928,231.845,32.1,6.933,21490.943,191.511,13.17,0.78,0
7,83,0,26,0,3,0,0,0,97928,231.845,32.1,6.933,21490.943,191.511,13.17,0.78,0
7,84,0,26,0,3,0,0,0,97928,231.845,32.1,6.933,21490.943,191.511,13.17,0.78,0
7,85,0,26,0,3,0,0,0,97928,231.845,32.1,6.933,21490.943,191.511,13.17,0.78,0
7,86,39,65,0,3,0,0,0,97928,231.845,32.1,6.933,21490.943,191.511,13.17,0.78,0
7,87,0,65,0,3,0,0,0,97928,231.845,32.1,6.933,21490.943,191.511,13.17,0.78,0
7,88,0,65,0,3,0,0,0,97928,231.845,32.1,6.933,21490.943,191.511,13.17,0.78,0
7,89,0,65,0,3,0,0,0,97928,231.845,32.1,6.933,21490.943,191.511,13.17,0.78,0
7,90,0,65,0,3,0,0,0,97928,231.845,32.1,6.933,21490.943,191.511,13.17,0.78,0
7,91,1,66,0,3,0,0,0,97928,231.845,32.1,6.933,21490.943,191.511,13.17,0.78,0
7,92,0,66,0,3,0,0,0,97928,231.845,32.1,6.933,21490.943,191.511,13.17,0.78,0
7,93,0,66,0,3,0,0,0,97928,231.845,32.1,6.933,21490.943,191.511,13.17,0.78,0
7,94,2,68,0,3,0,0,0,97928,231.845,32.1,6.933,21490.943,191.511,13.17,0.78,0
7,95,0,68,0,3,0,0,0,97928,231.845,32.1,6.933,21490.943,191.511,13.17,0.78,0
7,96,0,68,0,3,0,0,0,97928,231.845,32.1,6.933,21490.943,191.511,13.17,0.78,0
7,97,0,68,0,3,0,0,0,97928,231.845,32.1,6.933,21490.943,191.511,13.17,0.78,0
7,98,2,70,0,3,0,0,0,97928,231.845,32.1,6.933,21490.943,191.511,13.17,0.78,0
7,99,0,70,0,3,0,0,0,97928,231.845,32.1,6.933,21490.943,191.511,13.17,0.78,0
7,100,3,73,0,3,0,0,0,97928,231.845,32.1,6.933,21490.943,191.511,13.17,0.78,0
7,101,0,73,0,3,0,0,0,97928,231.845,32.1,6.933,21490.943,191.511,13.17,0.78,0
7,102,1,74,0,3,0,0,0,97928,231.845,32.1,6.933,21490.943,191.511,13.17,0.78,0
7,103,0,74,0,3,0,0,0,97928,231.845,32.1,6.933,21490.943,191.511,13.17,0.78,0
7,104,0,74,0,3,0,0,0,97928,231.845,32.1,6.933,21490.943,191.511,13.17,0.78,0
7,105,0,74,0,3,0,0,0,97928,231.845,32.1,6.933,21490.943,191.511,13.17,0.78,0
7,106,0,74,0,3,0,0,0,97928,231.845,32.1,6.933,21490.943,191.511,13.17,0.78,0
7,107,0,74,0,3,0,0,0,97928,231.845,32.1,6.933,21490.943,191.511,13.17,0.78,0
7,108,0,74,0,3,0,0,0,97928,231.845,32.1,6.933,21490.943,191.511,13.17,0.78,0
7,109,2,76,0,3,0,0,0,97928,231.845,32.1,6.933,21490.943,191.511,13.17,0.78,0
7,110,0,76,0,3,0,0,0,97928,231.845,32.1,6.933,21490.943,191.511,13.17,0.78,0
7,111,0,76,0,3,0,0,0,97928,231.845,32.1,6.933,21490.943,191.511,13.17,0.78,0
7,112,0,76,0,3,0,0,0,97928,231.845,32.1,6.933,21490.943,191.511,13.17,0.78,0
7,113,0,76,0,3,0,0,0,97928,231.845,32.1,6.933,21490.943,191.511,13.17,0.78,0
7,114,0,76,0,3,0,0,0,97928,231.845,32.1,6.933,21490.943,191.511,13.17,0.78,0
7,115,0,76,0,3,0,0,0,97928,231.845,32.1,6.933,21490.943,191.511,13.17,0.78,0
7,116,6,82,0,3,0,0,0,97928,231.845,32.1,6.933,21490.943,191.511,13.17,0.78,0
7,117,0,82,0,3,0,0,0,97928,231.845,32.1,6.933,21490.943,191.511,13.17,0.78,0
7,118,0,82,0,3,0,0,0,97928,231.845,32.1,6.933,21490.943,191.511,13.17,0.78,0
7,119,4,86,0,3,0,0,0,97928,231.845,32.1,6.933,21490.943,191.511,13.17,0.78,0
7,120,0,86,0,3,0,0,0,97928,231.845,32.1,6.933,21490.943,191.511,13.17,0.78,0
7,121,5,91,0,3,0,0,0,97928,231.845,32.1,6.933,21490.943,191.511,13.17,0.78,0
7,122,0,91,0,3,0,0,0,97928,231.845,32.1,6.933,21490.943,191.511,13.17,0.78,0
7,123,0,91,0,3,0,0,0,97928,231.845,32.1,6.933,21490.943,191.511,13.17,0.78,0
7,124,0,91,0,3,0,0,0,97928,231.845,32.1,6.933,21490.943,191.511,13.17,0.78,0
7,125,0,91,0,3,0,0,0,97928,231.845,32.1,6.933,21490.943,191.511,13.17,0.78,0
7,126,1,92,0,3,0,0,0,97928,231.845,32.1,6.933,21490.943,191.511,13.17,0.78,0
7,127,0,92,0,3,0,0,0,97928,231.845,32.1,6.933,21490.943,191.511,13.17,0.78,0
7,128,0,92,0,3,0,0,0,97928,231.845,32.1,6.933,21490.943,191.511,13.17,0.78,0
7,129,0,92,0,3,0,0,0,97928,231.845,32.1,6.933,21490.943,191.511,13.17,0.78,0
7,130,0,92,0,3,0,0,0,97928,231.845,32.1,6.933,21490.943,191.511,13.17,0.78,0
7,131,0,92,0,3,0,0,0,97928,231.845,32.1,6.933,21490.943,191.511,13.17,0.78,0
7,132,0,92,0,3,0,0,0,97928,231.845,32.1,6.933,21490.943,191.511,13.17,0.78,0
7,133,0,92,0,3,0,0,0,97928,231.845,32.1,6.933,21490.943,191.511,13.17,0.78,0
7,134,0,92,0,3,0,0,0,97928,231.845,32.1,6.933,21490.943,191.511,13.17,0.78,0
7,135,0,92,0,3,0,0,0,97928,231.845,32.1,6.933,21490.943,191.511,13.17,0.78,0
7,136,1,93,0,3,0,0,0,97928,231.845,32.1,6.933,21490.943,191.511,13.17,0.78,0
7,137,0,93,0,3,0,0,0,97928,231.845,32.1,6.933,21490.943,191.511,13.17,0.78,0
7,138,0,93,0,3,0,0,0,97928,231.845,32.1,6.933,21490.943,191.511,13.17,0.78,0
7,139,0,93,0,3,0,0,0,97928,231.845,32.1,6.933,21490.943,191.511,13.17,0.78,0
7,140,0,93,0,3,0,0,0,97928,231.845,32.1,6.933,21490.943,191.511,13.17,0.78,0
7,141,0,93,0,3,0,0,0,97928,231.845,32.1,6.933,21490.943,191.511,13.17,0.78,0
7,142,1,94,0,3,0,0,0,97928,231.845,32.1,6.933,21490.943,191.511,13.17,0.78,0
7,143,0,94,0,3,0,0,0,97928,231.845,32.1,6.933,21490.943,191.511,13.17,0.78,0
7,144,0,94,0,3,0,0,0,97928,231.845,32.1,6.933,21490.943,191.511,13.17,0.78,0
7,145,0,94,0,3,0,0,0,97928,231.845,32.1,6.933,21490.943,191.511,13.17,0.78,0
7,146,0,94,0,3,0,0,0,97928,231.845,32.1,6.933,21490.943,191.511,13.17,0.78,0
7,147,0,94,0,3,0,0,0,97928,231.845,32.1,6.933,21490.943,191.511,13.17,0.78,0
7,148,0,94,0,3,0,0,0,97928,231.845,32.1,6.933,21490.943,191.511,13.17,0.78,0
7,149,0,94,0,3,0,0,0,97928,231.845,32.1,6.933,21490.943,191.511,13.17,0.78,0
7,150,0,94,0,3,0,0,0,97928,231.845,32.1,6.933,21490.943,191.511,13.17,0.78,0
7,151,0,94,0,3,0,0,0,97928,231.845,32.1,6.933,21490.943,191.511,13.17,0.78,0
7,152,0,94,0,3,0,0,0,97928,231.845,32.1,6.933,21490.943,191.511,13.17,0.78,0
7,153,0,94,0,3,0,0,0,97928,231.845,32.1,6.933,21490.943,191.511,13.17,0.78,0
7,154,0,94,0,3,0,0,0,97928,231.845,32.1,6.933,21490.943,191.511,13.17,0.78,0
7,155,0,94,0,3,0,0,0,97928,231.845,32.1,6.933,21490.943,191.511,13.17,0.78,0
7,156,0,94,0,3,0,0,0,97928,231.845,32.1,6.933,21490.943,191.511,13.17,0.78,0
7,157,1,95,0,3,0,0,0,97928,231.845,32.1,6.933,21490.943,191.511,13.17,0.78,0
7,158,0,95,0,3,0,0,0,97928,231.845,32.1,6.933,21490.943,191.511,13.17,0.78,0
7,159,0,95,0,3,0,0,0,97928,231.845,32.1,6.933,21490.943,191.511,13.17,0.78,0
7,160,0,95,0,3,0,0,0,97928,231.845,32.1,6.933,21490.943,191.511,13.17,0.78,0
7,161,0,95,0,3,0,0,0,97928,231.845,32.1,6.933,21490.943,191.511,13.17,0.78,0
7,162,0,95,0,3,0,0,0,97928,231.845,32.1,6.933,21490.943,191.511,13.17,0.78,0
7,163,0,95,0,3,0,0,0,97928,231.845,32.1,6.933,21490.943,191.511,13.17,0.78,0
7,164,0,95,0,3,0,0,0,97928,231.845,32.1,6.933,21490.943,191.511,13.17,0.78,0
7,165,0,95,0,3,0,0,0,97928,231.845,32.1,6.933,21490.943,191.511,13.17,0.78,0
7,166,0,95,0,3,0,0,0,97928,231.845,32.1,6.933,21490.943,191.511,13.17,0.78,0
7,167,0,95,0,3,0,0,0,97928,231.845,32.1,6.933,21490.943,191.511,13.17,0.78,0
7,168,0,95,0,3,0,0,0,97928,231.845,32.1,6.933,21490.943,191.511,13.17,0.78,0
7,169,0,95,0,3,0,0,0,97928,231.845,32.1,6.933,21490.943,191.511,13.17,0.78,0
7,170,0,95,0,3,0,0,0,97928,231.845,32.1,6.933,21490.943,191.511,13.17,0.78,0
7,171,0,95,0,3,0,0,0,97928,231.845,32.1,6.933,21490.943,191.511,13.17,0.78,0
7,172,0,95,0,3,0,0,0,97928,231.845,32.1,6.933,21490.943,191.511,13.17,0.78,0
7,173,1,96,0,3,0,0,0,97928,231.845,32.1,6.933,21490.943,191.511,13.17,0.78,0
7,174,0,96,0,3,0,0,0,97928,231.845,32.1,6.933,21490.943,191.511,13.17,0.78,0
7,175,0,96,0,3,0,0,0,97928,231.845,32.1,6.933,21490.943,191.511,13.17,0.78,0
7,176,0,96,0,3,0,0,0,97928,231.845,32.1,6.933,21490.943,191.511,13.17,0.78,0
7,177,1,97,0,3,0,0,0,97928,231.845,32.1,6.933,21490.943,191.511,13.17,0.78,0
7,178,1,98,0,3,0,0,0,97928,231.845,32.1,6.933,21490.943,191.511,13.17,0.78,0
7,179,0,98,0,3,0,0,0,97928,231.845,32.1,6.933,21490.943,191.511,13.17,0.78,0
7,180,3,101,0,3,0,0,0,97928,231.845,32.1,6.933,21490.943,191.511,13.17,0.78,0
7,181,0,101,0,3,0,0,0,97928,231.845,32.1,6.933,21490.943,191.511,13.17,0.78,0
7,182,0,101,0,3,0,0,0,97928,231.845,32.1,6.933,21490.943,191.511,13.17,0.78,0
7,183,0,101,0,3,0,0,0,97928,231.845,32.1,6.933,21490.943,191.511,13.17,0.78,0
7,184,0,101,0,3,0,0,0,97928,231.845,32.1,6.933,21490.943,191.511,13.17,0.78,0
7,185,5,106,0,3,0,0,0,97928,231.845,32.1,6.933,21490.943,191.511,13.17,0.78,0
7,186,0,106,0,3,0,0,0,97928,231.845,32.1,6.933,21490.943,191.511,13.17,0.78,0
7,187,1,107,0,3,0,0,0,97928,231.845,32.1,6.933,21490.943,191.511,13.17,0.78,0
7,188,0,107,0,3,0,0,0,97928,231.845,32.1,6.933,21490.943,191.511,13.17,0.78,0
7,189,0,107,0,3,0,0,0,97928,231.845,32.1,6.933,21490.943,191.511,13.17,0.78,0
7,190,1,108,0,3,0,0,0,97928,231.845,32.1,6.933,21490.943,191.511,13.17,0.78,0
7,191,0,108,0,3,0,0,0,97928,231.845,32.1,6.933,21490.943,191.511,13.17,0.78,0
7,192,3,111,0,3,0,0,0,97928,231.845,32.1,6.933,21490.943,191.511,13.17,0.78,0
7,193,0,111,0,3,0,0,0,97928,231.845,32.1,6.933,21490.943,191.511,13.17,0.78,0
7,194,0,111,0,3,0,0,0,97928,231.845,32.1,6.933,21490.943,191.511,13.17,0.78,0
7,195,0,111,0,3,0,0,0,97928,231.845,32.1,6.933,21490.943,191.511,13.17,0.78,0
7,196,0,111,0,3,0,0,0,97928,231.845,32.1,6.933,21490.943,191.511,13.17,0.78,0
7,197,0,111,0,3,0,0,0,97928,231.845,32.1,6.933,21490.943,191.511,13.17,0.78,0
7,198,1,112,0,3,0,0,0,97928,231.845,32.1,6.933,21490.943,191.511,13.17,0.78,0
7,199,0,112,0,3,0,0,0,97928,231.845,32.1,6.933,21490.943,191.511,13.17,0.78,0
7,200,0,112,0,3,0,0,0,97928,231.845,32.1,6.933,21490.943,191.511,13.17,0.78,0
7,201,7,119,0,3,0,0,0,97928,231.845,32.1,6.933,21490.943,191.511,13.17,0.78,0
7,202,0,119,0,3,0,0,0,97928,231.845,32.1,6.933,21490.943,191.511,13.17,0.78,0
7,203,0,119,0,3,0,0,0,97928,231.845,32.1,6.933,21490.943,191.511,13.17,0.78,0
7,204,0,119,0,3,0,0,0,97928,231.845,32.1,6.933,21490.943,191.511,13.17,0.78,0
8,1,0,966,0,24,0,0,100,45195777,16.177,31.9,11.198,18933.907,191.032,5.5,0.825,4
8,2,167,1133,7,31,0,0,100,45195777,16.177,31.9,11.198,18933.907,191.032,5.5,0.825,4
8,3,0,1133,3,34,0,0,100,45195777,16.177,31.9,11.198,18933.907,191.032,5.5,0.825,4
8,4,132,1265,3,37,0,0,100,45195777,16.177,31.9,11.198,18933.907,191.032,5.5,0.825,4
8,5,186,1451,6,43,0,0,100,45195777,16.177,31.9,11.198,18933.907,191.032,5.5,0.825,4
8,6,103,1554,3,46,0,0,100,45195777,16.177,31.9,11.198,18933.907,191.032,5.5,0.825,4
8,7,74,1628,7,53,0,0,100,45195777,16.177,31.9,11.198,18933.907,191.032,5.5,0.825,4
8,8,87,1715,7,60,0,0,100,45195777,16.177,31.9,11.198,18933.907,191.032,5.5,0.825,4
8,9,80,1795,5,65,0,0,100,45195777,16.177,31.9,11.198,18933.907,191.032,5.5,0.825,4
8,10,99,1894,14,79,0,0,100,45195777,16.177,31.9,11.198,18933.907,191.032,5.5,0.825,4
8,11,81,1975,3,82,0,0,100,45195777,16.177,31.9,11.198,18933.907,191.032,5.5,0.825,4
8,12,162,2137,7,89,0,0,100,45195777,16.177,31.9,11.198,18933.907,191.032,5.5,0.825,4
8,13,66,2203,6,95,0,0,100,45195777,16.177,31.9,11.198,18933.907,191.032,5.5,0.825,4
8,14,69,2272,3,98,0,0,100,45195777,16.177,31.9,11.198,18933.907,191.032,5.5,0.825,4
8,15,160,2432,7,105,0,0,100,45195777,16.177,31.9,11.198,18933.907,191.032,5.5,0.825,4
8,16,0,2432,4,109,0,0,100,45195777,16.177,31.9,11.198,18933.907,191.032,5.5,0.825,4
8,17,128,2560,6,115,0,0,100,45195777,16.177,31.9,11.198,18933.907,191.032,5.5,0.825,4
8,18,98,2658,7,122,0,0,100,45195777,16.177,31.9,11.198,18933.907,191.032,5.5,0.825,4
8,19,170,2828,10,132,0,0,100,45195777,16.177,31.9,11.198,18933.907,191.032,5.5,0.825,4
8,20,102,2930,2,134,0,0,100,45195777,16.177,31.9,11.198,18933.907,191.032,5.5,0.825,4
8,21,90,3020,8,142,0,0,100,45195777,16.177,31.9,11.198,18933.907,191.032,5.5,0.825,4
8,22,112,3132,9,151,0,0,100,45195777,16.177,31.9,11.198,18933.907,191.032,5.5,0.825,4
8,23,144,3276,8,159,0,0,100,45195777,16.177,31.9,11.198,18933.907,191.032,5.5,0.825,4
8,24,147,3423,6,165,0,0,100,45195777,16.177,31.9,11.198,18933.907,191.032,5.5,0.825,4
8,25,0,3423,2,167,0,0,100,45195777,16.177,31.9,11.198,18933.907,191.032,5.5,0.825,4
8,26,344,3767,18,185,0,0,98.15,45195777,16.177,31.9,11.198,18933.907,191.032,5.5,0.825,4
8,27,0,3767,1,186,0,0,88.89,45195777,16.177,31.9,11.198,18933.907,191.032,5.5,0.825,4
8,28,223,3990,11,197,0,0,88.89,45195777,16.177,31.9,11.198,18933.907,191.032,5.5,0.825,4
8,29,124,4114,10,207,0,0,88.89,45195777,16.177,31.9,11.198,18933.907,191.032,5.5,0.825,4
8,30,158,4272,7,214,0,0,88.89,45195777,16.177,31.9,11.198,18933.907,191.032,5.5,0.825,4
8,31,143,4415,4,218,0,0,88.89,45195777,16.177,31.9,11.198,18933.907,191.032,5.5,0.825,4
8,32,104,4519,7,225,0,0,88.89,45195777,16.177,31.9,11.198,18933.907,191.032,5.5,0.825,4
8,33,149,4668,12,237,0,0,88.89,45195777,16.177,31.9,11.198,18933.907,191.032,5.5,0.825,4
8,34,102,4770,9,246,0,0,88.89,45195777,16.177,31.9,11.198,18933.907,191.032,5.5,0.825,4
8,35,104,4874,14,260,0,0,88.89,45195777,16.177,31.9,11.198,18933.907,191.032,5.5,0.825,4
8,36,133,5007,4,264,0,0,88.89,45195777,16.177,31.9,11.198,18933.907,191.032,5.5,0.825,4
8,37,188,5195,9,273,0,0,88.89,45195777,16.177,31.9,11.198,18933.907,191.032,5.5,0.825,4
8,38,163,5358,9,282,0,0,88.89,45195777,16.177,31.9,11.198,18933.907,191.032,5.5,0.825,4
8,39,240,5598,11,293,0,0,88.89,45195777,16.177,31.9,11.198,18933.907,191.032,5.5,0.825,4
8,40,165,5763,7,300,0,0,88.89,45195777,16.177,31.9,11.198,18933.907,191.032,5.5,0.825,4
8,41,13,5776,0,300,0,0,94.44,45195777,16.177,31.9,11.198,18933.907,191.032,5.5,0.825,4
8,42,245,6021,5,305,0,0,90.74,45195777,16.177,31.9,11.198,18933.907,191.032,5.5,0.825,4
8,43,529,6550,14,319,0,0,90.74,45195777,16.177,31.9,11.198,18933.907,191.032,5.5,0.825,4
8,44,316,6866,10,329,0,0,90.74,45195777,16.177,31.9,11.198,18933.907,191.032,5.5,0.825,4
8,45,255,7121,24,353,0,0,90.74,45195777,16.177,31.9,11.198,18933.907,191.032,5.5,0.825,4
8,46,345,7466,3,356,0,0,90.74,45195777,16.177,31.9,11.198,18933.907,191.032,5.5,0.825,4
8,47,326,7792,7,363,0,0,90.74,45195777,16.177,31.9,11.198,18933.907,191.032,5.5,0.825,4
8,48,0,7792,3,366,0,0,90.74,45195777,16.177,31.9,11.198,18933.907,191.032,5.5,0.825,4
8,49,566,8358,16,382,0,0,90.74,45195777,16.177,31.9,11.198,18933.907,191.032,5.5,0.825,4
8,50,438,8796,11,393,0,0,90.74,45195777,16.177,31.9,11.198,18933.907,191.032,5.5,0.825,4
8,51,474,9270,10,403,0,0,90.74,45195777,16.177,31.9,11.198,18933.907,191.032,5.5,0.825,4
8,52,648,9918,13,416,0,0,90.74,45195777,16.177,31.9,11.198,18933.907,191.032,5.5,0.825,4
8,53,718,10636,17,433,0,0,90.74,45195777,16.177,31.9,11.198,18933.907,191.032,5.5,0.825,4
8,54,704,11340,12,445,0,0,90.74,45195777,16.177,31.9,11.198,18933.907,191.032,5.5,0.825,4
8,55,723,12063,7,452,0,0,90.74,45195777,16.177,31.9,11.198,18933.907,191.032,5.5,0.825,4
8,56,552,12615,15,467,0,0,90.74,45195777,16.177,31.9,11.198,18933.907,191.032,5.5,0.825,4
8,57,600,13215,17,484,0,0,90.74,45195777,16.177,31.9,11.198,18933.907,191.032,5.5,0.825,4
8,58,705,13920,16,500,0,0,90.74,45195777,16.177,31.9,11.198,18933.907,191.032,5.5,0.825,4
8,59,769,14689,8,508,0,0,90.74,45195777,16.177,31.9,11.198,18933.907,191.032,5.5,0.825,4
8,60,717,15406,12,520,0,0,90.74,45195777,16.177,31.9,11.198,18933.907,191.032,5.5,0.825,4
8,61,795,16201,8,528,0,0,90.74,45195777,16.177,31.9,11.198,18933.907,191.032,5.5,0.825,4
8,62,637,16838,11,539,0,0,90.74,45195777,16.177,31.9,11.198,18933.907,191.032,5.5,0.825,4
8,63,564,17402,17,556,0,0,90.74,45195777,16.177,31.9,11.198,18933.907,191.032,5.5,0.825,4
8,64,904,18306,13,569,0,0,90.74,45195777,16.177,31.9,11.198,18933.907,191.032,5.5,0.825,4
8,65,949,19255,14,583,0,0,90.74,45195777,16.177,31.9,11.198,18933.907,191.032,5.5,0.825,4
8,66,0,19255,5,588,0,0,88.89,45195777,16.177,31.9,11.198,18933.907,191.032,5.5,0.825,4
8,67,1769,21024,44,632,0,0,88.89,45195777,16.177,31.9,11.198,18933.907,191.032,5.5,0.825,4
8,68,983,22007,16,648,0,0,88.89,45195777,16.177,31.9,11.198,18933.907,191.032,5.5,0.825,4
8,69,774,22781,16,664,0,0,88.89,45195777,16.177,31.9,11.198,18933.907,191.032,5.5,0.825,4
8,70,826,23607,29,693,0,0,88.89,45195777,16.177,31.9,11.198,18933.907,191.032,5.5,0.825,4
8,71,1141,24748,24,717,0,0,88.89,45195777,16.177,31.9,11.198,18933.907,191.032,5.5,0.825,4
8,72,1239,25987,18,735,0,0,88.89,45195777,16.177,31.9,11.198,18933.907,191.032,5.5,0.825,4
8,73,1373,27360,30,765,0,0,88.89,45195777,16.177,31.9,11.198,18933.907,191.032,5.5,0.825,4
8,74,1391,28751,20,785,0,0,88.89,45195777,16.177,31.9,11.198,18933.907,191.032,5.5,0.825,4
8,75,1531,30282,30,815,0,0,88.89,45195777,16.177,31.9,11.198,18933.907,191.032,5.5,0.825,4
8,76,1282,31564,18,833,0,0,88.89,45195777,16.177,31.9,11.198,18933.907,191.032,5.5,0.825,4
8,77,1208,32772,21,854,0,0,88.89,45195777,16.177,31.9,11.198,18933.907,191.032,5.5,0.825,4
8,78,1374,34146,24,878,0,0,88.89,45195777,16.177,31.9,11.198,18933.907,191.032,5.5,0.825,4
8,79,1393,35539,35,913,0,0,88.89,45195777,16.177,31.9,11.198,18933.907,191.032,5.5,0.825,4
8,80,0,35539,16,929,0,0,88.89,45195777,16.177,31.9,11.198,18933.907,191.032,5.5,0.825,4
8,81,4018,39557,50,979,0,0,88.89,45195777,16.177,31.9,11.198,18933.907,191.032,5.5,0.825,4
8,82,1634,41191,13,992,0,0,88.89,45195777,16.177,31.9,11.198,18933.907,191.032,5.5,0.825,4
8,83,1581,42772,19,1011,0,0,88.89,45195777,16.177,31.9,11.198,18933.907,191.032,5.5,0.825,4
8,84,2146,44918,32,1043,0,0,88.89,45195777,16.177,31.9,11.198,18933.907,191.032,5.5,0.825,4
8,85,0,44918,6,1049,0,0,88.89,45195777,16.177,31.9,11.198,18933.907,191.032,5.5,0.825,4
8,86,4920,49838,36,1085,0,0,88.89,45195777,16.177,31.9,11.198,18933.907,191.032,5.5,0.825,4
8,87,2606,52444,39,1124,0,0,88.89,45195777,16.177,31.9,11.198,18933.907,191.032,5.5,0.825,4
8,88,0,52444,43,1167,0,0,88.89,45195777,16.177,31.9,11.198,18933.907,191.032,5.5,0.825,4
8,89,5287,57731,40,1207,0,0,88.89,45195777,16.177,31.9,11.198,18933.907,191.032,5.5,0.825,4
8,90,0,57731,10,1217,0,0,88.89,45195777,16.177,31.9,11.198,18933.907,191.032,5.5,0.825,4
8,91,4524,62255,63,1280,0,0,88.89,45195777,16.177,31.9,11.198,18933.907,191.032,5.5,0.825,4
8,92,2262,64517,27,1307,0,0,92.59,45195777,16.177,31.9,11.198,18933.907,191.032,5.5,0.825,4
8,93,2667,67184,44,1351,0,0,81.48,45195777,16.177,31.9,11.198,18933.907,191.032,5.5,0.825,4
8,94,2744,69928,34,1385,0,0,92.59,45195777,16.177,31.9,11.198,18933.907,191.032,5.5,0.825,4
8,95,2845,72773,52,1437,0,0,92.59,45195777,16.177,31.9,11.198,18933.907,191.032,5.5,0.825,4
8,96,0,72773,16,1453,0,0,92.59,45195777,16.177,31.9,11.198,18933.907,191.032,5.5,0.825,4
8,97,2590,75363,37,1490,0,0,92.59,45195777,16.177,31.9,11.198,18933.907,191.032,5.5,0.825,4
8,98,2439,77802,33,1523,0,0,92.59,45195777,16.177,31.9,11.198,18933.907,191.032,5.5,0.825,4
8,99,2632,80434,79,1602,0,0,92.59,45195777,16.177,31.9,11.198,18933.907,191.032,5.5,0.825,4
8,100,2979,83413,52,1654,0,0,92.59,45195777,16.177,31.9,11.198,18933.907,191.032,5.5,0.825,4
8,101,3604,87017,53,1707,0,0,92.59,45195777,16.177,31.9,11.198,18933.907,191.032,5.5,0.825,4
8,102,3663,90680,42,1749,0,0,92.59,45195777,16.177,31.9,11.198,18933.907,191.032,5.5,0.825,4
8,103,3367,94047,61,1810,0,0,92.59,45195777,16.177,31.9,11.198,18933.907,191.032,5.5,0.825,4
8,104,3449,97496,8,1818,0,0,92.59,45195777,16.177,31.9,11.198,18933.907,191.032,5.5,0.825,4
8,105,2657,100153,85,1903,0,0,92.59,45195777,16.177,31.9,11.198,18933.907,191.032,5.5,0.825,4
8,106,3099,103252,23,1926,0,0,92.59,45195777,16.177,31.9,11.198,18933.907,191.032,5.5,0.825,4
8,107,3645,106897,124,2050,0,0,92.59,45195777,16.177,31.9,11.198,18933.907,191.032,5.5,0.825,4
8,108,4250,111147,62,2112,0,0,92.59,45195777,16.177,31.9,11.198,18933.907,191.032,5.5,0.825,4
8,109,3623,114770,21,2133,0,0,92.59,45195777,16.177,31.9,11.198,18933.907,191.032,5.5,0.825,4
8,110,4518,119288,71,2204,0,0,92.59,45195777,16.177,31.9,11.198,18933.907,191.032,5.5,0.825,4
8,111,3223,122511,42,2246,0,0,90.74,45195777,16.177,31.9,11.198,18933.907,191.032,5.5,0.825,4
8,112,4231,126742,127,2373,0,0,90.74,45195777,16.177,31.9,11.198,18933.907,191.032,5.5,0.825,4
8,113,4019,130761,0,2373,0,0,90.74,45195777,16.177,31.9,11.198,18933.907,191.032,5.5,0.825,4
8,114,5344,136105,133,2506,0,0,90.74,45195777,16.177,31.9,11.198,18933.907,191.032,5.5,0.825,4
8,115,5782,141887,111,2617,0,0,90.74,45195777,16.177,31.9,11.198,18933.907,191.032,5.5,0.825,4
8,116,6127,148014,105,2722,0,0,90.74,45195777,16.177,31.9,11.198,18933.907,191.032,5.5,0.825,4
8,117,5493,153507,125,2847,0,0,90.74,45195777,16.177,31.9,11.198,18933.907,191.032,5.5,0.825,4
8,118,9006,162513,92,2939,0,0,90.74,45195777,16.177,31.9,11.198,18933.907,191.032,5.5,0.825,4
8,119,0,162513,17,2956,0,0,90.74,45195777,16.177,31.9,11.198,18933.907,191.032,5.5,0.825,4
8,120,4890,167403,126,3082,0,0,90.74,45195777,16.177,31.9,11.198,18933.907,191.032,5.5,0.825,4
8,121,5939,173342,118,3200,0,0,90.74,45195777,16.177,31.9,11.198,18933.907,191.032,5.5,0.825,4
8,122,5641,178983,111,3311,0,0,90.74,45195777,16.177,31.9,11.198,18933.907,191.032,5.5,0.825,4
8,123,6377,185360,155,3466,0,0,90.74,45195777,16.177,31.9,11.198,18933.907,191.032,5.5,0.825,4
8,124,5929,191289,92,3558,0,0,90.74,45195777,16.177,31.9,11.198,18933.907,191.032,5.5,0.825,4
8,125,5241,196530,54,3612,0,0,88.89,45195777,16.177,31.9,11.198,18933.907,191.032,5.5,0.825,4
8,126,5376,201906,55,3667,0,0,88.89,45195777,16.177,31.9,11.198,18933.907,191.032,5.5,0.825,4
8,127,4824,206730,196,3863,0,0,88.89,45195777,16.177,31.9,11.198,18933.907,191.032,5.5,0.825,4
8,128,6792,213522,146,4009,0,0,88.89,45195777,16.177,31.9,11.198,18933.907,191.032,5.5,0.825,4
8,129,7147,220669,126,4135,0,0,87.96,45195777,16.177,31.9,11.198,18933.907,191.032,5.5,0.825,4
8,130,7513,228182,156,4291,0,0,87.96,45195777,16.177,31.9,11.198,18933.907,191.032,5.5,0.825,4
8,131,7482,235664,159,4450,0,0,87.96,45195777,16.177,31.9,11.198,18933.907,191.032,5.5,0.825,4
8,132,6134,241798,106,4556,0,0,87.96,45195777,16.177,31.9,11.198,18933.907,191.032,5.5,0.825,4
8,133,4688,246486,78,4634,0,0,87.96,45195777,16.177,31.9,11.198,18933.907,191.032,5.5,0.825,4
8,134,7369,253855,151,4785,0,0,87.96,45195777,16.177,31.9,11.198,18933.907,191.032,5.5,0.825,4
8,135,7043,260898,303,5088,0,0,87.96,45195777,16.177,31.9,11.198,18933.907,191.032,5.5,0.825,4
8,136,7663,268561,158,5246,0,0,87.96,45195777,16.177,31.9,11.198,18933.907,191.032,5.5,0.825,4
8,137,7498,276059,182,5428,0,0,87.96,45195777,16.177,31.9,11.198,18933.907,191.032,5.5,0.825,4
8,138,6365,282424,137,5565,0,0,87.96,45195777,16.177,31.9,11.198,18933.907,191.032,5.5,0.825,4
8,139,6663,289087,92,5657,0,0,87.96,45195777,16.177,31.9,11.198,18933.907,191.032,5.5,0.825,4
8,140,5469,294556,93,5750,0,0,87.96,45195777,16.177,31.9,11.198,18933.907,191.032,5.5,0.825,4
8,141,4557,299113,127,5877,0,0,87.96,45195777,16.177,31.9,11.198,18933.907,191.032,5.5,0.825,4
8,142,6840,305953,237,6114,0,0,87.96,45195777,16.177,31.9,11.198,18933.907,191.032,5.5,0.825,4
8,143,6693,312646,292,6406,0,0,87.96,45195777,16.177,31.9,11.198,18933.907,191.032,5.5,0.825,4
8,144,8225,320871,161,6567,0,0,87.96,45195777,16.177,31.9,11.198,18933.907,191.032,5.5,0.825,4
8,145,8159,329030,228,6795,0,0,87.96,45195777,16.177,31.9,11.198,18933.907,191.032,5.5,0.825,4
8,146,7759,336789,53,6848,0,0,87.96,45195777,16.177,31.9,11.198,18933.907,191.032,5.5,0.825,4
8,147,5352,342141,231,7079,0,0,87.96,45195777,16.177,31.9,11.198,18933.907,191.032,5.5,0.825,4
8,148,8713,350854,323,7402,0,0,87.96,45195777,16.177,31.9,11.198,18933.907,191.032,5.5,0.825,4
8,149,8771,359625,259,7661,0,0,87.96,45195777,16.177,31.9,11.198,18933.907,191.032,5.5,0.825,4
8,150,10550,370175,283,7944,0,0,87.96,45195777,16.177,31.9,11.198,18933.907,191.032,5.5,0.825,4
8,151,10104,380279,185,8129,0,0,87.96,45195777,16.177,31.9,11.198,18933.907,191.032,5.5,0.825,4
8,152,11730,392009,176,8305,0,0,87.96,45195777,16.177,31.9,11.198,18933.907,191.032,5.5,0.825,4
8,153,9217,401226,96,8401,0,0,87.96,45195777,16.177,31.9,11.198,18933.907,191.032,5.5,0.825,4
8,154,7187,408413,97,8498,0,0,87.96,45195777,16.177,31.9,11.198,18933.907,191.032,5.5,0.825,4
8,155,9309,417722,232,8730,0,0,87.96,45195777,16.177,31.9,11.198,18933.907,191.032,5.5,0.825,4
8,156,10504,428226,241,8971,0,0,87.96,45195777,16.177,31.9,11.198,18933.907,191.032,5.5,0.825,4
8,157,10933,439159,184,9155,0,0,87.96,45195777,16.177,31.9,11.198,18933.907,191.032,5.5,0.825,4
8,158,12026,451185,313,9468,0,0,87.96,45195777,16.177,31.9,11.198,18933.907,191.032,5.5,0.825,4
8,159,10684,461869,217,9685,0,0,87.96,45195777,16.177,31.9,11.198,18933.907,191.032,5.5,0.825,4
8,160,9924,471793,122,9807,0,0,87.96,45195777,16.177,31.9,11.198,18933.907,191.032,5.5,0.825,4
8,161,6986,478779,105,9912,0,0,87.96,45195777,16.177,31.9,11.198,18933.907,191.032,5.5,0.825,4
8,162,9215,487994,267,10179,0,0,87.96,45195777,16.177,31.9,11.198,18933.907,191.032,5.5,0.825,4
8,163,12027,500021,278,10457,0,0,87.96,45195777,16.177,31.9,11.198,18933.907,191.032,5.5,0.825,4
8,164,12259,512280,256,10713,0,0,87.96,45195777,16.177,31.9,11.198,18933.907,191.032,5.5,0.825,4
8,165,11905,524185,281,10994,0,0,87.96,45195777,16.177,31.9,11.198,18933.907,191.032,5.5,0.825,4
8,166,11505,535690,212,11206,0,0,87.96,45195777,16.177,31.9,11.198,18933.907,191.032,5.5,0.825,4
8,167,10778,546468,101,11307,0,0,87.96,45195777,16.177,31.9,11.198,18933.907,191.032,5.5,0.825,4
8,168,9056,555524,105,11412,0,0,87.96,45195777,16.177,31.9,11.198,18933.907,191.032,5.5,0.825,4
8,169,9908,565432,298,11710,0,0,87.96,45195777,16.177,31.9,11.198,18933.907,191.032,5.5,0.825,4
8,170,11893,577325,200,11910,0,0,87.96,45195777,16.177,31.9,11.198,18933.907,191.032,5.5,0.825,4
8,171,11674,588999,319,12229,0,0,87.96,45195777,16.177,31.9,11.198,18933.907,191.032,5.5,0.825,4
8,172,12701,601700,262,12491,0,0,87.96,45195777,16.177,31.9,11.198,18933.907,191.032,5.5,0.825,4
8,173,11945,613645,214,12705,0,0,87.96,45195777,16.177,31.9,11.198,18933.907,191.032,5.5,0.825,4
8,174,9276,622921,204,12909,0,0,87.96,45195777,16.177,31.9,11.198,18933.907,191.032,5.5,0.825,4
8,175,17213,640134,573,13482,0,0,87.96,45195777,16.177,31.9,11.198,18933.907,191.032,5.5,0.825,4
8,176,12027,652161,470,13952,0,0,87.96,45195777,16.177,31.9,11.198,18933.907,191.032,5.5,0.825,4
8,177,12638,664799,424,14376,0,0,87.96,45195777,16.177,31.9,11.198,18933.907,191.032,5.5,0.825,4
8,178,13467,678266,390,14766,0,0,87.96,45195777,16.177,31.9,11.198,18933.907,191.032,5.5,0.825,4
8,179,12956,691222,442,15208,0,0,87.96,45195777,16.177,31.9,11.198,18933.907,191.032,5.5,0.825,4
8,180,11249,702471,335,15543,0,0,87.96,45195777,16.177,31.9,11.198,18933.907,191.032,5.5,0.825,4
8,181,8841,711312,206,15749,0,0,87.96,45195777,16.177,31.9,11.198,18933.907,191.032,5.5,0.825,4
8,182,11807,723119,364,16113,0,0,87.96,45195777,16.177,31.9,11.198,18933.907,191.032,5.5,0.825,4
8,183,13477,736596,406,16519,0,0,87.96,45195777,16.177,31.9,11.198,18933.907,191.032,5.5,0.825,4
8,184,14392,750988,418,16937,0,0,87.96,45195777,16.177,31.9,11.198,18933.907,191.032,5.5,0.825,4
8,185,14001,764989,3351,20288,0,0,87.96,45195777,16.177,31.9,11.198,18933.907,191.032,5.5,0.825,4
8,186,14687,779676,311,20599,0,0,87.96,45195777,16.177,31.9,11.198,18933.907,191.032,5.5,0.825,4
8,187,11129,790805,196,20795,0,0,87.96,45195777,16.177,31.9,11.198,18933.907,191.032,5.5,0.825,4
8,188,7668,798473,223,21018,0,0,87.96,45195777,16.177,31.9,11.198,18933.907,191.032,5.5,0.825,4
8,189,11242,809715,450,21468,0,0,87.96,45195777,16.177,31.9,11.198,18933.907,191.032,5.5,0.825,4
8,190,14740,824455,359,21827,0,0,87.96,45195777,16.177,31.9,11.198,18933.907,191.032,5.5,0.825,4
8,191,16447,840902,399,22226,0,0,87.96,45195777,16.177,31.9,11.198,18933.907,191.032,5.5,0.825,4
8,192,15454,856356,484,22710,0,0,87.96,45195777,16.177,31.9,11.198,18933.907,191.032,5.5,0.825,4
8,193,15099,871455,515,23225,0,0,82.87,45195777,16.177,31.9,11.198,18933.907,191.032,5.5,0.825,4
8,194,12428,883883,356,23581,0,0,82.87,45195777,16.177,31.9,11.198,18933.907,191.032,5.5,0.825,4
8,195,10310,894193,287,23868,0,0,82.87,45195777,16.177,31.9,11.198,18933.907,191.032,5.5,0.825,4
8,196,9524,903717,318,24186,0,0,82.87,45195777,16.177,31.9,11.198,18933.907,191.032,5.5,0.825,4
8,197,13305,917022,386,24572,0,0,82.87,45195777,16.177,31.9,11.198,18933.907,191.032,5.5,0.825,4
8,198,14932,931954,349,24921,0,0,82.87,45195777,16.177,31.9,11.198,18933.907,191.032,5.5,0.825,4
8,199,17096,949050,421,25342,0,0,82.87,45195777,16.177,31.9,11.198,18933.907,191.032,5.5,0.825,4
8,200,16546,965596,381,25723,0,0,82.87,45195777,16.177,31.9,11.198,18933.907,191.032,5.5,0.825,4
8,201,13510,979106,384,26107,0,0,82.87,45195777,16.177,31.9,11.198,18933.907,191.032,5.5,0.825,4
8,202,10561,989667,160,26267,0,0,82.87,45195777,16.177,31.9,11.198,18933.907,191.032,5.5,0.825,4
8,203,12982,1002649,449,26716,0,0,82.87,45195777,16.177,31.9,11.198,18933.907,191.032,5.5,0.825,4
8,204,16337,1018986,384,27100,0,0,82.87,45195777,16.177,31.9,11.198,18933.907,191.032,5.5,0.825,4
9,1,39,571,0,3,0,0,0,2963234,102.931,35.7,11.232,8787.58,341.01,7.11,0.755,0
9,2,92,663,1,4,0,0,0,2963234,102.931,35.7,11.232,8787.58,341.01,7.11,0.755,0
9,3,73,736,3,7,0,0,0,2963234,102.931,35.7,11.232,8787.58,341.01,7.11,0.755,0
9,4,34,770,0,7,0,0,0,2963234,102.931,35.7,11.232,8787.58,341.01,7.11,0.755,0
9,5,52,822,0,7,0,0,0,2963234,102.931,35.7,11.232,8787.58,341.01,7.11,0.755,0
9,6,11,833,1,8,0,0,0,2963234,102.931,35.7,11.232,8787.58,341.01,7.11,0.755,0
9,7,20,853,0,8,0,0,0,2963234,102.931,35.7,11.232,8787.58,341.01,7.11,0.755,0
9,8,28,881,1,9,0,0,0,2963234,102.931,35.7,11.232,8787.58,341.01,7.11,0.755,0
9,9,40,921,1,10,0,0,0,2963234,102.931,35.7,11.232,8787.58,341.01,7.11,0.755,0
9,10,16,937,1,11,0,0,0,2963234,102.931,35.7,11.232,8787.58,341.01,7.11,0.755,0
9,11,30,967,2,13,0,0,0,2963234,102.931,35.7,11.232,8787.58,341.01,7.11,0.755,0
9,12,46,1013,0,13,0,0,0,2963234,102.931,35.7,11.232,8787.58,341.01,7.11,0.755,0
9,13,26,1039,1,14,0,0,0,2963234,102.931,35.7,11.232,8787.58,341.01,7.11,0.755,0
9,14,28,1067,2,16,0,0,0,2963234,102.931,35.7,11.232,8787.58,341.01,7.11,0.755,0
9,15,44,1111,1,17,0,0,0,2963234,102.931,35.7,11.232,8787.58,341.01,7.11,0.755,0
9,16,48,1159,1,18,0,0,0,2963234,102.931,35.7,11.232,8787.58,341.01,7.11,0.755,0
9,17,42,1201,1,19,0,0,0,2963234,102.931,35.7,11.232,8787.58,341.01,7.11,0.755,0
9,18,47,1248,1,20,0,0,0,2963234,102.931,35.7,11.232,8787.58,341.01,7.11,0.755,0
9,19,43,1291,0,20,0,0,0,2963234,102.931,35.7,11.232,8787.58,341.01,7.11,0.755,0
9,20,48,1339,2,22,0,0,0,2963234,102.931,35.7,11.232,8787.58,341.01,7.11,0.755,0
9,21,62,1401,2,24,0,0,0,2963234,102.931,35.7,11.232,8787.58,341.01,7.11,0.755,0
9,22,72,1473,0,24,0,0,0,2963234,102.931,35.7,11.232,8787.58,341.01,7.11,0.755,0
9,23,50,1523,0,24,0,0,0,2963234,102.931,35.7,11.232,8787.58,341.01,7.11,0.755,0
9,24,73,1596,3,27,0,0,0,2963234,102.931,35.7,11.232,8787.58,341.01,7.11,0.755,0
9,25,81,1677,1,28,0,0,0,2963234,102.931,35.7,11.232,8787.58,341.01,7.11,0.755,0
9,26,69,1746,0,28,0,0,0,2963234,102.931,35.7,11.232,8787.58,341.01,7.11,0.755,0
9,27,62,1808,1,29,0,0,0,2963234,102.931,35.7,11.232,8787.58,341.01,7.11,0.755,0
9,28,59,1867,1,30,0,0,0,2963234,102.931,35.7,11.232,8787.58,341.01,7.11,0.755,0
9,29,65,1932,0,30,0,0,0,2963234,102.931,35.7,11.232,8787.58,341.01,7.11,0.755,0
9,30,134,2066,2,32,0,0,0,2963234,102.931,35.7,11.232,8787.58,341.01,7.11,0.755,0
9,31,82,2148,1,33,0,0,0,2963234,102.931,35.7,11.232,8787.58,341.01,7.11,0.755,0
9,32,125,2273,0,33,0,0,0,2963234,102.931,35.7,11.232,8787.58,341.01,7.11,0.755,0
9,33,113,2386,2,35,0,0,0,2963234,102.931,35.7,11.232,8787.58,341.01,7.11,0.755,0
9,34,121,2507,4,39,0,0,0,2963234,102.931,35.7,11.232,8787.58,341.01,7.11,0.755,0
9,35,112,2619,1,40,0,0,0,2963234,102.931,35.7,11.232,8787.58,341.01,7.11,0.755,0
9,36,163,2782,0,40,0,0,0,2963234,102.931,35.7,11.232,8787.58,341.01,7.11,0.755,0
9,37,102,2884,2,42,0,0,0,2963234,102.931,35.7,11.232,8787.58,341.01,7.11,0.755,0
9,38,145,3029,1,43,0,0,0,2963234,102.931,35.7,11.232,8787.58,341.01,7.11,0.755,0
9,39,146,3175,1,44,0,0,0,2963234,102.931,35.7,11.232,8787.58,341.01,7.11,0.755,0
9,40,138,3313,1,45,0,0,0,2963234,102.931,35.7,11.232,8787.58,341.01,7.11,0.755,0
9,41,79,3392,1,46,0,0,0,2963234,102.931,35.7,11.232,8787.58,341.01,7.11,0.755,0
9,42,146,3538,1,47,0,0,0,2963234,102.931,35.7,11.232,8787.58,341.01,7.11,0.755,0
9,43,180,3718,1,48,0,0,0,2963234,102.931,35.7,11.232,8787.58,341.01,7.11,0.755,0
9,44,142,3860,1,49,0,0,0,2963234,102.931,35.7,11.232,8787.58,341.01,7.11,0.755,0
9,45,184,4044,3,52,0,0,0,2963234,102.931,35.7,11.232,8787.58,341.01,7.11,0.755,0
9,46,239,4283,3,55,0,0,0,2963234,102.931,35.7,11.232,8787.58,341.01,7.11,0.755,0
9,47,189,4472,5,60,0,0,0,2963234,102.931,35.7,11.232,8787.58,341.01,7.11,0.755,0
9,48,351,4823,1,61,0,0,0,2963234,102.931,35.7,11.232,8787.58,341.01,7.11,0.755,0
9,49,218,5041,3,64,0,0,0,2963234,102.931,35.7,11.232,8787.58,341.01,7.11,0.755,0
9,50,230,5271,3,67,0,0,0,2963234,102.931,35.7,11.232,8787.58,341.01,7.11,0.755,0
9,51,335,5606,3,70,0,0,0,2963234,102.931,35.7,11.232,8787.58,341.01,7.11,0.755,0
9,52,322,5928,4,74,0,0,0,2963234,102.931,35.7,11.232,8787.58,341.01,7.11,0.755,0
9,53,374,6302,3,77,0,0,0,2963234,102.931,35.7,11.232,8787.58,341.01,7.11,0.755,0
9,54,359,6661,4,81,0,0,0,2963234,102.931,35.7,11.232,8787.58,341.01,7.11,0.755,0
9,55,452,7113,6,87,0,0,0,2963234,102.931,35.7,11.232,8787.58,341.01,7.11,0.755,0
9,56,289,7402,4,91,0,0,0,2963234,102.931,35.7,11.232,8787.58,341.01,7.11,0.755,0
9,57,372,7774,7,98,0,0,0,2963234,102.931,35.7,11.232,8787.58,341.01,7.11,0.755,0
9,58,442,8216,15,113,0,0,0,2963234,102.931,35.7,11.232,8787.58,341.01,7.11,0.755,0
9,59,460,8676,7,120,0,0,0,2963234,102.931,35.7,11.232,8787.58,341.01,7.11,0.755,0
9,60,251,8927,7,127,0,0,0,2963234,102.931,35.7,11.232,8787.58,341.01,7.11,0.755,0
9,61,355,9282,4,131,0,0,0,2963234,102.931,35.7,11.232,8787.58,341.01,7.11,0.755,0
9,62,210,9492,8,139,0,0,0,2963234,102.931,35.7,11.232,8787.58,341.01,7.11,0.755,0
9,63,517,10009,19,158,0,0,0,2963234,102.931,35.7,11.232,8787.58,341.01,7.11,0.755,0
9,64,515,10524,12,170,0,0,0,2963234,102.931,35.7,11.232,8787.58,341.01,7.11,0.755,0
9,65,697,11221,6,176,0,0,0,2963234,102.931,35.7,11.232,8787.58,341.01,7.11,0.755,0
9,66,596,11817,7,183,0,0,0,2963234,102.931,35.7,11.232,8787.58,341.01,7.11,0.755,0
9,67,547,12364,7,190,0,0,0,2963234,102.931,35.7,11.232,8787.58,341.01,7.11,0.755,0
9,68,766,13130,10,200,0,0,0,2963234,102.931,35.7,11.232,8787.58,341.01,7.11,0.755,0
9,69,195,13325,11,211,0,0,0,2963234,102.931,35.7,11.232,8787.58,341.01,7.11,0.755,0
9,70,350,13675,6,217,0,0,0,2963234,102.931,35.7,11.232,8787.58,341.01,7.11,0.755,0
9,71,428,14103,10,227,0,0,0,2963234,102.931,35.7,11.232,8787.58,341.01,7.11,0.755,0
9,72,566,14669,18,245,0,0,0,2963234,102.931,35.7,11.232,8787.58,341.01,7.11,0.755,0
9,73,612,15281,13,258,0,0,0,2963234,102.931,35.7,11.232,8787.58,341.01,7.11,0.755,0
9,74,723,16004,6,264,0,0,0,2963234,102.931,35.7,11.232,8787.58,341.01,7.11,0.755,0
9,75,663,16667,5,269,0,0,0,2963234,102.931,35.7,11.232,8787.58,341.01,7.11,0.755,0
9,76,397,17064,16,285,0,0,0,2963234,102.931,35.7,11.232,8787.58,341.01,7.11,0.755,0
9,77,425,17489,8,293,0,0,0,2963234,102.931,35.7,11.232,8787.58,341.01,7.11,0.755,0
9,78,544,18033,9,302,0,0,0,2963234,102.931,35.7,11.232,8787.58,341.01,7.11,0.755,0
9,79,665,18698,7,309,0,0,0,2963234,102.931,35.7,11.232,8787.58,341.01,7.11,0.755,0
9,80,459,19157,10,319,0,0,0,2963234,102.931,35.7,11.232,8787.58,341.01,7.11,0.755,0
9,81,551,19708,13,332,0,0,0,2963234,102.931,35.7,11.232,8787.58,341.01,7.11,0.755,0
9,82,560,20268,18,350,0,0,0,2963234,102.931,35.7,11.232,8787.58,341.01,7.11,0.755,0
9,83,320,20588,10,360,0,0,0,2963234,102.931,35.7,11.232,8787.58,341.01,7.11,0.755,0
9,84,418,21006,12,372,0,0,0,2963234,102.931,35.7,11.232,8787.58,341.01,7.11,0.755,0
9,85,711,21717,14,386,0,0,0,2963234,102.931,35.7,11.232,8787.58,341.01,7.11,0.755,0
9,86,771,22488,11,397,0,0,0,2963234,102.931,35.7,11.232,8787.58,341.01,7.11,0.755,0
9,87,759,23247,13,410,0,0,0,2963234,102.931,35.7,11.232,8787.58,341.01,7.11,0.755,0
9,88,662,23909,10,420,0,0,0,2963234,102.931,35.7,11.232,8787.58,341.01,7.11,0.755,0
9,89,736,24645,6,426,0,0,0,2963234,102.931,35.7,11.232,8787.58,341.01,7.11,0.755,0
9,90,482,25127,7,433,0,0,0,2963234,102.931,35.7,11.232,8787.58,341.01,7.11,0.755,0
9,91,415,25542,10,443,0,0,0,2963234,102.931,35.7,11.232,8787.58,341.01,7.11,0.755,0
9,92,523,26065,10,453,0,0,0,2963234,102.931,35.7,11.232,8787.58,341.01,7.11,0.755,0
9,93,593,26658,6,459,0,0,0,2963234,102.931,35.7,11.232,8787.58,341.01,7.11,0.755,0
9,94,662,27320,10,469,0,0,0,2963234,102.931,35.7,11.232,8787.58,341.01,7.11,0.755,0
9,95,580,27900,8,477,0,0,0,2963234,102.931,35.7,11.232,8787.58,341.01,7.11,0.755,0
9,96,706,28606,7,484,0,0,0,2963234,102.931,35.7,11.232,8787.58,341.01,7.11,0.755,0
9,97,330,28936,7,491,0,0,0,2963234,102.931,35.7,11.232,8787.58,341.01,7.11,0.755,0
9,98,349,29285,12,503,0,0,0,2963234,102.931,35.7,11.232,8787.58,341.01,7.11,0.755,0
9,99,535,29820,18,521,0,0,0,2963234,102.931,35.7,11.232,8787.58,341.01,7.11,0.755,0
9,100,526,30346,14,535,0,0,0,2963234,102.931,35.7,11.232,8787.58,341.01,7.11,0.755,0
9,101,557,30903,11,546,0,0,0,2963234,102.931,35.7,11.232,8787.58,341.01,7.11,0.755,0
9,102,489,31392,13,559,0,0,0,2963234,102.931,35.7,11.232,8787.58,341.01,7.11,0.755,0
9,103,577,31969,6,565,0,0,0,2963234,102.931,35.7,11.232,8787.58,341.01,7.11,0.755,0
9,104,182,32151,8,573,0,0,0,2963234,102.931,35.7,11.232,8787.58,341.01,7.11,0.755,0
9,105,339,32490,8,581,0,0,0,2963234,102.931,35.7,11.232,8787.58,341.01,7.11,0.755,0
9,106,515,33005,11,592,0,0,0,2963234,102.931,35.7,11.232,8787.58,341.01,7.11,0.755,0
9,107,554,33559,15,607,0,0,0,2963234,102.931,35.7,11.232,8787.58,341.01,7.11,0.755,0
9,108,442,34001,13,620,0,0,0,2963234,102.931,35.7,11.232,8787.58,341.01,7.11,0.755,0
9,109,461,34462,11,631,0,0,0,2963234,102.931,35.7,11.232,8787.58,341.01,7.11,0.755,0
9,110,415,34877,10,641,0,0,0,2963234,102.931,35.7,11.232,8787.58,341.01,7.11,0.755,0
9,111,104,34981,9,650,0,0,0,2963234,102.931,35.7,11.232,8787.58,341.01,7.11,0.755,0
9,112,273,35254,12,662,0,0,0,2963234,102.931,35.7,11.232,8787.58,341.01,7.11,0.755,0
9,113,439,35693,16,678,0,0,0,2963234,102.931,35.7,11.232,8787.58,341.01,7.11,0.755,0
9,114,469,36162,10,688,0,0,0,2963234,102.931,35.7,11.232,8787.58,341.01,7.11,0.755,0
9,115,451,36613,4,692,0,0,0,2963234,102.931,35.7,11.232,8787.58,341.01,7.11,0.755,0
9,116,383,36996,8,700,0,0,0,2963234,102.931,35.7,11.232,8787.58,341.01,7.11,0.755,0
9,117,321,37317,5,705,0,0,0,2963234,102.931,35.7,11.232,8787.58,341.01,7.11,0.755,0
9,118,73,37390,6,711,0,0,0,2963234,102.931,35.7,11.232,8787.58,341.01,7.11,0.755,0
9,119,239,37629,8,719,0,0,0,2963234,102.931,35.7,11.232,8787.58,341.01,7.11,0.755,0
9,120,308,37937,4,723,0,0,0,2963234,102.931,35.7,11.232,8787.58,341.01,7.11,0.755,0
9,121,259,38196,5,728,0,0,0,2963234,102.931,35.7,11.232,8787.58,341.01,7.11,0.755,0
9,122,354,38550,10,738,0,0,0,2963234,102.931,35.7,11.232,8787.58,341.01,7.11,0.755,0
9,123,291,38841,11,749,0,0,0,2963234,102.931,35.7,11.232,8787.58,341.01,7.11,0.755,0
9,124,209,39050,5,754,0,0,0,2963234,102.931,35.7,11.232,8787.58,341.01,7.11,0.755,0
9,125,52,39102,8,762,0,0,0,2963234,102.931,35.7,11.232,8787.58,341.01,7.11,0.755,0
9,126,0,39102,0,762,0,0,0,2963234,102.931,35.7,11.232,8787.58,341.01,7.11,0.755,0
9,127,196,39298,6,768,0,0,0,2963234,102.931,35.7,11.232,8787.58,341.01,7.11,0.755,0
9,128,288,39586,2,770,0,0,0,2963234,102.931,35.7,11.232,8787.58,341.01,7.11,0.755,0
9,129,233,39819,2,772,0,0,0,2963234,102.931,35.7,11.232,8787.58,341.01,7.11,0.755,0
9,130,66,39885,5,777,0,0,0,2963234,102.931,35.7,11.232,8787.58,341.01,7.11,0.755,0
9,131,300,40185,8,785,0,0,0,2963234,102.931,35.7,11.232,8787.58,341.01,7.11,0.755,0
9,132,225,40410,6,791,0,0,0,2963234,102.931,35.7,11.232,8787.58,341.01,7.11,0.755,0
9,133,23,40433,5,796,0,0,0,2963234,102.931,35.7,11.232,8787.58,341.01,7.11,0.755,0
9,134,160,40593,7,803,0,0,0,2963234,102.931,35.7,11.232,8787.58,341.01,7.11,0.755,0
9,135,201,40794,3,806,0,0,0,2963234,102.931,35.7,11.232,8787.58,341.01,7.11,0.755,0
9,136,229,41023,3,809,0,0,0,2963234,102.931,35.7,11.232,8787.58,341.01,7.11,0.755,0
9,137,276,41299,5,814,0,0,0,2963234,102.931,35.7,11.232,8787.58,341.01,7.11,0.755,0
9,138,196,41495,3,817,0,0,0,2963234,102.931,35.7,11.232,8787.58,341.01,7.11,0.755,0
9,139,168,41663,1,818,0,0,0,2963234,102.931,35.7,11.232,8787.58,341.01,7.11,0.755,0
9,140,38,41701,6,824,0,0,0,2963234,102.931,35.7,11.232,8787.58,341.01,7.11,0.755,0
9,141,145,41846,8,832,0,0,0,2963234,102.931,35.7,11.232,8787.58,341.01,7.11,0.755,0
9,142,210,42056,1,833,0,0,0,2963234,102.931,35.7,11.232,8787.58,341.01,7.11,0.755,0
9,143,263,42319,3,836,0,0,0,2963234,102.931,35.7,11.232,8787.58,341.01,7.11,0.755,0
9,144,158,42477,6,842,0,0,0,2963234,102.931,35.7,11.232,8787.58,341.01,7.11,0.755,0
9,145,139,42616,8,850,0,0,0,2963234,102.931,35.7,11.232,8787.58,341.01,7.11,0.755,0
9,146,176,42792,2,852,0,0,0,2963234,102.931,35.7,11.232,8787.58,341.01,7.11,0.755,0
9,147,33,42825,2,854,0,0,0,2963234,102.931,35.7,11.232,8787.58,341.01,7.11,0.755,0
9,148,111,42936,4,858,0,0,0,2963234,102.931,35.7,11.232,8787.58,341.01,7.11,0.755,0
9,149,131,43067,3,861,0,0,0,2963234,102.931,35.7,11.232,8787.58,341.01,7.11,0.755,0
9,150,203,43270,3,864,0,0,0,2963234,102.931,35.7,11.232,8787.58,341.01,7.11,0.755,0
9,151,181,43451,5,869,0,0,0,2963234,102.931,35.7,11.232,8787.58,341.01,7.11,0.755,0
9,152,175,43626,3,872,0,0,0,2963234,102.931,35.7,11.232,8787.58,341.01,7.11,0.755,0
9,153,124,43750,5,877,0,0,0,2963234,102.931,35.7,11.232,8787.58,341.01,7.11,0.755,0
9,154,31,43781,2,879,0,0,0,2963234,102.931,35.7,11.232,8787.58,341.01,7.11,0.755,0
9,155,97,43878,2,881,0,0,0,2963234,102.931,35.7,11.232,8787.58,341.01,7.11,0.755,0
9,156,197,44075,3,884,0,0,0,2963234,102.931,35.7,11.232,8787.58,341.01,7.11,0.755,0
9,157,196,44271,3,887,0,0,0,2963234,102.931,35.7,11.232,8787.58,341.01,7.11,0.755,0
9,158,190,44461,4,891,0,0,0,2963234,102.931,35.7,11.232,8787.58,341.01,7.11,0.755,0
9,159,188,44649,4,895,0,0,0,2963234,102.931,35.7,11.232,8787.58,341.01,7.11,0.755,0
9,160,134,44783,2,897,0,0,0,2963234,102.931,35.7,11.232,8787.58,341.01,7.11,0.755,0
9,161,62,44845,3,900,0,0,0,2963234,102.931,35.7,11.232,8787.58,341.01,7.11,0.755,0
9,162,108,44953,3,903,0,0,0,2963234,102.931,35.7,11.232,8787.58,341.01,7.11,0.755,0
9,163,199,45152,2,905,0,0,0,2963234,102.931,35.7,11.232,8787.58,341.01,7.11,0.755,0
9,164,174,45326,1,906,0,0,0,2963234,102.931,35.7,11.232,8787.58,341.01,7.11,0.755,0
9,165,177,45503,3,909,0,0,0,2963234,102.931,35.7,11.232,8787.58,341.01,7.11,0.755,0
9,166,172,45675,2,911,0,0,0,2963234,102.931,35.7,11.232,8787.58,341.01,7.11,0.755,0
9,167,187,45862,5,916,0,0,0,2963234,102.931,35.7,11.232,8787.58,341.01,7.11,0.755,0
9,168,107,45969,3,919,0,0,0,2963234,102.931,35.7,11.232,8787.58,341.01,7.11,0.755,0
9,169,150,46119,1,920,0,0,0,2963234,102.931,35.7,11.232,8787.58,341.01,7.11,0.755,0
9,170,257,46376,3,923,0,0,0,2963234,102.931,35.7,11.232,8787.58,341.01,7.11,0.755,0
9,171,295,46671,2,925,0,0,0,2963234,102.931,35.7,11.232,8787.58,341.01,7.11,0.755,0
9,172,239,46910,1,926,0,0,0,2963234,102.931,35.7,11.232,8787.58,341.01,7.11,0.755,0
9,173,244,47154,2,928,0,0,0,2963234,102.931,35.7,11.232,8787.58,341.01,7.11,0.755,0
9,174,277,47431,2,930,0,0,0,2963234,102.931,35.7,11.232,8787.58,341.01,7.11,0.755,0
9,175,121,47552,6,936,0,0,0,2963234,102.931,35.7,11.232,8787.58,341.01,7.11,0.755,0
9,176,115,47667,2,938,0,0,0,2963234,102.931,35.7,11.232,8787.58,341.01,7.11,0.755,0
9,177,210,47877,4,942,0,0,0,2963234,102.931,35.7,11.232,8787.58,341.01,7.11,0.755,0
9,178,374,48251,3,945,0,0,0,2963234,102.931,35.7,11.232,8787.58,341.01,7.11,0.755,0
9,179,392,48643,2,947,0,0,0,2963234,102.931,35.7,11.232,8787.58,341.01,7.11,0.755,0
9,180,429,49072,1,948,0,0,0,2963234,102.931,35.7,11.232,8787.58,341.01,7.11,0.755,0
9,181,328,49400,3,951,0,0,0,2963234,102.931,35.7,11.232,8787.58,341.01,7.11,0.755,0
9,182,174,49574,6,957,0,0,0,2963234,102.931,35.7,11.232,8787.58,341.01,7.11,0.755,0
9,183,327,49901,1,958,0,0,0,2963234,102.931,35.7,11.232,8787.58,341.01,7.11,0.755,0
9,184,458,50359,1,959,0,0,0,2963234,102.931,35.7,11.232,8787.58,341.01,7.11,0.755,0
9,185,491,50850,4,963,0,0,0,2963234,102.931,35.7,11.232,8787.58,341.01,7.11,0.755,0
9,186,532,51382,3,966,0,0,0,2963234,102.931,35.7,11.232,8787.58,341.01,7.11,0.755,0
9,187,543,51925,6,972,0,0,0,2963234,102.931,35.7,11.232,8787.58,341.01,7.11,0.755,0
9,188,571,52496,5,977,0,0,0,2963234,102.931,35.7,11.232,8787.58,341.01,7.11,0.755,0
9,189,181,52677,7,984,0,0,0,2963234,102.931,35.7,11.232,8787.58,341.01,7.11,0.755,0
9,190,406,53083,6,990,0,0,0,2963234,102.931,35.7,11.232,8787.58,341.01,7.11,0.755,0
9,191,672,53755,5,995,0,0,0,2963234,102.931,35.7,11.232,8787.58,341.01,7.11,0.755,0
9,192,718,54473,10,1005,0,0,0,2963234,102.931,35.7,11.232,8787.58,341.01,7.11,0.755,0
9,193,614,55087,5,1010,0,0,0,2963234,102.931,35.7,11.232,8787.58,341.01,7.11,0.755,0
9,194,649,55736,6,1016,0,0,0,2963234,102.931,35.7,11.232,8787.58,341.01,7.11,0.755,0
9,195,715,56451,4,1020,0,0,0,2963234,102.931,35.7,11.232,8787.58,341.01,7.11,0.755,0
9,196,1115,57566,12,1032,0,0,0,2963234,102.931,35.7,11.232,8787.58,341.01,7.11,0.755,0
9,197,1058,58624,7,1039,0,0,0,2963234,102.931,35.7,11.232,8787.58,341.01,7.11,0.755,0
9,198,0,58624,0,1039,0,0,0,2963234,102.931,35.7,11.232,8787.58,341.01,7.11,0.755,0
9,199,1371,59995,7,1046,0,0,0,2963234,102.931,35.7,11.232,8787.58,341.01,7.11,0.755,0
9,200,1465,61460,10,1056,0,0,0,2963234,102.931,35.7,11.232,8787.58,341.01,7.11,0.755,0
9,201,1540,63000,11,1067,0,0,0,2963234,102.931,35.7,11.232,8787.58,341.01,7.11,0.755,0
9,202,1694,64694,14,1081,0,0,0,2963234,102.931,35.7,11.232,8787.58,341.01,7.11,0.755,0
9,203,766,65460,10,1091,0,0,0,2963234,102.931,35.7,11.232,8787.58,341.01,7.11,0.755,0
9,204,1234,66694,10,1101,0,0,0,2963234,102.931,35.7,11.232,8787.58,341.01,7.11,0.755,0
11,1,150,4707,1,20,0,0,71.3,25499881,3.202,37.9,15.504,44648.71,107.791,5.07,0.939,4
11,2,269,4976,1,21,0,0,73.15,25499881,3.202,37.9,15.504,44648.71,107.791,5.07,0.939,4
11,3,248,5224,2,23,0,0,73.15,25499881,3.202,37.9,15.504,44648.71,107.791,5.07,0.939,4
11,4,324,5548,7,30,0,0,73.15,25499881,3.202,37.9,15.504,44648.71,107.791,5.07,0.939,4
11,5,139,5687,4,34,0,297154,73.15,25499881,3.202,37.9,15.504,44648.71,107.791,5.07,0.939,4
11,6,57,5744,2,36,5509,302663,73.15,25499881,3.202,37.9,15.504,44648.71,107.791,5.07,0.939,4
11,7,100,5844,6,42,8037,310700,73.15,25499881,3.202,37.9,15.504,44648.71,107.791,5.07,0.939,4
11,8,112,5956,3,45,8668,319368,73.15,25499881,3.202,37.9,15.504,44648.71,107.791,5.07,0.939,4
11,9,96,6052,5,50,10766,330134,73.15,25499881,3.202,37.9,15.504,44648.71,107.791,5.07,0.939,4
11,10,100,6152,2,52,8212,338346,73.15,25499881,3.202,37.9,15.504,44648.71,107.791,5.07,0.939,4
11,11,86,6238,2,54,9501,347847,73.15,25499881,3.202,37.9,15.504,44648.71,107.791,5.07,0.939,4
11,12,51,6289,3,57,6094,353941,73.15,25499881,3.202,37.9,15.504,44648.71,107.791,5.07,0.939,4
11,13,33,6322,4,61,8195,362136,73.15,25499881,3.202,37.9,15.504,44648.71,107.791,5.07,0.939,4
11,14,44,6366,0,61,4357,366493,73.15,25499881,3.202,37.9,15.504,44648.71,107.791,5.07,0.939,4
11,15,50,6416,0,61,4884,371377,73.15,25499881,3.202,37.9,15.504,44648.71,107.791,5.07,0.939,4
11,16,42,6458,2,63,8626,380003,73.15,25499881,3.202,37.9,15.504,44648.71,107.791,5.07,0.939,4
11,17,39,6497,0,63,11527,391530,73.15,25499881,3.202,37.9,15.504,44648.71,107.791,5.07,0.939,4
11,18,36,6533,4,67,14980,406510,69.44,25499881,3.202,37.9,15.504,44648.71,107.791,5.07,0.939,4
11,19,53,6586,2,69,14486,420996,69.44,25499881,3.202,37.9,15.504,44648.71,107.791,5.07,0.939,4
11,20,26,6612,1,70,10738,431734,69.44,25499881,3.202,37.9,15.504,44648.71,107.791,5.07,0.939,4
11,21,13,6625,1,71,8108,439842,69.44,25499881,3.202,37.9,15.504,44648.71,107.791,5.07,0.939,4
11,22,22,6647,3,74,12599,452441,69.44,25499881,3.202,37.9,15.504,44648.71,107.791,5.07,0.939,4
11,23,7,6654,0,74,14218,466659,69.44,25499881,3.202,37.9,15.504,44648.71,107.791,5.07,0.939,4
11,24,13,6667,1,75,15711,482370,69.44,25499881,3.202,37.9,15.504,44648.71,107.791,5.07,0.939,4
11,25,20,6687,4,79,11887,494257,69.44,25499881,3.202,37.9,15.504,44648.71,107.791,5.07,0.939,4
11,26,16,6703,2,81,12192,506449,69.44,25499881,3.202,37.9,15.504,44648.71,107.791,5.07,0.939,4
11,27,10,6713,2,83,10614,517063,69.44,25499881,3.202,37.9,15.504,44648.71,107.791,5.07,0.939,4
11,28,12,6725,1,84,13616,530679,69.44,25499881,3.202,37.9,15.504,44648.71,107.791,5.07,0.939,4
11,29,13,6738,4,88,13731,544410,69.44,25499881,3.202,37.9,15.504,44648.71,107.791,5.07,0.939,4
11,30,8,6746,2,90,19231,563641,69.44,25499881,3.202,37.9,15.504,44648.71,107.791,5.07,0.939,4
11,31,16,6762,2,92,25227,588868,69.44,25499881,3.202,37.9,15.504,44648.71,107.791,5.07,0.939,4
11,32,5,6767,1,93,22715,611583,69.44,25499881,3.202,37.9,15.504,44648.71,107.791,5.07,0.939,4
11,33,16,6783,0,93,21524,633107,69.44,25499881,3.202,37.9,15.504,44648.71,107.791,5.07,0.939,4
11,34,18,6801,2,95,17107,650214,69.44,25499881,3.202,37.9,15.504,44648.71,107.791,5.07,0.939,4
11,35,24,6825,0,95,14542,664756,69.44,25499881,3.202,37.9,15.504,44648.71,107.791,5.07,0.939,4
11,36,24,6849,1,96,23900,688656,69.44,25499881,3.202,37.9,15.504,44648.71,107.791,5.07,0.939,4
11,37,26,6875,1,97,33893,722549,69.44,25499881,3.202,37.9,15.504,44648.71,107.791,5.07,0.939,4
11,38,21,6896,0,97,34701,757250,69.44,25499881,3.202,37.9,15.504,44648.71,107.791,5.07,0.939,4
11,39,18,6914,0,97,38206,795456,69.44,25499881,3.202,37.9,15.504,44648.71,107.791,5.07,0.939,4
11,40,15,6929,0,97,32416,827872,69.44,25499881,3.202,37.9,15.504,44648.71,107.791,5.07,0.939,4
11,41,12,6941,0,97,27247,855119,69.44,25499881,3.202,37.9,15.504,44648.71,107.791,5.07,0.939,4
11,42,7,6948,0,97,22808,877927,69.44,25499881,3.202,37.9,15.504,44648.71,107.791,5.07,0.939,4
11,43,16,6964,0,97,31098,909025,69.44,25499881,3.202,37.9,15.504,44648.71,107.791,5.07,0.939,4
11,44,11,6975,1,98,34455,943480,69.44,25499881,3.202,37.9,15.504,44648.71,107.791,5.07,0.939,4
11,45,14,6989,0,98,40336,983816,65.74,25499881,3.202,37.9,15.504,44648.71,107.791,5.07,0.939,4
11,46,30,7019,0,98,31836,1015652,64.35,25499881,3.202,37.9,15.504,44648.71,107.791,5.07,0.939,4
11,47,17,7036,0,98,26474,1042126,64.35,25499881,3.202,37.9,15.504,44648.71,107.791,5.07,0.939,4
11,48,9,7045,0,98,19908,1062034,67.13,25499881,3.202,37.9,15.504,44648.71,107.791,5.07,0.939,4
11,49,15,7060,1,99,23836,1085870,67.13,25499881,3.202,37.9,15.504,44648.71,107.791,5.07,0.939,4
11,50,8,7068,0,99,25697,1111567,67.13,25499881,3.202,37.9,15.504,44648.71,107.791,5.07,0.939,4
11,51,11,7079,1,100,26117,1137684,67.13,25499881,3.202,37.9,15.504,44648.71,107.791,5.07,0.939,4
11,52,2,7081,0,100,32998,1170682,67.13,25499881,3.202,37.9,15.504,44648.71,107.791,5.07,0.939,4
11,53,14,7095,1,101,21580,1192262,67.13,25499881,3.202,37.9,15.504,44648.71,107.791,5.07,0.939,4
11,54,11,7106,1,102,32533,1224795,67.13,25499881,3.202,37.9,15.504,44648.71,107.791,5.07,0.939,4
11,55,3,7109,0,102,19405,1244200,65.28,25499881,3.202,37.9,15.504,44648.71,107.791,5.07,0.939,4
11,56,9,7118,0,102,44023,1288223,65.28,25499881,3.202,37.9,15.504,44648.71,107.791,5.07,0.939,4
11,57,15,7133,0,102,50098,1338321,65.28,25499881,3.202,37.9,15.504,44648.71,107.791,5.07,0.939,4
11,58,6,7139,0,102,29123,1367444,65.28,25499881,3.202,37.9,15.504,44648.71,107.791,5.07,0.939,4
11,59,11,7150,0,102,30178,1397622,63.43,25499881,3.202,37.9,15.504,44648.71,107.791,5.07,0.939,4
11,60,23,7173,0,102,30916,1428538,63.43,25499881,3.202,37.9,15.504,44648.71,107.791,5.07,0.939,4
11,61,12,7185,0,102,26030,1454568,63.43,25499881,3.202,37.9,15.504,44648.71,107.791,5.07,0.939,4
11,62,10,7195,0,102,17652,1472220,62.04,25499881,3.202,37.9,15.504,44648.71,107.791,5.07,0.939,4
11,63,9,7204,0,102,18167,1490387,62.04,25499881,3.202,37.9,15.504,44648.71,107.791,5.07,0.939,4
11,64,17,7221,0,102,22313,1512700,62.04,25499881,3.202,37.9,15.504,44648.71,107.791,5.07,0.939,4
11,65,8,7229,0,102,33629,1546329,62.04,25499881,3.202,37.9,15.504,44648.71,107.791,5.07,0.939,4
11,66,11,7240,0,102,32863,1579192,62.04,25499881,3.202,37.9,15.504,44648.71,107.791,5.07,0.939,4
11,67,11,7251,0,102,11396,1590588,62.04,25499881,3.202,37.9,15.504,44648.71,107.791,5.07,0.939,4
11,68,4,7255,0,102,26874,1617462,62.04,25499881,3.202,37.9,15.504,44648.71,107.791,5.07,0.939,4
11,69,5,7260,0,102,16053,1633515,62.04,25499881,3.202,37.9,15.504,44648.71,107.791,5.07,0.939,4
11,70,5,7265,0,102,17169,1650684,56.48,25499881,3.202,37.9,15.504,44648.71,107.791,5.07,0.939,4
11,71,2,7267,0,102,29270,1679954,56.48,25499881,3.202,37.9,15.504,44648.71,107.791,5.07,0.939,4
11,72,9,7276,0,102,31269,1711223,56.48,25499881,3.202,37.9,15.504,44648.71,107.791,5.07,0.939,4
11,73,9,7285,0,102,34327,1745550,46.76,25499881,3.202,37.9,15.504,44648.71,107.791,5.07,0.939,4
11,74,5,7290,0,102,37101,1782651,46.76,25499881,3.202,37.9,15.504,44648.71,107.791,5.07,0.939,4
11,75,12,7302,0,102,29702,1812353,46.76,25499881,3.202,37.9,15.504,44648.71,107.791,5.07,0.939,4
11,76,18,7320,0,102,15796,1828149,46.76,25499881,3.202,37.9,15.504,44648.71,107.791,5.07,0.939,4
11,77,15,7335,0,102,20198,1848347,46.76,25499881,3.202,37.9,15.504,44648.71,107.791,5.07,0.939,4
11,78,12,7347,0,102,27770,1876117,46.76,25499881,3.202,37.9,15.504,44648.71,107.791,5.07,0.939,4
11,79,23,7370,0,102,51380,1927497,46.76,25499881,3.202,37.9,15.504,44648.71,107.791,5.07,0.939,4
11,80,21,7391,0,102,42708,1970205,46.76,25499881,3.202,37.9,15.504,44648.71,107.791,5.07,0.939,4
11,81,18,7409,0,102,35173,2005378,46.76,25499881,3.202,37.9,15.504,44648.71,107.791,5.07,0.939,4
11,82,27,7436,0,102,35946,2041324,46.76,25499881,3.202,37.9,15.504,44648.71,107.791,5.07,0.939,4
11,83,25,7461,0,102,66525,2107849,46.76,25499881,3.202,37.9,15.504,44648.71,107.791,5.07,0.939,4
11,84,13,7474,0,102,24972,2132821,52.31,25499881,3.202,37.9,15.504,44648.71,107.791,5.07,0.939,4
11,85,18,7492,0,102,47603,2180424,52.31,25499881,3.202,37.9,15.504,44648.71,107.791,5.07,0.939,4
11,86,29,7521,1,103,51917,2232341,52.31,25499881,3.202,37.9,15.504,44648.71,107.791,5.07,0.939,4
11,87,37,7558,1,104,49498,2281839,52.31,25499881,3.202,37.9,15.504,44648.71,107.791,5.07,0.939,4
11,88,37,7595,0,104,54222,2336061,52.31,25499881,3.202,37.9,15.504,44648.71,107.791,5.07,0.939,4
11,89,46,7641,0,104,43114,2379175,52.31,25499881,3.202,37.9,15.504,44648.71,107.791,5.07,0.939,4
11,90,45,7686,0,104,36520,2415695,52.31,25499881,3.202,37.9,15.504,44648.71,107.791,5.07,0.939,4
11,91,81,7767,0,104,40287,2455982,52.31,25499881,3.202,37.9,15.504,44648.71,107.791,5.07,0.939,4
11,92,67,7834,0,104,49941,2505923,68.98,25499881,3.202,37.9,15.504,44648.71,107.791,5.07,0.939,4
11,93,86,7920,0,104,57859,2563782,68.98,25499881,3.202,37.9,15.504,44648.71,107.791,5.07,0.939,4
11,94,81,8001,0,104,54078,2617860,68.98,25499881,3.202,37.9,15.504,44648.71,107.791,5.07,0.939,4
11,95,254,8255,0,104,50176,2668036,68.98,25499881,3.202,37.9,15.504,44648.71,107.791,5.07,0.939,4
11,96,107,8362,0,104,45399,2713435,68.98,25499881,3.202,37.9,15.504,44648.71,107.791,5.07,0.939,4
11,97,87,8449,0,104,45730,2759165,68.98,25499881,3.202,37.9,15.504,44648.71,107.791,5.07,0.939,4
11,98,137,8586,2,106,41942,2801107,68.98,25499881,3.202,37.9,15.504,44648.71,107.791,5.07,0.939,4
11,99,169,8755,0,106,55299,2856406,75.46,25499881,3.202,37.9,15.504,44648.71,107.791,5.07,0.939,4
11,100,131,8886,0,106,54425,2910831,75.46,25499881,3.202,37.9,15.504,44648.71,107.791,5.07,0.939,4
11,101,173,9059,0,106,59437,2970268,75.46,25499881,3.202,37.9,15.504,44648.71,107.791,5.07,0.939,4
11,102,300,9359,0,106,51225,3021493,75.46,25499881,3.202,37.9,15.504,44648.71,107.791,5.07,0.939,4
11,103,194,9553,1,107,53995,3075488,75.46,25499881,3.202,37.9,15.504,44648.71,107.791,5.07,0.939,4
11,104,244,9797,1,108,42300,3117788,71.76,25499881,3.202,37.9,15.504,44648.71,107.791,5.07,0.939,4
11,105,183,9980,0,108,44449,3162237,71.76,25499881,3.202,37.9,15.504,44648.71,107.791,5.07,0.939,4
11,106,271,10251,0,108,59904,3222141,71.76,25499881,3.202,37.9,15.504,44648.71,107.791,5.07,0.939,4
11,107,244,10495,3,111,65575,3287716,68.06,25499881,3.202,37.9,15.504,44648.71,107.791,5.07,0.939,4
11,108,315,10810,2,113,62728,3350444,68.06,25499881,3.202,37.9,15.504,44648.71,107.791,5.07,0.939,4
11,109,425,11235,3,116,63387,3413831,68.06,25499881,3.202,37.9,15.504,44648.71,107.791,5.07,0.939,4
11,110,206,11441,2,118,62632,3476463,68.06,25499881,3.202,37.9,15.504,44648.71,107.791,5.07,0.939,4
11,111,361,11802,4,122,57962,3534425,68.06,25499881,3.202,37.9,15.504,44648.71,107.791,5.07,0.939,4
11,112,267,12069,1,123,56310,3590735,68.06,25499881,3.202,37.9,15.504,44648.71,107.791,5.07,0.939,4
11,113,359,12428,3,126,59794,3650529,68.06,25499881,3.202,37.9,15.504,44648.71,107.791,5.07,0.939,4
11,114,468,12896,2,128,69308,3719837,68.06,25499881,3.202,37.9,15.504,44648.71,107.791,5.07,0.939,4
11,115,410,13306,5,133,75584,3795421,68.06,25499881,3.202,37.9,15.504,44648.71,107.791,5.07,0.939,4
11,116,289,13595,6,139,64084,3859505,68.06,25499881,3.202,37.9,15.504,44648.71,107.791,5.07,0.939,4
11,117,355,13950,6,145,75619,3935124,68.06,25499881,3.202,37.9,15.504,44648.71,107.791,5.07,0.939,4
11,118,453,14403,10,155,51966,3987090,68.06,25499881,3.202,37.9,15.504,44648.71,107.791,5.07,0.939,4
11,119,532,14935,6,161,0,3987090,68.06,25499881,3.202,37.9,15.504,44648.71,107.791,5.07,0.939,4
11,120,369,15304,6,167,0,4098249,68.06,25499881,3.202,37.9,15.504,44648.71,107.791,5.07,0.939,4
11,121,278,15582,9,176,66205,4164454,68.06,25499881,3.202,37.9,15.504,44648.71,107.791,5.07,0.939,4
11,122,721,16303,13,189,0,4164454,68.06,25499881,3.202,37.9,15.504,44648.71,107.791,5.07,0.939,4
11,123,602,16905,7,196,0,4307224,68.06,25499881,3.202,37.9,15.504,44648.71,107.791,5.07,0.939,4
11,124,377,17282,4,200,39158,4346382,75.46,25499881,3.202,37.9,15.504,44648.71,107.791,5.07,0.939,4
11,125,641,17923,8,208,40529,4386911,79.17,25499881,3.202,37.9,15.504,44648.71,107.791,5.07,0.939,4
11,126,395,18318,13,221,94706,4481617,79.17,25499881,3.202,37.9,15.504,44648.71,107.791,5.07,0.939,4
11,127,411,18729,11,232,70464,4552081,79.17,25499881,3.202,37.9,15.504,44648.71,107.791,5.07,0.939,4
11,128,715,19444,15,247,80008,4632089,79.17,25499881,3.202,37.9,15.504,44648.71,107.791,5.07,0.939,4
11,129,418,19862,8,255,91937,4724026,79.17,25499881,3.202,37.9,15.504,44648.71,107.791,5.07,0.939,4
11,130,410,20272,11,266,40197,4764223,79.17,25499881,3.202,37.9,15.504,44648.71,107.791,5.07,0.939,4
11,131,426,20698,12,278,93191,4857414,79.17,25499881,3.202,37.9,15.504,44648.71,107.791,5.07,0.939,4
11,132,386,21084,17,295,61132,4918546,79.17,25499881,3.202,37.9,15.504,44648.71,107.791,5.07,0.939,4
11,133,313,21397,18,313,61626,4980172,79.17,25499881,3.202,37.9,15.504,44648.71,107.791,5.07,0.939,4
11,134,316,21713,18,331,61172,5041344,79.17,25499881,3.202,37.9,15.504,44648.71,107.791,5.07,0.939,4
11,135,414,22127,21,352,68441,5109785,79.17,25499881,3.202,37.9,15.504,44648.71,107.791,5.07,0.939,4
11,136,231,22358,9,361,70629,5180414,79.17,25499881,3.202,37.9,15.504,44648.71,107.791,5.07,0.939,4
11,137,385,22743,14,375,63370,5243784,79.17,25499881,3.202,37.9,15.504,44648.71,107.791,5.07,0.939,4
11,138,292,23035,4,379,53774,5297558,79.17,25499881,3.202,37.9,15.504,44648.71,107.791,5.07,0.939,4
11,139,253,23288,17,396,38539,5336097,79.17,25499881,3.202,37.9,15.504,44648.71,107.791,5.07,0.939,4
11,140,311,23599,25,421,44516,5380613,79.17,25499881,3.202,37.9,15.504,44648.71,107.791,5.07,0.939,4
11,141,174,23773,17,438,59882,5440495,79.17,25499881,3.202,37.9,15.504,44648.71,107.791,5.07,0.939,4
11,142,220,23993,12,450,68336,5508831,79.17,25499881,3.202,37.9,15.504,44648.71,107.791,5.07,0.939,4
11,143,243,24236,13,463,0,5508831,79.17,25499881,3.202,37.9,15.504,44648.71,107.791,5.07,0.939,4
11,144,171,24407,9,472,0,5508831,79.17,25499881,3.202,37.9,15.504,44648.71,107.791,5.07,0.939,4
11,145,195,24602,13,485,0,5706587,79.17,25499881,3.202,37.9,15.504,44648.71,107.791,5.07,0.939,4
11,146,210,24812,17,502,51447,5758034,79.17,25499881,3.202,37.9,15.504,44648.71,107.791,5.07,0.939,4
11,147,104,24916,15,517,56675,5814709,79.17,25499881,3.202,37.9,15.504,44648.71,107.791,5.07,0.939,4
11,148,137,25053,8,525,71703,5886412,79.17,25499881,3.202,37.9,15.504,44648.71,107.791,5.07,0.939,4
11,149,152,25205,24,549,86268,5972680,79.17,25499881,3.202,37.9,15.504,44648.71,107.791,5.07,0.939,4
11,150,117,25322,23,572,0,5972680,75.46,25499881,3.202,37.9,15.504,44648.71,107.791,5.07,0.939,4
11,151,126,25448,11,583,0,5972680,75.46,25499881,3.202,37.9,15.504,44648.71,107.791,5.07,0.939,4
11,152,99,25547,17,600,0,6168229,75.46,25499881,3.202,37.9,15.504,44648.71,107.791,5.07,0.939,4
11,153,123,25670,11,611,46224,6214453,75.46,25499881,3.202,37.9,15.504,44648.71,107.791,5.07,0.939,4
11,154,76,25746,41,652,41344,6255797,75.46,25499881,3.202,37.9,15.504,44648.71,107.791,5.07,0.939,4
11,155,73,25819,5,657,63998,6319795,75.46,25499881,3.202,37.9,15.504,44648.71,107.791,5.07,0.939,4
11,156,104,25923,6,663,70983,6390778,75.46,25499881,3.202,37.9,15.504,44648.71,107.791,5.07,0.939,4
11,157,126,26049,15,678,0,6390778,75.46,25499881,3.202,37.9,15.504,44648.71,107.791,5.07,0.939,4
11,158,87,26136,59,737,0,6390778,75.46,25499881,3.202,37.9,15.504,44648.71,107.791,5.07,0.939,4
11,159,71,26207,11,748,0,6657348,75.46,25499881,3.202,37.9,15.504,44648.71,107.791,5.07,0.939,4
11,160,72,26279,5,753,36086,6693434,75.46,25499881,3.202,37.9,15.504,44648.71,107.791,5.07,0.939,4
11,161,43,26322,9,762,36963,6730397,75.46,25499881,3.202,37.9,15.504,44648.71,107.791,5.07,0.939,4
11,162,52,26374,8,770,58936,6789333,75.46,25499881,3.202,37.9,15.504,44648.71,107.791,5.07,0.939,4
11,163,91,26465,11,781,60098,6849431,75.46,25499881,3.202,37.9,15.504,44648.71,107.791,5.07,0.939,4
11,164,48,26513,7,788,0,6849431,75.46,25499881,3.202,37.9,15.504,44648.71,107.791,5.07,0.939,4
11,165,52,26565,9,797,0,6849431,75.46,25499881,3.202,37.9,15.504,44648.71,107.791,5.07,0.939,4
11,166,42,26607,6,803,0,7016090,75.46,25499881,3.202,37.9,15.504,44648.71,107.791,5.07,0.939,4
11,167,44,26651,7,810,30946,7047036,75.46,25499881,3.202,37.9,15.504,44648.71,107.791,5.07,0.939,4
11,168,41,26692,6,816,29503,7076539,75.46,25499881,3.202,37.9,15.504,44648.71,107.791,5.07,0.939,4
11,169,46,26738,0,816,47845,7124384,75.46,25499881,3.202,37.9,15.504,44648.71,107.791,5.07,0.939,4
11,170,41,26779,8,824,54357,7178741,75.46,25499881,3.202,37.9,15.504,44648.71,107.791,5.07,0.939,4
11,171,34,26813,8,832,0,7178741,75.46,25499881,3.202,37.9,15.504,44648.71,107.791,5.07,0.939,4
11,172,48,26861,5,837,0,7178741,75.46,25499881,3.202,37.9,15.504,44648.71,107.791,5.07,0.939,4
11,173,24,26885,7,844,0,7296252,75.46,25499881,3.202,37.9,15.504,44648.71,107.791,5.07,0.939,4
11,174,13,26898,5,849,23436,7319688,75.46,25499881,3.202,37.9,15.504,44648.71,107.791,5.07,0.939,4
11,175,14,26912,2,851,31595,7351283,75.46,25499881,3.202,37.9,15.504,44648.71,107.791,5.07,0.939,4
11,176,30,26942,3,854,42410,7393693,75.46,25499881,3.202,37.9,15.504,44648.71,107.791,5.07,0.939,4
11,177,31,26973,5,859,47634,7441327,75.46,25499881,3.202,37.9,15.504,44648.71,107.791,5.07,0.939,4
11,178,10,26983,2,861,0,7441327,75.46,25499881,3.202,37.9,15.504,44648.71,107.791,5.07,0.939,4
11,179,17,27000,8,869,0,7441327,75.46,25499881,3.202,37.9,15.504,44648.71,107.791,5.07,0.939,4
11,180,16,27016,1,870,0,7546223,75.46,25499881,3.202,37.9,15.504,44648.71,107.791,5.07,0.939,4
11,181,24,27040,2,872,17099,7563322,68.06,25499881,3.202,37.9,15.504,44648.71,107.791,5.07,0.939,4
11,182,4,27044,3,875,26010,7589332,68.06,25499881,3.202,37.9,15.504,44648.71,107.791,5.07,0.939,4
11,183,19,27063,7,882,48071,7637403,68.06,25499881,3.202,37.9,15.504,44648.71,107.791,5.07,0.939,4
11,184,0,27063,0,882,42248,7679651,68.06,25499881,3.202,37.9,15.504,44648.71,107.791,5.07,0.939,4
11,185,33,27096,6,888,0,7679651,68.06,25499881,3.202,37.9,15.504,44648.71,107.791,5.07,0.939,4
11,186,17,27113,2,890,0,7679651,68.06,25499881,3.202,37.9,15.504,44648.71,107.791,5.07,0.939,4
11,187,8,27121,3,893,0,7679651,68.06,25499881,3.202,37.9,15.504,44648.71,107.791,5.07,0.939,4
11,188,15,27136,1,894,0,7679651,68.06,25499881,3.202,37.9,15.504,44648.71,107.791,5.07,0.939,4
11,189,13,27149,0,894,0,7819472,68.06,25499881,3.202,37.9,15.504,44648.71,107.791,5.07,0.939,4
11,190,25,27174,1,895,32769,7852241,68.06,25499881,3.202,37.9,15.504,44648.71,107.791,5.07,0.939,4
11,191,8,27182,2,897,42837,7895078,68.06,25499881,3.202,37.9,15.504,44648.71,107.791,5.07,0.939,4
11,192,24,27206,0,897,0,7895078,68.06,25499881,3.202,37.9,15.504,44648.71,107.791,5.07,0.939,4
11,193,23,27229,0,897,0,7895078,68.06,25499881,3.202,37.9,15.504,44648.71,107.791,5.07,0.939,4
11,194,15,27244,0,897,0,8008111,68.06,25499881,3.202,37.9,15.504,44648.71,107.791,5.07,0.939,4
11,195,20,27264,1,898,27447,8035558,68.06,25499881,3.202,37.9,15.504,44648.71,107.791,5.07,0.939,4
11,196,22,27286,0,898,27430,8062988,68.06,25499881,3.202,37.9,15.504,44648.71,107.791,5.07,0.939,4
11,197,31,27317,1,899,46502,8109490,68.06,25499881,3.202,37.9,15.504,44648.71,107.791,5.07,0.939,4
11,198,24,27341,5,904,43626,8153116,68.06,25499881,3.202,37.9,15.504,44648.71,107.791,5.07,0.939,4
11,199,21,27362,0,904,0,8153116,65.28,25499881,3.202,37.9,15.504,44648.71,107.791,5.07,0.939,4
11,200,9,27371,0,904,0,8153116,65.28,25499881,3.202,37.9,15.504,44648.71,107.791,5.07,0.939,4
11,201,12,27383,0,904,0,8276036,65.28,25499881,3.202,37.9,15.504,44648.71,107.791,5.07,0.939,4
11,202,7,27390,0,904,27338,8303374,65.28,25499881,3.202,37.9,15.504,44648.71,107.791,5.07,0.939,4
11,203,9,27399,1,905,0,8303374,65.28,25499881,3.202,37.9,15.504,44648.71,107.791,5.07,0.939,4
11,204,31,27430,0,905,0,8303374,65.28,25499881,3.202,37.9,15.504,44648.71,107.791,5.07,0.939,4
12,1,564,10182,20,128,3519,55863,85.19,9006400,106.749,44.4,19.202,45436.686,145.183,6.35,0.908,0
12,2,529,10711,18,146,36327,92190,85.19,9006400,106.749,44.4,19.202,45436.686,145.183,6.35,0.908,0
12,3,418,11129,12,158,6153,98343,85.19,9006400,106.749,44.4,19.202,45436.686,145.183,6.35,0.908,0
12,4,396,11525,10,168,5791,104134,85.19,9006400,106.749,44.4,19.202,45436.686,145.183,6.35,0.908,0
12,5,241,11766,18,186,4282,108416,85.19,9006400,106.749,44.4,19.202,45436.686,145.183,6.35,0.908,0
12,6,217,11983,18,204,2880,111296,85.19,9006400,106.749,44.4,19.202,45436.686,145.183,6.35,0.908,0
12,7,314,12297,16,220,3939,115235,85.19,9006400,106.749,44.4,19.202,45436.686,145.183,6.35,0.908,0
12,8,343,12640,23,243,5520,120755,85.19,9006400,106.749,44.4,19.202,45436.686,145.183,6.35,0.908,0
12,9,329,12969,30,273,5532,126287,85.19,9006400,106.749,44.4,19.202,45436.686,145.183,6.35,0.908,0
12,10,279,13248,22,295,8456,134743,85.19,9006400,106.749,44.4,19.202,45436.686,145.183,6.35,0.908,0
12,11,312,13560,24,319,6232,140975,85.19,9006400,106.749,44.4,19.202,45436.686,145.183,6.35,0.908,0
12,12,247,13807,18,337,3902,144877,85.19,9006400,106.749,44.4,19.202,45436.686,145.183,6.35,0.908,0
12,13,130,13937,13,350,3535,148412,85.19,9006400,106.749,44.4,19.202,45436.686,145.183,6.35,0.908,0
12,14,106,14043,18,368,3384,151796,81.48,9006400,106.749,44.4,19.202,45436.686,145.183,6.35,0.908,0
12,15,191,14234,16,384,5005,156801,81.48,9006400,106.749,44.4,19.202,45436.686,145.183,6.35,0.908,0
12,16,136,14370,9,393,6015,162816,81.48,9006400,106.749,44.4,19.202,45436.686,145.183,6.35,0.908,0
12,17,78,14448,17,410,6456,169272,81.48,9006400,106.749,44.4,19.202,45436.686,145.183,6.35,0.908,0
12,18,155,14603,21,431,6660,175932,81.48,9006400,106.749,44.4,19.202,45436.686,145.183,6.35,0.908,0
12,19,59,14662,12,443,3311,179243,81.48,9006400,106.749,44.4,19.202,45436.686,145.183,6.35,0.908,0
12,20,48,14710,9,452,3706,182949,81.48,9006400,106.749,44.4,19.202,45436.686,145.183,6.35,0.908,0
12,21,73,14783,10,462,6069,189018,81.48,9006400,106.749,44.4,19.202,45436.686,145.183,6.35,0.908,0
12,22,50,14833,1,463,12776,201794,81.48,9006400,106.749,44.4,19.202,45436.686,145.183,6.35,0.908,0
12,23,91,14924,31,494,4041,205835,78.7,9006400,106.749,44.4,19.202,45436.686,145.183,6.35,0.908,0
12,24,61,14985,14,508,6851,212686,78.7,9006400,106.749,44.4,19.202,45436.686,145.183,6.35,0.908,0
12,25,83,15068,5,513,8403,221089,78.7,9006400,106.749,44.4,19.202,45436.686,145.183,6.35,0.908,0
12,26,66,15134,23,536,6542,227631,78.7,9006400,106.749,44.4,19.202,45436.686,145.183,6.35,0.908,0
12,27,55,15189,6,542,4906,232537,78.7,9006400,106.749,44.4,19.202,45436.686,145.183,6.35,0.908,0
12,28,67,15256,7,549,7041,239578,78.7,9006400,106.749,44.4,19.202,45436.686,145.183,6.35,0.908,0
12,29,58,15314,20,569,8176,247754,78.7,9006400,106.749,44.4,19.202,45436.686,145.183,6.35,0.908,0
12,30,50,15364,11,580,8645,256399,78.7,9006400,106.749,44.4,19.202,45436.686,145.183,6.35,0.908,0
12,31,60,15424,4,584,7680,264079,71.3,9006400,106.749,44.4,19.202,45436.686,145.183,6.35,0.908,0
12,32,34,15458,5,589,5540,269619,68.52,9006400,106.749,44.4,19.202,45436.686,145.183,6.35,0.908,0
12,33,12,15470,7,596,4736,274355,68.52,9006400,106.749,44.4,19.202,45436.686,145.183,6.35,0.908,0
12,34,68,15538,2,598,4716,279071,64.81,9006400,106.749,44.4,19.202,45436.686,145.183,6.35,0.908,0
12,35,31,15569,2,600,6812,285883,64.81,9006400,106.749,44.4,19.202,45436.686,145.183,6.35,0.908,0
12,36,17,15586,6,606,6371,292254,64.81,9006400,106.749,44.4,19.202,45436.686,145.183,6.35,0.908,0
12,37,65,15651,2,608,5640,297894,64.81,9006400,106.749,44.4,19.202,45436.686,145.183,6.35,0.908,0
12,38,22,15673,1,609,6175,304069,64.81,9006400,106.749,44.4,19.202,45436.686,145.183,6.35,0.908,0
12,39,62,15735,5,614,7621,311690,64.81,9006400,106.749,44.4,19.202,45436.686,145.183,6.35,0.908,0
12,40,42,15777,1,615,4818,316508,64.81,9006400,106.749,44.4,19.202,45436.686,145.183,6.35,0.908,0
12,41,10,15787,3,618,2976,319484,59.26,9006400,106.749,44.4,19.202,45436.686,145.183,6.35,0.908,0
12,42,87,15874,2,620,9830,329314,59.26,9006400,106.749,44.4,19.202,45436.686,145.183,6.35,0.908,0
12,43,36,15910,3,623,6938,336252,59.26,9006400,106.749,44.4,19.202,45436.686,145.183,6.35,0.908,0
12,44,54,15964,1,624,8354,344606,59.26,9006400,106.749,44.4,19.202,45436.686,145.183,6.35,0.908,0
12,45,41,16005,2,626,6745,351351,59.26,9006400,106.749,44.4,19.202,45436.686,145.183,6.35,0.908,0
12,46,63,16068,2,628,6042,357393,59.26,9006400,106.749,44.4,19.202,45436.686,145.183,6.35,0.908,0
12,47,72,16140,0,628,5116,362509,59.26,9006400,106.749,44.4,19.202,45436.686,145.183,6.35,0.908,0
12,48,14,16154,1,629,3364,365873,55.56,9006400,106.749,44.4,19.202,45436.686,145.183,6.35,0.908,0
12,49,25,16179,0,629,6562,372435,55.56,9006400,106.749,44.4,19.202,45436.686,145.183,6.35,0.908,0
12,50,78,16257,3,632,7157,379592,55.56,9006400,106.749,44.4,19.202,45436.686,145.183,6.35,0.908,0
12,51,18,16275,1,633,0,379592,55.56,9006400,106.749,44.4,19.202,45436.686,145.183,6.35,0.908,0
12,52,57,16332,0,633,0,390488,55.56,9006400,106.749,44.4,19.202,45436.686,145.183,6.35,0.908,0
12,53,29,16361,2,635,5875,396363,55.56,9006400,106.749,44.4,19.202,45436.686,145.183,6.35,0.908,0
12,54,46,16407,4,639,5494,401857,55.56,9006400,106.749,44.4,19.202,45436.686,145.183,6.35,0.908,0
12,55,32,16439,1,640,3484,405341,55.56,9006400,106.749,44.4,19.202,45436.686,145.183,6.35,0.908,0
12,56,20,16459,1,641,5844,411185,55.56,9006400,106.749,44.4,19.202,45436.686,145.183,6.35,0.908,0
12,57,38,16497,2,643,7521,418706,55.56,9006400,106.749,44.4,19.202,45436.686,145.183,6.35,0.908,0
12,58,18,16515,2,645,8666,427372,55.56,9006400,106.749,44.4,19.202,45436.686,145.183,6.35,0.908,0
12,59,28,16543,23,668,6930,434302,50,9006400,106.749,44.4,19.202,45436.686,145.183,6.35,0.908,0
12,60,51,16594,0,668,7841,442143,50,9006400,106.749,44.4,19.202,45436.686,145.183,6.35,0.908,0
12,61,44,16638,0,668,6391,448534,50,9006400,106.749,44.4,19.202,45436.686,145.183,6.35,0.908,0
12,62,4,16642,0,668,3286,451820,50,9006400,106.749,44.4,19.202,45436.686,145.183,6.35,0.908,0
12,63,21,16663,0,668,4558,456378,50,9006400,106.749,44.4,19.202,45436.686,145.183,6.35,0.908,0
12,64,11,16674,1,669,6580,462958,46.3,9006400,106.749,44.4,19.202,45436.686,145.183,6.35,0.908,0
12,65,31,16705,1,670,8508,471466,43.52,9006400,106.749,44.4,19.202,45436.686,145.183,6.35,0.908,0
12,66,36,16741,0,670,7983,479449,43.52,9006400,106.749,44.4,19.202,45436.686,145.183,6.35,0.908,0
12,67,62,16803,2,672,6463,485912,43.52,9006400,106.749,44.4,19.202,45436.686,145.183,6.35,0.908,0
12,68,19,16822,0,672,3685,489597,43.52,9006400,106.749,44.4,19.202,45436.686,145.183,6.35,0.908,0
12,69,46,16868,0,672,5164,494761,43.52,9006400,106.749,44.4,19.202,45436.686,145.183,6.35,0.908,0
12,70,21,16889,0,672,6160,500921,43.52,9006400,106.749,44.4,19.202,45436.686,145.183,6.35,0.908,0
12,71,13,16902,0,672,5423,506344,43.52,9006400,106.749,44.4,19.202,45436.686,145.183,6.35,0.908,0
12,72,34,16936,1,673,6157,512501,43.52,9006400,106.749,44.4,19.202,45436.686,145.183,6.35,0.908,0
12,73,28,16964,1,674,0,512501,43.52,9006400,106.749,44.4,19.202,45436.686,145.183,6.35,0.908,0
12,74,30,16994,1,675,0,520976,43.52,9006400,106.749,44.4,19.202,45436.686,145.183,6.35,0.908,0
12,75,20,17014,2,677,3864,524840,43.52,9006400,106.749,44.4,19.202,45436.686,145.183,6.35,0.908,0
12,76,24,17038,0,677,2830,527670,43.52,9006400,106.749,44.4,19.202,45436.686,145.183,6.35,0.908,0
12,77,27,17065,1,678,5030,532700,43.52,9006400,106.749,44.4,19.202,45436.686,145.183,6.35,0.908,0
12,78,33,17098,3,681,7915,540615,43.52,9006400,106.749,44.4,19.202,45436.686,145.183,6.35,0.908,0
12,79,17,17115,6,687,5312,545927,43.52,9006400,106.749,44.4,19.202,45436.686,145.183,6.35,0.908,0
12,80,40,17155,1,688,6203,552130,43.52,9006400,106.749,44.4,19.202,45436.686,145.183,6.35,0.908,0
12,81,30,17185,0,688,6078,558208,43.52,9006400,106.749,44.4,19.202,45436.686,145.183,6.35,0.908,0
12,82,62,17247,0,688,2376,560584,43.52,9006400,106.749,44.4,19.202,45436.686,145.183,6.35,0.908,0
12,83,38,17285,2,690,5216,565800,43.52,9006400,106.749,44.4,19.202,45436.686,145.183,6.35,0.908,0
12,84,35,17320,0,690,6673,572473,43.52,9006400,106.749,44.4,19.202,45436.686,145.183,6.35,0.908,0
12,85,31,17351,3,693,6111,578584,43.52,9006400,106.749,44.4,19.202,45436.686,145.183,6.35,0.908,0
12,86,33,17384,0,693,5659,584243,43.52,9006400,106.749,44.4,19.202,45436.686,145.183,6.35,0.908,0
12,87,47,17431,5,698,6199,590442,43.52,9006400,106.749,44.4,19.202,45436.686,145.183,6.35,0.908,0
12,88,67,17498,0,698,7053,597495,43.52,9006400,106.749,44.4,19.202,45436.686,145.183,6.35,0.908,0
12,89,64,17562,2,700,5025,602520,43.52,9006400,106.749,44.4,19.202,45436.686,145.183,6.35,0.908,0
12,90,63,17625,2,702,3855,606375,43.52,9006400,106.749,44.4,19.202,45436.686,145.183,6.35,0.908,0
12,91,41,17666,1,703,6381,612756,43.52,9006400,106.749,44.4,19.202,45436.686,145.183,6.35,0.908,0
12,92,111,17777,2,705,8110,620866,43.52,9006400,106.749,44.4,19.202,45436.686,145.183,6.35,0.908,0
12,93,37,17814,0,705,7834,628700,43.52,9006400,106.749,44.4,19.202,45436.686,145.183,6.35,0.908,0
12,94,138,17952,0,705,6805,635505,43.52,9006400,106.749,44.4,19.202,45436.686,145.183,6.35,0.908,0
12,95,121,18073,0,705,7174,642679,43.52,9006400,106.749,44.4,19.202,45436.686,145.183,6.35,0.908,0
12,96,123,18196,0,705,5125,647804,43.52,9006400,106.749,44.4,19.202,45436.686,145.183,6.35,0.908,0
12,97,73,18269,1,706,6301,654105,43.52,9006400,106.749,44.4,19.202,45436.686,145.183,6.35,0.908,0
12,98,57,18326,0,706,6044,660149,43.52,9006400,106.749,44.4,19.202,45436.686,145.183,6.35,0.908,0
12,99,89,18415,0,706,8071,668220,43.52,9006400,106.749,44.4,19.202,45436.686,145.183,6.35,0.908,0
12,100,101,18516,0,706,7507,675727,43.52,9006400,106.749,44.4,19.202,45436.686,145.183,6.35,0.908,0
12,101,97,18613,0,706,7757,683484,31.48,9006400,106.749,44.4,19.202,45436.686,145.183,6.35,0.908,0
12,102,74,18687,0,706,8225,691709,31.48,9006400,106.749,44.4,19.202,45436.686,145.183,6.35,0.908,0
12,103,108,18795,0,706,5031,696740,31.48,9006400,106.749,44.4,19.202,45436.686,145.183,6.35,0.908,0
12,104,52,18847,2,708,3876,700616,31.48,9006400,106.749,44.4,19.202,45436.686,145.183,6.35,0.908,0
12,105,12,18859,0,708,0,700616,31.48,9006400,106.749,44.4,19.202,45436.686,145.183,6.35,0.908,0
12,106,201,19060,1,709,0,716293,31.48,9006400,106.749,44.4,19.202,45436.686,145.183,6.35,0.908,0
12,107,55,19115,1,710,10052,726345,31.48,9006400,106.749,44.4,19.202,45436.686,145.183,6.35,0.908,0
12,108,153,19268,0,710,8068,734413,31.48,9006400,106.749,44.4,19.202,45436.686,145.183,6.35,0.908,0
12,109,138,19406,0,710,8677,743090,31.48,9006400,106.749,44.4,19.202,45436.686,145.183,6.35,0.908,0
12,110,102,19508,0,710,5579,748669,31.48,9006400,106.749,44.4,19.202,45436.686,145.183,6.35,0.908,0
12,111,63,19571,0,710,49767,798436,31.48,9006400,106.749,44.4,19.202,45436.686,145.183,6.35,0.908,0
12,112,108,19679,0,710,7164,805600,31.48,9006400,106.749,44.4,19.202,45436.686,145.183,6.35,0.908,0
12,113,139,19818,0,710,9081,814681,31.48,9006400,106.749,44.4,19.202,45436.686,145.183,6.35,0.908,0
12,114,140,19958,1,711,11350,826031,31.48,9006400,106.749,44.4,19.202,45436.686,145.183,6.35,0.908,0
12,115,164,20122,0,711,7810,833841,31.48,9006400,106.749,44.4,19.202,45436.686,145.183,6.35,0.908,0
12,116,107,20229,0,711,7049,840890,31.48,9006400,106.749,44.4,19.202,45436.686,145.183,6.35,0.908,0
12,117,120,20349,1,712,7008,847898,31.48,9006400,106.749,44.4,19.202,45436.686,145.183,6.35,0.908,0
12,118,137,20486,0,712,13308,861206,31.48,9006400,106.749,44.4,19.202,45436.686,145.183,6.35,0.908,0
12,119,64,20550,1,713,9396,870602,31.48,9006400,106.749,44.4,19.202,45436.686,145.183,6.35,0.908,0
12,120,132,20682,0,713,9434,880036,31.48,9006400,106.749,44.4,19.202,45436.686,145.183,6.35,0.908,0
12,121,164,20846,3,716,10425,890461,31.48,9006400,106.749,44.4,19.202,45436.686,145.183,6.35,0.908,0
12,122,163,21009,2,718,7358,897819,31.48,9006400,106.749,44.4,19.202,45436.686,145.183,6.35,0.908,0
12,123,89,21098,0,718,7495,905314,31.48,9006400,106.749,44.4,19.202,45436.686,145.183,6.35,0.908,0
12,124,126,21224,0,718,5123,910437,31.48,9006400,106.749,44.4,19.202,45436.686,145.183,6.35,0.908,0
12,125,85,21309,0,718,6341,916778,31.48,9006400,106.749,44.4,19.202,45436.686,145.183,6.35,0.908,0
12,126,32,21341,0,718,7124,923902,31.48,9006400,106.749,44.4,19.202,45436.686,145.183,6.35,0.908,0
12,127,131,21472,1,719,0,923902,31.48,9006400,106.749,44.4,19.202,45436.686,145.183,6.35,0.908,0
12,128,103,21575,0,719,0,937275,31.48,9006400,106.749,44.4,19.202,45436.686,145.183,6.35,0.908,0
12,129,114,21689,0,719,10030,947305,31.48,9006400,106.749,44.4,19.202,45436.686,145.183,6.35,0.908,0
12,130,130,21819,1,720,7934,955239,31.48,9006400,106.749,44.4,19.202,45436.686,145.183,6.35,0.908,0
12,131,116,21935,1,721,6629,961868,31.48,9006400,106.749,44.4,19.202,45436.686,145.183,6.35,0.908,0
12,132,76,22011,0,721,3890,965758,31.48,9006400,106.749,44.4,19.202,45436.686,145.183,6.35,0.908,0
12,133,111,22122,2,723,8750,974508,31.48,9006400,106.749,44.4,19.202,45436.686,145.183,6.35,0.908,0
12,134,138,22260,0,723,8510,983018,31.48,9006400,106.749,44.4,19.202,45436.686,145.183,6.35,0.908,0
12,135,241,22501,1,724,8490,991508,31.48,9006400,106.749,44.4,19.202,45436.686,145.183,6.35,0.908,0
12,136,229,22730,1,725,11924,1003432,31.48,9006400,106.749,44.4,19.202,45436.686,145.183,6.35,0.908,0
12,137,221,22951,0,725,5922,1009354,31.48,9006400,106.749,44.4,19.202,45436.686,145.183,6.35,0.908,0
12,138,260,23211,3,728,9136,1018490,31.48,9006400,106.749,44.4,19.202,45436.686,145.183,6.35,0.908,0
12,139,162,23373,0,728,5577,1024067,31.48,9006400,106.749,44.4,19.202,45436.686,145.183,6.35,0.908,0
12,140,344,23717,1,729,13821,1037888,31.48,9006400,106.749,44.4,19.202,45436.686,145.183,6.35,0.908,0
12,141,158,23875,0,729,10328,1048216,31.48,9006400,106.749,44.4,19.202,45436.686,145.183,6.35,0.908,0
12,142,425,24300,0,729,13221,1061437,31.48,9006400,106.749,44.4,19.202,45436.686,145.183,6.35,0.908,0
12,143,308,24608,0,729,13972,1075409,31.48,9006400,106.749,44.4,19.202,45436.686,145.183,6.35,0.908,0
12,144,275,24883,1,730,11746,1087155,31.48,9006400,106.749,44.4,19.202,45436.686,145.183,6.35,0.908,0
12,145,216,25099,2,732,7832,1094987,31.48,9006400,106.749,44.4,19.202,45436.686,145.183,6.35,0.908,0
12,146,140,25239,0,732,6219,1101206,31.48,9006400,106.749,44.4,19.202,45436.686,145.183,6.35,0.908,0
12,147,308,25547,1,733,8883,1110089,31.48,9006400,106.749,44.4,19.202,45436.686,145.183,6.35,0.908,0
12,148,291,25838,0,733,9110,1119199,31.48,9006400,106.749,44.4,19.202,45436.686,145.183,6.35,0.908,0
12,149,316,26154,0,733,14044,1133243,31.48,9006400,106.749,44.4,19.202,45436.686,145.183,6.35,0.908,0
12,150,227,26381,0,733,14701,1147944,31.48,9006400,106.749,44.4,19.202,45436.686,145.183,6.35,0.908,0
12,151,382,26763,0,733,12799,1160743,31.48,9006400,106.749,44.4,19.202,45436.686,145.183,6.35,0.908,0
12,152,174,26937,0,733,11349,1172092,31.48,9006400,106.749,44.4,19.202,45436.686,145.183,6.35,0.908,0
12,153,281,27218,0,733,8619,1180711,31.48,9006400,106.749,44.4,19.202,45436.686,145.183,6.35,0.908,0
12,154,186,27404,0,733,12416,1193127,31.48,9006400,106.749,44.4,19.202,45436.686,145.183,6.35,0.908,0
12,155,337,27741,1,734,17441,1210568,31.48,9006400,106.749,44.4,19.202,45436.686,145.183,6.35,0.908,0
12,156,442,28183,0,734,14689,1225257,31.48,9006400,106.749,44.4,19.202,45436.686,145.183,6.35,0.908,0
12,157,312,28495,1,735,11232,1236489,31.48,9006400,106.749,44.4,19.202,45436.686,145.183,6.35,0.908,0
12,158,271,28766,0,735,11318,1247807,31.48,9006400,106.749,44.4,19.202,45436.686,145.183,6.35,0.908,0
12,159,208,28974,0,735,8018,1255825,36.11,9006400,106.749,44.4,19.202,45436.686,145.183,6.35,0.908,0
12,160,220,29194,1,736,10398,1266223,36.11,9006400,106.749,44.4,19.202,45436.686,145.183,6.35,0.908,0
12,161,511,29705,10,746,10254,1276477,36.11,9006400,106.749,44.4,19.202,45436.686,145.183,6.35,0.908,0
12,162,495,30200,1,747,11582,1288059,36.11,9006400,106.749,44.4,19.202,45436.686,145.183,6.35,0.908,0
12,163,754,30954,0,747,14971,1303030,36.11,9006400,106.749,44.4,19.202,45436.686,145.183,6.35,0.908,0
12,164,497,31451,1,748,13789,1316819,36.11,9006400,106.749,44.4,19.202,45436.686,145.183,6.35,0.908,0
12,165,1005,32456,2,750,14674,1331493,36.11,9006400,106.749,44.4,19.202,45436.686,145.183,6.35,0.908,0
12,166,495,32951,4,754,10573,1342066,36.11,9006400,106.749,44.4,19.202,45436.686,145.183,6.35,0.908,0
12,167,384,33335,2,756,9342,1351408,36.11,9006400,106.749,44.4,19.202,45436.686,145.183,6.35,0.908,0
12,168,549,33884,1,757,13100,1364508,36.11,9006400,106.749,44.4,19.202,45436.686,145.183,6.35,0.908,0
12,169,860,34744,0,757,15331,1379839,36.11,9006400,106.749,44.4,19.202,45436.686,145.183,6.35,0.908,0
12,170,704,35448,1,758,0,1379839,37.04,9006400,106.749,44.4,19.202,45436.686,145.183,6.35,0.908,0
12,171,922,36370,0,758,0,1413965,37.04,9006400,106.749,44.4,19.202,45436.686,145.183,6.35,0.908,0
12,172,821,37191,5,763,18134,1432099,37.04,9006400,106.749,44.4,19.202,45436.686,145.183,6.35,0.908,0
12,173,757,37948,2,765,12584,1444683,37.04,9006400,106.749,44.4,19.202,45436.686,145.183,6.35,0.908,0
12,174,609,38557,1,766,13412,1458095,37.04,9006400,106.749,44.4,19.202,45436.686,145.183,6.35,0.908,0
12,175,593,39150,1,767,14552,1472647,37.04,9006400,106.749,44.4,19.202,45436.686,145.183,6.35,0.908,0
12,176,747,39897,4,771,16617,1489264,37.04,9006400,106.749,44.4,19.202,45436.686,145.183,6.35,0.908,0
12,177,661,40558,6,777,18518,1507782,37.04,9006400,106.749,44.4,19.202,45436.686,145.183,6.35,0.908,0
12,178,688,41246,6,783,0,1507782,37.04,9006400,106.749,44.4,19.202,45436.686,145.183,6.35,0.908,0
12,179,1071,42317,3,786,0,1545634,37.04,9006400,106.749,44.4,19.202,45436.686,145.183,6.35,0.908,0
12,180,623,42940,1,787,9865,1555499,37.04,9006400,106.749,44.4,19.202,45436.686,145.183,6.35,0.908,0
12,181,526,43466,0,787,14493,1569992,37.04,9006400,106.749,44.4,19.202,45436.686,145.183,6.35,0.908,0
12,182,419,43885,3,790,16586,1586578,40.74,9006400,106.749,44.4,19.202,45436.686,145.183,6.35,0.908,0
12,183,722,44607,6,796,31409,1617987,40.74,9006400,106.749,44.4,19.202,45436.686,145.183,6.35,0.908,0
12,184,1146,45753,3,799,18586,1636573,40.74,9006400,106.749,44.4,19.202,45436.686,145.183,6.35,0.908,0
12,185,564,46317,3,802,21839,1658412,40.74,9006400,106.749,44.4,19.202,45436.686,145.183,6.35,0.908,0
12,186,872,47189,1,803,0,1658412,40.74,9006400,106.749,44.4,19.202,45436.686,145.183,6.35,0.908,0
12,187,830,48019,6,809,0,1686373,40.74,9006400,106.749,44.4,19.202,45436.686,145.183,6.35,0.908,0
12,188,599,48618,4,813,11895,1698268,40.74,9006400,106.749,44.4,19.202,45436.686,145.183,6.35,0.908,0
12,189,1268,49886,5,818,18237,1716505,40.74,9006400,106.749,44.4,19.202,45436.686,145.183,6.35,0.908,0
12,190,549,50435,22,840,18589,1735094,40.74,9006400,106.749,44.4,19.202,45436.686,145.183,6.35,0.908,0
12,191,947,51382,4,844,21762,1756856,40.74,9006400,106.749,44.4,19.202,45436.686,145.183,6.35,0.908,0
12,192,1221,52603,9,853,18575,1775431,40.74,9006400,106.749,44.4,19.202,45436.686,145.183,6.35,0.908,0
12,193,1181,53784,4,857,20016,1795447,40.74,9006400,106.749,44.4,19.202,45436.686,145.183,6.35,0.908,0
12,194,901,54685,1,858,13816,1809263,40.74,9006400,106.749,44.4,19.202,45436.686,145.183,6.35,0.908,0
12,195,1298,55983,6,864,13668,1822931,40.74,9006400,106.749,44.4,19.202,45436.686,145.183,6.35,0.908,0
12,196,608,56591,5,869,21708,1844639,44.91,9006400,106.749,44.4,19.202,45436.686,145.183,6.35,0.908,0
12,197,1171,57762,10,879,17033,1861672,44.91,9006400,106.749,44.4,19.202,45436.686,145.183,6.35,0.908,0
12,198,1606,59368,9,888,19813,1881485,44.91,9006400,106.749,44.4,19.202,45436.686,145.183,6.35,0.908,0
12,199,1396,60764,6,894,20841,1902326,44.91,9006400,106.749,44.4,19.202,45436.686,145.183,6.35,0.908,0
12,200,1691,62455,7,901,24444,1926770,44.91,9006400,106.749,44.4,19.202,45436.686,145.183,6.35,0.908,0
12,201,2040,64495,6,907,11258,1938028,44.91,9006400,106.749,44.4,19.202,45436.686,145.183,6.35,0.908,0
12,202,1062,65557,3,910,14550,1952578,44.91,9006400,106.749,44.4,19.202,45436.686,145.183,6.35,0.908,0
12,203,1054,66611,9,919,19469,1972047,44.91,9006400,106.749,44.4,19.202,45436.686,145.183,6.35,0.908,0
12,204,1803,68414,8,927,0,1972047,44.91,9006400,106.749,44.4,19.202,45436.686,145.183,6.35,0.908,0
13,1,25,298,1,5,0,0,88.89,10139175,119.309,32.4,6.018,15847.419,559.812,7.11,0.757,0
13,2,61,359,0,5,0,0,88.89,10139175,119.309,32.4,6.018,15847.419,559.812,7.11,0.757,0
13,3,41,400,0,5,0,0,88.89,10139175,119.309,32.4,6.018,15847.419,559.812,7.11,0.757,0
13,4,43,443,0,5,0,0,88.89,10139175,119.309,32.4,6.018,15847.419,559.812,7.11,0.757,0
13,5,78,521,0,5,0,0,88.89,10139175,119.309,32.4,6.018,15847.419,559.812,7.11,0.757,0
13,6,63,584,2,7,0,0,88.89,10139175,119.309,32.4,6.018,15847.419,559.812,7.11,0.757,0
13,7,57,641,0,7,0,0,88.89,10139175,119.309,32.4,6.018,15847.419,559.812,7.11,0.757,0
13,8,76,717,1,8,0,0,88.89,10139175,119.309,32.4,6.018,15847.419,559.812,7.11,0.757,0
13,9,105,822,0,8,0,0,88.89,10139175,119.309,32.4,6.018,15847.419,559.812,7.11,0.757,0
13,10,104,926,1,9,0,0,88.89,10139175,119.309,32.4,6.018,15847.419,559.812,7.11,0.757,0
13,11,65,991,1,10,0,0,88.89,10139175,119.309,32.4,6.018,15847.419,559.812,7.11,0.757,0
13,12,67,1058,1,11,0,0,88.89,10139175,119.309,32.4,6.018,15847.419,559.812,7.11,0.757,0
13,13,40,1098,0,11,0,0,88.89,10139175,119.309,32.4,6.018,15847.419,559.812,7.11,0.757,0
13,14,50,1148,1,12,0,0,88.89,10139175,119.309,32.4,6.018,15847.419,559.812,7.11,0.757,0
13,15,49,1197,1,13,0,0,88.89,10139175,119.309,32.4,6.018,15847.419,559.812,7.11,0.757,0
13,16,56,1253,0,13,0,0,91.67,10139175,119.309,32.4,6.018,15847.419,559.812,7.11,0.757,0
13,17,30,1283,2,15,0,0,91.67,10139175,119.309,32.4,6.018,15847.419,559.812,7.11,0.757,0
13,18,57,1340,0,15,0,0,91.67,10139175,119.309,32.4,6.018,15847.419,559.812,7.11,0.757,0
13,19,33,1373,3,18,0,0,91.67,10139175,119.309,32.4,6.018,15847.419,559.812,7.11,0.757,0
13,20,25,1398,1,19,0,0,91.67,10139175,119.309,32.4,6.018,15847.419,559.812,7.11,0.757,0
13,21,38,1436,0,19,0,0,91.67,10139175,119.309,32.4,6.018,15847.419,559.812,7.11,0.757,0
13,22,44,1480,1,20,0,0,91.67,10139175,119.309,32.4,6.018,15847.419,559.812,7.11,0.757,0
13,23,38,1518,0,20,0,0,91.67,10139175,119.309,32.4,6.018,15847.419,559.812,7.11,0.757,0
13,24,30,1548,0,20,0,0,91.67,10139175,119.309,32.4,6.018,15847.419,559.812,7.11,0.757,0
13,25,44,1592,1,21,0,0,91.67,10139175,119.309,32.4,6.018,15847.419,559.812,7.11,0.757,0
13,26,25,1617,0,21,0,0,91.67,10139175,119.309,32.4,6.018,15847.419,559.812,7.11,0.757,0
13,27,28,1645,0,21,0,0,87.96,10139175,119.309,32.4,6.018,15847.419,559.812,7.11,0.757,0
13,28,33,1678,1,22,0,0,87.96,10139175,119.309,32.4,6.018,15847.419,559.812,7.11,0.757,0
13,29,39,1717,0,22,0,0,87.96,10139175,119.309,32.4,6.018,15847.419,559.812,7.11,0.757,0
13,30,49,1766,1,23,0,0,87.96,10139175,119.309,32.4,6.018,15847.419,559.812,7.11,0.757,0
13,31,38,1804,1,24,0,0,87.96,10139175,119.309,32.4,6.018,15847.419,559.812,7.11,0.757,0
13,32,50,1854,1,25,0,0,87.96,10139175,119.309,32.4,6.018,15847.419,559.812,7.11,0.757,0
13,33,40,1894,0,25,0,0,87.96,10139175,119.309,32.4,6.018,15847.419,559.812,7.11,0.757,0
13,34,38,1932,0,25,0,0,87.96,10139175,119.309,32.4,6.018,15847.419,559.812,7.11,0.757,0
13,35,52,1984,1,26,0,0,87.96,10139175,119.309,32.4,6.018,15847.419,559.812,7.11,0.757,0
13,36,76,2060,0,26,0,0,87.96,10139175,119.309,32.4,6.018,15847.419,559.812,7.11,0.757,0
13,37,67,2127,2,28,0,0,87.96,10139175,119.309,32.4,6.018,15847.419,559.812,7.11,0.757,0
13,38,77,2204,0,28,0,0,87.96,10139175,119.309,32.4,6.018,15847.419,559.812,7.11,0.757,0
13,39,75,2279,0,28,0,0,85.19,10139175,119.309,32.4,6.018,15847.419,559.812,7.11,0.757,0
13,40,143,2422,3,31,0,0,85.19,10139175,119.309,32.4,6.018,15847.419,559.812,7.11,0.757,0
13,41,97,2519,1,32,0,0,85.19,10139175,119.309,32.4,6.018,15847.419,559.812,7.11,0.757,0
13,42,70,2589,0,32,0,0,85.19,10139175,119.309,32.4,6.018,15847.419,559.812,7.11,0.757,0
13,43,104,2693,1,33,0,0,85.19,10139175,119.309,32.4,6.018,15847.419,559.812,7.11,0.757,0
13,44,65,2758,2,35,0,0,85.19,10139175,119.309,32.4,6.018,15847.419,559.812,7.11,0.757,0
13,45,121,2879,0,35,0,0,85.19,10139175,119.309,32.4,6.018,15847.419,559.812,7.11,0.757,0
13,46,101,2980,1,36,0,0,85.19,10139175,119.309,32.4,6.018,15847.419,559.812,7.11,0.757,0
13,47,158,3138,0,36,0,0,85.19,10139175,119.309,32.4,6.018,15847.419,559.812,7.11,0.757,0
13,48,136,3274,3,39,0,0,77.78,10139175,119.309,32.4,6.018,15847.419,559.812,7.11,0.757,0
13,49,13,3287,1,40,0,0,77.78,10139175,119.309,32.4,6.018,15847.419,559.812,7.11,0.757,0
13,50,231,3518,1,41,0,0,77.78,10139175,119.309,32.4,6.018,15847.419,559.812,7.11,0.757,0
13,51,113,3631,2,43,0,0,77.78,10139175,119.309,32.4,6.018,15847.419,559.812,7.11,0.757,0
13,52,118,3749,1,44,0,0,77.78,10139175,119.309,32.4,6.018,15847.419,559.812,7.11,0.757,0
13,53,106,3855,2,46,0,0,77.78,10139175,119.309,32.4,6.018,15847.419,559.812,7.11,0.757,0
13,54,127,3982,3,49,0,0,77.78,10139175,119.309,32.4,6.018,15847.419,559.812,7.11,0.757,0
13,55,140,4122,0,49,0,0,77.78,10139175,119.309,32.4,6.018,15847.419,559.812,7.11,0.757,0
13,56,149,4271,2,51,0,0,77.78,10139175,119.309,32.4,6.018,15847.419,559.812,7.11,0.757,0
13,57,132,4403,1,52,0,0,77.78,10139175,119.309,32.4,6.018,15847.419,559.812,7.11,0.757,0
13,58,165,4568,2,54,0,0,77.78,10139175,119.309,32.4,6.018,15847.419,559.812,7.11,0.757,0
13,59,191,4759,2,56,0,0,77.78,10139175,119.309,32.4,6.018,15847.419,559.812,7.11,0.757,0
13,60,230,4989,2,58,0,0,77.78,10139175,119.309,32.4,6.018,15847.419,559.812,7.11,0.757,0
13,61,257,5246,3,61,0,0,77.78,10139175,119.309,32.4,6.018,15847.419,559.812,7.11,0.757,0
13,62,248,5494,2,63,0,0,77.78,10139175,119.309,32.4,6.018,15847.419,559.812,7.11,0.757,0
13,63,168,5662,5,68,0,0,77.78,10139175,119.309,32.4,6.018,15847.419,559.812,7.11,0.757,0
13,64,273,5935,3,71,0,0,85.19,10139175,119.309,32.4,6.018,15847.419,559.812,7.11,0.757,0
13,65,325,6260,5,76,0,0,85.19,10139175,119.309,32.4,6.018,15847.419,559.812,7.11,0.757,0
13,66,262,6522,2,78,0,0,85.19,10139175,119.309,32.4,6.018,15847.419,559.812,7.11,0.757,0
13,67,338,6860,4,82,0,0,85.19,10139175,119.309,32.4,6.018,15847.419,559.812,7.11,0.757,0
13,68,379,7239,2,84,0,0,85.19,10139175,119.309,32.4,6.018,15847.419,559.812,7.11,0.757,0
13,69,314,7553,4,88,0,0,77.78,10139175,119.309,32.4,6.018,15847.419,559.812,7.11,0.757,0
13,70,323,7876,5,93,0,0,77.78,10139175,119.309,32.4,6.018,15847.419,559.812,7.11,0.757,0
13,71,315,8191,5,98,0,0,77.78,10139175,119.309,32.4,6.018,15847.419,559.812,7.11,0.757,0
13,72,339,8530,4,102,0,0,77.78,10139175,119.309,32.4,6.018,15847.419,559.812,7.11,0.757,0
13,73,352,8882,6,108,0,0,77.78,10139175,119.309,32.4,6.018,15847.419,559.812,7.11,0.757,0
13,74,336,9218,5,113,0,0,77.78,10139175,119.309,32.4,6.018,15847.419,559.812,7.11,0.757,0
13,75,352,9570,2,115,0,0,83.33,10139175,119.309,32.4,6.018,15847.419,559.812,7.11,0.757,0
13,76,387,9957,4,119,0,0,83.33,10139175,119.309,32.4,6.018,15847.419,559.812,7.11,0.757,0
13,77,367,10324,3,122,0,0,83.33,10139175,119.309,32.4,6.018,15847.419,559.812,7.11,0.757,0
13,78,338,10662,4,126,0,0,77.78,10139175,119.309,32.4,6.018,15847.419,559.812,7.11,0.757,0
13,79,329,10991,7,133,0,0,77.78,10139175,119.309,32.4,6.018,15847.419,559.812,7.11,0.757,0
13,80,338,11329,6,139,0,0,77.78,10139175,119.309,32.4,6.018,15847.419,559.812,7.11,0.757,0
13,81,438,11767,4,143,0,0,77.78,10139175,119.309,32.4,6.018,15847.419,559.812,7.11,0.757,0
13,82,471,12238,5,148,0,0,96.3,10139175,119.309,32.4,6.018,15847.419,559.812,7.11,0.757,0
13,83,491,12729,6,154,0,0,96.3,10139175,119.309,32.4,6.018,15847.419,559.812,7.11,0.757,0
13,84,478,13207,7,161,0,0,96.3,10139175,119.309,32.4,6.018,15847.419,559.812,7.11,0.757,0
13,85,508,13715,6,167,0,0,96.3,10139175,119.309,32.4,6.018,15847.419,559.812,7.11,0.757,0
13,86,590,14305,7,174,0,0,96.3,10139175,119.309,32.4,6.018,15847.419,559.812,7.11,0.757,0
13,87,547,14852,6,180,0,0,96.3,10139175,119.309,32.4,6.018,15847.419,559.812,7.11,0.757,0
13,88,517,15369,7,187,0,0,96.3,10139175,119.309,32.4,6.018,15847.419,559.812,7.11,0.757,0
13,89,521,15890,6,193,0,0,96.3,10139175,119.309,32.4,6.018,15847.419,559.812,7.11,0.757,0
13,90,534,16424,5,198,0,0,96.3,10139175,119.309,32.4,6.018,15847.419,559.812,7.11,0.757,0
13,91,544,16968,8,206,0,0,96.3,10139175,119.309,32.4,6.018,15847.419,559.812,7.11,0.757,0
13,92,556,17524,7,213,0,0,96.3,10139175,119.309,32.4,6.018,15847.419,559.812,7.11,0.757,0
13,93,588,18112,7,220,0,0,96.3,10139175,119.309,32.4,6.018,15847.419,559.812,7.11,0.757,0
13,94,572,18684,8,228,0,0,96.3,10139175,119.309,32.4,6.018,15847.419,559.812,7.11,0.757,0
13,95,583,19267,7,235,0,0,96.3,10139175,119.309,32.4,6.018,15847.419,559.812,7.11,0.757,0
13,96,534,19801,6,241,0,0,96.3,10139175,119.309,32.4,6.018,15847.419,559.812,7.11,0.757,0
13,97,523,20324,9,250,0,0,96.3,10139175,119.309,32.4,6.018,15847.419,559.812,7.11,0.757,0
13,98,513,20837,8,258,0,0,96.3,10139175,119.309,32.4,6.018,15847.419,559.812,7.11,0.757,0
13,99,537,21374,7,265,0,0,96.3,10139175,119.309,32.4,6.018,15847.419,559.812,7.11,0.757,0
13,100,542,21916,9,274,0,0,96.3,10139175,119.309,32.4,6.018,15847.419,559.812,7.11,0.757,0
13,101,548,22464,10,284,0,0,96.3,10139175,119.309,32.4,6.018,15847.419,559.812,7.11,0.757,0
13,102,526,22990,8,292,0,0,96.3,10139175,119.309,32.4,6.018,15847.419,559.812,7.11,0.757,0
13,103,531,23521,6,298,0,0,96.3,10139175,119.309,32.4,6.018,15847.419,559.812,7.11,0.757,0
13,104,520,24041,8,306,0,0,96.3,10139175,119.309,32.4,6.018,15847.419,559.812,7.11,0.757,0
13,105,529,24570,7,313,0,0,96.3,10139175,119.309,32.4,6.018,15847.419,559.812,7.11,0.757,0
13,106,543,25113,6,319,0,0,96.3,10139175,119.309,32.4,6.018,15847.419,559.812,7.11,0.757,0
13,107,559,25672,7,326,0,0,96.3,10139175,119.309,32.4,6.018,15847.419,559.812,7.11,0.757,0
13,108,493,26165,8,334,0,0,96.3,10139175,119.309,32.4,6.018,15847.419,559.812,7.11,0.757,0
13,109,471,26636,7,341,0,0,96.3,10139175,119.309,32.4,6.018,15847.419,559.812,7.11,0.757,0
13,110,497,27133,8,349,0,0,96.3,10139175,119.309,32.4,6.018,15847.419,559.812,7.11,0.757,0
13,111,388,27521,5,354,0,0,96.3,10139175,119.309,32.4,6.018,15847.419,559.812,7.11,0.757,0
13,112,369,27890,9,363,0,0,96.3,10139175,119.309,32.4,6.018,15847.419,559.812,7.11,0.757,0
13,113,352,28242,13,376,0,0,96.3,10139175,119.309,32.4,6.018,15847.419,559.812,7.11,0.757,0
13,114,391,28633,9,385,0,0,96.3,10139175,119.309,32.4,6.018,15847.419,559.812,7.11,0.757,0
13,115,347,28980,6,391,0,0,96.3,10139175,119.309,32.4,6.018,15847.419,559.812,7.11,0.757,0
13,116,332,29312,9,400,0,0,96.3,10139175,119.309,32.4,6.018,15847.419,559.812,7.11,0.757,0
13,117,321,29633,8,408,0,0,96.3,10139175,119.309,32.4,6.018,15847.419,559.812,7.11,0.757,0
13,118,417,30050,9,417,0,0,96.3,10139175,119.309,32.4,6.018,15847.419,559.812,7.11,0.757,0
13,119,396,30446,6,423,0,0,97.22,10139175,119.309,32.4,6.018,15847.419,559.812,7.11,0.757,0
13,120,412,30858,7,430,0,0,97.22,10139175,119.309,32.4,6.018,15847.419,559.812,7.11,0.757,0
13,121,363,31221,8,438,0,0,97.22,10139175,119.309,32.4,6.018,15847.419,559.812,7.11,0.757,0
13,122,339,31560,3,441,0,0,97.22,10139175,119.309,32.4,6.018,15847.419,559.812,7.11,0.757,0
13,123,318,31878,7,448,0,0,97.22,10139175,119.309,32.4,6.018,15847.419,559.812,7.11,0.757,0
13,124,279,32157,6,454,0,0,97.22,10139175,119.309,32.4,6.018,15847.419,559.812,7.11,0.757,0
13,125,286,32443,8,462,0,0,97.22,10139175,119.309,32.4,6.018,15847.419,559.812,7.11,0.757,0
13,126,241,32684,6,468,0,0,97.22,10139175,119.309,32.4,6.018,15847.419,559.812,7.11,0.757,0
13,127,226,32910,5,473,0,0,97.22,10139175,119.309,32.4,6.018,15847.419,559.812,7.11,0.757,0
13,128,193,33103,3,476,0,0,86.11,10139175,119.309,32.4,6.018,15847.419,559.812,7.11,0.757,0
13,129,144,33247,3,479,0,0,86.11,10139175,119.309,32.4,6.018,15847.419,559.812,7.11,0.757,0
13,130,129,33376,4,483,0,0,86.11,10139175,119.309,32.4,6.018,15847.419,559.812,7.11,0.757,0
13,131,105,33481,5,488,0,0,86.11,10139175,119.309,32.4,6.018,15847.419,559.812,7.11,0.757,0
13,132,87,33568,2,490,0,0,85.19,10139175,119.309,32.4,6.018,15847.419,559.812,7.11,0.757,0
13,133,79,33647,2,492,0,0,85.19,10139175,119.309,32.4,6.018,15847.419,559.812,7.11,0.757,0
13,134,84,33731,3,495,0,0,85.19,10139175,119.309,32.4,6.018,15847.419,559.812,7.11,0.757,0
13,135,93,33824,2,497,0,0,85.19,10139175,119.309,32.4,6.018,15847.419,559.812,7.11,0.757,0
13,136,91,33915,3,500,0,0,85.19,10139175,119.309,32.4,6.018,15847.419,559.812,7.11,0.757,0
13,137,103,34018,4,504,0,0,85.19,10139175,119.309,32.4,6.018,15847.419,559.812,7.11,0.757,0
13,138,89,34107,2,506,0,0,85.19,10139175,119.309,32.4,6.018,15847.419,559.812,7.11,0.757,0
13,139,112,34219,0,506,0,0,85.19,10139175,119.309,32.4,6.018,15847.419,559.812,7.11,0.757,0
13,140,124,34343,2,508,0,0,85.19,10139175,119.309,32.4,6.018,15847.419,559.812,7.11,0.757,0
13,141,131,34474,1,509,0,0,85.19,10139175,119.309,32.4,6.018,15847.419,559.812,7.11,0.757,0
13,142,146,34620,1,510,0,0,85.19,10139175,119.309,32.4,6.018,15847.419,559.812,7.11,0.757,0
13,143,139,34759,0,510,0,0,85.19,10139175,119.309,32.4,6.018,15847.419,559.812,7.11,0.757,0
13,144,162,34921,2,512,0,0,85.19,10139175,119.309,32.4,6.018,15847.419,559.812,7.11,0.757,0
13,145,184,35105,3,515,0,0,85.19,10139175,119.309,32.4,6.018,15847.419,559.812,7.11,0.757,0
13,146,169,35274,3,518,0,0,85.19,10139175,119.309,32.4,6.018,15847.419,559.812,7.11,0.757,0
13,147,152,35426,1,519,0,0,85.19,10139175,119.309,32.4,6.018,15847.419,559.812,7.11,0.757,0
13,148,133,35559,2,521,0,0,85.19,10139175,119.309,32.4,6.018,15847.419,559.812,7.11,0.757,0
13,149,148,35707,1,522,0,0,85.19,10139175,119.309,32.4,6.018,15847.419,559.812,7.11,0.757,0
13,150,137,35844,2,524,0,0,85.19,10139175,119.309,32.4,6.018,15847.419,559.812,7.11,0.757,0
13,151,142,35986,3,527,0,0,85.19,10139175,119.309,32.4,6.018,15847.419,559.812,7.11,0.757,0
13,152,188,36174,2,529,0,0,85.19,10139175,119.309,32.4,6.018,15847.419,559.812,7.11,0.757,0
13,153,135,36309,2,531,0,0,85.19,10139175,119.309,32.4,6.018,15847.419,559.812,7.11,0.757,0
13,154,126,36435,3,534,0,0,85.19,10139175,119.309,32.4,6.018,15847.419,559.812,7.11,0.757,0
13,155,143,36578,2,536,0,0,85.19,10139175,119.309,32.4,6.018,15847.419,559.812,7.11,0.757,0
13,156,154,36732,2,538,0,0,85.19,10139175,119.309,32.4,6.018,15847.419,559.812,7.11,0.757,0
13,157,167,36899,3,541,0,0,85.19,10139175,119.309,32.4,6.018,15847.419,559.812,7.11,0.757,0
13,158,132,37031,2,543,0,0,85.19,10139175,119.309,32.4,6.018,15847.419,559.812,7.11,0.757,0
13,159,161,37192,2,545,0,0,82.41,10139175,119.309,32.4,6.018,15847.419,559.812,7.11,0.757,0
13,160,137,37329,3,548,0,0,82.41,10139175,119.309,32.4,6.018,15847.419,559.812,7.11,0.757,0
13,161,89,37418,3,551,0,0,82.41,10139175,119.309,32.4,6.018,15847.419,559.812,7.11,0.757,0
13,162,139,37557,1,552,0,0,82.41,10139175,119.309,32.4,6.018,15847.419,559.812,7.11,0.757,0
13,163,175,37732,3,555,0,0,82.41,10139175,119.309,32.4,6.018,15847.419,559.812,7.11,0.757,0
13,164,142,37874,1,556,0,0,82.41,10139175,119.309,32.4,6.018,15847.419,559.812,7.11,0.757,0
13,165,163,38037,1,557,0,0,82.41,10139175,119.309,32.4,6.018,15847.419,559.812,7.11,0.757,0
13,166,135,38172,2,559,0,0,82.41,10139175,119.309,32.4,6.018,15847.419,559.812,7.11,0.757,0
13,167,155,38327,3,562,0,0,82.41,10139175,119.309,32.4,6.018,15847.419,559.812,7.11,0.757,0
13,168,76,38403,2,564,0,0,78.7,10139175,119.309,32.4,6.018,15847.419,559.812,7.11,0.757,0
13,169,114,38517,2,566,0,0,78.7,10139175,119.309,32.4,6.018,15847.419,559.812,7.11,0.757,0
13,170,141,38658,3,569,0,0,78.7,10139175,119.309,32.4,6.018,15847.419,559.812,7.11,0.757,0
13,171,119,38777,2,571,0,0,70.37,10139175,119.309,32.4,6.018,15847.419,559.812,7.11,0.757,0
13,172,117,38894,1,572,0,0,70.37,10139175,119.309,32.4,6.018,15847.419,559.812,7.11,0.757,0
13,173,148,39042,2,574,0,0,70.37,10139175,119.309,32.4,6.018,15847.419,559.812,7.11,0.757,0
13,174,146,39188,1,575,0,0,70.37,10139175,119.309,32.4,6.018,15847.419,559.812,7.11,0.757,0
13,175,92,39280,1,576,0,0,70.37,10139175,119.309,32.4,6.018,15847.419,559.812,7.11,0.757,0
13,176,98,39378,2,578,0,0,70.37,10139175,119.309,32.4,6.018,15847.419,559.812,7.11,0.757,0
13,177,146,39524,2,580,0,0,70.37,10139175,119.309,32.4,6.018,15847.419,559.812,7.11,0.757,0
13,178,162,39686,1,581,0,0,70.37,10139175,119.309,32.4,6.018,15847.419,559.812,7.11,0.757,0
13,179,101,39787,2,583,0,0,70.37,10139175,119.309,32.4,6.018,15847.419,559.812,7.11,0.757,0
13,180,108,39895,2,585,0,0,70.37,10139175,119.309,32.4,6.018,15847.419,559.812,7.11,0.757,0
13,181,128,40023,1,586,0,0,70.37,10139175,119.309,32.4,6.018,15847.419,559.812,7.11,0.757,0
13,182,38,40061,2,588,0,0,68.98,10139175,119.309,32.4,6.018,15847.419,559.812,7.11,0.757,0
13,183,58,40119,2,590,0,0,68.98,10139175,119.309,32.4,6.018,15847.419,559.812,7.11,0.757,0
13,184,110,40229,1,591,0,0,68.98,10139175,119.309,32.4,6.018,15847.419,559.812,7.11,0.757,0
13,185,80,40309,2,593,0,0,68.98,10139175,119.309,32.4,6.018,15847.419,559.812,7.11,0.757,0
13,186,144,40453,1,594,0,0,68.98,10139175,119.309,32.4,6.018,15847.419,559.812,7.11,0.757,0
13,187,108,40561,1,595,0,0,68.98,10139175,119.309,32.4,6.018,15847.419,559.812,7.11,0.757,0
13,188,130,40691,1,596,0,0,68.98,10139175,119.309,32.4,6.018,15847.419,559.812,7.11,0.757,0
13,189,97,40788,2,598,0,0,68.98,10139175,119.309,32.4,6.018,15847.419,559.812,7.11,0.757,0
13,190,143,40931,2,600,0,0,68.98,10139175,119.309,32.4,6.018,15847.419,559.812,7.11,0.757,0
13,191,182,41113,2,602,0,0,66.2,10139175,119.309,32.4,6.018,15847.419,559.812,7.11,0.757,0
13,192,191,41304,1,603,0,0,66.2,10139175,119.309,32.4,6.018,15847.419,559.812,7.11,0.757,0
13,193,215,41519,2,605,0,0,66.2,10139175,119.309,32.4,6.018,15847.419,559.812,7.11,0.757,0
13,194,233,41752,3,608,0,0,66.2,10139175,119.309,32.4,6.018,15847.419,559.812,7.11,0.757,0
13,195,230,41982,1,609,0,0,66.2,10139175,119.309,32.4,6.018,15847.419,559.812,7.11,0.757,0
13,196,122,42104,0,609,0,0,66.2,10139175,119.309,32.4,6.018,15847.419,559.812,7.11,0.757,0
13,197,277,42381,3,612,0,0,66.2,10139175,119.309,32.4,6.018,15847.419,559.812,7.11,0.757,0
13,198,369,42750,4,616,0,0,66.2,10139175,119.309,32.4,6.018,15847.419,559.812,7.11,0.757,0
13,199,530,43280,3,619,0,0,66.2,10139175,119.309,32.4,6.018,15847.419,559.812,7.11,0.757,0
13,200,509,43789,2,621,0,0,66.2,10139175,119.309,32.4,6.018,15847.419,559.812,7.11,0.757,0
13,201,528,44317,2,623,0,0,66.2,10139175,119.309,32.4,6.018,15847.419,559.812,7.11,0.757,0
13,202,647,44964,3,626,0,0,66.2,10139175,119.309,32.4,6.018,15847.419,559.812,7.11,0.757,0
13,203,331,45295,4,630,0,0,66.2,10139175,119.309,32.4,6.018,15847.419,559.812,7.11,0.757,0
13,204,584,45879,5,635,0,0,66.2,10139175,119.309,32.4,6.018,15847.419,559.812,7.11,0.757,0
14,1,1,15,0,0,0,0,0,393248,39.497,34.3,8.996,27717.847,235.954,13.17,0.807,0
14,2,6,21,1,1,0,0,0,393248,39.497,34.3,8.996,27717.847,235.954,13.17,0.807,0
14,3,3,24,0,1,0,0,0,393248,39.497,34.3,8.996,27717.847,235.954,13.17,0.807,0
14,4,0,24,2,3,0,0,0,393248,39.497,34.3,8.996,27717.847,235.954,13.17,0.807,0
14,5,4,28,1,4,0,0,0,393248,39.497,34.3,8.996,27717.847,235.954,13.17,0.807,0
14,6,1,29,1,5,0,0,0,393248,39.497,34.3,8.996,27717.847,235.954,13.17,0.807,0
14,7,4,33,0,5,0,0,0,393248,39.497,34.3,8.996,27717.847,235.954,13.17,0.807,0
14,8,3,36,1,6,0,0,0,393248,39.497,34.3,8.996,27717.847,235.954,13.17,0.807,0
14,9,4,40,1,7,0,0,0,393248,39.497,34.3,8.996,27717.847,235.954,13.17,0.807,0
14,10,1,41,1,8,0,0,0,393248,39.497,34.3,8.996,27717.847,235.954,13.17,0.807,0
14,11,1,42,0,8,0,0,0,393248,39.497,34.3,8.996,27717.847,235.954,13.17,0.807,0
14,12,4,46,0,8,0,0,0,393248,39.497,34.3,8.996,27717.847,235.954,13.17,0.807,0
14,13,1,47,0,8,0,0,0,393248,39.497,34.3,8.996,27717.847,235.954,13.17,0.807,0
14,14,2,49,0,8,0,0,0,393248,39.497,34.3,8.996,27717.847,235.954,13.17,0.807,0
14,15,0,49,0,8,0,0,0,393248,39.497,34.3,8.996,27717.847,235.954,13.17,0.807,0
14,16,4,53,0,8,0,0,0,393248,39.497,34.3,8.996,27717.847,235.954,13.17,0.807,0
14,17,1,54,1,9,0,0,0,393248,39.497,34.3,8.996,27717.847,235.954,13.17,0.807,0
14,18,1,55,0,9,0,0,0,393248,39.497,34.3,8.996,27717.847,235.954,13.17,0.807,0
14,19,3,58,0,9,0,0,0,393248,39.497,34.3,8.996,27717.847,235.954,13.17,0.807,0
14,20,2,60,0,9,0,0,0,393248,39.497,34.3,8.996,27717.847,235.954,13.17,0.807,0
14,21,4,64,0,9,0,0,0,393248,39.497,34.3,8.996,27717.847,235.954,13.17,0.807,0
14,22,1,65,0,9,0,0,0,393248,39.497,34.3,8.996,27717.847,235.954,13.17,0.807,0
14,23,5,70,0,9,0,0,0,393248,39.497,34.3,8.996,27717.847,235.954,13.17,0.807,0
14,24,2,72,2,11,0,0,0,393248,39.497,34.3,8.996,27717.847,235.954,13.17,0.807,0
14,25,1,73,0,11,0,0,0,393248,39.497,34.3,8.996,27717.847,235.954,13.17,0.807,0
14,26,5,78,0,11,0,0,0,393248,39.497,34.3,8.996,27717.847,235.954,13.17,0.807,0
14,27,2,80,0,11,0,0,0,393248,39.497,34.3,8.996,27717.847,235.954,13.17,0.807,0
14,28,0,80,0,11,0,0,0,393248,39.497,34.3,8.996,27717.847,235.954,13.17,0.807,0
14,29,0,80,0,11,0,0,0,393248,39.497,34.3,8.996,27717.847,235.954,13.17,0.807,0
14,30,0,80,0,11,0,0,0,393248,39.497,34.3,8.996,27717.847,235.954,13.17,0.807,0
14,31,1,81,0,11,0,0,0,393248,39.497,34.3,8.996,27717.847,235.954,13.17,0.807,0
14,32,1,82,0,11,0,0,0,393248,39.497,34.3,8.996,27717.847,235.954,13.17,0.807,0
14,33,1,83,0,11,0,0,0,393248,39.497,34.3,8.996,27717.847,235.954,13.17,0.807,0
14,34,0,83,0,11,0,0,0,393248,39.497,34.3,8.996,27717.847,235.954,13.17,0.807,0
14,35,0,83,0,11,0,0,0,393248,39.497,34.3,8.996,27717.847,235.954,13.17,0.807,0
14,36,6,89,0,11,0,0,0,393248,39.497,34.3,8.996,27717.847,235.954,13.17,0.807,0
14,37,3,92,0,11,0,0,0,393248,39.497,34.3,8.996,27717.847,235.954,13.17,0.807,0
14,38,0,92,0,11,0,0,0,393248,39.497,34.3,8.996,27717.847,235.954,13.17,0.807,0
14,39,0,92,0,11,0,0,0,393248,39.497,34.3,8.996,27717.847,235.954,13.17,0.807,0
14,40,0,92,0,11,0,0,0,393248,39.497,34.3,8.996,27717.847,235.954,13.17,0.807,0
14,41,0,92,0,11,0,0,0,393248,39.497,34.3,8.996,27717.847,235.954,13.17,0.807,0
14,42,1,93,0,11,0,0,0,393248,39.497,34.3,8.996,27717.847,235.954,13.17,0.807,0
14,43,0,93,0,11,0,0,0,393248,39.497,34.3,8.996,27717.847,235.954,13.17,0.807,0
14,44,1,94,0,11,0,0,0,393248,39.497,34.3,8.996,27717.847,235.954,13.17,0.807,0
14,45,2,96,0,11,0,0,0,393248,39.497,34.3,8.996,27717.847,235.954,13.17,0.807,0
14,46,0,96,0,11,0,0,0,393248,39.497,34.3,8.996,27717.847,235.954,13.17,0.807,0
14,47,0,96,0,11,0,0,0,393248,39.497,34.3,8.996,27717.847,235.954,13.17,0.807,0
14,48,0,96,0,11,0,0,0,393248,39.497,34.3,8.996,27717.847,235.954,13.17,0.807,0
14,49,0,96,0,11,0,0,0,393248,39.497,34.3,8.996,27717.847,235.954,13.17,0.807,0
14,50,0,96,0,11,0,0,0,393248,39.497,34.3,8.996,27717.847,235.954,13.17,0.807,0
14,51,1,97,0,11,0,0,0,393248,39.497,34.3,8.996,27717.847,235.954,13.17,0.807,0
14,52,0,97,0,11,0,0,0,393248,39.497,34.3,8.996,27717.847,235.954,13.17,0.807,0
14,53,0,97,0,11,0,0,0,393248,39.497,34.3,8.996,27717.847,235.954,13.17,0.807,0
14,54,3,100,0,11,0,0,0,393248,39.497,34.3,8.996,27717.847,235.954,13.17,0.807,0
14,55,0,100,0,11,0,0,0,393248,39.497,34.3,8.996,27717.847,235.954,13.17,0.807,0
14,56,0,100,0,11,0,0,0,393248,39.497,34.3,8.996,27717.847,235.954,13.17,0.807,0
14,57,0,100,0,11,0,0,0,393248,39.497,34.3,8.996,27717.847,235.954,13.17,0.807,0
14,58,0,100,0,11,0,0,0,393248,39.497,34.3,8.996,27717.847,235.954,13.17,0.807,0
14,59,1,101,0,11,0,0,0,393248,39.497,34.3,8.996,27717.847,235.954,13.17,0.807,0
14,60,1,102,0,11,0,0,0,393248,39.497,34.3,8.996,27717.847,235.954,13.17,0.807,0
14,61,0,102,0,11,0,0,0,393248,39.497,34.3,8.996,27717.847,235.954,13.17,0.807,0
14,62,0,102,0,11,0,0,0,393248,39.497,34.3,8.996,27717.847,235.954,13.17,0.807,0
14,63,0,102,0,11,0,0,0,393248,39.497,34.3,8.996,27717.847,235.954,13.17,0.807,0
14,64,0,102,0,11,0,0,0,393248,39.497,34.3,8.996,27717.847,235.954,13.17,0.807,0
14,65,0,102,0,11,0,0,0,393248,39.497,34.3,8.996,27717.847,235.954,13.17,0.807,0
14,66,0,102,0,11,0,0,0,393248,39.497,34.3,8.996,27717.847,235.954,13.17,0.807,0
14,67,0,102,0,11,0,0,0,393248,39.497,34.3,8.996,27717.847,235.954,13.17,0.807,0
14,68,1,103,0,11,0,0,0,393248,39.497,34.3,8.996,27717.847,235.954,13.17,0.807,0
14,69,0,103,0,11,0,0,0,393248,39.497,34.3,8.996,27717.847,235.954,13.17,0.807,0
14,70,0,103,0,11,0,0,0,393248,39.497,34.3,8.996,27717.847,235.954,13.17,0.807,0
14,71,0,103,0,11,0,0,0,393248,39.497,34.3,8.996,27717.847,235.954,13.17,0.807,0
14,72,0,103,0,11,0,0,0,393248,39.497,34.3,8.996,27717.847,235.954,13.17,0.807,0
14,73,0,103,0,11,0,0,0,393248,39.497,34.3,8.996,27717.847,235.954,13.17,0.807,0
14,74,0,103,0,11,0,0,0,393248,39.497,34.3,8.996,27717.847,235.954,13.17,0.807,0
14,75,0,103,0,11,0,0,0,393248,39.497,34.3,8.996,27717.847,235.954,13.17,0.807,0
14,76,0,103,0,11,0,0,0,393248,39.497,34.3,8.996,27717.847,235.954,13.17,0.807,0
14,77,1,104,0,11,0,0,0,393248,39.497,34.3,8.996,27717.847,235.954,13.17,0.807,0
14,78,0,104,0,11,0,0,0,393248,39.497,34.3,8.996,27717.847,235.954,13.17,0.807,0
14,79,0,104,0,11,0,0,0,393248,39.497,34.3,8.996,27717.847,235.954,13.17,0.807,0
14,80,0,104,0,11,0,0,0,393248,39.497,34.3,8.996,27717.847,235.954,13.17,0.807,0
14,81,0,104,0,11,0,0,0,393248,39.497,34.3,8.996,27717.847,235.954,13.17,0.807,0
14,82,0,104,0,11,0,0,0,393248,39.497,34.3,8.996,27717.847,235.954,13.17,0.807,0
14,83,0,104,0,11,0,0,0,393248,39.497,34.3,8.996,27717.847,235.954,13.17,0.807,0
14,84,0,104,0,11,0,0,0,393248,39.497,34.3,8.996,27717.847,235.954,13.17,0.807,0
14,85,0,104,0,11,0,0,0,393248,39.497,34.3,8.996,27717.847,235.954,13.17,0.807,0
14,86,0,104,0,11,0,0,0,393248,39.497,34.3,8.996,27717.847,235.954,13.17,0.807,0
14,87,0,104,0,11,0,0,0,393248,39.497,34.3,8.996,27717.847,235.954,13.17,0.807,0
14,88,0,104,0,11,0,0,0,393248,39.497,34.3,8.996,27717.847,235.954,13.17,0.807,0
14,89,0,104,0,11,0,0,0,393248,39.497,34.3,8.996,27717.847,235.954,13.17,0.807,0
14,90,0,104,0,11,0,0,0,393248,39.497,34.3,8.996,27717.847,235.954,13.17,0.807,0
14,91,0,104,0,11,0,0,0,393248,39.497,34.3,8.996,27717.847,235.954,13.17,0.807,0
14,92,0,104,0,11,0,0,0,393248,39.497,34.3,8.996,27717.847,235.954,13.17,0.807,0
14,93,0,104,0,11,0,0,0,393248,39.497,34.3,8.996,27717.847,235.954,13.17,0.807,0
14,94,0,104,0,11,0,0,0,393248,39.497,34.3,8.996,27717.847,235.954,13.17,0.807,0
14,95,0,104,0,11,0,0,0,393248,39.497,34.3,8.996,27717.847,235.954,13.17,0.807,0
14,96,0,104,0,11,0,0,0,393248,39.497,34.3,8.996,27717.847,235.954,13.17,0.807,0
14,97,0,104,0,11,0,0,0,393248,39.497,34.3,8.996,27717.847,235.954,13.17,0.807,0
14,98,0,104,0,11,0,0,0,393248,39.497,34.3,8.996,27717.847,235.954,13.17,0.807,0
14,99,0,104,0,11,0,0,0,393248,39.497,34.3,8.996,27717.847,235.954,13.17,0.807,0
14,100,2,106,0,11,0,0,0,393248,39.497,34.3,8.996,27717.847,235.954,13.17,0.807,0
14,101,1,107,0,11,0,0,0,393248,39.497,34.3,8.996,27717.847,235.954,13.17,0.807,0
14,102,1,108,0,11,0,0,0,393248,39.497,34.3,8.996,27717.847,235.954,13.17,0.807,0
14,103,3,111,0,11,0,0,0,393248,39.497,34.3,8.996,27717.847,235.954,13.17,0.807,0
14,104,0,111,0,11,0,0,0,393248,39.497,34.3,8.996,27717.847,235.954,13.17,0.807,0
14,105,2,113,0,11,0,0,0,393248,39.497,34.3,8.996,27717.847,235.954,13.17,0.807,0
14,106,3,116,0,11,0,0,0,393248,39.497,34.3,8.996,27717.847,235.954,13.17,0.807,0
14,107,3,119,0,11,0,0,0,393248,39.497,34.3,8.996,27717.847,235.954,13.17,0.807,0
14,108,5,124,0,11,0,0,0,393248,39.497,34.3,8.996,27717.847,235.954,13.17,0.807,0
14,109,5,129,0,11,0,0,0,393248,39.497,34.3,8.996,27717.847,235.954,13.17,0.807,0
14,110,9,138,0,11,0,0,0,393248,39.497,34.3,8.996,27717.847,235.954,13.17,0.807,0
14,111,15,153,0,11,0,0,0,393248,39.497,34.3,8.996,27717.847,235.954,13.17,0.807,0
14,112,21,174,0,11,0,0,0,393248,39.497,34.3,8.996,27717.847,235.954,13.17,0.807,0
14,113,20,194,0,11,0,0,0,393248,39.497,34.3,8.996,27717.847,235.954,13.17,0.807,0
14,114,25,219,0,11,0,0,0,393248,39.497,34.3,8.996,27717.847,235.954,13.17,0.807,0
14,115,55,274,0,11,0,0,0,393248,39.497,34.3,8.996,27717.847,235.954,13.17,0.807,0
14,116,42,316,0,11,0,0,0,393248,39.497,34.3,8.996,27717.847,235.954,13.17,0.807,0
14,117,10,326,0,11,0,0,0,393248,39.497,34.3,8.996,27717.847,235.954,13.17,0.807,0
14,118,16,342,0,11,0,0,0,393248,39.497,34.3,8.996,27717.847,235.954,13.17,0.807,0
14,119,40,382,0,11,0,0,0,393248,39.497,34.3,8.996,27717.847,235.954,13.17,0.807,0
14,120,65,447,0,11,0,0,0,393248,39.497,34.3,8.996,27717.847,235.954,13.17,0.807,0
14,121,37,484,0,11,0,0,0,393248,39.497,34.3,8.996,27717.847,235.954,13.17,0.807,0
14,122,24,508,3,14,0,0,0,393248,39.497,34.3,8.996,27717.847,235.954,13.17,0.807,0
14,123,66,574,0,14,0,0,0,393248,39.497,34.3,8.996,27717.847,235.954,13.17,0.807,0
14,124,25,599,0,14,0,0,0,393248,39.497,34.3,8.996,27717.847,235.954,13.17,0.807,0
14,125,49,648,0,14,0,0,0,393248,39.497,34.3,8.996,27717.847,235.954,13.17,0.807,0
14,126,31,679,0,14,0,0,0,393248,39.497,34.3,8.996,27717.847,235.954,13.17,0.807,0
14,127,36,715,0,14,0,0,0,393248,39.497,34.3,8.996,27717.847,235.954,13.17,0.807,0
14,128,36,751,0,14,0,0,0,393248,39.497,34.3,8.996,27717.847,235.954,13.17,0.807,0
14,129,10,761,0,14,0,0,0,393248,39.497,34.3,8.996,27717.847,235.954,13.17,0.807,0
14,130,69,830,0,14,0,0,0,393248,39.497,34.3,8.996,27717.847,235.954,13.17,0.807,0
14,131,48,878,0,14,0,0,0,393248,39.497,34.3,8.996,27717.847,235.954,13.17,0.807,0
14,132,20,898,1,15,0,0,0,393248,39.497,34.3,8.996,27717.847,235.954,13.17,0.807,0
14,133,47,945,0,15,0,0,0,393248,39.497,34.3,8.996,27717.847,235.954,13.17,0.807,0
14,134,44,989,0,15,0,0,0,393248,39.497,34.3,8.996,27717.847,235.954,13.17,0.807,0
14,135,47,1036,0,15,0,0,0,393248,39.497,34.3,8.996,27717.847,235.954,13.17,0.807,0
14,136,53,1089,0,15,0,0,0,393248,39.497,34.3,8.996,27717.847,235.954,13.17,0.807,0
14,137,30,1119,2,17,0,0,0,393248,39.497,34.3,8.996,27717.847,235.954,13.17,0.807,0
14,138,133,1252,0,17,0,0,0,393248,39.497,34.3,8.996,27717.847,235.954,13.17,0.807,0
14,139,63,1315,1,18,0,0,0,393248,39.497,34.3,8.996,27717.847,235.954,13.17,0.807,0
14,140,14,1329,1,19,0,0,0,393248,39.497,34.3,8.996,27717.847,235.954,13.17,0.807,0
14,141,95,1424,1,20,0,0,0,393248,39.497,34.3,8.996,27717.847,235.954,13.17,0.807,0
14,142,107,1531,2,22,0,0,0,393248,39.497,34.3,8.996,27717.847,235.954,13.17,0.807,0
14,143,79,1610,1,23,0,0,0,393248,39.497,34.3,8.996,27717.847,235.954,13.17,0.807,0
14,144,93,1703,4,27,0,0,0,393248,39.497,34.3,8.996,27717.847,235.954,13.17,0.807,0
14,145,62,1765,2,29,0,0,0,393248,39.497,34.3,8.996,27717.847,235.954,13.17,0.807,0
14,146,0,1765,0,29,0,0,0,393248,39.497,34.3,8.996,27717.847,235.954,13.17,0.807,0
14,147,33,1798,11,40,0,0,0,393248,39.497,34.3,8.996,27717.847,235.954,13.17,0.807,0
14,148,15,1813,0,40,0,0,0,393248,39.497,34.3,8.996,27717.847,235.954,13.17,0.807,0
14,149,0,1813,0,40,0,0,0,393248,39.497,34.3,8.996,27717.847,235.954,13.17,0.807,0
14,150,110,1923,0,40,0,0,0,393248,39.497,34.3,8.996,27717.847,235.954,13.17,0.807,0
14,151,134,2057,0,40,0,0,0,393248,39.497,34.3,8.996,27717.847,235.954,13.17,0.807,0
14,152,78,2135,3,43,0,0,0,393248,39.497,34.3,8.996,27717.847,235.954,13.17,0.807,0
14,153,32,2167,0,43,0,0,0,393248,39.497,34.3,8.996,27717.847,235.954,13.17,0.807,0
14,154,50,2217,1,44,0,0,0,393248,39.497,34.3,8.996,27717.847,235.954,13.17,0.807,0
14,155,59,2276,2,46,0,0,0,393248,39.497,34.3,8.996,27717.847,235.954,13.17,0.807,0
14,156,61,2337,1,47,0,0,0,393248,39.497,34.3,8.996,27717.847,235.954,13.17,0.807,0
14,157,49,2386,3,50,0,0,0,393248,39.497,34.3,8.996,27717.847,235.954,13.17,0.807,0
14,158,0,2386,0,50,0,0,0,393248,39.497,34.3,8.996,27717.847,235.954,13.17,0.807,0
14,159,90,2476,5,55,0,0,0,393248,39.497,34.3,8.996,27717.847,235.954,13.17,0.807,0
14,160,70,2546,3,58,0,0,0,393248,39.497,34.3,8.996,27717.847,235.954,13.17,0.807,0
14,161,39,2585,1,59,0,0,0,393248,39.497,34.3,8.996,27717.847,235.954,13.17,0.807,0
14,162,72,2657,4,63,0,0,0,393248,39.497,34.3,8.996,27717.847,235.954,13.17,0.807,0
14,163,64,2721,0,63,0,0,0,393248,39.497,34.3,8.996,27717.847,235.954,13.17,0.807,0
14,164,0,2721,0,63,0,0,0,393248,39.497,34.3,8.996,27717.847,235.954,13.17,0.807,0
14,165,93,2814,2,65,0,0,0,393248,39.497,34.3,8.996,27717.847,235.954,13.17,0.807,0
14,166,114,2928,2,67,0,0,0,393248,39.497,34.3,8.996,27717.847,235.954,13.17,0.807,0
14,167,0,2928,0,67,0,0,0,393248,39.497,34.3,8.996,27717.847,235.954,13.17,0.807,0
14,168,80,3008,1,68,0,0,0,393248,39.497,34.3,8.996,27717.847,235.954,13.17,0.807,0
14,169,24,3032,1,69,0,0,0,393248,39.497,34.3,8.996,27717.847,235.954,13.17,0.807,0
14,170,55,3087,0,69,0,0,0,393248,39.497,34.3,8.996,27717.847,235.954,13.17,0.807,0
14,171,90,3177,0,69,0,0,0,393248,39.497,34.3,8.996,27717.847,235.954,13.17,0.807,0
14,172,37,3214,4,73,0,0,0,393248,39.497,34.3,8.996,27717.847,235.954,13.17,0.807,0
14,173,101,3315,1,74,0,0,0,393248,39.497,34.3,8.996,27717.847,235.954,13.17,0.807,0
14,174,55,3370,0,74,0,0,0,393248,39.497,34.3,8.996,27717.847,235.954,13.17,0.807,0
14,175,48,3418,1,75,0,0,0,393248,39.497,34.3,8.996,27717.847,235.954,13.17,0.807,0
14,176,49,3467,2,77,0,0,0,393248,39.497,34.3,8.996,27717.847,235.954,13.17,0.807,0
14,177,151,3618,3,80,0,0,0,393248,39.497,34.3,8.996,27717.847,235.954,13.17,0.807,0
14,178,81,3699,6,86,0,0,0,393248,39.497,34.3,8.996,27717.847,235.954,13.17,0.807,0
14,179,91,3790,1,87,0,0,0,393248,39.497,34.3,8.996,27717.847,235.954,13.17,0.807,0
14,180,0,3790,0,87,0,0,0,393248,39.497,34.3,8.996,27717.847,235.954,13.17,0.807,0
14,181,0,3790,0,87,0,0,0,393248,39.497,34.3,8.996,27717.847,235.954,13.17,0.807,0
14,182,48,3838,2,89,0,0,0,393248,39.497,34.3,8.996,27717.847,235.954,13.17,0.807,0
14,183,65,3903,2,91,0,0,0,393248,39.497,34.3,8.996,27717.847,235.954,13.17,0.807,0
14,184,220,4123,5,96,0,0,0,393248,39.497,34.3,8.996,27717.847,235.954,13.17,0.807,0
14,185,97,4220,0,96,0,0,0,393248,39.497,34.3,8.996,27717.847,235.954,13.17,0.807,0
14,186,0,4220,0,96,0,0,0,393248,39.497,34.3,8.996,27717.847,235.954,13.17,0.807,0
14,187,189,4409,0,96,0,0,0,393248,39.497,34.3,8.996,27717.847,235.954,13.17,0.807,0
14,188,0,4409,0,96,0,0,0,393248,39.497,34.3,8.996,27717.847,235.954,13.17,0.807,0
14,189,150,4559,4,100,0,0,0,393248,39.497,34.3,8.996,27717.847,235.954,13.17,0.807,0
14,190,0,4559,0,100,0,0,0,393248,39.497,34.3,8.996,27717.847,235.954,13.17,0.807,0
14,191,154,4713,2,102,0,0,0,393248,39.497,34.3,8.996,27717.847,235.954,13.17,0.807,0
14,192,0,4713,0,102,0,0,0,393248,39.497,34.3,8.996,27717.847,235.954,13.17,0.807,0
14,193,242,4955,4,106,0,0,0,393248,39.497,34.3,8.996,27717.847,235.954,13.17,0.807,0
14,194,68,5023,0,106,0,0,0,393248,39.497,34.3,8.996,27717.847,235.954,13.17,0.807,0
14,195,55,5078,1,107,0,0,0,393248,39.497,34.3,8.996,27717.847,235.954,13.17,0.807,0
14,196,85,5163,1,108,0,0,0,393248,39.497,34.3,8.996,27717.847,235.954,13.17,0.807,0
14,197,0,5163,0,108,0,0,0,393248,39.497,34.3,8.996,27717.847,235.954,13.17,0.807,0
14,198,222,5385,4,112,0,0,0,393248,39.497,34.3,8.996,27717.847,235.954,13.17,0.807,0
14,199,0,5385,0,112,0,0,0,393248,39.497,34.3,8.996,27717.847,235.954,13.17,0.807,0
14,200,132,5517,2,114,0,0,0,393248,39.497,34.3,8.996,27717.847,235.954,13.17,0.807,0
14,201,111,5628,2,116,0,0,0,393248,39.497,34.3,8.996,27717.847,235.954,13.17,0.807,0
14,202,75,5703,6,122,0,0,0,393248,39.497,34.3,8.996,27717.847,235.954,13.17,0.807,0
14,203,70,5773,1,123,0,0,0,393248,39.497,34.3,8.996,27717.847,235.954,13.17,0.807,0
14,204,150,5923,1,124,0,0,0,393248,39.497,34.3,8.996,27717.847,235.954,13.17,0.807,0
15,1,52,567,0,4,0,0,78.7,1701583,1935.907,32.4,2.372,43290.705,151.689,16.52,0.846,0
15,2,2,569,0,4,0,0,78.7,1701583,1935.907,32.4,2.372,43290.705,151.689,16.52,0.846,0
15,3,74,643,0,4,0,37996,78.7,1701583,1935.907,32.4,2.372,43290.705,151.689,16.52,0.846,0
15,4,0,643,0,4,1260,39256,78.7,1701583,1935.907,32.4,2.372,43290.705,151.689,16.52,0.846,0
15,5,45,688,0,4,5130,44386,78.7,1701583,1935.907,32.4,2.372,43290.705,151.689,16.52,0.846,0
15,6,12,700,0,4,3298,47684,78.7,1701583,1935.907,32.4,2.372,43290.705,151.689,16.52,0.846,0
15,7,56,756,0,4,2443,50127,78.7,1701583,1935.907,32.4,2.372,43290.705,151.689,16.52,0.846,0
15,8,55,811,1,5,2677,52804,78.7,1701583,1935.907,32.4,2.372,43290.705,151.689,16.52,0.846,0
15,9,12,823,0,5,2292,55096,75,1701583,1935.907,32.4,2.372,43290.705,151.689,16.52,0.846,0
15,10,64,887,0,5,2585,57681,75,1701583,1935.907,32.4,2.372,43290.705,151.689,16.52,0.846,0
15,11,111,998,1,6,3025,60706,75,1701583,1935.907,32.4,2.372,43290.705,151.689,16.52,0.846,0
15,12,42,1040,0,6,3267,63973,75,1701583,1935.907,32.4,2.372,43290.705,151.689,16.52,0.846,0
15,13,96,1136,0,6,3354,67327,75,1701583,1935.907,32.4,2.372,43290.705,151.689,16.52,0.846,0
15,14,225,1361,1,7,3486,70813,75,1701583,1935.907,32.4,2.372,43290.705,151.689,16.52,0.846,0
15,15,167,1528,0,7,2459,73272,75,1701583,1935.907,32.4,2.372,43290.705,151.689,16.52,0.846,0
15,16,145,1673,0,7,3672,76944,75,1701583,1935.907,32.4,2.372,43290.705,151.689,16.52,0.846,0
15,17,27,1700,0,7,2668,79612,75,1701583,1935.907,32.4,2.372,43290.705,151.689,16.52,0.846,0
15,18,44,1744,0,7,2956,82568,75,1701583,1935.907,32.4,2.372,43290.705,151.689,16.52,0.846,0
15,19,29,1773,0,7,4164,86732,75,1701583,1935.907,32.4,2.372,43290.705,151.689,16.52,0.846,0
15,20,100,1873,0,7,3575,90307,75,1701583,1935.907,32.4,2.372,43290.705,151.689,16.52,0.846,0
15,21,34,1907,0,7,4073,94380,75,1701583,1935.907,32.4,2.372,43290.705,151.689,16.52,0.846,0
15,22,66,1973,0,7,3416,97796,75,1701583,1935.907,32.4,2.372,43290.705,151.689,16.52,0.846,0
15,23,34,2007,0,7,2235,100031,75,1701583,1935.907,32.4,2.372,43290.705,151.689,16.52,0.846,0
15,24,210,2217,1,8,5334,105365,75,1701583,1935.907,32.4,2.372,43290.705,151.689,16.52,0.846,0
15,25,301,2518,0,8,5042,110407,75,1701583,1935.907,32.4,2.372,43290.705,151.689,16.52,0.846,0
15,26,71,2589,0,8,3703,114110,75,1701583,1935.907,32.4,2.372,43290.705,151.689,16.52,0.846,0
15,27,58,2647,0,8,3687,117797,75,1701583,1935.907,32.4,2.372,43290.705,151.689,16.52,0.846,0
15,28,76,2723,0,8,3909,121706,75,1701583,1935.907,32.4,2.372,43290.705,151.689,16.52,0.846,0
15,29,88,2811,0,8,5199,126905,75,1701583,1935.907,32.4,2.372,43290.705,151.689,16.52,0.846,0
15,30,110,2921,0,8,2789,129694,75,1701583,1935.907,32.4,2.372,43290.705,151.689,16.52,0.846,0
15,31,119,3040,0,8,4388,134082,75,1701583,1935.907,32.4,2.372,43290.705,151.689,16.52,0.846,0
15,32,130,3170,0,8,4196,138278,75,1701583,1935.907,32.4,2.372,43290.705,151.689,16.52,0.846,0
15,33,114,3284,0,8,5877,144155,75,1701583,1935.907,32.4,2.372,43290.705,151.689,16.52,0.846,0
15,34,99,3383,0,8,5431,149586,75,1701583,1935.907,32.4,2.372,43290.705,151.689,16.52,0.846,0
15,35,150,3533,0,8,5915,155501,75,1701583,1935.907,32.4,2.372,43290.705,151.689,16.52,0.846,0
15,36,187,3720,0,8,4840,160341,75,1701583,1935.907,32.4,2.372,43290.705,151.689,16.52,0.846,0
15,37,214,3934,0,8,6037,166378,75,1701583,1935.907,32.4,2.372,43290.705,151.689,16.52,0.846,0
15,38,265,4199,0,8,5780,172158,75,1701583,1935.907,32.4,2.372,43290.705,151.689,16.52,0.846,0
15,39,245,4444,0,8,6195,178353,75,1701583,1935.907,32.4,2.372,43290.705,151.689,16.52,0.846,0
15,40,330,4774,0,8,5676,184029,75,1701583,1935.907,32.4,2.372,43290.705,151.689,16.52,0.846,0
15,41,167,4941,0,8,6751,190780,75,1701583,1935.907,32.4,2.372,43290.705,151.689,16.52,0.846,0
15,42,295,5236,0,8,7118,197898,75,1701583,1935.907,32.4,2.372,43290.705,151.689,16.52,0.846,0
15,43,295,5531,1,9,7672,205570,75,1701583,1935.907,32.4,2.372,43290.705,151.689,16.52,0.846,0
15,44,285,5816,1,10,5557,211127,75,1701583,1935.907,32.4,2.372,43290.705,151.689,16.52,0.846,0
15,45,382,6198,0,10,11415,222542,75,1701583,1935.907,32.4,2.372,43290.705,151.689,16.52,0.846,0
15,46,385,6583,2,12,7646,230188,75,1701583,1935.907,32.4,2.372,43290.705,151.689,16.52,0.846,0
15,47,164,6747,0,12,6640,236828,75,1701583,1935.907,32.4,2.372,43290.705,151.689,16.52,0.846,0
15,48,209,6956,0,12,6203,243031,75,1701583,1935.907,32.4,2.372,43290.705,151.689,16.52,0.846,0
15,49,228,7184,0,12,5174,248205,75,1701583,1935.907,32.4,2.372,43290.705,151.689,16.52,0.846,0
15,50,348,7532,0,12,7428,255633,75,1701583,1935.907,32.4,2.372,43290.705,151.689,16.52,0.846,0
15,51,356,7888,0,12,0,255633,75,1701583,1935.907,32.4,2.372,43290.705,151.689,16.52,0.846,0
15,52,286,8174,0,12,0,269179,75,1701583,1935.907,32.4,2.372,43290.705,151.689,16.52,0.846,0
15,53,240,8414,0,12,7373,276552,75,1701583,1935.907,32.4,2.372,43290.705,151.689,16.52,0.846,0
15,54,388,8802,1,13,4652,281204,75,1701583,1935.907,32.4,2.372,43290.705,151.689,16.52,0.846,0
15,55,336,9138,1,14,2680,283884,75,1701583,1935.907,32.4,2.372,43290.705,151.689,16.52,0.846,0
15,56,33,9171,0,14,2339,286223,75,1701583,1935.907,32.4,2.372,43290.705,151.689,16.52,0.846,0
15,57,195,9366,0,14,4904,291127,75,1701583,1935.907,32.4,2.372,43290.705,151.689,16.52,0.846,0
15,58,267,9633,1,15,6746,297873,75,1701583,1935.907,32.4,2.372,43290.705,151.689,16.52,0.846,0
15,59,419,10052,0,15,6306,304179,75,1701583,1935.907,32.4,2.372,43290.705,151.689,16.52,0.846,0
15,60,397,10449,0,15,5394,309573,75,1701583,1935.907,32.4,2.372,43290.705,151.689,16.52,0.846,0
15,61,344,10793,2,17,7234,316807,75,1701583,1935.907,32.4,2.372,43290.705,151.689,16.52,0.846,0
15,62,605,11398,2,19,6355,323162,75,1701583,1935.907,32.4,2.372,43290.705,151.689,16.52,0.846,0
15,63,406,11804,0,19,7571,330733,75,1701583,1935.907,32.4,2.372,43290.705,151.689,16.52,0.846,0
15,64,507,12311,0,19,7040,337773,75,1701583,1935.907,32.4,2.372,43290.705,151.689,16.52,0.846,0
15,65,504,12815,1,20,7564,345337,75,1701583,1935.907,32.4,2.372,43290.705,151.689,16.52,0.846,0
15,66,481,13296,1,21,8785,354122,75,1701583,1935.907,32.4,2.372,43290.705,151.689,16.52,0.846,0
15,67,539,13835,2,23,7254,361376,75,1701583,1935.907,32.4,2.372,43290.705,151.689,16.52,0.846,0
15,68,548,14383,1,24,5680,367056,75,1701583,1935.907,32.4,2.372,43290.705,151.689,16.52,0.846,0
15,69,380,14763,2,26,7306,374362,75,1701583,1935.907,32.4,2.372,43290.705,151.689,16.52,0.846,0
15,70,654,15417,1,27,3873,378235,75,1701583,1935.907,32.4,2.372,43290.705,151.689,16.52,0.846,0
15,71,783,16200,2,29,7899,386134,75,1701583,1935.907,32.4,2.372,43290.705,151.689,16.52,0.846,0
15,72,467,16667,3,32,7776,393910,75,1701583,1935.907,32.4,2.372,43290.705,151.689,16.52,0.846,0
15,73,0,16667,2,34,9126,403036,75,1701583,1935.907,32.4,2.372,43290.705,151.689,16.52,0.846,0
15,74,1046,17713,2,36,7806,410842,75,1701583,1935.907,32.4,2.372,43290.705,151.689,16.52,0.846,0
15,75,514,18227,3,39,7571,418413,75,1701583,1935.907,32.4,2.372,43290.705,151.689,16.52,0.846,0
15,76,317,18544,4,43,6779,425192,75,1701583,1935.907,32.4,2.372,43290.705,151.689,16.52,0.846,0
15,77,469,19013,3,46,12888,438080,75,1701583,1935.907,32.4,2.372,43290.705,151.689,16.52,0.846,0
15,78,540,19553,1,47,0,438080,75,1701583,1935.907,32.4,2.372,43290.705,151.689,16.52,0.846,0
15,79,408,19961,2,49,0,454368,75,1701583,1935.907,32.4,2.372,43290.705,151.689,16.52,0.846,0
15,80,469,20430,6,55,0,454368,75,1701583,1935.907,32.4,2.372,43290.705,151.689,16.52,0.846,0
15,81,486,20916,2,57,0,470409,75,1701583,1935.907,32.4,2.372,43290.705,151.689,16.52,0.846,0
15,82,415,21331,3,60,0,470409,75,1701583,1935.907,32.4,2.372,43290.705,151.689,16.52,0.846,0
15,83,433,21764,3,63,0,485715,75,1701583,1935.907,32.4,2.372,43290.705,151.689,16.52,0.846,0
15,84,643,22407,2,65,0,485715,75,1701583,1935.907,32.4,2.372,43290.705,151.689,16.52,0.846,0
15,85,655,23062,2,67,0,494028,75,1701583,1935.907,32.4,2.372,43290.705,151.689,16.52,0.846,0
15,86,508,23570,2,69,8735,502763,75,1701583,1935.907,32.4,2.372,43290.705,151.689,16.52,0.846,0
15,87,511,24081,2,71,8695,511458,75,1701583,1935.907,32.4,2.372,43290.705,151.689,16.52,0.846,0
15,88,724,24805,7,78,9643,521101,75,1701583,1935.907,32.4,2.372,43290.705,151.689,16.52,0.846,0
15,89,462,25267,0,78,8141,529242,75,1701583,1935.907,32.4,2.372,43290.705,151.689,16.52,0.846,0
15,90,438,25705,5,83,7274,536516,75,1701583,1935.907,32.4,2.372,43290.705,151.689,16.52,0.846,0
15,91,534,26239,1,84,8609,545125,75,1701583,1935.907,32.4,2.372,43290.705,151.689,16.52,0.846,0
15,92,519,26758,3,87,9114,554239,75,1701583,1935.907,32.4,2.372,43290.705,151.689,16.52,0.846,0
15,93,656,27414,5,92,10126,564365,75,1701583,1935.907,32.4,2.372,43290.705,151.689,16.52,0.846,0
15,94,423,27837,2,94,9740,574105,75,1701583,1935.907,32.4,2.372,43290.705,151.689,16.52,0.846,0
15,95,573,28410,1,95,9965,584070,75,1701583,1935.907,32.4,2.372,43290.705,151.689,16.52,0.846,0
15,96,447,28857,2,97,18081,602151,75,1701583,1935.907,32.4,2.372,43290.705,151.689,16.52,0.846,0
15,97,510,29367,0,97,9945,612096,75,1701583,1935.907,32.4,2.372,43290.705,151.689,16.52,0.846,0
15,98,454,29821,1,98,0,612096,69.44,1701583,1935.907,32.4,2.372,43290.705,151.689,16.52,0.846,0
15,99,500,30321,0,98,0,630753,69.44,1701583,1935.907,32.4,2.372,43290.705,151.689,16.52,0.846,0
15,100,610,30931,2,100,0,630753,69.44,1701583,1935.907,32.4,2.372,43290.705,151.689,16.52,0.846,0
15,101,597,31528,3,103,0,640219,69.44,1701583,1935.907,32.4,2.372,43290.705,151.689,16.52,0.846,0
15,102,511,32039,1,104,8801,649020,69.44,1701583,1935.907,32.4,2.372,43290.705,151.689,16.52,0.846,0
15,103,431,32470,0,104,7639,656659,69.44,1701583,1935.907,32.4,2.372,43290.705,151.689,16.52,0.846,0
15,104,471,32941,5,109,9589,666248,69.44,1701583,1935.907,32.4,2.372,43290.705,151.689,16.52,0.846,0
15,105,535,33476,0,109,9203,675451,69.44,1701583,1935.907,32.4,2.372,43290.705,151.689,16.52,0.846,0
15,106,602,34078,2,111,9867,685318,69.44,1701583,1935.907,32.4,2.372,43290.705,151.689,16.52,0.846,0
15,107,482,34560,6,117,8221,693539,69.44,1701583,1935.907,32.4,2.372,43290.705,151.689,16.52,0.846,0
15,108,524,35084,4,121,9463,703002,69.44,1701583,1935.907,32.4,2.372,43290.705,151.689,16.52,0.846,0
15,109,389,35473,3,124,7684,710686,69.44,1701583,1935.907,32.4,2.372,43290.705,151.689,16.52,0.846,0
15,110,531,36004,0,124,7037,717723,69.44,1701583,1935.907,32.4,2.372,43290.705,151.689,16.52,0.846,0
15,111,418,36422,2,126,8417,726140,69.44,1701583,1935.907,32.4,2.372,43290.705,151.689,16.52,0.846,0
15,112,514,36936,2,128,18554,744694,69.44,1701583,1935.907,32.4,2.372,43290.705,151.689,16.52,0.846,0
15,113,380,37316,1,129,0,744694,69.44,1701583,1935.907,32.4,2.372,43290.705,151.689,16.52,0.846,0
15,114,321,37637,1,130,0,760733,69.44,1701583,1935.907,32.4,2.372,43290.705,151.689,16.52,0.846,0
15,115,359,37996,4,134,0,760733,69.44,1701583,1935.907,32.4,2.372,43290.705,151.689,16.52,0.846,0
15,116,462,38458,2,136,0,780081,69.44,1701583,1935.907,32.4,2.372,43290.705,151.689,16.52,0.846,0
15,117,289,38747,1,137,0,780081,69.44,1701583,1935.907,32.4,2.372,43290.705,151.689,16.52,0.846,0
15,118,384,39131,3,140,0,798799,69.44,1701583,1935.907,32.4,2.372,43290.705,151.689,16.52,0.846,0
15,119,351,39482,1,141,9477,808276,69.44,1701583,1935.907,32.4,2.372,43290.705,151.689,16.52,0.846,0
15,120,439,39921,0,141,9332,817608,69.44,1701583,1935.907,32.4,2.372,43290.705,151.689,16.52,0.846,0
15,121,390,40311,3,144,9064,826672,69.44,1701583,1935.907,32.4,2.372,43290.705,151.689,16.52,0.846,0
15,122,444,40755,2,146,4326,830998,69.44,1701583,1935.907,32.4,2.372,43290.705,151.689,16.52,0.846,0
15,123,227,40982,1,147,4569,835567,69.44,1701583,1935.907,32.4,2.372,43290.705,151.689,16.52,0.846,0
15,124,208,41190,0,147,7425,842992,69.44,1701583,1935.907,32.4,2.372,43290.705,151.689,16.52,0.846,0
15,125,346,41536,0,147,7656,850648,69.44,1701583,1935.907,32.4,2.372,43290.705,151.689,16.52,0.846,0
15,126,299,41835,3,150,7601,858249,69.44,1701583,1935.907,32.4,2.372,43290.705,151.689,16.52,0.846,0
15,127,297,42132,1,151,0,858249,69.44,1701583,1935.907,32.4,2.372,43290.705,151.689,16.52,0.846,0
15,128,382,42514,3,154,0,867534,69.44,1701583,1935.907,32.4,2.372,43290.705,151.689,16.52,0.846,0
15,129,375,42889,2,156,9166,876700,69.44,1701583,1935.907,32.4,2.372,43290.705,151.689,16.52,0.846,0
15,130,418,43307,3,159,9395,886095,69.44,1701583,1935.907,32.4,2.372,43290.705,151.689,16.52,0.846,0
15,131,322,43629,2,161,6831,892926,69.44,1701583,1935.907,32.4,2.372,43290.705,151.689,16.52,0.846,0
15,132,382,44011,1,162,9133,902059,69.44,1701583,1935.907,32.4,2.372,43290.705,151.689,16.52,0.846,0
15,133,386,44397,1,163,10052,912111,69.44,1701583,1935.907,32.4,2.372,43290.705,151.689,16.52,0.846,0
15,134,407,44804,2,165,21651,933762,69.44,1701583,1935.907,32.4,2.372,43290.705,151.689,16.52,0.846,0
15,135,460,45264,1,166,0,933762,69.44,1701583,1935.907,32.4,2.372,43290.705,151.689,16.52,0.846,0
15,136,462,45726,1,167,0,944798,69.44,1701583,1935.907,32.4,2.372,43290.705,151.689,16.52,0.846,0
15,137,326,46052,1,168,9394,954192,69.44,1701583,1935.907,32.4,2.372,43290.705,151.689,16.52,0.846,0
15,138,378,46430,2,170,8142,962334,69.44,1701583,1935.907,32.4,2.372,43290.705,151.689,16.52,0.846,0
15,139,0,46430,0,170,9669,972003,69.44,1701583,1935.907,32.4,2.372,43290.705,151.689,16.52,0.846,0
15,140,755,47185,3,173,9205,981208,69.44,1701583,1935.907,32.4,2.372,43290.705,151.689,16.52,0.846,0
15,141,0,47185,2,175,19579,1000787,69.44,1701583,1935.907,32.4,2.372,43290.705,151.689,16.52,0.846,0
15,142,0,47185,0,175,0,1000787,69.44,1701583,1935.907,32.4,2.372,43290.705,151.689,16.52,0.846,0
15,143,765,47950,4,179,0,1011805,69.44,1701583,1935.907,32.4,2.372,43290.705,151.689,16.52,0.846,0
15,144,353,48303,0,179,8998,1020803,69.44,1701583,1935.907,32.4,2.372,43290.705,151.689,16.52,0.846,0
15,145,735,49038,4,183,9166,1029969,60.19,1701583,1935.907,32.4,2.372,43290.705,151.689,16.52,0.846,0
15,146,0,49038,1,184,9602,1039571,60.19,1701583,1935.907,32.4,2.372,43290.705,151.689,16.52,0.846,0
15,147,292,49330,0,184,9364,1048935,60.19,1701583,1935.907,32.4,2.372,43290.705,151.689,16.52,0.846,0
15,148,746,50076,2,186,18972,1067907,60.19,1701583,1935.907,32.4,2.372,43290.705,151.689,16.52,0.846,0
15,149,317,50393,0,186,0,1067907,60.19,1701583,1935.907,32.4,2.372,43290.705,151.689,16.52,0.846,0
15,150,363,50756,2,188,0,1078767,60.19,1701583,1935.907,32.4,2.372,43290.705,151.689,16.52,0.846,0
15,151,357,51113,1,189,9651,1088418,60.19,1701583,1935.907,32.4,2.372,43290.705,151.689,16.52,0.846,0
15,152,278,51391,0,189,12311,1100729,60.19,1701583,1935.907,32.4,2.372,43290.705,151.689,16.52,0.846,0
15,153,183,51574,0,189,0,1100729,60.19,1701583,1935.907,32.4,2.372,43290.705,151.689,16.52,0.846,0
15,154,0,51574,1,190,0,1108088,60.19,1701583,1935.907,32.4,2.372,43290.705,151.689,16.52,0.846,0
15,155,398,51972,0,190,10749,1118837,60.19,1701583,1935.907,32.4,2.372,43290.705,151.689,16.52,0.846,0
15,156,468,52440,0,190,9992,1128829,60.19,1701583,1935.907,32.4,2.372,43290.705,151.689,16.52,0.846,0
15,157,367,52807,0,190,11734,1140563,60.19,1701583,1935.907,32.4,2.372,43290.705,151.689,16.52,0.846,0
15,158,626,53433,4,194,11711,1152274,60.19,1701583,1935.907,32.4,2.372,43290.705,151.689,16.52,0.846,0
15,159,662,54095,2,196,20534,1172808,60.19,1701583,1935.907,32.4,2.372,43290.705,151.689,16.52,0.846,0
15,160,676,54771,2,198,0,1172808,60.19,1701583,1935.907,32.4,2.372,43290.705,151.689,16.52,0.846,0
15,161,1305,56076,2,200,0,1194923,60.19,1701583,1935.907,32.4,2.372,43290.705,151.689,16.52,0.846,0
15,162,0,56076,2,202,12337,1207260,60.19,1701583,1935.907,32.4,2.372,43290.705,151.689,16.52,0.846,0
15,163,702,56778,1,203,0,1207260,60.19,1701583,1935.907,32.4,2.372,43290.705,151.689,16.52,0.846,0
15,164,672,57450,1,204,0,1230227,60.19,1701583,1935.907,32.4,2.372,43290.705,151.689,16.52,0.846,0
15,165,757,58207,4,208,9977,1240204,60.19,1701583,1935.907,32.4,2.372,43290.705,151.689,16.52,0.846,0
15,166,632,58839,2,210,0,1240204,60.19,1701583,1935.907,32.4,2.372,43290.705,151.689,16.52,0.846,0
15,167,747,59586,2,212,0,1252898,60.19,1701583,1935.907,32.4,2.372,43290.705,151.689,16.52,0.846,0
15,168,721,60307,1,213,23177,1276075,60.19,1701583,1935.907,32.4,2.372,43290.705,151.689,16.52,0.846,0
15,169,658,60965,0,213,12299,1288374,56.48,1701583,1935.907,32.4,2.372,43290.705,151.689,16.52,0.846,0
15,170,678,61643,2,215,0,1288374,63.89,1701583,1935.907,32.4,2.372,43290.705,151.689,16.52,0.846,0
15,171,841,62484,1,216,0,1301170,63.89,1701583,1935.907,32.4,2.372,43290.705,151.689,16.52,0.846,0
15,172,705,63189,3,219,22832,1324002,63.89,1701583,1935.907,32.4,2.372,43290.705,151.689,16.52,0.846,0
15,173,690,63879,1,220,0,1324002,63.89,1701583,1935.907,32.4,2.372,43290.705,151.689,16.52,0.846,0
15,174,620,64499,1,221,0,1333275,63.89,1701583,1935.907,32.4,2.372,43290.705,151.689,16.52,0.846,0
15,175,540,65039,0,221,11438,1344713,63.89,1701583,1935.907,32.4,2.372,43290.705,151.689,16.52,0.846,0
15,176,713,65752,5,226,10686,1355399,63.89,1701583,1935.907,32.4,2.372,43290.705,151.689,16.52,0.846,0
15,177,650,66402,5,231,22705,1378104,63.89,1701583,1935.907,32.4,2.372,43290.705,151.689,16.52,0.846,0
15,178,612,67014,0,231,0,1378104,63.89,1701583,1935.907,32.4,2.372,43290.705,151.689,16.52,0.846,0
15,179,687,67701,4,235,0,1388323,63.89,1701583,1935.907,32.4,2.372,43290.705,151.689,16.52,0.846,0
15,180,489,68190,1,236,10131,1398454,63.89,1701583,1935.907,32.4,2.372,43290.705,151.689,16.52,0.846,0
15,181,585,68775,6,242,9118,1407572,63.89,1701583,1935.907,32.4,2.372,43290.705,151.689,16.52,0.846,0
15,182,1073,69848,3,245,10557,1418129,63.89,1701583,1935.907,32.4,2.372,43290.705,151.689,16.52,0.846,0
15,183,574,70422,1,246,11303,1429432,63.89,1701583,1935.907,32.4,2.372,43290.705,151.689,16.52,0.846,0
15,184,442,70864,6,252,9900,1439332,63.89,1701583,1935.907,32.4,2.372,43290.705,151.689,16.52,0.846,0
15,185,510,71374,2,254,10821,1450153,63.89,1701583,1935.907,32.4,2.372,43290.705,151.689,16.52,0.846,0
15,186,429,71803,1,255,8767,1458920,63.89,1701583,1935.907,32.4,2.372,43290.705,151.689,16.52,0.846,0
15,187,507,72310,3,258,9735,1468655,63.89,1701583,1935.907,32.4,2.372,43290.705,151.689,16.52,0.846,0
15,188,352,72662,2,260,9508,1478163,63.89,1701583,1935.907,32.4,2.372,43290.705,151.689,16.52,0.846,0
15,189,454,73116,1,261,10540,1488703,63.89,1701583,1935.907,32.4,2.372,43290.705,151.689,16.52,0.846,0
15,190,360,73476,1,262,20368,1509071,63.89,1701583,1935.907,32.4,2.372,43290.705,151.689,16.52,0.846,0
15,191,456,73932,0,262,0,1509071,63.89,1701583,1935.907,32.4,2.372,43290.705,151.689,16.52,0.846,0
15,192,490,74422,2,264,0,1519596,63.89,1701583,1935.907,32.4,2.372,43290.705,151.689,16.52,0.846,0
15,193,438,74860,7,271,10537,1530133,63.89,1701583,1935.907,32.4,2.372,43290.705,151.689,16.52,0.846,0
15,194,427,75287,2,273,8792,1538925,63.89,1701583,1935.907,32.4,2.372,43290.705,151.689,16.52,0.846,0
15,195,0,75287,0,273,9086,1548011,63.89,1701583,1935.907,32.4,2.372,43290.705,151.689,16.52,0.846,0
15,196,661,75948,7,280,9627,1557638,63.89,1701583,1935.907,32.4,2.372,43290.705,151.689,16.52,0.846,0
15,197,324,76272,6,286,10399,1568037,63.89,1701583,1935.907,32.4,2.372,43290.705,151.689,16.52,0.846,0
15,198,349,76621,1,287,9463,1577500,63.89,1701583,1935.907,32.4,2.372,43290.705,151.689,16.52,0.846,0
15,199,333,76954,2,289,10922,1588422,63.89,1701583,1935.907,32.4,2.372,43290.705,151.689,16.52,0.846,0
15,200,371,77325,3,292,11127,1599549,63.89,1701583,1935.907,32.4,2.372,43290.705,151.689,16.52,0.846,0
15,201,246,77571,3,295,8143,1607692,63.89,1701583,1935.907,32.4,2.372,43290.705,151.689,16.52,0.846,0
15,202,331,77902,5,300,9940,1617632,63.89,1701583,1935.907,32.4,2.372,43290.705,151.689,16.52,0.846,0
15,203,322,78224,2,302,10444,1628076,63.89,1701583,1935.907,32.4,2.372,43290.705,151.689,16.52,0.846,0
15,204,309,78533,3,305,0,1628076,63.89,1701583,1935.907,32.4,2.372,43290.705,151.689,16.52,0.846,0
16,1,2,51,0,5,147,1906,87.04,164689383,1265.036,27.5,5.098,3523.984,298.003,8.38,0.608,3
16,2,3,54,1,6,207,2113,87.04,164689383,1265.036,27.5,5.098,3523.984,298.003,8.38,0.608,3
16,3,2,56,0,6,434,2547,87.04,164689383,1265.036,27.5,5.098,3523.984,298.003,8.38,0.608,3
16,4,5,61,0,6,367,2914,87.04,164689383,1265.036,27.5,5.098,3523.984,298.003,8.38,0.608,3
16,5,9,70,2,8,696,3610,87.04,164689383,1265.036,27.5,5.098,3523.984,298.003,8.38,0.608,3
16,6,18,88,1,9,792,4402,87.04,164689383,1265.036,27.5,5.098,3523.984,298.003,8.38,0.608,3
16,7,35,123,3,12,981,5383,87.04,164689383,1265.036,27.5,5.098,3523.984,298.003,8.38,0.608,3
16,8,41,164,5,17,1097,6480,87.04,164689383,1265.036,27.5,5.098,3523.984,298.003,8.38,0.608,3
16,9,54,218,3,20,1184,7664,87.04,164689383,1265.036,27.5,5.098,3523.984,298.003,8.38,0.608,3
16,10,112,330,1,21,649,8313,90.74,164689383,1265.036,27.5,5.098,3523.984,298.003,8.38,0.608,3
16,11,94,424,6,27,1340,9653,93.52,164689383,1265.036,27.5,5.098,3523.984,298.003,8.38,0.608,3
16,12,58,482,3,30,1570,11223,93.52,164689383,1265.036,27.5,5.098,3523.984,298.003,8.38,0.608,3
16,13,139,621,4,34,1905,13128,93.52,164689383,1265.036,27.5,5.098,3523.984,298.003,8.38,0.608,3
16,14,182,803,5,39,1740,14868,93.52,164689383,1265.036,27.5,5.098,3523.984,298.003,8.38,0.608,3
16,15,209,1012,7,46,2135,17003,93.52,164689383,1265.036,27.5,5.098,3523.984,298.003,8.38,0.608,3
16,16,219,1231,4,50,2190,19193,93.52,164689383,1265.036,27.5,5.098,3523.984,298.003,8.38,0.608,3
16,17,341,1572,10,60,2114,21307,93.52,164689383,1265.036,27.5,5.098,3523.984,298.003,8.38,0.608,3
16,18,266,1838,15,75,2634,23941,93.52,164689383,1265.036,27.5,5.098,3523.984,298.003,8.38,0.608,3
16,19,306,2144,9,84,2663,26604,93.52,164689383,1265.036,27.5,5.098,3523.984,298.003,8.38,0.608,3
16,20,312,2456,7,91,2974,29578,93.52,164689383,1265.036,27.5,5.098,3523.984,298.003,8.38,0.608,3
16,21,492,2948,10,101,3096,32674,93.52,164689383,1265.036,27.5,5.098,3523.984,298.003,8.38,0.608,3
16,22,434,3382,9,110,3416,36090,93.52,164689383,1265.036,27.5,5.098,3523.984,298.003,8.38,0.608,3
16,23,390,3772,10,120,3686,39776,93.52,164689383,1265.036,27.5,5.098,3523.984,298.003,8.38,0.608,3
16,24,414,4186,7,127,3337,43113,93.52,164689383,1265.036,27.5,5.098,3523.984,298.003,8.38,0.608,3
16,25,503,4689,4,131,3476,46589,93.52,164689383,1265.036,27.5,5.098,3523.984,298.003,8.38,0.608,3
16,26,309,4998,9,140,3812,50401,93.52,164689383,1265.036,27.5,5.098,3523.984,298.003,8.38,0.608,3
16,27,418,5416,5,145,4332,54733,93.52,164689383,1265.036,27.5,5.098,3523.984,298.003,8.38,0.608,3
16,28,497,5913,7,152,4968,59701,93.52,164689383,1265.036,27.5,5.098,3523.984,298.003,8.38,0.608,3
16,29,549,6462,3,155,4965,64666,93.52,164689383,1265.036,27.5,5.098,3523.984,298.003,8.38,0.608,3
16,30,641,7103,8,163,5573,70239,93.52,164689383,1265.036,27.5,5.098,3523.984,298.003,8.38,0.608,3
16,31,564,7667,5,168,5827,76066,89.81,164689383,1265.036,27.5,5.098,3523.984,298.003,8.38,0.608,3
16,32,571,8238,2,170,5368,81434,89.81,164689383,1265.036,27.5,5.098,3523.984,298.003,8.38,0.608,3
16,33,552,8790,5,175,6260,87694,89.81,164689383,1265.036,27.5,5.098,3523.984,298.003,8.38,0.608,3
16,34,665,9455,2,177,5711,93405,89.81,164689383,1265.036,27.5,5.098,3523.984,298.003,8.38,0.608,3
16,35,688,10143,5,182,0,93405,89.81,164689383,1265.036,27.5,5.098,3523.984,298.003,8.38,0.608,3
16,36,786,10929,1,183,6241,99646,89.81,164689383,1265.036,27.5,5.098,3523.984,298.003,8.38,0.608,3
16,37,790,11719,3,186,5867,105513,89.81,164689383,1265.036,27.5,5.098,3523.984,298.003,8.38,0.608,3
16,38,706,12425,13,199,5941,111454,89.81,164689383,1265.036,27.5,5.098,3523.984,298.003,8.38,0.608,3
16,39,709,13134,7,206,5465,116919,89.81,164689383,1265.036,27.5,5.098,3523.984,298.003,8.38,0.608,3
16,40,636,13770,8,214,5738,122657,89.81,164689383,1265.036,27.5,5.098,3523.984,298.003,8.38,0.608,3
16,41,887,14657,14,228,7208,129865,89.81,164689383,1265.036,27.5,5.098,3523.984,298.003,8.38,0.608,3
16,42,1034,15691,11,239,6773,136638,89.81,164689383,1265.036,27.5,5.098,3523.984,298.003,8.38,0.608,3
16,43,969,16660,11,250,7900,144538,89.81,164689383,1265.036,27.5,5.098,3523.984,298.003,8.38,0.608,3
16,44,1162,17822,19,269,7392,151930,89.81,164689383,1265.036,27.5,5.098,3523.984,298.003,8.38,0.608,3
16,45,1041,18863,14,283,8582,160512,89.81,164689383,1265.036,27.5,5.098,3523.984,298.003,8.38,0.608,3
16,46,1202,20065,15,298,6782,167294,89.81,164689383,1265.036,27.5,5.098,3523.984,298.003,8.38,0.608,3
16,47,930,20995,16,314,8114,175408,93.52,164689383,1265.036,27.5,5.098,3523.984,298.003,8.38,0.608,3
16,48,1273,22268,14,328,9788,185196,93.52,164689383,1265.036,27.5,5.098,3523.984,298.003,8.38,0.608,3
16,49,1602,23870,21,349,8449,193645,93.52,164689383,1265.036,27.5,5.098,3523.984,298.003,8.38,0.608,3
16,50,1251,25121,21,370,10260,203905,93.52,164689383,1265.036,27.5,5.098,3523.984,298.003,8.38,0.608,3
16,51,1617,26738,16,386,10262,214167,93.52,164689383,1265.036,27.5,5.098,3523.984,298.003,8.38,0.608,3
16,52,1773,28511,22,408,9727,223894,93.52,164689383,1265.036,27.5,5.098,3523.984,298.003,8.38,0.608,3
16,53,1694,30205,24,432,10834,234728,93.52,164689383,1265.036,27.5,5.098,3523.984,298.003,8.38,0.608,3
16,54,1873,32078,20,452,8908,243636,93.52,164689383,1265.036,27.5,5.098,3523.984,298.003,8.38,0.608,3
16,55,1532,33610,28,480,9451,253087,93.52,164689383,1265.036,27.5,5.098,3523.984,298.003,8.38,0.608,3
16,56,1975,35585,21,501,5407,258494,93.52,164689383,1265.036,27.5,5.098,3523.984,298.003,8.38,0.608,3
16,57,1166,36751,21,522,8015,266509,93.52,164689383,1265.036,27.5,5.098,3523.984,298.003,8.38,0.608,3
16,58,1541,38292,22,544,9310,275819,93.52,164689383,1265.036,27.5,5.098,3523.984,298.003,8.38,0.608,3
16,59,2029,40321,15,559,11301,287120,93.52,164689383,1265.036,27.5,5.098,3523.984,298.003,8.38,0.608,3
16,60,2523,42844,23,582,9997,297117,93.52,164689383,1265.036,27.5,5.098,3523.984,298.003,8.38,0.608,3
16,61,1764,44608,28,610,11876,308993,62.96,164689383,1265.036,27.5,5.098,3523.984,298.003,8.38,0.608,3
16,62,2545,47153,40,650,11339,320332,62.96,164689383,1265.036,27.5,5.098,3523.984,298.003,8.38,0.608,3
16,63,2381,49534,22,672,12704,333036,62.96,164689383,1265.036,27.5,5.098,3523.984,298.003,8.38,0.608,3
16,64,2911,52445,37,709,12510,345546,62.96,164689383,1265.036,27.5,5.098,3523.984,298.003,8.38,0.608,3
16,65,2695,55140,37,746,12694,358240,62.96,164689383,1265.036,27.5,5.098,3523.984,298.003,8.38,0.608,3
16,66,2423,57563,35,781,14088,372328,62.96,164689383,1265.036,27.5,5.098,3523.984,298.003,8.38,0.608,3
16,67,2828,60391,30,811,12486,384814,62.96,164689383,1265.036,27.5,5.098,3523.984,298.003,8.38,0.608,3
16,68,2635,63026,35,846,13136,397950,62.96,164689383,1265.036,27.5,5.098,3523.984,298.003,8.38,0.608,3
16,69,2743,65769,42,888,12944,410894,62.96,164689383,1265.036,27.5,5.098,3523.984,298.003,8.38,0.608,3
16,70,2735,68504,42,930,14664,425558,62.96,164689383,1265.036,27.5,5.098,3523.984,298.003,8.38,0.608,3
16,71,3171,71675,45,975,15965,441523,62.96,164689383,1265.036,27.5,5.098,3523.984,298.003,8.38,0.608,3
16,72,3190,74865,37,1012,15772,457295,62.96,164689383,1265.036,27.5,5.098,3523.984,298.003,8.38,0.608,3
16,73,3187,78052,37,1049,15990,473285,62.96,164689383,1265.036,27.5,5.098,3523.984,298.003,8.38,0.608,3
16,74,3471,81523,46,1095,16638,489923,62.96,164689383,1265.036,27.5,5.098,3523.984,298.003,8.38,0.608,3
16,75,2856,84379,44,1139,14505,504428,62.96,164689383,1265.036,27.5,5.098,3523.984,298.003,8.38,0.608,3
16,76,3141,87520,32,1171,15038,519466,62.96,164689383,1265.036,27.5,5.098,3523.984,298.003,8.38,0.608,3
16,77,3099,90619,38,1209,17214,536680,74.54,164689383,1265.036,27.5,5.098,3523.984,298.003,8.38,0.608,3
16,78,3862,94481,53,1262,17527,554207,74.54,164689383,1265.036,27.5,5.098,3523.984,298.003,8.38,0.608,3
16,79,4008,98489,43,1305,16259,570466,74.54,164689383,1265.036,27.5,5.098,3523.984,298.003,8.38,0.608,3
16,80,3803,102292,38,1343,15045,585511,74.54,164689383,1265.036,27.5,5.098,3523.984,298.003,8.38,0.608,3
16,81,3243,105535,45,1388,14031,599542,74.54,164689383,1265.036,27.5,5.098,3523.984,298.003,8.38,0.608,3
16,82,3240,108775,37,1425,15585,615127,74.54,164689383,1265.036,27.5,5.098,3523.984,298.003,8.38,0.608,3
16,83,3531,112306,39,1464,15555,630682,74.54,164689383,1265.036,27.5,5.098,3523.984,298.003,8.38,0.608,3
16,84,3480,115786,38,1502,16292,646974,74.54,164689383,1265.036,27.5,5.098,3523.984,298.003,8.38,0.608,3
16,85,3412,119198,43,1545,16433,663407,74.54,164689383,1265.036,27.5,5.098,3523.984,298.003,8.38,0.608,3
16,86,3462,122660,37,1582,17999,681406,74.54,164689383,1265.036,27.5,5.098,3523.984,298.003,8.38,0.608,3
16,87,3946,126606,39,1621,18498,699904,74.54,164689383,1265.036,27.5,5.098,3523.984,298.003,8.38,0.608,3
16,88,3868,130474,40,1661,15157,715061,74.54,164689383,1265.036,27.5,5.098,3523.984,298.003,8.38,0.608,3
16,89,3504,133978,34,1695,18099,733160,74.54,164689383,1265.036,27.5,5.098,3523.984,298.003,8.38,0.608,3
16,90,3809,137787,43,1738,17837,750997,74.54,164689383,1265.036,27.5,5.098,3523.984,298.003,8.38,0.608,3
16,91,4014,141801,45,1783,18426,769423,74.54,164689383,1265.036,27.5,5.098,3523.984,298.003,8.38,0.608,3
16,92,3682,145483,64,1847,17875,787298,74.54,164689383,1265.036,27.5,5.098,3523.984,298.003,8.38,0.608,3
16,93,3775,149258,41,1888,18362,805660,74.54,164689383,1265.036,27.5,5.098,3523.984,298.003,8.38,0.608,3
16,94,4019,153277,38,1926,14650,820310,74.54,164689383,1265.036,27.5,5.098,3523.984,298.003,8.38,0.608,3
16,95,3114,156391,42,1968,14727,835037,74.54,164689383,1265.036,27.5,5.098,3523.984,298.003,8.38,0.608,3
16,96,3288,159679,29,1997,13988,849025,74.54,164689383,1265.036,27.5,5.098,3523.984,298.003,8.38,0.608,3
16,97,2738,162417,55,2052,14245,863270,74.54,164689383,1265.036,27.5,5.098,3523.984,298.003,8.38,0.608,3
16,98,3201,165618,44,2096,13173,876443,74.54,164689383,1265.036,27.5,5.098,3523.984,298.003,8.38,0.608,3
16,99,3027,168645,55,2151,15672,892115,74.54,164689383,1265.036,27.5,5.098,3523.984,298.003,8.38,0.608,3
16,100,3489,172134,46,2197,15632,907747,74.54,164689383,1265.036,27.5,5.098,3523.984,298.003,8.38,0.608,3
16,101,3360,175494,41,2238,13488,921235,74.54,164689383,1265.036,27.5,5.098,3523.984,298.003,8.38,0.608,3
16,102,2949,178443,37,2275,11193,932428,74.54,164689383,1265.036,27.5,5.098,3523.984,298.003,8.38,0.608,3
16,103,2686,181129,30,2305,11059,943487,74.54,164689383,1265.036,27.5,5.098,3523.984,298.003,8.38,0.608,3
16,104,2666,183795,47,2352,12423,955910,74.54,164689383,1265.036,27.5,5.098,3523.984,298.003,8.38,0.608,3
16,105,3099,186894,39,2391,13453,969363,74.54,164689383,1265.036,27.5,5.098,3523.984,298.003,8.38,0.608,3
16,106,3163,190057,33,2424,14002,983365,74.54,164689383,1265.036,27.5,5.098,3523.984,298.003,8.38,0.608,3
16,107,3533,193590,33,2457,12889,996254,80.09,164689383,1265.036,27.5,5.098,3523.984,298.003,8.38,0.608,3
16,108,2733,196323,39,2496,13460,1009714,80.09,164689383,1265.036,27.5,5.098,3523.984,298.003,8.38,0.608,3
16,109,3034,199357,51,2547,10923,1020637,80.09,164689383,1265.036,27.5,5.098,3523.984,298.003,8.38,0.608,3
16,110,2709,202066,34,2581,10625,1031262,80.09,164689383,1265.036,27.5,5.098,3523.984,298.003,8.38,0.608,3
16,111,2459,204525,37,2618,13362,1044624,80.09,164689383,1265.036,27.5,5.098,3523.984,298.003,8.38,0.608,3
16,112,2928,207453,50,2668,12898,1057522,80.09,164689383,1265.036,27.5,5.098,3523.984,298.003,8.38,0.608,3
16,113,3057,210510,41,2709,12050,1069572,80.09,164689383,1265.036,27.5,5.098,3523.984,298.003,8.38,0.608,3
16,114,2744,213254,42,2751,12398,1081970,80.09,164689383,1265.036,27.5,5.098,3523.984,298.003,8.38,0.608,3
16,115,2856,216110,50,2801,12027,1093997,80.09,164689383,1265.036,27.5,5.098,3523.984,298.003,8.38,0.608,3
16,116,2548,218658,35,2836,10446,1104443,80.09,164689383,1265.036,27.5,5.098,3523.984,298.003,8.38,0.608,3
16,117,2520,221178,38,2874,10078,1114521,80.09,164689383,1265.036,27.5,5.098,3523.984,298.003,8.38,0.608,3
16,118,2275,223453,54,2928,12859,1127380,80.09,164689383,1265.036,27.5,5.098,3523.984,298.003,8.38,0.608,3
16,119,2772,226225,37,2965,12714,1140094,80.09,164689383,1265.036,27.5,5.098,3523.984,298.003,8.38,0.608,3
16,120,2960,229185,35,3000,14127,1154221,80.09,164689383,1265.036,27.5,5.098,3523.984,298.003,8.38,0.608,3
16,121,3009,232194,35,3035,12937,1167158,80.09,164689383,1265.036,27.5,5.098,3523.984,298.003,8.38,0.608,3
16,122,2695,234889,48,3083,12614,1179772,80.09,164689383,1265.036,27.5,5.098,3523.984,298.003,8.38,0.608,3
16,123,2772,237661,28,3111,8802,1188574,80.09,164689383,1265.036,27.5,5.098,3523.984,298.003,8.38,0.608,3
16,124,2199,239860,21,3132,3684,1192258,80.09,164689383,1265.036,27.5,5.098,3523.984,298.003,8.38,0.608,3
16,125,886,240746,22,3154,4249,1196507,80.09,164689383,1265.036,27.5,5.098,3523.984,298.003,8.38,0.608,3
16,126,1356,242102,30,3184,7712,1204219,80.09,164689383,1265.036,27.5,5.098,3523.984,298.003,8.38,0.608,3
16,127,1918,244020,50,3234,11160,1215379,80.09,164689383,1265.036,27.5,5.098,3523.984,298.003,8.38,0.608,3
16,128,2654,246674,33,3267,12708,1228087,80.09,164689383,1265.036,27.5,5.098,3523.984,298.003,8.38,0.608,3
16,129,2977,249651,39,3306,12699,1240786,80.09,164689383,1265.036,27.5,5.098,3523.984,298.003,8.38,0.608,3
16,130,2851,252502,27,3333,11737,1252523,80.09,164689383,1265.036,27.5,5.098,3523.984,298.003,8.38,0.608,3
16,131,2611,255113,32,3365,10759,1263282,80.09,164689383,1265.036,27.5,5.098,3523.984,298.003,8.38,0.608,3
16,132,2487,257600,34,3399,12849,1276131,80.09,164689383,1265.036,27.5,5.098,3523.984,298.003,8.38,0.608,3
16,133,2907,260507,39,3438,14820,1290951,80.09,164689383,1265.036,27.5,5.098,3523.984,298.003,8.38,0.608,3
16,134,2996,263503,33,3471,14751,1305702,80.09,164689383,1265.036,27.5,5.098,3523.984,298.003,8.38,0.608,3
16,135,2995,266498,42,3513,13162,1318864,80.09,164689383,1265.036,27.5,5.098,3523.984,298.003,8.38,0.608,3
16,136,2617,269115,44,3557,12856,1331720,80.09,164689383,1265.036,27.5,5.098,3523.984,298.003,8.38,0.608,3
16,137,2766,271881,34,3591,12891,1344611,80.09,164689383,1265.036,27.5,5.098,3523.984,298.003,8.38,0.608,3
16,138,2644,274525,34,3625,10018,1354629,80.09,164689383,1265.036,27.5,5.098,3523.984,298.003,8.38,0.608,3
16,139,2024,276549,32,3657,12523,1367152,80.09,164689383,1265.036,27.5,5.098,3523.984,298.003,8.38,0.608,3
16,140,2595,279144,37,3694,14630,1381782,80.09,164689383,1265.036,27.5,5.098,3523.984,298.003,8.38,0.608,3
16,141,3200,282344,46,3740,14678,1396460,80.09,164689383,1265.036,27.5,5.098,3523.984,298.003,8.38,0.608,3
16,142,2747,285091,41,3781,14059,1410519,80.09,164689383,1265.036,27.5,5.098,3523.984,298.003,8.38,0.608,3
16,143,2868,287959,41,3822,12943,1423462,80.09,164689383,1265.036,27.5,5.098,3523.984,298.003,8.38,0.608,3
16,144,2401,290360,39,3861,11356,1434818,80.09,164689383,1265.036,27.5,5.098,3523.984,298.003,8.38,0.608,3
16,145,2265,292625,46,3907,10801,1445619,80.09,164689383,1265.036,27.5,5.098,3523.984,298.003,8.38,0.608,3
16,146,1973,294598,34,3941,13382,1459001,80.09,164689383,1265.036,27.5,5.098,3523.984,298.003,8.38,0.608,3
16,147,2485,297083,42,3983,14153,1473154,80.09,164689383,1265.036,27.5,5.098,3523.984,298.003,8.38,0.608,3
16,148,2545,299628,45,4028,15070,1488224,80.09,164689383,1265.036,27.5,5.098,3523.984,298.003,8.38,0.608,3
16,149,2519,302147,54,4082,15124,1503348,80.09,164689383,1265.036,27.5,5.098,3523.984,298.003,8.38,0.608,3
16,150,2436,304583,45,4127,13741,1517089,80.09,164689383,1265.036,27.5,5.098,3523.984,298.003,8.38,0.608,3
16,151,2211,306794,47,4174,11689,1528778,80.09,164689383,1265.036,27.5,5.098,3523.984,298.003,8.38,0.608,3
16,152,2131,308925,32,4206,11934,1540712,80.09,164689383,1265.036,27.5,5.098,3523.984,298.003,8.38,0.608,3
16,153,1897,310822,42,4248,12454,1553166,80.09,164689383,1265.036,27.5,5.098,3523.984,298.003,8.38,0.608,3
16,154,2174,312996,33,4281,12209,1565375,80.09,164689383,1265.036,27.5,5.098,3523.984,298.003,8.38,0.608,3
16,155,1950,314946,35,4316,15204,1580579,80.09,164689383,1265.036,27.5,5.098,3523.984,298.003,8.38,0.608,3
16,156,2582,317528,35,4351,14422,1595001,80.09,164689383,1265.036,27.5,5.098,3523.984,298.003,8.38,0.608,3
16,157,2158,319686,32,4383,13073,1608074,80.09,164689383,1265.036,27.5,5.098,3523.984,298.003,8.38,0.608,3
16,158,1929,321615,29,4412,12847,1620921,80.09,164689383,1265.036,27.5,5.098,3523.984,298.003,8.38,0.608,3
16,159,1950,323565,35,4447,11354,1632275,80.09,164689383,1265.036,27.5,5.098,3523.984,298.003,8.38,0.608,3
16,160,1592,325157,2,4449,15412,1647687,80.09,164689383,1265.036,27.5,5.098,3523.984,298.003,8.38,0.608,3
16,161,2202,327359,67,4516,14973,1662660,80.09,164689383,1265.036,27.5,5.098,3523.984,298.003,8.38,0.608,3
16,162,1892,329251,36,4552,14755,1677415,80.09,164689383,1265.036,27.5,5.098,3523.984,298.003,8.38,0.608,3
16,163,1827,331078,41,4593,15559,1692974,80.09,164689383,1265.036,27.5,5.098,3523.984,298.003,8.38,0.608,3
16,164,1892,332970,41,4634,14747,1707721,80.09,164689383,1265.036,27.5,5.098,3523.984,298.003,8.38,0.608,3
16,165,1792,334762,34,4668,10723,1718444,80.09,164689383,1265.036,27.5,5.098,3523.984,298.003,8.38,0.608,3
16,166,1282,336044,34,4702,12999,1731443,80.09,164689383,1265.036,27.5,5.098,3523.984,298.003,8.38,0.608,3
16,167,1476,337520,31,4733,14216,1745659,80.09,164689383,1265.036,27.5,5.098,3523.984,298.003,8.38,0.608,3
16,168,1812,339332,26,4759,14050,1759709,80.09,164689383,1265.036,27.5,5.098,3523.984,298.003,8.38,0.608,3
16,169,1724,341056,43,4802,13360,1773069,80.09,164689383,1265.036,27.5,5.098,3523.984,298.003,8.38,0.608,3
16,170,1615,342671,21,4823,13673,1786742,80.09,164689383,1265.036,27.5,5.098,3523.984,298.003,8.38,0.608,3
16,171,1593,344264,36,4859,12730,1799472,80.09,164689383,1265.036,27.5,5.098,3523.984,298.003,8.38,0.608,3
16,172,1541,345805,22,4881,13170,1812642,80.09,164689383,1265.036,27.5,5.098,3523.984,298.003,8.38,0.608,3
16,173,1567,347372,32,4913,11591,1824233,80.09,164689383,1265.036,27.5,5.098,3523.984,298.003,8.38,0.608,3
16,174,1544,348916,26,4939,13053,1837286,80.09,164689383,1265.036,27.5,5.098,3523.984,298.003,8.38,0.608,3
16,175,1705,350621,40,4979,14164,1851450,80.09,164689383,1265.036,27.5,5.098,3523.984,298.003,8.38,0.608,3
16,176,1557,352178,28,5007,14150,1865600,80.09,164689383,1265.036,27.5,5.098,3523.984,298.003,8.38,0.608,3
16,177,1666,353844,37,5044,12900,1878500,80.09,164689383,1265.036,27.5,5.098,3523.984,298.003,8.38,0.608,3
16,178,1540,355384,28,5072,12473,1890973,80.09,164689383,1265.036,27.5,5.098,3523.984,298.003,8.38,0.608,3
16,179,1383,356767,21,5093,10765,1901738,80.09,164689383,1265.036,27.5,5.098,3523.984,298.003,8.38,0.608,3
16,180,1106,357873,36,5129,10685,1912423,80.09,164689383,1265.036,27.5,5.098,3523.984,298.003,8.38,0.608,3
16,181,1275,359148,32,5161,11922,1924345,80.09,164689383,1265.036,27.5,5.098,3523.984,298.003,8.38,0.608,3
16,182,1407,360555,32,5193,12869,1937214,80.09,164689383,1265.036,27.5,5.098,3523.984,298.003,8.38,0.608,3
16,183,1488,362043,26,5219,13404,1950618,80.09,164689383,1265.036,27.5,5.098,3523.984,298.003,8.38,0.608,3
16,184,1436,363479,32,5251,11420,1962038,80.09,164689383,1265.036,27.5,5.098,3523.984,298.003,8.38,0.608,3
16,185,1508,364987,21,5272,11176,1973214,80.09,164689383,1265.036,27.5,5.098,3523.984,298.003,8.38,0.608,3
16,186,1396,366383,33,5305,9554,1982768,80.09,164689383,1265.036,27.5,5.098,3523.984,298.003,8.38,0.608,3
16,187,1182,367565,20,5325,9859,1992627,80.09,164689383,1265.036,27.5,5.098,3523.984,298.003,8.38,0.608,3
16,188,1125,368690,23,5348,11767,2004394,80.09,164689383,1265.036,27.5,5.098,3523.984,298.003,8.38,0.608,3
16,189,1442,370132,27,5375,12345,2016739,80.09,164689383,1265.036,27.5,5.098,3523.984,298.003,8.38,0.608,3
16,190,1499,371631,30,5405,13032,2029771,80.09,164689383,1265.036,27.5,5.098,3523.984,298.003,8.38,0.608,3
16,191,1520,373151,35,5440,12605,2042376,80.09,164689383,1265.036,27.5,5.098,3523.984,298.003,8.38,0.608,3
16,192,1441,374592,20,5460,11256,2053632,80.09,164689383,1265.036,27.5,5.098,3523.984,298.003,8.38,0.608,3
16,193,1278,375870,17,5477,10859,2064491,80.09,164689383,1265.036,27.5,5.098,3523.984,298.003,8.38,0.608,3
16,194,1203,377073,23,5500,9467,2073958,80.09,164689383,1265.036,27.5,5.098,3523.984,298.003,8.38,0.608,3
16,195,1193,378266,24,5524,13227,2087185,80.09,164689383,1265.036,27.5,5.098,3523.984,298.003,8.38,0.608,3
16,196,1472,379738,31,5555,13815,2101000,80.09,164689383,1265.036,27.5,5.098,3523.984,298.003,8.38,0.608,3
16,197,1537,381275,22,5577,14411,2115411,80.09,164689383,1265.036,27.5,5.098,3523.984,298.003,8.38,0.608,3
16,198,1684,382959,16,5593,14104,2129515,80.09,164689383,1265.036,27.5,5.098,3523.984,298.003,8.38,0.608,3
16,199,1600,384559,15,5608,13577,2143092,80.09,164689383,1265.036,27.5,5.098,3523.984,298.003,8.38,0.608,3
16,200,1527,386086,15,5623,11573,2154665,80.09,164689383,1265.036,27.5,5.098,3523.984,298.003,8.38,0.608,3
16,201,1209,387295,23,5646,11866,2166531,80.09,164689383,1265.036,27.5,5.098,3523.984,298.003,8.38,0.608,3
16,202,1274,388569,14,5660,15146,2181677,80.09,164689383,1265.036,27.5,5.098,3523.984,298.003,8.38,0.608,3
16,203,1637,390206,21,5681,0,2181677,80.09,164689383,1265.036,27.5,5.098,3523.984,298.003,8.38,0.608,3
16,204,1383,391589,18,5699,0,2181677,80.09,164689383,1265.036,27.5,5.098,3523.984,298.003,8.38,0.608,3
17,1,0,34,0,0,0,0,73.15,287371,664.463,39.8,14.952,16978.068,170.05,13.57,0.8,0
17,2,11,45,0,0,0,0,73.15,287371,664.463,39.8,14.952,16978.068,170.05,13.57,0.8,0
17,3,0,45,0,0,0,0,83.33,287371,664.463,39.8,14.952,16978.068,170.05,13.57,0.8,0
17,4,0,45,0,0,0,0,83.33,287371,664.463,39.8,14.952,16978.068,170.05,13.57,0.8,0
17,5,6,51,0,0,0,0,83.33,287371,664.463,39.8,14.952,16978.068,170.05,13.57,0.8,0
17,6,5,56,1,1,0,0,83.33,287371,664.463,39.8,14.952,16978.068,170.05,13.57,0.8,0
17,7,4,60,1,2,0,0,83.33,287371,664.463,39.8,14.952,16978.068,170.05,13.57,0.8,0
17,8,3,63,1,3,0,0,88.89,287371,664.463,39.8,14.952,16978.068,170.05,13.57,0.8,0
17,9,0,63,0,3,0,0,88.89,287371,664.463,39.8,14.952,16978.068,170.05,13.57,0.8,0
17,10,3,66,0,3,0,0,88.89,287371,664.463,39.8,14.952,16978.068,170.05,13.57,0.8,0
17,11,1,67,1,4,0,0,88.89,287371,664.463,39.8,14.952,16978.068,170.05,13.57,0.8,0
17,12,1,68,0,4,0,0,88.89,287371,664.463,39.8,14.952,16978.068,170.05,13.57,0.8,0
17,13,3,71,0,4,0,0,88.89,287371,664.463,39.8,14.952,16978.068,170.05,13.57,0.8,0
17,14,1,72,0,4,0,0,88.89,287371,664.463,39.8,14.952,16978.068,170.05,13.57,0.8,0
17,15,1,73,1,5,0,0,88.89,287371,664.463,39.8,14.952,16978.068,170.05,13.57,0.8,0
17,16,2,75,0,5,0,0,88.89,287371,664.463,39.8,14.952,16978.068,170.05,13.57,0.8,0
17,17,0,75,0,5,0,0,88.89,287371,664.463,39.8,14.952,16978.068,170.05,13.57,0.8,0
17,18,0,75,0,5,0,0,88.89,287371,664.463,39.8,14.952,16978.068,170.05,13.57,0.8,0
17,19,0,75,0,5,0,0,88.89,287371,664.463,39.8,14.952,16978.068,170.05,13.57,0.8,0
17,20,0,75,0,5,0,0,88.89,287371,664.463,39.8,14.952,16978.068,170.05,13.57,0.8,0
17,21,0,75,0,5,0,0,88.89,287371,664.463,39.8,14.952,16978.068,170.05,13.57,0.8,0
17,22,0,75,0,5,0,0,88.89,287371,664.463,39.8,14.952,16978.068,170.05,13.57,0.8,0
17,23,1,76,1,6,0,0,88.89,287371,664.463,39.8,14.952,16978.068,170.05,13.57,0.8,0
17,24,0,76,0,6,0,0,88.89,287371,664.463,39.8,14.952,16978.068,170.05,13.57,0.8,0
17,25,0,76,0,6,0,0,88.89,287371,664.463,39.8,14.952,16978.068,170.05,13.57,0.8,0
17,26,3,79,0,6,0,0,88.89,287371,664.463,39.8,14.952,16978.068,170.05,13.57,0.8,0
17,27,0,79,0,6,0,0,88.89,287371,664.463,39.8,14.952,16978.068,170.05,13.57,0.8,0
17,28,1,80,0,6,0,0,88.89,287371,664.463,39.8,14.952,16978.068,170.05,13.57,0.8,0
17,29,0,80,0,6,0,0,88.89,287371,664.463,39.8,14.952,16978.068,170.05,13.57,0.8,0
17,30,0,80,1,7,0,0,88.89,287371,664.463,39.8,14.952,16978.068,170.05,13.57,0.8,0
17,31,1,81,0,7,0,0,88.89,287371,664.463,39.8,14.952,16978.068,170.05,13.57,0.8,0
17,32,0,81,0,7,0,0,88.89,287371,664.463,39.8,14.952,16978.068,170.05,13.57,0.8,0
17,33,0,81,0,7,0,0,88.89,287371,664.463,39.8,14.952,16978.068,170.05,13.57,0.8,0
17,34,1,82,0,7,0,0,81.48,287371,664.463,39.8,14.952,16978.068,170.05,13.57,0.8,0
17,35,0,82,0,7,0,0,81.48,287371,664.463,39.8,14.952,16978.068,170.05,13.57,0.8,0
17,36,0,82,0,7,0,0,81.48,287371,664.463,39.8,14.952,16978.068,170.05,13.57,0.8,0
17,37,0,82,0,7,0,0,81.48,287371,664.463,39.8,14.952,16978.068,170.05,13.57,0.8,0
17,38,0,82,0,7,0,0,81.48,287371,664.463,39.8,14.952,16978.068,170.05,13.57,0.8,0
17,39,1,83,0,7,0,0,81.48,287371,664.463,39.8,14.952,16978.068,170.05,13.57,0.8,0
17,40,1,84,0,7,0,0,81.48,287371,664.463,39.8,14.952,16978.068,170.05,13.57,0.8,0
17,41,0,84,0,7,0,0,81.48,287371,664.463,39.8,14.952,16978.068,170.05,13.57,0.8,0
17,42,0,84,0,7,0,0,81.48,287371,664.463,39.8,14.952,16978.068,170.05,13.57,0.8,0
17,43,1,85,0,7,0,0,81.48,287371,664.463,39.8,14.952,16978.068,170.05,13.57,0.8,0
17,44,0,85,0,7,0,0,81.48,287371,664.463,39.8,14.952,16978.068,170.05,13.57,0.8,0
17,45,0,85,0,7,0,0,81.48,287371,664.463,39.8,14.952,16978.068,170.05,13.57,0.8,0
17,46,0,85,0,7,0,0,81.48,287371,664.463,39.8,14.952,16978.068,170.05,13.57,0.8,0
17,47,1,86,0,7,0,0,81.48,287371,664.463,39.8,14.952,16978.068,170.05,13.57,0.8,0
17,48,2,88,0,7,0,0,81.48,287371,664.463,39.8,14.952,16978.068,170.05,13.57,0.8,0
17,49,0,88,0,7,0,0,81.48,287371,664.463,39.8,14.952,16978.068,170.05,13.57,0.8,0
17,50,2,90,0,7,0,0,81.48,287371,664.463,39.8,14.952,16978.068,170.05,13.57,0.8,0
17,51,0,90,0,7,0,0,81.48,287371,664.463,39.8,14.952,16978.068,170.05,13.57,0.8,0
17,52,0,90,0,7,0,0,81.48,287371,664.463,39.8,14.952,16978.068,170.05,13.57,0.8,0
17,53,0,90,0,7,0,0,81.48,287371,664.463,39.8,14.952,16978.068,170.05,13.57,0.8,0
17,54,2,92,0,7,0,0,81.48,287371,664.463,39.8,14.952,16978.068,170.05,13.57,0.8,0
17,55,0,92,0,7,0,0,81.48,287371,664.463,39.8,14.952,16978.068,170.05,13.57,0.8,0
17,56,0,92,0,7,0,0,81.48,287371,664.463,39.8,14.952,16978.068,170.05,13.57,0.8,0
17,57,0,92,0,7,0,0,81.48,287371,664.463,39.8,14.952,16978.068,170.05,13.57,0.8,0
17,58,0,92,0,7,0,0,81.48,287371,664.463,39.8,14.952,16978.068,170.05,13.57,0.8,0
17,59,0,92,0,7,0,0,81.48,287371,664.463,39.8,14.952,16978.068,170.05,13.57,0.8,0
17,60,0,92,0,7,0,0,81.48,287371,664.463,39.8,14.952,16978.068,170.05,13.57,0.8,0
17,61,0,92,0,7,0,0,81.48,287371,664.463,39.8,14.952,16978.068,170.05,13.57,0.8,0
17,62,0,92,0,7,0,0,78.7,287371,664.463,39.8,14.952,16978.068,170.05,13.57,0.8,0
17,63,0,92,0,7,0,0,78.7,287371,664.463,39.8,14.952,16978.068,170.05,13.57,0.8,0
17,64,0,92,0,7,0,0,78.7,287371,664.463,39.8,14.952,16978.068,170.05,13.57,0.8,0
17,65,0,92,0,7,0,0,78.7,287371,664.463,39.8,14.952,16978.068,170.05,13.57,0.8,0
17,66,0,92,0,7,0,0,78.7,287371,664.463,39.8,14.952,16978.068,170.05,13.57,0.8,0
17,67,0,92,0,7,0,0,78.7,287371,664.463,39.8,14.952,16978.068,170.05,13.57,0.8,0
17,68,0,92,0,7,0,0,78.7,287371,664.463,39.8,14.952,16978.068,170.05,13.57,0.8,0
17,69,0,92,0,7,0,0,75,287371,664.463,39.8,14.952,16978.068,170.05,13.57,0.8,0
17,70,0,92,0,7,0,0,75,287371,664.463,39.8,14.952,16978.068,170.05,13.57,0.8,0
17,71,0,92,0,7,0,0,75,287371,664.463,39.8,14.952,16978.068,170.05,13.57,0.8,0
17,72,4,96,0,7,0,0,75,287371,664.463,39.8,14.952,16978.068,170.05,13.57,0.8,0
17,73,0,96,0,7,0,0,75,287371,664.463,39.8,14.952,16978.068,170.05,13.57,0.8,0
17,74,0,96,0,7,0,0,75,287371,664.463,39.8,14.952,16978.068,170.05,13.57,0.8,0
17,75,0,96,0,7,0,0,75,287371,664.463,39.8,14.952,16978.068,170.05,13.57,0.8,0
17,76,0,96,0,7,0,0,66.67,287371,664.463,39.8,14.952,16978.068,170.05,13.57,0.8,0
17,77,1,97,0,7,0,0,66.67,287371,664.463,39.8,14.952,16978.068,170.05,13.57,0.8,0
17,78,0,97,0,7,0,0,66.67,287371,664.463,39.8,14.952,16978.068,170.05,13.57,0.8,0
17,79,0,97,0,7,0,0,66.67,287371,664.463,39.8,14.952,16978.068,170.05,13.57,0.8,0
17,80,0,97,0,7,0,0,66.67,287371,664.463,39.8,14.952,16978.068,170.05,13.57,0.8,0
17,81,0,97,0,7,0,0,66.67,287371,664.463,39.8,14.952,16978.068,170.05,13.57,0.8,0
17,82,0,97,0,7,0,0,66.67,287371,664.463,39.8,14.952,16978.068,170.05,13.57,0.8,0
17,83,0,97,0,7,0,0,66.67,287371,664.463,39.8,14.952,16978.068,170.05,13.57,0.8,0
17,84,0,97,0,7,0,0,66.67,287371,664.463,39.8,14.952,16978.068,170.05,13.57,0.8,0
17,85,0,97,0,7,0,0,66.67,287371,664.463,39.8,14.952,16978.068,170.05,13.57,0.8,0
17,86,0,97,0,7,0,0,66.67,287371,664.463,39.8,14.952,16978.068,170.05,13.57,0.8,0
17,87,0,97,0,7,0,0,66.67,287371,664.463,39.8,14.952,16978.068,170.05,13.57,0.8,0
17,88,0,97,0,7,0,0,66.67,287371,664.463,39.8,14.952,16978.068,170.05,13.57,0.8,0
17,89,0,97,0,7,0,0,66.67,287371,664.463,39.8,14.952,16978.068,170.05,13.57,0.8,0
17,90,0,97,0,7,0,0,66.67,287371,664.463,39.8,14.952,16978.068,170.05,13.57,0.8,0
17,91,0,97,0,7,0,0,66.67,287371,664.463,39.8,14.952,16978.068,170.05,13.57,0.8,0
17,92,0,97,0,7,0,0,57.41,287371,664.463,39.8,14.952,16978.068,170.05,13.57,0.8,0
17,93,0,97,0,7,0,0,57.41,287371,664.463,39.8,14.952,16978.068,170.05,13.57,0.8,0
17,94,0,97,0,7,0,0,57.41,287371,664.463,39.8,14.952,16978.068,170.05,13.57,0.8,0
17,95,0,97,0,7,0,0,57.41,287371,664.463,39.8,14.952,16978.068,170.05,13.57,0.8,0
17,96,0,97,0,7,0,0,57.41,287371,664.463,39.8,14.952,16978.068,170.05,13.57,0.8,0
17,97,1,98,0,7,0,0,57.41,287371,664.463,39.8,14.952,16978.068,170.05,13.57,0.8,0
17,98,0,98,0,7,0,0,57.41,287371,664.463,39.8,14.952,16978.068,170.05,13.57,0.8,0
17,99,0,98,0,7,0,0,57.41,287371,664.463,39.8,14.952,16978.068,170.05,13.57,0.8,0
17,100,0,98,0,7,0,0,57.41,287371,664.463,39.8,14.952,16978.068,170.05,13.57,0.8,0
17,101,0,98,0,7,0,0,57.41,287371,664.463,39.8,14.952,16978.068,170.05,13.57,0.8,0
17,102,0,98,0,7,0,0,57.41,287371,664.463,39.8,14.952,16978.068,170.05,13.57,0.8,0
17,103,5,103,0,7,0,0,54.63,287371,664.463,39.8,14.952,16978.068,170.05,13.57,0.8,0
17,104,0,103,0,7,0,0,54.63,287371,664.463,39.8,14.952,16978.068,170.05,13.57,0.8,0
17,105,0,103,0,7,0,0,54.63,287371,664.463,39.8,14.952,16978.068,170.05,13.57,0.8,0
17,106,0,103,0,7,0,0,54.63,287371,664.463,39.8,14.952,16978.068,170.05,13.57,0.8,0
17,107,1,104,0,7,0,0,54.63,287371,664.463,39.8,14.952,16978.068,170.05,13.57,0.8,0
17,108,0,104,0,7,0,0,54.63,287371,664.463,39.8,14.952,16978.068,170.05,13.57,0.8,0
17,109,0,104,0,7,0,0,54.63,287371,664.463,39.8,14.952,16978.068,170.05,13.57,0.8,0
17,110,0,104,0,7,0,0,54.63,287371,664.463,39.8,14.952,16978.068,170.05,13.57,0.8,0
17,111,1,105,0,7,0,0,54.63,287371,664.463,39.8,14.952,16978.068,170.05,13.57,0.8,0
17,112,1,106,0,7,0,0,54.63,287371,664.463,39.8,14.952,16978.068,170.05,13.57,0.8,0
17,113,0,106,0,7,0,0,54.63,287371,664.463,39.8,14.952,16978.068,170.05,13.57,0.8,0
17,114,0,106,0,7,0,0,50.93,287371,664.463,39.8,14.952,16978.068,170.05,13.57,0.8,0
17,115,0,106,0,7,0,0,50.93,287371,664.463,39.8,14.952,16978.068,170.05,13.57,0.8,0
17,116,2,108,0,7,0,0,45.37,287371,664.463,39.8,14.952,16978.068,170.05,13.57,0.8,0
17,117,0,108,0,7,0,0,45.37,287371,664.463,39.8,14.952,16978.068,170.05,13.57,0.8,0
17,118,2,110,0,7,0,0,45.37,287371,664.463,39.8,14.952,16978.068,170.05,13.57,0.8,0
17,119,0,110,0,7,0,0,45.37,287371,664.463,39.8,14.952,16978.068,170.05,13.57,0.8,0
17,120,0,110,0,7,0,0,45.37,287371,664.463,39.8,14.952,16978.068,170.05,13.57,0.8,0
17,121,0,110,0,7,0,0,45.37,287371,664.463,39.8,14.952,16978.068,170.05,13.57,0.8,0
17,122,0,110,0,7,0,0,45.37,287371,664.463,39.8,14.952,16978.068,170.05,13.57,0.8,0
17,123,0,110,0,7,0,0,45.37,287371,664.463,39.8,14.952,16978.068,170.05,13.57,0.8,0
17,124,12,122,0,7,0,0,45.37,287371,664.463,39.8,14.952,16978.068,170.05,13.57,0.8,0
17,125,10,132,0,7,0,0,48.15,287371,664.463,39.8,14.952,16978.068,170.05,13.57,0.8,0
17,126,0,132,0,7,0,0,48.15,287371,664.463,39.8,14.952,16978.068,170.05,13.57,0.8,0
17,127,0,132,0,7,0,0,48.15,287371,664.463,39.8,14.952,16978.068,170.05,13.57,0.8,0
17,128,1,133,0,7,0,0,48.15,287371,664.463,39.8,14.952,16978.068,170.05,13.57,0.8,0
17,129,0,133,0,7,0,0,48.15,287371,664.463,39.8,14.952,16978.068,170.05,13.57,0.8,0
17,130,5,138,0,7,0,0,48.15,287371,664.463,39.8,14.952,16978.068,170.05,13.57,0.8,0
17,131,0,138,0,7,0,0,48.15,287371,664.463,39.8,14.952,16978.068,170.05,13.57,0.8,0
17,132,4,142,0,7,0,0,48.15,287371,664.463,39.8,14.952,16978.068,170.05,13.57,0.8,0
17,133,1,143,0,7,0,0,48.15,287371,664.463,39.8,14.952,16978.068,170.05,13.57,0.8,0
17,134,0,143,0,7,0,0,48.15,287371,664.463,39.8,14.952,16978.068,170.05,13.57,0.8,0
17,135,0,143,0,7,0,0,48.15,287371,664.463,39.8,14.952,16978.068,170.05,13.57,0.8,0
17,136,1,144,0,7,0,0,48.15,287371,664.463,39.8,14.952,16978.068,170.05,13.57,0.8,0
17,137,4,148,0,7,0,0,48.15,287371,664.463,39.8,14.952,16978.068,170.05,13.57,0.8,0
17,138,2,150,0,7,0,0,48.15,287371,664.463,39.8,14.952,16978.068,170.05,13.57,0.8,0
17,139,1,151,0,7,0,0,48.15,287371,664.463,39.8,14.952,16978.068,170.05,13.57,0.8,0
17,140,1,152,0,7,0,0,48.15,287371,664.463,39.8,14.952,16978.068,170.05,13.57,0.8,0
17,141,1,153,0,7,0,0,48.15,287371,664.463,39.8,14.952,16978.068,170.05,13.57,0.8,0
17,142,2,155,0,7,0,0,48.15,287371,664.463,39.8,14.952,16978.068,170.05,13.57,0.8,0
17,143,1,156,0,7,0,0,38.89,287371,664.463,39.8,14.952,16978.068,170.05,13.57,0.8,0
17,144,1,157,0,7,0,0,38.89,287371,664.463,39.8,14.952,16978.068,170.05,13.57,0.8,0
17,145,1,158,0,7,0,0,38.89,287371,664.463,39.8,14.952,16978.068,170.05,13.57,0.8,0
17,146,3,161,0,7,0,0,38.89,287371,664.463,39.8,14.952,16978.068,170.05,13.57,0.8,0
17,147,0,161,0,7,0,0,38.89,287371,664.463,39.8,14.952,16978.068,170.05,13.57,0.8,0
17,148,3,164,0,7,0,0,38.89,287371,664.463,39.8,14.952,16978.068,170.05,13.57,0.8,0
17,149,1,165,0,7,0,0,38.89,287371,664.463,39.8,14.952,16978.068,170.05,13.57,0.8,0
17,150,0,165,0,7,0,0,38.89,287371,664.463,39.8,14.952,16978.068,170.05,13.57,0.8,0
17,151,1,166,0,7,0,0,38.89,287371,664.463,39.8,14.952,16978.068,170.05,13.57,0.8,0
17,152,4,170,0,7,0,0,38.89,287371,664.463,39.8,14.952,16978.068,170.05,13.57,0.8,0
17,153,3,173,0,7,0,0,38.89,287371,664.463,39.8,14.952,16978.068,170.05,13.57,0.8,0
17,154,1,174,0,7,0,0,38.89,287371,664.463,39.8,14.952,16978.068,170.05,13.57,0.8,0
17,155,2,176,0,7,0,0,38.89,287371,664.463,39.8,14.952,16978.068,170.05,13.57,0.8,0
17,156,0,176,0,7,0,0,38.89,287371,664.463,39.8,14.952,16978.068,170.05,13.57,0.8,0
17,157,1,177,0,7,0,0,38.89,287371,664.463,39.8,14.952,16978.068,170.05,13.57,0.8,0
17,158,1,178,0,7,0,0,38.89,287371,664.463,39.8,14.952,16978.068,170.05,13.57,0.8,0
17,159,0,178,0,7,0,0,38.89,287371,664.463,39.8,14.952,16978.068,170.05,13.57,0.8,0
17,160,1,179,0,7,0,0,38.89,287371,664.463,39.8,14.952,16978.068,170.05,13.57,0.8,0
17,161,0,179,0,7,0,0,38.89,287371,664.463,39.8,14.952,16978.068,170.05,13.57,0.8,0
17,162,1,180,0,7,0,0,38.89,287371,664.463,39.8,14.952,16978.068,170.05,13.57,0.8,0
17,163,0,180,0,7,0,0,38.89,287371,664.463,39.8,14.952,16978.068,170.05,13.57,0.8,0
17,164,0,180,0,7,0,0,38.89,287371,664.463,39.8,14.952,16978.068,170.05,13.57,0.8,0
17,165,0,180,0,7,0,0,38.89,287371,664.463,39.8,14.952,16978.068,170.05,13.57,0.8,0
17,166,0,180,0,7,0,0,38.89,287371,664.463,39.8,14.952,16978.068,170.05,13.57,0.8,0
17,167,1,181,0,7,0,0,38.89,287371,664.463,39.8,14.952,16978.068,170.05,13.57,0.8,0
17,168,2,183,0,7,0,0,38.89,287371,664.463,39.8,14.952,16978.068,170.05,13.57,0.8,0
17,169,1,184,0,7,0,0,38.89,287371,664.463,39.8,14.952,16978.068,170.05,13.57,0.8,0
17,170,1,185,0,7,0,0,38.89,287371,664.463,39.8,14.952,16978.068,170.05,13.57,0.8,0
17,171,0,185,0,7,0,0,38.89,287371,664.463,39.8,14.952,16978.068,170.05,13.57,0.8,0
17,172,0,185,0,7,0,0,38.89,287371,664.463,39.8,14.952,16978.068,170.05,13.57,0.8,0
17,173,0,185,0,7,0,0,38.89,287371,664.463,39.8,14.952,16978.068,170.05,13.57,0.8,0
17,174,4,189,0,7,0,0,31.48,287371,664.463,39.8,14.952,16978.068,170.05,13.57,0.8,0
17,175,0,189,0,7,0,0,31.48,287371,664.463,39.8,14.952,16978.068,170.05,13.57,0.8,0
17,176,0,189,0,7,0,0,31.48,287371,664.463,39.8,14.952,16978.068,170.05,13.57,0.8,0
17,177,0,189,0,7,0,0,31.48,287371,664.463,39.8,14.952,16978.068,170.05,13.57,0.8,0
17,178,0,189,0,7,0,0,31.48,287371,664.463,39.8,14.952,16978.068,170.05,13.57,0.8,0
17,179,1,190,0,7,0,0,31.48,287371,664.463,39.8,14.952,16978.068,170.05,13.57,0.8,0
17,180,0,190,0,7,0,0,31.48,287371,664.463,39.8,14.952,16978.068,170.05,13.57,0.8,0
17,181,0,190,0,7,0,0,31.48,287371,664.463,39.8,14.952,16978.068,170.05,13.57,0.8,0
17,182,0,190,0,7,0,0,31.48,287371,664.463,39.8,14.952,16978.068,170.05,13.57,0.8,0
17,183,0,190,0,7,0,0,31.48,287371,664.463,39.8,14.952,16978.068,170.05,13.57,0.8,0
17,184,0,190,0,7,0,0,31.48,287371,664.463,39.8,14.952,16978.068,170.05,13.57,0.8,0
17,185,3,193,0,7,0,0,31.48,287371,664.463,39.8,14.952,16978.068,170.05,13.57,0.8,0
17,186,0,193,0,7,0,0,31.48,287371,664.463,39.8,14.952,16978.068,170.05,13.57,0.8,0
17,187,3,196,0,7,0,0,31.48,287371,664.463,39.8,14.952,16978.068,170.05,13.57,0.8,0
17,188,3,199,0,7,0,0,31.48,287371,664.463,39.8,14.952,16978.068,170.05,13.57,0.8,0
17,189,1,200,0,7,0,0,31.48,287371,664.463,39.8,14.952,16978.068,170.05,13.57,0.8,0
17,190,0,200,0,7,0,0,31.48,287371,664.463,39.8,14.952,16978.068,170.05,13.57,0.8,0
17,191,3,203,0,7,0,0,31.48,287371,664.463,39.8,14.952,16978.068,170.05,13.57,0.8,0
17,192,0,203,0,7,0,0,25.93,287371,664.463,39.8,14.952,16978.068,170.05,13.57,0.8,0
17,193,1,204,0,7,0,0,25.93,287371,664.463,39.8,14.952,16978.068,170.05,13.57,0.8,0
17,194,2,206,0,7,0,0,25.93,287371,664.463,39.8,14.952,16978.068,170.05,13.57,0.8,0
17,195,2,208,0,7,0,0,25.93,287371,664.463,39.8,14.952,16978.068,170.05,13.57,0.8,0
17,196,0,208,0,7,0,0,25.93,287371,664.463,39.8,14.952,16978.068,170.05,13.57,0.8,0
17,197,2,210,0,7,0,0,25.93,287371,664.463,39.8,14.952,16978.068,170.05,13.57,0.8,0
17,198,5,215,0,7,0,0,25.93,287371,664.463,39.8,14.952,16978.068,170.05,13.57,0.8,0
17,199,3,218,0,7,0,0,25.93,287371,664.463,39.8,14.952,16978.068,170.05,13.57,0.8,0
17,200,1,219,0,7,0,0,25.93,287371,664.463,39.8,14.952,16978.068,170.05,13.57,0.8,0
17,201,0,219,0,7,0,0,25.93,287371,664.463,39.8,14.952,16978.068,170.05,13.57,0.8,0
17,202,3,222,0,7,0,0,25.93,287371,664.463,39.8,14.952,16978.068,170.05,13.57,0.8,0
17,203,0,222,0,7,0,0,25.93,287371,664.463,39.8,14.952,16978.068,170.05,13.57,0.8,0
17,204,0,222,0,7,0,0,25.93,287371,664.463,39.8,14.952,16978.068,170.05,13.57,0.8,0
18,1,47,152,0,0,1000,32000,8.33,9449321,46.858,40.3,14.799,17167.967,443.129,5.18,0.808,0
18,2,0,152,0,0,0,32000,8.33,9449321,46.858,40.3,14.799,17167.967,443.129,5.18,0.808,0
18,3,102,254,4,4,0,32000,8.33,9449321,46.858,40.3,14.799,17167.967,443.129,5.18,0.808,0
18,4,97,351,0,4,0,32000,19.44,9449321,46.858,40.3,14.799,17167.967,443.129,5.18,0.808,0
18,5,43,394,1,5,0,32000,19.44,9449321,46.858,40.3,14.799,17167.967,443.129,5.18,0.808,0
18,6,170,564,3,8,0,40000,19.44,9449321,46.858,40.3,14.799,17167.967,443.129,5.18,0.808,0
18,7,136,700,5,13,0,40000,19.44,9449321,46.858,40.3,14.799,17167.967,443.129,5.18,0.808,0
18,8,161,861,0,13,0,46000,19.44,9449321,46.858,40.3,14.799,17167.967,443.129,5.18,0.808,0
18,9,205,1066,0,13,3000,49000,19.44,9449321,46.858,40.3,14.799,17167.967,443.129,5.18,0.808,0
18,10,420,1486,3,16,0,49000,19.44,9449321,46.858,40.3,14.799,17167.967,443.129,5.18,0.808,0
18,11,495,1981,3,19,0,49000,19.44,9449321,46.858,40.3,14.799,17167.967,443.129,5.18,0.808,0
18,12,245,2226,4,23,0,64000,19.44,9449321,46.858,40.3,14.799,17167.967,443.129,5.18,0.808,0
18,13,352,2578,3,26,4000,68000,19.44,9449321,46.858,40.3,14.799,17167.967,443.129,5.18,0.808,0
18,14,341,2919,3,29,3875,71875,19.44,9449321,46.858,40.3,14.799,17167.967,443.129,5.18,0.808,0
18,15,362,3281,4,33,4323,76198,19.44,9449321,46.858,40.3,14.799,17167.967,443.129,5.18,0.808,0
18,16,447,3728,3,36,0,76198,19.44,9449321,46.858,40.3,14.799,17167.967,443.129,5.18,0.808,0
18,17,476,4204,4,40,0,86813,19.44,9449321,46.858,40.3,14.799,17167.967,443.129,5.18,0.808,0
18,18,575,4779,3,43,5896,92709,19.44,9449321,46.858,40.3,14.799,17167.967,443.129,5.18,0.808,0
18,19,518,5297,2,45,5522,98231,19.44,9449321,46.858,40.3,14.799,17167.967,443.129,5.18,0.808,0
18,20,510,5807,2,47,4335,102566,13.89,9449321,46.858,40.3,14.799,17167.967,443.129,5.18,0.808,0
18,21,457,6264,4,51,5979,108545,13.89,9449321,46.858,40.3,14.799,17167.967,443.129,5.18,0.808,0
18,22,459,6723,4,55,6410,114955,13.89,9449321,46.858,40.3,14.799,17167.967,443.129,5.18,0.808,0
18,23,558,7281,3,58,7588,122543,13.89,9449321,46.858,40.3,14.799,17167.967,443.129,5.18,0.808,0
18,24,741,8022,2,60,8281,130824,13.89,9449321,46.858,40.3,14.799,17167.967,443.129,5.18,0.808,0
18,25,751,8773,3,63,8471,139295,13.89,9449321,46.858,40.3,14.799,17167.967,443.129,5.18,0.808,0
18,26,817,9590,4,67,8230,147525,13.89,9449321,46.858,40.3,14.799,17167.967,443.129,5.18,0.808,0
18,27,873,10463,5,72,6275,153800,13.89,9449321,46.858,40.3,14.799,17167.967,443.129,5.18,0.808,0
18,28,826,11289,3,75,7228,161028,13.89,9449321,46.858,40.3,14.799,17167.967,443.129,5.18,0.808,0
18,29,919,12208,4,79,7958,168986,13.89,9449321,46.858,40.3,14.799,17167.967,443.129,5.18,0.808,0
18,30,973,13181,5,84,7639,176625,13.89,9449321,46.858,40.3,14.799,17167.967,443.129,5.18,0.808,0
18,31,846,14027,5,89,9637,186262,13.89,9449321,46.858,40.3,14.799,17167.967,443.129,5.18,0.808,0
18,32,890,14917,4,93,9168,195430,13.89,9449321,46.858,40.3,14.799,17167.967,443.129,5.18,0.808,0
18,33,911,15828,4,97,8809,204239,13.89,9449321,46.858,40.3,14.799,17167.967,443.129,5.18,0.808,0
18,34,877,16705,2,99,7130,211369,13.89,9449321,46.858,40.3,14.799,17167.967,443.129,5.18,0.808,0
18,35,784,17489,4,103,0,211369,13.89,9449321,46.858,40.3,14.799,17167.967,443.129,5.18,0.808,0
18,36,861,18350,4,107,0,211369,13.89,9449321,46.858,40.3,14.799,17167.967,443.129,5.18,0.808,0
18,37,905,19255,5,112,0,229466,13.89,9449321,46.858,40.3,14.799,17167.967,443.129,5.18,0.808,0
18,38,913,20168,4,116,10680,240146,13.89,9449321,46.858,40.3,14.799,17167.967,443.129,5.18,0.808,0
18,39,933,21101,5,121,11625,251771,13.89,9449321,46.858,40.3,14.799,17167.967,443.129,5.18,0.808,0
18,40,951,22052,5,126,11772,263543,13.89,9449321,46.858,40.3,14.799,17167.967,443.129,5.18,0.808,0
18,41,921,22973,5,131,10517,274060,13.89,9449321,46.858,40.3,14.799,17167.967,443.129,5.18,0.808,0
18,42,933,23906,4,135,10385,284445,13.89,9449321,46.858,40.3,14.799,17167.967,443.129,5.18,0.808,0
18,43,967,24873,7,142,11935,296380,13.89,9449321,46.858,40.3,14.799,17167.967,443.129,5.18,0.808,0
18,44,952,25825,4,146,11776,308156,13.89,9449321,46.858,40.3,14.799,17167.967,443.129,5.18,0.808,0
18,45,947,26772,5,151,0,308156,13.89,9449321,46.858,40.3,14.799,17167.967,443.129,5.18,0.808,0
18,46,958,27730,5,156,0,308156,13.89,9449321,46.858,40.3,14.799,17167.967,443.129,5.18,0.808,0
18,47,951,28681,4,160,0,350515,13.89,9449321,46.858,40.3,14.799,17167.967,443.129,5.18,0.808,0
18,48,969,29650,5,165,0,350515,13.89,9449321,46.858,40.3,14.799,17167.967,443.129,5.18,0.808,0
18,49,922,30572,6,171,0,350515,13.89,9449321,46.858,40.3,14.799,17167.967,443.129,5.18,0.808,0
18,50,936,31508,4,175,0,387673,13.89,9449321,46.858,40.3,14.799,17167.967,443.129,5.18,0.808,0
18,51,918,32426,4,179,0,387673,13.89,9449321,46.858,40.3,14.799,17167.967,443.129,5.18,0.808,0
18,52,945,33371,6,185,0,419004,13.89,9449321,46.858,40.3,14.799,17167.967,443.129,5.18,0.808,0
18,53,932,34303,5,190,15614,434618,13.89,9449321,46.858,40.3,14.799,17167.967,443.129,5.18,0.808,0
18,54,941,35244,4,194,0,434618,13.89,9449321,46.858,40.3,14.799,17167.967,443.129,5.18,0.808,0
18,55,954,36198,5,199,0,463004,13.89,9449321,46.858,40.3,14.799,17167.967,443.129,5.18,0.808,0
18,56,946,37144,5,204,9902,472906,13.89,9449321,46.858,40.3,14.799,17167.967,443.129,5.18,0.808,0
18,57,915,38059,4,208,0,472906,13.89,9449321,46.858,40.3,14.799,17167.967,443.129,5.18,0.808,0
18,58,897,38956,6,214,0,472906,13.89,9449321,46.858,40.3,14.799,17167.967,443.129,5.18,0.808,0
18,59,902,39858,5,219,0,472906,13.89,9449321,46.858,40.3,14.799,17167.967,443.129,5.18,0.808,0
18,60,906,40764,5,224,0,526559,13.89,9449321,46.858,40.3,14.799,17167.967,443.129,5.18,0.808,0
18,61,894,41658,5,229,14534,541093,13.89,9449321,46.858,40.3,14.799,17167.967,443.129,5.18,0.808,0
18,62,898,42556,6,235,12284,553377,13.89,9449321,46.858,40.3,14.799,17167.967,443.129,5.18,0.808,0
18,63,847,43403,5,240,9568,562945,13.89,9449321,46.858,40.3,14.799,17167.967,443.129,5.18,0.808,0
18,64,852,44255,3,243,0,562945,13.89,9449321,46.858,40.3,14.799,17167.967,443.129,5.18,0.808,0
18,65,861,45116,5,248,0,562945,13.89,9449321,46.858,40.3,14.799,17167.967,443.129,5.18,0.808,0
18,66,865,45981,5,253,0,562945,13.89,9449321,46.858,40.3,14.799,17167.967,443.129,5.18,0.808,0
18,67,887,46868,6,259,0,562945,13.89,9449321,46.858,40.3,14.799,17167.967,443.129,5.18,0.808,0
18,68,883,47751,4,263,0,622313,13.89,9449321,46.858,40.3,14.799,17167.967,443.129,5.18,0.808,0
18,69,879,48630,6,269,10680,632993,13.89,9449321,46.858,40.3,14.799,17167.967,443.129,5.18,0.808,0
18,70,823,49453,7,276,0,632993,13.89,9449321,46.858,40.3,14.799,17167.967,443.129,5.18,0.808,0
18,71,812,50265,6,282,0,632993,13.89,9449321,46.858,40.3,14.799,17167.967,443.129,5.18,0.808,0
18,72,801,51066,6,288,0,632993,13.89,9449321,46.858,40.3,14.799,17167.967,443.129,5.18,0.808,0
18,73,750,51816,5,293,0,632993,13.89,9449321,46.858,40.3,14.799,17167.967,443.129,5.18,0.808,0
18,74,704,52520,5,298,0,714324,13.89,9449321,46.858,40.3,14.799,17167.967,443.129,5.18,0.808,0
18,75,721,53241,5,303,0,714324,13.89,9449321,46.858,40.3,14.799,17167.967,443.129,5.18,0.808,0
18,76,732,53973,5,308,0,749917,13.89,9449321,46.858,40.3,14.799,17167.967,443.129,5.18,0.808,0
18,77,707,54680,4,312,10632,760549,13.89,9449321,46.858,40.3,14.799,17167.967,443.129,5.18,0.808,0
18,78,689,55369,6,318,0,760549,13.89,9449321,46.858,40.3,14.799,17167.967,443.129,5.18,0.808,0
18,79,663,56032,6,324,0,800435,13.89,9449321,46.858,40.3,14.799,17167.967,443.129,5.18,0.808,0
18,80,625,56657,7,331,21452,821887,13.89,9449321,46.858,40.3,14.799,17167.967,443.129,5.18,0.808,0
18,81,676,57333,2,333,20286,842173,13.89,9449321,46.858,40.3,14.799,17167.967,443.129,5.18,0.808,0
18,82,603,57936,10,343,0,842173,13.89,9449321,46.858,40.3,14.799,17167.967,443.129,5.18,0.808,0
18,83,569,58505,3,346,0,876639,13.89,9449321,46.858,40.3,14.799,17167.967,443.129,5.18,0.808,0
18,84,518,59023,5,351,0,876639,13.89,9449321,46.858,40.3,14.799,17167.967,443.129,5.18,0.808,0
18,85,464,59487,6,357,0,901904,13.89,9449321,46.858,40.3,14.799,17167.967,443.129,5.18,0.808,0
18,86,458,59945,5,362,17235,919139,13.89,9449321,46.858,40.3,14.799,17167.967,443.129,5.18,0.808,0
18,87,437,60382,5,367,20385,939524,13.89,9449321,46.858,40.3,14.799,17167.967,443.129,5.18,0.808,0
18,88,331,60713,6,373,0,939524,13.89,9449321,46.858,40.3,14.799,17167.967,443.129,5.18,0.808,0
18,89,382,61095,4,377,0,939524,13.89,9449321,46.858,40.3,14.799,17167.967,443.129,5.18,0.808,0
18,90,380,61475,6,383,0,992007,13.89,9449321,46.858,40.3,14.799,17167.967,443.129,5.18,0.808,0
18,91,315,61790,4,387,0,992007,13.89,9449321,46.858,40.3,14.799,17167.967,443.129,5.18,0.808,0
18,92,328,62118,5,392,0,992007,13.89,9449321,46.858,40.3,14.799,17167.967,443.129,5.18,0.808,0
18,93,306,62424,6,398,0,992007,13.89,9449321,46.858,40.3,14.799,17167.967,443.129,5.18,0.808,0
18,94,274,62698,7,405,0,1043876,11.11,9449321,46.858,40.3,14.799,17167.967,443.129,5.18,0.808,0
18,95,299,62997,7,412,0,1043876,11.11,9449321,46.858,40.3,14.799,17167.967,443.129,5.18,0.808,0
18,96,273,63270,6,418,0,1043876,11.11,9449321,46.858,40.3,14.799,17167.967,443.129,5.18,0.808,0
18,97,284,63554,5,423,0,1074240,11.11,9449321,46.858,40.3,14.799,17167.967,443.129,5.18,0.808,0
18,98,250,63804,6,429,0,1074240,11.11,9449321,46.858,40.3,14.799,17167.967,443.129,5.18,0.808,0
18,99,199,64003,7,436,0,1074240,11.11,9449321,46.858,40.3,14.799,17167.967,443.129,5.18,0.808,0
18,100,221,64224,7,443,0,1074240,11.11,9449321,46.858,40.3,14.799,17167.967,443.129,5.18,0.808,0
18,101,187,64411,6,449,0,1074240,11.11,9449321,46.858,40.3,14.799,17167.967,443.129,5.18,0.808,0
18,102,193,64604,5,454,0,1074240,11.11,9449321,46.858,40.3,14.799,17167.967,443.129,5.18,0.808,0
18,103,163,64767,5,459,0,1134653,11.11,9449321,46.858,40.3,14.799,17167.967,443.129,5.18,0.808,0
18,104,165,64932,5,464,0,1134653,11.11,9449321,46.858,40.3,14.799,17167.967,443.129,5.18,0.808,0
18,105,182,65114,4,468,0,1134653,11.11,9449321,46.858,40.3,14.799,17167.967,443.129,5.18,0.808,0
18,106,155,65269,6,474,0,1144696,11.11,9449321,46.858,40.3,14.799,17167.967,443.129,5.18,0.808,0
18,107,174,65443,6,480,0,1144696,11.11,9449321,46.858,40.3,14.799,17167.967,443.129,5.18,0.808,0
18,108,180,65623,5,485,0,1172880,11.11,9449321,46.858,40.3,14.799,17167.967,443.129,5.18,0.808,0
18,109,159,65782,6,491,0,1172880,11.11,9449321,46.858,40.3,14.799,17167.967,443.129,5.18,0.808,0
18,110,171,65953,4,495,0,1172880,11.11,9449321,46.858,40.3,14.799,17167.967,443.129,5.18,0.808,0
18,111,142,66095,4,499,0,1172880,11.11,9449321,46.858,40.3,14.799,17167.967,443.129,5.18,0.808,0
18,112,118,66213,4,503,0,1172880,11.11,9449321,46.858,40.3,14.799,17167.967,443.129,5.18,0.808,0
18,113,135,66348,4,507,0,1209400,11.11,9449321,46.858,40.3,14.799,17167.967,443.129,5.18,0.808,0
18,114,173,66521,6,513,10305,1219705,11.11,9449321,46.858,40.3,14.799,17167.967,443.129,5.18,0.808,0
18,115,167,66688,6,519,10979,1230684,11.11,9449321,46.858,40.3,14.799,17167.967,443.129,5.18,0.808,0
18,116,158,66846,0,519,10940,1241624,11.11,9449321,46.858,40.3,14.799,17167.967,443.129,5.18,0.808,0
18,117,156,67002,11,530,9735,1251359,11.11,9449321,46.858,40.3,14.799,17167.967,443.129,5.18,0.808,0
18,118,130,67132,4,534,6040,1257399,11.11,9449321,46.858,40.3,14.799,17167.967,443.129,5.18,0.808,0
18,119,119,67251,4,538,0,1257399,11.11,9449321,46.858,40.3,14.799,17167.967,443.129,5.18,0.808,0
18,120,115,67366,5,543,0,1278583,11.11,9449321,46.858,40.3,14.799,17167.967,443.129,5.18,0.808,0
18,121,152,67518,5,548,10003,1288586,11.11,9449321,46.858,40.3,14.799,17167.967,443.129,5.18,0.808,0
18,122,147,67665,5,553,10842,1299428,11.11,9449321,46.858,40.3,14.799,17167.967,443.129,5.18,0.808,0
18,123,143,67808,6,559,0,1299428,11.11,9449321,46.858,40.3,14.799,17167.967,443.129,5.18,0.808,0
18,124,138,67946,4,563,0,1319976,11.11,9449321,46.858,40.3,14.799,17167.967,443.129,5.18,0.808,0
18,125,121,68067,4,567,0,1319976,11.11,9449321,46.858,40.3,14.799,17167.967,443.129,5.18,0.808,0
18,126,99,68166,4,571,0,1325776,11.11,9449321,46.858,40.3,14.799,17167.967,443.129,5.18,0.808,0
18,127,84,68250,3,574,0,1325776,11.11,9449321,46.858,40.3,14.799,17167.967,443.129,5.18,0.808,0
18,128,126,68376,3,577,0,1344303,11.11,9449321,46.858,40.3,14.799,17167.967,443.129,5.18,0.808,0
18,129,127,68503,3,580,0,1344303,11.11,9449321,46.858,40.3,14.799,17167.967,443.129,5.18,0.808,0
18,130,111,68614,3,583,0,1363011,11.11,9449321,46.858,40.3,14.799,17167.967,443.129,5.18,0.808,0
18,131,124,68738,2,585,0,1363011,11.11,9449321,46.858,40.3,14.799,17167.967,443.129,5.18,0.808,0
18,132,112,68850,2,587,0,1363011,11.11,9449321,46.858,40.3,14.799,17167.967,443.129,5.18,0.808,0
18,133,97,68947,2,589,0,1377540,11.11,9449321,46.858,40.3,14.799,17167.967,443.129,5.18,0.808,0
18,134,58,69005,3,592,6486,1384026,11.11,9449321,46.858,40.3,14.799,17167.967,443.129,5.18,0.808,0
18,135,97,69102,3,595,0,1384026,11.11,9449321,46.858,40.3,14.799,17167.967,443.129,5.18,0.808,0
18,136,101,69203,4,599,0,1384026,11.11,9449321,46.858,40.3,14.799,17167.967,443.129,5.18,0.808,0
18,137,105,69308,4,603,0,1384026,11.11,9449321,46.858,40.3,14.799,17167.967,443.129,5.18,0.808,0
18,138,116,69424,4,607,0,1384026,11.11,9449321,46.858,40.3,14.799,17167.967,443.129,5.18,0.808,0
18,139,92,69516,3,610,0,1384026,11.11,9449321,46.858,40.3,14.799,17167.967,443.129,5.18,0.808,0
18,140,73,69589,3,613,0,1384026,11.11,9449321,46.858,40.3,14.799,17167.967,443.129,5.18,0.808,0
18,141,84,69673,4,617,0,1384026,11.11,9449321,46.858,40.3,14.799,17167.967,443.129,5.18,0.808,0
18,142,128,69801,5,622,0,1384026,11.11,9449321,46.858,40.3,14.799,17167.967,443.129,5.18,0.808,0
18,143,149,69950,5,627,0,1384026,11.11,9449321,46.858,40.3,14.799,17167.967,443.129,5.18,0.808,0
18,144,161,70111,5,632,0,1465555,11.11,9449321,46.858,40.3,14.799,17167.967,443.129,5.18,0.808,0
18,145,174,70285,5,637,8520,1474075,11.11,9449321,46.858,40.3,14.799,17167.967,443.129,5.18,0.808,0
18,146,183,70468,5,642,0,1474075,11.11,9449321,46.858,40.3,14.799,17167.967,443.129,5.18,0.808,0
18,147,177,70645,4,646,0,1480047,11.11,9449321,46.858,40.3,14.799,17167.967,443.129,5.18,0.808,0
18,148,82,70727,6,652,0,1480047,11.11,9449321,46.858,40.3,14.799,17167.967,443.129,5.18,0.808,0
18,149,247,70974,5,657,0,1497421,11.11,9449321,46.858,40.3,14.799,17167.967,443.129,5.18,0.808,0
18,150,191,71165,5,662,0,1497421,11.11,9449321,46.858,40.3,14.799,17167.967,443.129,5.18,0.808,0
18,151,181,71346,5,667,0,1497421,11.11,9449321,46.858,40.3,14.799,17167.967,443.129,5.18,0.808,0
18,152,177,71523,4,671,0,1497421,11.11,9449321,46.858,40.3,14.799,17167.967,443.129,5.18,0.808,0
18,153,164,71687,5,676,0,1497421,11.11,9449321,46.858,40.3,14.799,17167.967,443.129,5.18,0.808,0
18,154,156,71843,5,681,0,1534792,11.11,9449321,46.858,40.3,14.799,17167.967,443.129,5.18,0.808,0
18,155,119,71962,5,686,0,1534792,11.11,9449321,46.858,40.3,14.799,17167.967,443.129,5.18,0.808,0
18,156,179,72141,5,691,0,1554129,11.11,9449321,46.858,40.3,14.799,17167.967,443.129,5.18,0.808,0
18,157,161,72302,5,696,0,1554129,11.11,9449321,46.858,40.3,14.799,17167.967,443.129,5.18,0.808,0
18,158,183,72485,5,701,0,1554129,11.11,9449321,46.858,40.3,14.799,17167.967,443.129,5.18,0.808,0
18,159,178,72663,4,705,0,1554129,11.11,9449321,46.858,40.3,14.799,17167.967,443.129,5.18,0.808,0
18,160,196,72859,6,711,0,1591247,11.11,9449321,46.858,40.3,14.799,17167.967,443.129,5.18,0.808,0
18,161,172,73031,5,716,0,1591247,11.11,9449321,46.858,40.3,14.799,17167.967,443.129,5.18,0.808,0
18,162,177,73208,5,721,0,1605547,11.11,9449321,46.858,40.3,14.799,17167.967,443.129,5.18,0.808,0
18,163,194,73402,5,726,0,1605547,11.11,9449321,46.858,40.3,14.799,17167.967,443.129,5.18,0.808,0
18,164,189,73591,6,732,0,1605547,11.11,9449321,46.858,40.3,14.799,17167.967,443.129,5.18,0.808,0
18,165,193,73784,6,738,0,1605547,11.11,9449321,46.858,40.3,14.799,17167.967,443.129,5.18,0.808,0
18,166,191,73975,6,744,0,1654618,11.11,9449321,46.858,40.3,14.799,17167.967,443.129,5.18,0.808,0
18,167,198,74173,6,750,7315,1661933,11.11,9449321,46.858,40.3,14.799,17167.967,443.129,5.18,0.808,0
18,168,187,74360,6,756,0,1661933,11.11,9449321,46.858,40.3,14.799,17167.967,443.129,5.18,0.808,0
18,169,192,74552,5,761,0,1672256,11.11,9449321,46.858,40.3,14.799,17167.967,443.129,5.18,0.808,0
18,170,211,74763,6,767,0,1672256,11.11,9449321,46.858,40.3,14.799,17167.967,443.129,5.18,0.808,0
18,171,224,74987,4,771,0,1700790,11.11,9449321,46.858,40.3,14.799,17167.967,443.129,5.18,0.808,0
18,172,243,75230,2,773,0,1700790,11.11,9449321,46.858,40.3,14.799,17167.967,443.129,5.18,0.808,0
18,173,231,75461,3,776,0,1700790,11.11,9449321,46.858,40.3,14.799,17167.967,443.129,5.18,0.808,0
18,174,213,75674,4,780,0,1700790,11.11,9449321,46.858,40.3,14.799,17167.967,443.129,5.18,0.808,0
18,175,224,75898,5,785,0,1744682,11.11,9449321,46.858,40.3,14.799,17167.967,443.129,5.18,0.808,0
18,176,206,76104,6,791,0,1744682,11.11,9449321,46.858,40.3,14.799,17167.967,443.129,5.18,0.808,0
18,177,253,76357,5,796,0,1744682,11.11,9449321,46.858,40.3,14.799,17167.967,443.129,5.18,0.808,0
18,178,294,76651,6,802,0,1792426,11.11,9449321,46.858,40.3,14.799,17167.967,443.129,5.18,0.808,0
18,179,306,76957,5,807,0,1792426,11.11,9449321,46.858,40.3,14.799,17167.967,443.129,5.18,0.808,0
18,180,332,77289,6,813,0,1792426,11.11,9449321,46.858,40.3,14.799,17167.967,443.129,5.18,0.808,0
18,181,320,77609,5,818,0,1792426,11.11,9449321,46.858,40.3,14.799,17167.967,443.129,5.18,0.808,0
18,182,337,77946,4,822,0,1841704,11.11,9449321,46.858,40.3,14.799,17167.967,443.129,5.18,0.808,0
18,183,314,78260,6,828,0,1841704,11.11,9449321,46.858,40.3,14.799,17167.967,443.129,5.18,0.808,0
18,184,371,78631,5,833,0,1841704,11.11,9449321,46.858,40.3,14.799,17167.967,443.129,5.18,0.808,0
18,185,388,79019,6,839,0,1841704,11.11,9449321,46.858,40.3,14.799,17167.967,443.129,5.18,0.808,0
18,186,402,79421,5,844,0,1841704,11.11,9449321,46.858,40.3,14.799,17167.967,443.129,5.18,0.808,0
18,187,431,79852,7,851,0,1841704,11.11,9449321,46.858,40.3,14.799,17167.967,443.129,5.18,0.808,0
18,188,443,80295,6,857,0,1841704,11.11,9449321,46.858,40.3,14.799,17167.967,443.129,5.18,0.808,0
18,189,401,80696,5,862,0,1841704,11.11,9449321,46.858,40.3,14.799,17167.967,443.129,5.18,0.808,0
18,190,394,81090,6,868,0,1841704,11.11,9449321,46.858,40.3,14.799,17167.967,443.129,5.18,0.808,0
18,191,415,81505,6,874,0,1841704,11.11,9449321,46.858,40.3,14.799,17167.967,443.129,5.18,0.808,0
18,192,477,81982,6,880,0,1841704,11.11,9449321,46.858,40.3,14.799,17167.967,443.129,5.18,0.808,0
18,193,489,82471,5,885,0,1841704,11.11,9449321,46.858,40.3,14.799,17167.967,443.129,5.18,0.808,0
18,194,0,82471,0,885,0,1841704,11.11,9449321,46.858,40.3,14.799,17167.967,443.129,5.18,0.808,0
18,195,1063,83534,11,896,0,1841704,11.11,9449321,46.858,40.3,14.799,17167.967,443.129,5.18,0.808,0
18,196,464,83998,5,901,0,1841704,11.11,9449321,46.858,40.3,14.799,17167.967,443.129,5.18,0.808,0
18,197,526,84524,5,906,0,1841704,11.11,9449321,46.858,40.3,14.799,17167.967,443.129,5.18,0.808,0
18,198,597,85121,5,911,0,1841704,11.11,9449321,46.858,40.3,14.799,17167.967,443.129,5.18,0.808,0
18,199,613,85734,5,916,0,1841704,11.11,9449321,46.858,40.3,14.799,17167.967,443.129,5.18,0.808,0
18,200,658,86392,5,921,0,1841704,11.11,9449321,46.858,40.3,14.799,17167.967,443.129,5.18,0.808,0
18,201,0,86392,0,921,0,1841704,11.11,9449321,46.858,40.3,14.799,17167.967,443.129,5.18,0.808,0
18,202,1306,87698,8,929,0,1841704,11.11,9449321,46.858,40.3,14.799,17167.967,443.129,5.18,0.808,0
18,203,592,88290,4,933,0,1841704,11.11,9449321,46.858,40.3,14.799,17167.967,443.129,5.18,0.808,0
18,204,619,88909,4,937,0,1841704,11.11,9449321,46.858,40.3,14.799,17167.967,443.129,5.18,0.808,0
19,1,1681,16977,208,1376,5891,75043,81.48,11589616,375.564,41.8,18.571,42658.576,114.898,4.29,0.916,0
19,2,1516,18493,232,1608,6088,81131,81.48,11589616,375.564,41.8,18.571,42658.576,114.898,4.29,0.916,0
19,3,1478,19971,219,1827,6718,87849,81.48,11589616,375.564,41.8,18.571,42658.576,114.898,4.29,0.916,0
19,4,1694,21665,236,2063,5368,93217,81.48,11589616,375.564,41.8,18.571,42658.576,114.898,4.29,0.916,0
19,5,922,22587,270,2333,3828,97045,81.48,11589616,375.564,41.8,18.571,42658.576,114.898,4.29,0.916,0
19,6,665,23252,246,2579,5840,102885,81.48,11589616,375.564,41.8,18.571,42658.576,114.898,4.29,0.916,0
19,7,1934,25186,257,2836,7509,110394,81.48,11589616,375.564,41.8,18.571,42658.576,114.898,4.29,0.916,0
19,8,1515,26701,277,3113,7972,118366,81.48,11589616,375.564,41.8,18.571,42658.576,114.898,4.29,0.916,0
19,9,1598,28299,321,3434,8224,126590,81.48,11589616,375.564,41.8,18.571,42658.576,114.898,4.29,0.916,0
19,10,2239,30538,271,3705,8537,135127,81.48,11589616,375.564,41.8,18.571,42658.576,114.898,4.29,0.916,0
19,11,2336,32874,302,4007,8148,143275,81.48,11589616,375.564,41.8,18.571,42658.576,114.898,4.29,0.916,0
19,12,1029,33903,285,4292,7287,150562,81.48,11589616,375.564,41.8,18.571,42658.576,114.898,4.29,0.916,0
19,13,524,34427,265,4557,6698,157260,81.48,11589616,375.564,41.8,18.571,42658.576,114.898,4.29,0.916,0
19,14,537,34964,277,4834,8163,165423,81.48,11589616,375.564,41.8,18.571,42658.576,114.898,4.29,0.916,0
19,15,1560,36524,261,5095,10984,176407,81.48,11589616,375.564,41.8,18.571,42658.576,114.898,4.29,0.916,0
19,16,1633,38157,280,5375,10742,187149,81.48,11589616,375.564,41.8,18.571,42658.576,114.898,4.29,0.916,0
19,17,1674,39831,246,5621,11300,198449,81.48,11589616,375.564,41.8,18.571,42658.576,114.898,4.29,0.916,0
19,18,1394,41225,205,5826,10312,208761,81.48,11589616,375.564,41.8,18.571,42658.576,114.898,4.29,0.916,0
19,19,722,41947,208,6034,7200,215961,81.48,11589616,375.564,41.8,18.571,42658.576,114.898,4.29,0.916,0
19,20,443,42390,190,6224,11916,227877,81.48,11589616,375.564,41.8,18.571,42658.576,114.898,4.29,0.916,0
19,21,1276,43666,206,6430,10878,238755,81.48,11589616,375.564,41.8,18.571,42658.576,114.898,4.29,0.916,0
19,22,1270,44936,203,6633,15588,254343,81.48,11589616,375.564,41.8,18.571,42658.576,114.898,4.29,0.916,0
19,23,777,45713,181,6814,17379,271722,81.48,11589616,375.564,41.8,18.571,42658.576,114.898,4.29,0.916,0
19,24,976,46689,156,6970,19068,290790,81.48,11589616,375.564,41.8,18.571,42658.576,114.898,4.29,0.916,0
19,25,811,47500,155,7125,17193,307983,81.48,11589616,375.564,41.8,18.571,42658.576,114.898,4.29,0.916,0
19,26,388,47888,142,7267,13879,321862,81.48,11589616,375.564,41.8,18.571,42658.576,114.898,4.29,0.916,0
19,27,205,48093,154,7421,17472,339334,81.48,11589616,375.564,41.8,18.571,42658.576,114.898,4.29,0.916,0
19,28,755,48848,135,7556,20371,359705,81.48,11589616,375.564,41.8,18.571,42658.576,114.898,4.29,0.916,0
19,29,569,49417,110,7666,22660,382365,81.48,11589616,375.564,41.8,18.571,42658.576,114.898,4.29,0.916,0
19,30,522,49939,107,7773,24870,407235,81.48,11589616,375.564,41.8,18.571,42658.576,114.898,4.29,0.916,0
19,31,586,50525,87,7860,23551,430786,81.48,11589616,375.564,41.8,18.571,42658.576,114.898,4.29,0.916,0
19,32,237,50762,93,7953,16482,447268,81.48,11589616,375.564,41.8,18.571,42658.576,114.898,4.29,0.916,0
19,33,286,51048,75,8028,13430,460698,81.48,11589616,375.564,41.8,18.571,42658.576,114.898,4.29,0.916,0
19,34,140,51188,94,8122,23199,483897,81.48,11589616,375.564,41.8,18.571,42658.576,114.898,4.29,0.916,0
19,35,670,51858,95,8217,21521,505418,78.7,11589616,375.564,41.8,18.571,42658.576,114.898,4.29,0.916,0
19,36,546,52404,81,8298,20762,526180,78.7,11589616,375.564,41.8,18.571,42658.576,114.898,4.29,0.916,0
19,37,552,52956,76,8374,22031,548211,78.7,11589616,375.564,41.8,18.571,42658.576,114.898,4.29,0.916,0
19,38,442,53398,71,8445,25882,574093,78.7,11589616,375.564,41.8,18.571,42658.576,114.898,4.29,0.916,0
19,39,483,53881,74,8519,21012,595105,78.7,11589616,375.564,41.8,18.571,42658.576,114.898,4.29,0.916,0
19,40,240,54121,71,8590,12301,607406,78.7,11589616,375.564,41.8,18.571,42658.576,114.898,4.29,0.916,0
19,41,118,54239,72,8662,11055,618461,75,11589616,375.564,41.8,18.571,42658.576,114.898,4.29,0.916,0
19,42,476,54715,65,8727,20515,638976,75,11589616,375.564,41.8,18.571,42658.576,114.898,4.29,0.916,0
19,43,395,55110,45,8772,23140,662116,75,11589616,375.564,41.8,18.571,42658.576,114.898,4.29,0.916,0
19,44,321,55431,56,8828,20263,682379,75,11589616,375.564,41.8,18.571,42658.576,114.898,4.29,0.916,0
19,45,305,55736,43,8871,20884,703263,75,11589616,375.564,41.8,18.571,42658.576,114.898,4.29,0.916,0
19,46,346,56082,45,8916,14425,717688,75,11589616,375.564,41.8,18.571,42658.576,114.898,4.29,0.916,0
19,47,147,56229,30,8946,10103,727791,75,11589616,375.564,41.8,18.571,42658.576,114.898,4.29,0.916,0
19,48,81,56310,31,8977,10710,738501,75,11589616,375.564,41.8,18.571,42658.576,114.898,4.29,0.916,0
19,49,317,56627,37,9014,16701,755202,75,11589616,375.564,41.8,18.571,42658.576,114.898,4.29,0.916,0
19,50,292,56919,33,9047,18759,773961,75,11589616,375.564,41.8,18.571,42658.576,114.898,4.29,0.916,0
19,51,385,57304,30,9077,9878,783839,75,11589616,375.564,41.8,18.571,42658.576,114.898,4.29,0.916,0
19,52,70,57374,34,9111,13278,797117,75,11589616,375.564,41.8,18.571,42658.576,114.898,4.29,0.916,0
19,53,248,57622,41,9152,9227,806344,75,11589616,375.564,41.8,18.571,42658.576,114.898,4.29,0.916,0
19,54,123,57745,25,9177,7022,813366,75,11589616,375.564,41.8,18.571,42658.576,114.898,4.29,0.916,0
19,55,75,57820,33,9210,9982,823348,75,11589616,375.564,41.8,18.571,42658.576,114.898,4.29,0.916,0
19,56,314,58134,26,9236,16225,839573,75,11589616,375.564,41.8,18.571,42658.576,114.898,4.29,0.916,0
19,57,202,58336,24,9260,17772,857345,75,11589616,375.564,41.8,18.571,42658.576,114.898,4.29,0.916,0
19,58,182,58518,24,9284,13090,870435,75,11589616,375.564,41.8,18.571,42658.576,114.898,4.29,0.916,0
19,59,171,58689,26,9310,13616,884051,75,11589616,375.564,41.8,18.571,42658.576,114.898,4.29,0.916,0
19,60,165,58854,16,9326,9729,893780,75,11589616,375.564,41.8,18.571,42658.576,114.898,4.29,0.916,0
19,61,61,58915,23,9349,6795,900575,75,11589616,375.564,41.8,18.571,42658.576,114.898,4.29,0.916,0
19,62,49,58964,22,9371,5438,906013,75,11589616,375.564,41.8,18.571,42658.576,114.898,4.29,0.916,0
19,63,59,59023,21,9392,10656,916669,75,11589616,375.564,41.8,18.571,42658.576,114.898,4.29,0.916,0
19,64,181,59204,23,9415,14800,931469,75,11589616,375.564,41.8,18.571,42658.576,114.898,4.29,0.916,0
19,65,159,59363,20,9435,12842,944311,75,11589616,375.564,41.8,18.571,42658.576,114.898,4.29,0.916,0
19,66,172,59535,14,9449,13083,957394,73.15,11589616,375.564,41.8,18.571,42658.576,114.898,4.29,0.916,0
19,67,154,59689,12,9461,11865,969259,73.15,11589616,375.564,41.8,18.571,42658.576,114.898,4.29,0.916,0
19,68,69,59758,11,9472,7307,976566,73.15,11589616,375.564,41.8,18.571,42658.576,114.898,4.29,0.916,0
19,69,53,59811,12,9484,11013,987579,51.85,11589616,375.564,41.8,18.571,42658.576,114.898,4.29,0.916,0
19,70,152,59963,9,9493,15085,1002664,51.85,11589616,375.564,41.8,18.571,42658.576,114.898,4.29,0.916,0
19,71,145,60108,12,9505,14326,1016990,51.85,11589616,375.564,41.8,18.571,42658.576,114.898,4.29,0.916,0
19,72,119,60227,12,9517,13941,1030931,51.85,11589616,375.564,41.8,18.571,42658.576,114.898,4.29,0.916,0
19,73,95,60322,7,9524,13743,1044674,51.85,11589616,375.564,41.8,18.571,42658.576,114.898,4.29,0.916,0
19,74,89,60411,10,9534,12521,1057195,51.85,11589616,375.564,41.8,18.571,42658.576,114.898,4.29,0.916,0
19,75,49,60460,5,9539,6245,1063440,51.85,11589616,375.564,41.8,18.571,42658.576,114.898,4.29,0.916,0
19,76,22,60482,3,9542,11905,1075345,51.85,11589616,375.564,41.8,18.571,42658.576,114.898,4.29,0.916,0
19,77,147,60629,8,9550,15194,1090539,51.85,11589616,375.564,41.8,18.571,42658.576,114.898,4.29,0.916,0
19,78,99,60728,7,9557,15312,1105851,51.85,11589616,375.564,41.8,18.571,42658.576,114.898,4.29,0.916,0
19,79,123,60851,7,9564,13959,1119810,51.85,11589616,375.564,41.8,18.571,42658.576,114.898,4.29,0.916,0
19,80,108,60959,5,9569,13395,1133205,51.85,11589616,375.564,41.8,18.571,42658.576,114.898,4.29,0.916,0
19,81,121,61080,4,9573,12534,1145739,51.85,11589616,375.564,41.8,18.571,42658.576,114.898,4.29,0.916,0
19,82,50,61130,3,9576,6602,1152341,51.85,11589616,375.564,41.8,18.571,42658.576,114.898,4.29,0.916,0
19,83,20,61150,9,9585,11129,1163470,51.85,11589616,375.564,41.8,18.571,42658.576,114.898,4.29,0.916,0
19,84,143,61293,12,9597,17383,1180853,51.85,11589616,375.564,41.8,18.571,42658.576,114.898,4.29,0.916,0
19,85,110,61403,4,9601,18466,1199319,51.85,11589616,375.564,41.8,18.571,42658.576,114.898,4.29,0.916,0
19,86,100,61503,3,9604,15202,1214521,51.85,11589616,375.564,41.8,18.571,42658.576,114.898,4.29,0.916,0
19,87,76,61579,5,9609,14554,1229075,51.85,11589616,375.564,41.8,18.571,42658.576,114.898,4.29,0.916,0
19,88,113,61692,2,9611,10950,1240025,51.85,11589616,375.564,41.8,18.571,42658.576,114.898,4.29,0.916,0
19,89,41,61733,8,9619,6184,1246209,51.85,11589616,375.564,41.8,18.571,42658.576,114.898,4.29,0.916,0
19,90,24,61757,5,9624,11992,1258201,51.85,11589616,375.564,41.8,18.571,42658.576,114.898,4.29,0.916,0
19,91,127,61884,3,9627,16062,1274263,51.85,11589616,375.564,41.8,18.571,42658.576,114.898,4.29,0.916,0
19,92,100,61984,8,9635,15172,1289435,48.15,11589616,375.564,41.8,18.571,42658.576,114.898,4.29,0.916,0
19,93,135,62119,2,9637,13607,1303042,48.15,11589616,375.564,41.8,18.571,42658.576,114.898,4.29,0.916,0
19,94,93,62212,5,9642,12376,1315418,48.15,11589616,375.564,41.8,18.571,42658.576,114.898,4.29,0.916,0
19,95,94,62306,2,9644,10003,1325421,48.15,11589616,375.564,41.8,18.571,42658.576,114.898,4.29,0.916,0
19,96,64,62370,3,9647,5800,1331221,48.15,11589616,375.564,41.8,18.571,42658.576,114.898,4.29,0.916,0
19,97,24,62394,2,9649,10721,1341942,48.15,11589616,375.564,41.8,18.571,42658.576,114.898,4.29,0.916,0
19,98,112,62506,1,9650,13924,1355866,48.15,11589616,375.564,41.8,18.571,42658.576,114.898,4.29,0.916,0
19,99,99,62605,3,9653,13859,1369725,48.15,11589616,375.564,41.8,18.571,42658.576,114.898,4.29,0.916,0
19,100,137,62742,1,9654,12535,1382260,48.15,11589616,375.564,41.8,18.571,42658.576,114.898,4.29,0.916,0
19,101,124,62866,2,9656,12022,1394282,48.15,11589616,375.564,41.8,18.571,42658.576,114.898,4.29,0.916,0
19,102,127,62993,0,9656,9290,1403572,48.15,11589616,375.564,41.8,18.571,42658.576,114.898,4.29,0.916,0
19,103,62,63055,2,9658,5622,1409194,48.15,11589616,375.564,41.8,18.571,42658.576,114.898,4.29,0.916,0
19,104,43,63098,4,9662,10241,1419435,48.15,11589616,375.564,41.8,18.571,42658.576,114.898,4.29,0.916,0
19,105,224,63322,0,9662,15070,1434505,48.15,11589616,375.564,41.8,18.571,42658.576,114.898,4.29,0.916,0
19,106,207,63529,3,9665,16354,1450859,48.15,11589616,375.564,41.8,18.571,42658.576,114.898,4.29,0.916,0
19,107,260,63789,5,9670,14479,1465338,48.15,11589616,375.564,41.8,18.571,42658.576,114.898,4.29,0.916,0
19,108,226,64015,5,9675,13993,1479331,48.15,11589616,375.564,41.8,18.571,42658.576,114.898,4.29,0.916,0
19,109,274,64289,2,9677,10449,1489780,48.15,11589616,375.564,41.8,18.571,42658.576,114.898,4.29,0.916,0
19,110,130,64419,3,9680,6279,1496059,48.15,11589616,375.564,41.8,18.571,42658.576,114.898,4.29,0.916,0
19,111,64,64483,1,9681,11901,1507960,48.15,11589616,375.564,41.8,18.571,42658.576,114.898,4.29,0.916,0
19,112,443,64926,2,9683,11987,1519947,48.15,11589616,375.564,41.8,18.571,42658.576,114.898,4.29,0.916,0
19,113,145,65071,1,9684,13283,1533230,48.15,11589616,375.564,41.8,18.571,42658.576,114.898,4.29,0.916,0
19,114,553,65624,2,9686,18285,1551515,48.15,11589616,375.564,41.8,18.571,42658.576,114.898,4.29,0.916,0
19,115,439,66063,2,9688,18678,1570193,48.15,11589616,375.564,41.8,18.571,42658.576,114.898,4.29,0.916,0
19,116,496,66559,5,9693,14507,1584700,48.15,11589616,375.564,41.8,18.571,42658.576,114.898,4.29,0.916,0
19,117,229,66788,1,9694,10981,1595681,48.15,11589616,375.564,41.8,18.571,42658.576,114.898,4.29,0.916,0
19,118,184,66972,2,9696,14560,1610241,48.15,11589616,375.564,41.8,18.571,42658.576,114.898,4.29,0.916,0
19,119,595,67567,4,9700,25521,1635762,50.93,11589616,375.564,41.8,18.571,42658.576,114.898,4.29,0.916,0
19,120,685,68252,1,9701,25480,1661242,61.11,11589616,375.564,41.8,18.571,42658.576,114.898,4.29,0.916,0
19,121,703,68955,3,9704,26134,1687376,61.11,11589616,375.564,41.8,18.571,42658.576,114.898,4.29,0.916,0
19,122,635,69590,2,9706,21530,1708906,61.11,11589616,375.564,41.8,18.571,42658.576,114.898,4.29,0.916,0
19,123,684,70274,3,9709,20418,1729324,61.11,11589616,375.564,41.8,18.571,42658.576,114.898,4.29,0.916,0
19,124,309,70583,2,9711,11695,1741019,61.11,11589616,375.564,41.8,18.571,42658.576,114.898,4.29,0.916,0
19,125,148,70731,5,9716,16827,1757846,61.11,11589616,375.564,41.8,18.571,42658.576,114.898,4.29,0.916,0
19,126,794,71525,3,9719,25451,1783297,61.11,11589616,375.564,41.8,18.571,42658.576,114.898,4.29,0.916,0
19,127,813,72338,5,9724,26379,1809676,61.11,11589616,375.564,41.8,18.571,42658.576,114.898,4.29,0.916,0
19,128,767,73105,5,9729,23195,1832871,61.11,11589616,375.564,41.8,18.571,42658.576,114.898,4.29,0.916,0
19,129,769,73874,4,9733,22826,1855697,57.41,11589616,375.564,41.8,18.571,42658.576,114.898,4.29,0.916,0
19,130,771,74645,6,9739,16668,1872365,57.41,11589616,375.564,41.8,18.571,42658.576,114.898,4.29,0.916,0
19,131,304,74949,2,9741,9956,1882321,62.96,11589616,375.564,41.8,18.571,42658.576,114.898,4.29,0.916,0
19,132,122,75071,5,9746,17036,1899357,62.96,11589616,375.564,41.8,18.571,42658.576,114.898,4.29,0.916,0
19,133,873,75944,11,9757,25658,1925015,62.96,11589616,375.564,41.8,18.571,42658.576,114.898,4.29,0.916,0
19,134,718,76662,13,9770,22073,1947088,56.48,11589616,375.564,41.8,18.571,42658.576,114.898,4.29,0.916,0
19,135,609,77271,11,9781,21859,1968947,56.48,11589616,375.564,41.8,18.571,42658.576,114.898,4.29,0.916,0
19,136,669,77940,12,9793,18676,1987623,56.48,11589616,375.564,41.8,18.571,42658.576,114.898,4.29,0.916,0
19,137,587,78527,12,9805,12981,2000604,56.48,11589616,375.564,41.8,18.571,42658.576,114.898,4.29,0.916,0
19,138,163,78690,9,9814,8932,2009536,56.48,11589616,375.564,41.8,18.571,42658.576,114.898,4.29,0.916,0
19,139,132,78822,7,9821,17998,2027534,56.48,11589616,375.564,41.8,18.571,42658.576,114.898,4.29,0.916,0
19,140,707,79529,7,9828,27111,2054645,56.48,11589616,375.564,41.8,18.571,42658.576,114.898,4.29,0.916,0
19,141,725,80254,11,9839,23088,2077733,56.48,11589616,375.564,41.8,18.571,42658.576,114.898,4.29,0.916,0
19,142,612,80866,9,9848,23852,2101585,56.48,11589616,375.564,41.8,18.571,42658.576,114.898,4.29,0.916,0
19,143,581,81447,4,9852,20813,2122398,56.48,11589616,375.564,41.8,18.571,42658.576,114.898,4.29,0.916,0
19,144,510,81957,3,9855,15631,2138029,56.48,11589616,375.564,41.8,18.571,42658.576,114.898,4.29,0.916,0
19,145,203,82160,5,9860,8529,2146558,56.48,11589616,375.564,41.8,18.571,42658.576,114.898,4.29,0.916,0
19,146,115,82275,3,9863,17609,2164167,56.48,11589616,375.564,41.8,18.571,42658.576,114.898,4.29,0.916,0
19,147,607,82882,5,9868,27040,2191207,56.48,11589616,375.564,41.8,18.571,42658.576,114.898,4.29,0.916,0
19,148,527,83409,5,9873,24596,2215803,56.48,11589616,375.564,41.8,18.571,42658.576,114.898,4.29,0.916,0
19,149,526,83935,4,9877,21308,2237111,50.93,11589616,375.564,41.8,18.571,42658.576,114.898,4.29,0.916,0
19,150,535,84470,3,9880,25114,2262225,50.93,11589616,375.564,41.8,18.571,42658.576,114.898,4.29,0.916,0
19,151,614,85084,4,9884,19052,2281277,50.93,11589616,375.564,41.8,18.571,42658.576,114.898,4.29,0.916,0
19,152,195,85279,6,9890,10600,2291877,50.93,11589616,375.564,41.8,18.571,42658.576,114.898,4.29,0.916,0
19,153,117,85396,1,9891,19657,2311534,50.93,11589616,375.564,41.8,18.571,42658.576,114.898,4.29,0.916,0
19,154,634,86030,3,9894,28223,2339757,50.93,11589616,375.564,41.8,18.571,42658.576,114.898,4.29,0.916,0
19,155,565,86595,3,9897,30069,2369826,50.93,11589616,375.564,41.8,18.571,42658.576,114.898,4.29,0.916,0
19,156,574,87169,2,9899,24017,2393843,50.93,11589616,375.564,41.8,18.571,42658.576,114.898,4.29,0.916,0
19,157,677,87846,4,9903,26583,2420426,50.93,11589616,375.564,41.8,18.571,42658.576,114.898,4.29,0.916,0
19,158,728,88574,2,9905,19740,2440166,50.93,11589616,375.564,41.8,18.571,42658.576,114.898,4.29,0.916,0
19,159,322,88896,1,9906,10963,2451129,50.93,11589616,375.564,41.8,18.571,42658.576,114.898,4.29,0.916,0
19,160,155,89051,2,9908,23129,2474258,50.93,11589616,375.564,41.8,18.571,42658.576,114.898,4.29,0.916,0
19,161,918,89969,4,9912,35123,2509381,50.93,11589616,375.564,41.8,18.571,42658.576,114.898,4.29,0.916,0
19,162,871,90840,3,9915,35047,2544428,50.93,11589616,375.564,41.8,18.571,42658.576,114.898,4.29,0.916,0
19,163,1024,91864,2,9917,36232,2580660,50.93,11589616,375.564,41.8,18.571,42658.576,114.898,4.29,0.916,0
19,164,1143,93007,3,9920,38042,2618702,50.93,11589616,375.564,41.8,18.571,42658.576,114.898,4.29,0.916,0
19,165,1284,94291,5,9925,27126,2645828,50.93,11589616,375.564,41.8,18.571,42658.576,114.898,4.29,0.916,0
19,166,617,94908,1,9926,19155,2664983,50.93,11589616,375.564,41.8,18.571,42658.576,114.898,4.29,0.916,0
19,167,301,95209,1,9927,29307,2694290,50.93,11589616,375.564,41.8,18.571,42658.576,114.898,4.29,0.916,0
19,168,1724,96933,4,9931,42303,2736593,50.93,11589616,375.564,41.8,18.571,42658.576,114.898,4.29,0.916,0
19,169,1628,98561,3,9934,46674,2783267,50.93,11589616,375.564,41.8,18.571,42658.576,114.898,4.29,0.916,0
19,170,1941,100502,2,9936,43222,2826489,50.93,11589616,375.564,41.8,18.571,42658.576,114.898,4.29,0.916,0
19,171,1750,102252,1,9937,41428,2867917,50.93,11589616,375.564,41.8,18.571,42658.576,114.898,4.29,0.916,0
19,172,1709,103961,6,9943,26392,2894309,50.93,11589616,375.564,41.8,18.571,42658.576,114.898,4.29,0.916,0
19,173,894,104855,8,9951,21874,2916183,50.93,11589616,375.564,41.8,18.571,42658.576,114.898,4.29,0.916,0
19,174,461,105316,3,9954,34932,2951115,50.93,11589616,375.564,41.8,18.571,42658.576,114.898,4.29,0.916,0
19,175,2202,107518,3,9957,45049,2996164,50.93,11589616,375.564,41.8,18.571,42658.576,114.898,4.29,0.916,0
19,176,2074,109592,1,9958,44434,3040598,50.93,11589616,375.564,41.8,18.571,42658.576,114.898,4.29,0.916,0
19,177,2096,111688,8,9966,40555,3081153,50.93,11589616,375.564,41.8,18.571,42658.576,114.898,4.29,0.916,0
19,178,1795,113483,4,9970,37845,3118998,50.93,11589616,375.564,41.8,18.571,42658.576,114.898,4.29,0.916,0
19,179,1622,115105,5,9975,33430,3152428,50.93,11589616,375.564,41.8,18.571,42658.576,114.898,4.29,0.916,0
19,180,943,116048,6,9981,20314,3172742,50.93,11589616,375.564,41.8,18.571,42658.576,114.898,4.29,0.916,0
19,181,539,116587,12,9993,28510,3201252,50.93,11589616,375.564,41.8,18.571,42658.576,114.898,4.29,0.916,0
19,182,2777,119364,13,10006,47998,3249250,50.93,11589616,375.564,41.8,18.571,42658.576,114.898,4.29,0.916,0
19,183,2978,122342,9,10015,46261,3295511,45.37,11589616,375.564,41.8,18.571,42658.576,114.898,4.29,0.916,0
19,184,3239,125581,6,10021,41606,3337117,45.37,11589616,375.564,41.8,18.571,42658.576,114.898,4.29,0.916,0
19,185,3407,128988,15,10036,41719,3378836,45.37,11589616,375.564,41.8,18.571,42658.576,114.898,4.29,0.916,0
19,186,3721,132709,11,10047,34192,3413028,45.37,11589616,375.564,41.8,18.571,42658.576,114.898,4.29,0.916,0
19,187,1709,134418,15,10062,17955,3430983,45.37,11589616,375.564,41.8,18.571,42658.576,114.898,4.29,0.916,0
19,188,1035,135453,14,10076,27372,3458355,45.37,11589616,375.564,41.8,18.571,42658.576,114.898,4.29,0.916,0
19,189,5244,140697,14,10090,45641,3503996,45.37,11589616,375.564,41.8,18.571,42658.576,114.898,4.29,0.916,0
19,190,5686,146383,18,10108,54388,3558384,45.37,11589616,375.564,41.8,18.571,42658.576,114.898,4.29,0.916,0
19,191,6789,153172,20,10128,49752,3608136,45.37,11589616,375.564,41.8,18.571,42658.576,114.898,4.29,0.916,0
19,192,6580,159752,20,10148,53427,3661563,43.52,11589616,375.564,41.8,18.571,42658.576,114.898,4.29,0.916,0
19,193,7777,167529,19,10167,47375,3708938,43.52,11589616,375.564,41.8,18.571,42658.576,114.898,4.29,0.916,0
19,194,4305,171834,22,10189,30346,3739284,43.52,11589616,375.564,41.8,18.571,42658.576,114.898,4.29,0.916,0
19,195,2408,174242,25,10214,44505,3783789,43.52,11589616,375.564,41.8,18.571,42658.576,114.898,4.29,0.916,0
19,196,9650,183892,36,10250,59238,3843027,43.52,11589616,375.564,41.8,18.571,42658.576,114.898,4.29,0.916,0
19,197,12243,196135,34,10284,72324,3915351,43.52,11589616,375.564,41.8,18.571,42658.576,114.898,4.29,0.916,0
19,198,11464,207599,42,10326,65080,3980431,43.52,11589616,375.564,41.8,18.571,42658.576,114.898,4.29,0.916,0
19,199,10545,218144,35,10361,67241,4047672,43.52,11589616,375.564,41.8,18.571,42658.576,114.898,4.29,0.916,0
19,200,10906,229050,34,10395,61179,4108851,43.52,11589616,375.564,41.8,18.571,42658.576,114.898,4.29,0.916,0
19,201,5612,234662,21,10416,43669,4152520,43.52,11589616,375.564,41.8,18.571,42658.576,114.898,4.29,0.916,0
19,202,3045,237707,29,10445,0,4152520,52.78,11589616,375.564,41.8,18.571,42658.576,114.898,4.29,0.916,0
19,203,9650,237707,36,10445,59238,4152520,43.52,11589616,375.564,41.8,18.571,42658.576,114.898,4.29,0.916,0
19,204,5612,237707,21,10445,43669,4152520,43.52,11589616,375.564,41.8,18.571,42658.576,114.898,4.29,0.916,0
20,1,0,3,0,0,0,0,75,397621,16.426,25,3.853,7824.362,176.957,17.11,0.708,0
20,2,0,3,0,0,0,0,75,397621,16.426,25,3.853,7824.362,176.957,17.11,0.708,0
20,3,0,3,0,0,0,0,75,397621,16.426,25,3.853,7824.362,176.957,17.11,0.708,0
20,4,1,4,0,0,0,0,75,397621,16.426,25,3.853,7824.362,176.957,17.11,0.708,0
20,5,0,4,0,0,0,0,75,397621,16.426,25,3.853,7824.362,176.957,17.11,0.708,0
20,6,1,5,1,1,0,0,75,397621,16.426,25,3.853,7824.362,176.957,17.11,0.708,0
20,7,2,7,0,1,0,0,75,397621,16.426,25,3.853,7824.362,176.957,17.11,0.708,0
20,8,0,7,0,1,0,0,75,397621,16.426,25,3.853,7824.362,176.957,17.11,0.708,0
20,9,1,8,0,1,0,0,75,397621,16.426,25,3.853,7824.362,176.957,17.11,0.708,0
20,10,1,9,0,1,0,0,75,397621,16.426,25,3.853,7824.362,176.957,17.11,0.708,0
20,11,1,10,1,2,0,0,75,397621,16.426,25,3.853,7824.362,176.957,17.11,0.708,0
20,12,3,13,0,2,0,0,75,397621,16.426,25,3.853,7824.362,176.957,17.11,0.708,0
20,13,1,14,0,2,0,0,75,397621,16.426,25,3.853,7824.362,176.957,17.11,0.708,0
20,14,4,18,0,2,0,0,75,397621,16.426,25,3.853,7824.362,176.957,17.11,0.708,0
20,15,0,18,0,2,0,0,75,397621,16.426,25,3.853,7824.362,176.957,17.11,0.708,0
20,16,0,18,0,2,0,0,75,397621,16.426,25,3.853,7824.362,176.957,17.11,0.708,0
20,17,0,18,0,2,0,0,75,397621,16.426,25,3.853,7824.362,176.957,17.11,0.708,0
20,18,0,18,0,2,0,0,75,397621,16.426,25,3.853,7824.362,176.957,17.11,0.708,0
20,19,0,18,0,2,0,0,75,397621,16.426,25,3.853,7824.362,176.957,17.11,0.708,0
20,20,0,18,0,2,0,0,75,397621,16.426,25,3.853,7824.362,176.957,17.11,0.708,0
20,21,0,18,0,2,0,0,75,397621,16.426,25,3.853,7824.362,176.957,17.11,0.708,0
20,22,0,18,0,2,0,0,75,397621,16.426,25,3.853,7824.362,176.957,17.11,0.708,0
20,23,0,18,0,2,0,0,75,397621,16.426,25,3.853,7824.362,176.957,17.11,0.708,0
20,24,0,18,0,2,0,0,75,397621,16.426,25,3.853,7824.362,176.957,17.11,0.708,0
20,25,0,18,0,2,0,0,75,397621,16.426,25,3.853,7824.362,176.957,17.11,0.708,0
20,26,0,18,0,2,0,0,75,397621,16.426,25,3.853,7824.362,176.957,17.11,0.708,0
20,27,0,18,0,2,0,0,76.85,397621,16.426,25,3.853,7824.362,176.957,17.11,0.708,0
20,28,0,18,0,2,0,0,76.85,397621,16.426,25,3.853,7824.362,176.957,17.11,0.708,0
20,29,0,18,0,2,0,0,76.85,397621,16.426,25,3.853,7824.362,176.957,17.11,0.708,0
20,30,0,18,0,2,0,0,76.85,397621,16.426,25,3.853,7824.362,176.957,17.11,0.708,0
20,31,0,18,0,2,0,0,76.85,397621,16.426,25,3.853,7824.362,176.957,17.11,0.708,0
20,32,0,18,0,2,0,0,76.85,397621,16.426,25,3.853,7824.362,176.957,17.11,0.708,0
20,33,0,18,0,2,0,0,76.85,397621,16.426,25,3.853,7824.362,176.957,17.11,0.708,0
20,34,0,18,0,2,0,0,76.85,397621,16.426,25,3.853,7824.362,176.957,17.11,0.708,0
20,35,0,18,0,2,0,0,76.85,397621,16.426,25,3.853,7824.362,176.957,17.11,0.708,0
20,36,0,18,0,2,0,0,76.85,397621,16.426,25,3.853,7824.362,176.957,17.11,0.708,0
20,37,0,18,0,2,0,0,76.85,397621,16.426,25,3.853,7824.362,176.957,17.11,0.708,0
20,38,0,18,0,2,0,0,76.85,397621,16.426,25,3.853,7824.362,176.957,17.11,0.708,0
20,39,0,18,0,2,0,0,76.85,397621,16.426,25,3.853,7824.362,176.957,17.11,0.708,0
20,40,0,18,0,2,0,0,76.85,397621,16.426,25,3.853,7824.362,176.957,17.11,0.708,0
20,41,0,18,0,2,0,0,76.85,397621,16.426,25,3.853,7824.362,176.957,17.11,0.708,0
20,42,0,18,0,2,0,0,76.85,397621,16.426,25,3.853,7824.362,176.957,17.11,0.708,0
20,43,0,18,0,2,0,0,76.85,397621,16.426,25,3.853,7824.362,176.957,17.11,0.708,0
20,44,0,18,0,2,0,0,76.85,397621,16.426,25,3.853,7824.362,176.957,17.11,0.708,0
20,45,0,18,0,2,0,0,85.19,397621,16.426,25,3.853,7824.362,176.957,17.11,0.708,0
20,46,0,18,0,2,0,0,85.19,397621,16.426,25,3.853,7824.362,176.957,17.11,0.708,0
20,47,0,18,0,2,0,0,85.19,397621,16.426,25,3.853,7824.362,176.957,17.11,0.708,0
20,48,0,18,0,2,0,0,85.19,397621,16.426,25,3.853,7824.362,176.957,17.11,0.708,0
20,49,0,18,0,2,0,0,85.19,397621,16.426,25,3.853,7824.362,176.957,17.11,0.708,0
20,50,0,18,0,2,0,0,85.19,397621,16.426,25,3.853,7824.362,176.957,17.11,0.708,0
20,51,0,18,0,2,0,0,85.19,397621,16.426,25,3.853,7824.362,176.957,17.11,0.708,0
20,52,0,18,0,2,0,0,85.19,397621,16.426,25,3.853,7824.362,176.957,17.11,0.708,0
20,53,0,18,0,2,0,0,85.19,397621,16.426,25,3.853,7824.362,176.957,17.11,0.708,0
20,54,0,18,0,2,0,0,85.19,397621,16.426,25,3.853,7824.362,176.957,17.11,0.708,0
20,55,0,18,0,2,0,0,85.19,397621,16.426,25,3.853,7824.362,176.957,17.11,0.708,0
20,56,0,18,0,2,0,0,85.19,397621,16.426,25,3.853,7824.362,176.957,17.11,0.708,0
20,57,0,18,0,2,0,0,85.19,397621,16.426,25,3.853,7824.362,176.957,17.11,0.708,0
20,58,0,18,0,2,0,0,85.19,397621,16.426,25,3.853,7824.362,176.957,17.11,0.708,0
20,59,0,18,0,2,0,0,85.19,397621,16.426,25,3.853,7824.362,176.957,17.11,0.708,0
20,60,0,18,0,2,0,0,85.19,397621,16.426,25,3.853,7824.362,176.957,17.11,0.708,0
20,61,0,18,0,2,0,0,85.19,397621,16.426,25,3.853,7824.362,176.957,17.11,0.708,0
20,62,0,18,0,2,0,0,75.93,397621,16.426,25,3.853,7824.362,176.957,17.11,0.708,0
20,63,0,18,0,2,0,0,75.93,397621,16.426,25,3.853,7824.362,176.957,17.11,0.708,0
20,64,0,18,0,2,0,0,75.93,397621,16.426,25,3.853,7824.362,176.957,17.11,0.708,0
20,65,0,18,0,2,0,0,75.93,397621,16.426,25,3.853,7824.362,176.957,17.11,0.708,0
20,66,0,18,0,2,0,0,75.93,397621,16.426,25,3.853,7824.362,176.957,17.11,0.708,0
20,67,0,18,0,2,0,0,75.93,397621,16.426,25,3.853,7824.362,176.957,17.11,0.708,0
20,68,0,18,0,2,0,0,75.93,397621,16.426,25,3.853,7824.362,176.957,17.11,0.708,0
20,69,0,18,0,2,0,0,75.93,397621,16.426,25,3.853,7824.362,176.957,17.11,0.708,0
20,70,1,19,0,2,0,0,75.93,397621,16.426,25,3.853,7824.362,176.957,17.11,0.708,0
20,71,1,20,0,2,0,0,75.93,397621,16.426,25,3.853,7824.362,176.957,17.11,0.708,0
20,72,0,20,0,2,0,0,73.15,397621,16.426,25,3.853,7824.362,176.957,17.11,0.708,0
20,73,0,20,0,2,0,0,73.15,397621,16.426,25,3.853,7824.362,176.957,17.11,0.708,0
20,74,0,20,0,2,0,0,73.15,397621,16.426,25,3.853,7824.362,176.957,17.11,0.708,0
20,75,0,20,0,2,0,0,73.15,397621,16.426,25,3.853,7824.362,176.957,17.11,0.708,0
20,76,1,21,0,2,0,0,71.3,397621,16.426,25,3.853,7824.362,176.957,17.11,0.708,0
20,77,0,21,0,2,0,0,71.3,397621,16.426,25,3.853,7824.362,176.957,17.11,0.708,0
20,78,0,21,0,2,0,0,71.3,397621,16.426,25,3.853,7824.362,176.957,17.11,0.708,0
20,79,1,22,0,2,0,0,71.3,397621,16.426,25,3.853,7824.362,176.957,17.11,0.708,0
20,80,0,22,0,2,0,0,71.3,397621,16.426,25,3.853,7824.362,176.957,17.11,0.708,0
20,81,0,22,0,2,0,0,71.3,397621,16.426,25,3.853,7824.362,176.957,17.11,0.708,0
20,82,0,22,0,2,0,0,71.3,397621,16.426,25,3.853,7824.362,176.957,17.11,0.708,0
20,83,0,22,0,2,0,0,71.3,397621,16.426,25,3.853,7824.362,176.957,17.11,0.708,0
20,84,1,23,0,2,0,0,71.3,397621,16.426,25,3.853,7824.362,176.957,17.11,0.708,0
20,85,0,23,0,2,0,0,71.3,397621,16.426,25,3.853,7824.362,176.957,17.11,0.708,0
20,86,0,23,0,2,0,0,71.3,397621,16.426,25,3.853,7824.362,176.957,17.11,0.708,0
20,87,0,23,0,2,0,0,71.3,397621,16.426,25,3.853,7824.362,176.957,17.11,0.708,0
20,88,1,24,0,2,0,0,71.3,397621,16.426,25,3.853,7824.362,176.957,17.11,0.708,0
20,89,0,24,0,2,0,0,71.3,397621,16.426,25,3.853,7824.362,176.957,17.11,0.708,0
20,90,0,24,0,2,0,0,71.3,397621,16.426,25,3.853,7824.362,176.957,17.11,0.708,0
20,91,0,24,0,2,0,0,71.3,397621,16.426,25,3.853,7824.362,176.957,17.11,0.708,0
20,92,4,28,0,2,0,0,67.59,397621,16.426,25,3.853,7824.362,176.957,17.11,0.708,0
20,93,0,28,0,2,0,0,67.59,397621,16.426,25,3.853,7824.362,176.957,17.11,0.708,0
20,94,0,28,0,2,0,0,67.59,397621,16.426,25,3.853,7824.362,176.957,17.11,0.708,0
20,95,2,30,0,2,0,0,67.59,397621,16.426,25,3.853,7824.362,176.957,17.11,0.708,0
20,96,0,30,0,2,0,0,67.59,397621,16.426,25,3.853,7824.362,176.957,17.11,0.708,0
20,97,0,30,0,2,0,0,67.59,397621,16.426,25,3.853,7824.362,176.957,17.11,0.708,0
20,98,0,30,0,2,0,0,67.59,397621,16.426,25,3.853,7824.362,176.957,17.11,0.708,0
20,99,0,30,0,2,0,0,67.59,397621,16.426,25,3.853,7824.362,176.957,17.11,0.708,0
20,100,0,30,0,2,0,0,67.59,397621,16.426,25,3.853,7824.362,176.957,17.11,0.708,0
20,101,3,33,0,2,0,0,67.59,397621,16.426,25,3.853,7824.362,176.957,17.11,0.708,0
20,102,4,37,0,2,0,0,67.59,397621,16.426,25,3.853,7824.362,176.957,17.11,0.708,0
20,103,0,37,0,2,0,0,67.59,397621,16.426,25,3.853,7824.362,176.957,17.11,0.708,0
20,104,0,37,0,2,0,0,67.59,397621,16.426,25,3.853,7824.362,176.957,17.11,0.708,0
20,105,0,37,0,2,0,0,67.59,397621,16.426,25,3.853,7824.362,176.957,17.11,0.708,0
20,106,2,39,0,2,0,0,67.59,397621,16.426,25,3.853,7824.362,176.957,17.11,0.708,0
20,107,0,39,0,2,0,0,67.59,397621,16.426,25,3.853,7824.362,176.957,17.11,0.708,0
20,108,1,40,0,2,0,0,67.59,397621,16.426,25,3.853,7824.362,176.957,17.11,0.708,0
20,109,0,40,0,2,0,0,67.59,397621,16.426,25,3.853,7824.362,176.957,17.11,0.708,0
20,110,0,40,0,2,0,0,67.59,397621,16.426,25,3.853,7824.362,176.957,17.11,0.708,0
20,111,0,40,0,2,0,0,67.59,397621,16.426,25,3.853,7824.362,176.957,17.11,0.708,0
20,112,2,42,0,2,0,0,67.59,397621,16.426,25,3.853,7824.362,176.957,17.11,0.708,0
20,113,1,43,0,2,0,0,67.59,397621,16.426,25,3.853,7824.362,176.957,17.11,0.708,0
20,114,0,43,0,2,0,0,67.59,397621,16.426,25,3.853,7824.362,176.957,17.11,0.708,0
20,115,4,47,0,2,0,0,67.59,397621,16.426,25,3.853,7824.362,176.957,17.11,0.708,0
20,116,1,48,0,2,0,0,67.59,397621,16.426,25,3.853,7824.362,176.957,17.11,0.708,0
20,117,0,48,0,2,0,0,67.59,397621,16.426,25,3.853,7824.362,176.957,17.11,0.708,0
20,118,0,48,0,2,0,0,67.59,397621,16.426,25,3.853,7824.362,176.957,17.11,0.708,0
20,119,0,48,0,2,0,0,67.59,397621,16.426,25,3.853,7824.362,176.957,17.11,0.708,0
20,120,0,48,0,2,0,0,67.59,397621,16.426,25,3.853,7824.362,176.957,17.11,0.708,0
20,121,0,48,0,2,0,0,67.59,397621,16.426,25,3.853,7824.362,176.957,17.11,0.708,0
20,122,0,48,0,2,0,0,67.59,397621,16.426,25,3.853,7824.362,176.957,17.11,0.708,0
20,123,0,48,0,2,0,0,67.59,397621,16.426,25,3.853,7824.362,176.957,17.11,0.708,0
20,124,8,56,0,2,0,0,67.59,397621,16.426,25,3.853,7824.362,176.957,17.11,0.708,0
20,125,1,57,0,2,0,0,67.59,397621,16.426,25,3.853,7824.362,176.957,17.11,0.708,0
20,126,0,57,0,2,0,0,67.59,397621,16.426,25,3.853,7824.362,176.957,17.11,0.708,0
20,127,15,72,0,2,0,0,67.59,397621,16.426,25,3.853,7824.362,176.957,17.11,0.708,0
20,128,14,86,0,2,0,0,67.59,397621,16.426,25,3.853,7824.362,176.957,17.11,0.708,0
20,129,28,114,0,2,0,0,70.83,397621,16.426,25,3.853,7824.362,176.957,17.11,0.708,0
20,130,32,146,0,2,0,0,70.83,397621,16.426,25,3.853,7824.362,176.957,17.11,0.708,0
20,131,7,153,0,2,0,0,70.83,397621,16.426,25,3.853,7824.362,176.957,17.11,0.708,0
20,132,1,154,0,2,0,0,70.83,397621,16.426,25,3.853,7824.362,176.957,17.11,0.708,0
20,133,23,177,0,2,0,0,70.83,397621,16.426,25,3.853,7824.362,176.957,17.11,0.708,0
20,134,33,210,0,2,0,0,70.83,397621,16.426,25,3.853,7824.362,176.957,17.11,0.708,0
20,135,86,296,0,2,0,0,70.83,397621,16.426,25,3.853,7824.362,176.957,17.11,0.708,0
20,136,60,356,0,2,0,0,70.83,397621,16.426,25,3.853,7824.362,176.957,17.11,0.708,0
20,137,32,388,1,3,0,0,70.83,397621,16.426,25,3.853,7824.362,176.957,17.11,0.708,0
20,138,64,452,0,3,0,0,70.83,397621,16.426,25,3.853,7824.362,176.957,17.11,0.708,0
20,139,0,452,0,3,0,0,70.83,397621,16.426,25,3.853,7824.362,176.957,17.11,0.708,0
20,140,23,475,1,4,0,0,70.83,397621,16.426,25,3.853,7824.362,176.957,17.11,0.708,0
20,141,78,553,0,4,0,0,70.83,397621,16.426,25,3.853,7824.362,176.957,17.11,0.708,0
20,142,0,553,1,5,0,0,70.83,397621,16.426,25,3.853,7824.362,176.957,17.11,0.708,0
20,143,52,605,0,5,0,0,70.83,397621,16.426,25,3.853,7824.362,176.957,17.11,0.708,0
20,144,43,648,0,5,0,0,70.83,397621,16.426,25,3.853,7824.362,176.957,17.11,0.708,0
20,145,20,668,1,6,0,0,70.83,397621,16.426,25,3.853,7824.362,176.957,17.11,0.708,0
20,146,18,686,0,6,0,0,70.83,397621,16.426,25,3.853,7824.362,176.957,17.11,0.708,0
20,147,27,713,4,10,0,0,70.83,397621,16.426,25,3.853,7824.362,176.957,17.11,0.708,0
20,148,17,730,0,10,0,0,70.83,397621,16.426,25,3.853,7824.362,176.957,17.11,0.708,0
20,149,30,760,1,11,0,0,70.83,397621,16.426,25,3.853,7824.362,176.957,17.11,0.708,0
20,150,58,818,1,12,0,0,70.83,397621,16.426,25,3.853,7824.362,176.957,17.11,0.708,0
20,151,52,870,0,12,0,0,70.83,397621,16.426,25,3.853,7824.362,176.957,17.11,0.708,0
20,152,94,964,1,13,0,0,70.83,397621,16.426,25,3.853,7824.362,176.957,17.11,0.708,0
20,153,30,994,0,13,0,0,70.83,397621,16.426,25,3.853,7824.362,176.957,17.11,0.708,0
20,154,13,1007,0,13,0,0,70.83,397621,16.426,25,3.853,7824.362,176.957,17.11,0.708,0
20,155,43,1050,0,13,0,0,72.22,397621,16.426,25,3.853,7824.362,176.957,17.11,0.708,0
20,156,51,1101,0,13,0,0,72.22,397621,16.426,25,3.853,7824.362,176.957,17.11,0.708,0
20,157,17,1118,0,13,0,0,72.22,397621,16.426,25,3.853,7824.362,176.957,17.11,0.708,0
20,158,34,1152,2,15,0,0,72.22,397621,16.426,25,3.853,7824.362,176.957,17.11,0.708,0
20,159,42,1194,0,15,0,0,72.22,397621,16.426,25,3.853,7824.362,176.957,17.11,0.708,0
20,160,67,1261,0,15,0,0,72.22,397621,16.426,25,3.853,7824.362,176.957,17.11,0.708,0
20,161,46,1307,1,16,0,0,72.22,397621,16.426,25,3.853,7824.362,176.957,17.11,0.708,0
20,162,54,1361,0,16,0,0,72.22,397621,16.426,25,3.853,7824.362,176.957,17.11,0.708,0
20,163,4,1365,2,18,0,0,72.22,397621,16.426,25,3.853,7824.362,176.957,17.11,0.708,0
20,164,34,1399,1,19,0,0,72.22,397621,16.426,25,3.853,7824.362,176.957,17.11,0.708,0
20,165,36,1435,0,19,0,0,72.22,397621,16.426,25,3.853,7824.362,176.957,17.11,0.708,0
20,166,23,1458,0,19,0,0,72.22,397621,16.426,25,3.853,7824.362,176.957,17.11,0.708,0
20,167,22,1480,0,19,0,0,72.22,397621,16.426,25,3.853,7824.362,176.957,17.11,0.708,0
20,168,21,1501,0,19,0,0,72.22,397621,16.426,25,3.853,7824.362,176.957,17.11,0.708,0
20,169,27,1528,0,19,0,0,72.22,397621,16.426,25,3.853,7824.362,176.957,17.11,0.708,0
20,170,8,1536,0,19,0,0,72.22,397621,16.426,25,3.853,7824.362,176.957,17.11,0.708,0
20,171,31,1567,0,19,0,0,72.22,397621,16.426,25,3.853,7824.362,176.957,17.11,0.708,0
20,172,23,1590,1,20,0,0,72.22,397621,16.426,25,3.853,7824.362,176.957,17.11,0.708,0
20,173,16,1606,0,20,0,0,72.22,397621,16.426,25,3.853,7824.362,176.957,17.11,0.708,0
20,174,21,1627,1,21,0,0,72.22,397621,16.426,25,3.853,7824.362,176.957,17.11,0.708,0
20,175,8,1635,0,21,0,0,72.22,397621,16.426,25,3.853,7824.362,176.957,17.11,0.708,0
20,176,34,1669,0,21,0,0,72.22,397621,16.426,25,3.853,7824.362,176.957,17.11,0.708,0
20,177,37,1706,1,22,0,0,72.22,397621,16.426,25,3.853,7824.362,176.957,17.11,0.708,0
20,178,52,1758,0,22,0,0,72.22,397621,16.426,25,3.853,7824.362,176.957,17.11,0.708,0
20,179,50,1808,1,23,0,0,72.22,397621,16.426,25,3.853,7824.362,176.957,17.11,0.708,0
20,180,17,1825,1,24,0,0,72.22,397621,16.426,25,3.853,7824.362,176.957,17.11,0.708,0
20,181,29,1854,0,24,0,0,72.22,397621,16.426,25,3.853,7824.362,176.957,17.11,0.708,0
20,182,37,1891,0,24,0,0,72.22,397621,16.426,25,3.853,7824.362,176.957,17.11,0.708,0
20,183,52,1943,2,26,0,0,72.22,397621,16.426,25,3.853,7824.362,176.957,17.11,0.708,0
20,184,49,1992,1,27,0,0,69.44,397621,16.426,25,3.853,7824.362,176.957,17.11,0.708,0
20,185,34,2026,0,27,0,0,69.44,397621,16.426,25,3.853,7824.362,176.957,17.11,0.708,0
20,186,54,2080,1,28,0,0,69.44,397621,16.426,25,3.853,7824.362,176.957,17.11,0.708,0
20,187,51,2131,1,29,0,0,69.44,397621,16.426,25,3.853,7824.362,176.957,17.11,0.708,0
20,188,65,2196,1,30,0,0,69.44,397621,16.426,25,3.853,7824.362,176.957,17.11,0.708,0
20,189,8,2204,0,30,0,0,69.44,397621,16.426,25,3.853,7824.362,176.957,17.11,0.708,0
20,190,39,2243,4,34,0,0,69.44,397621,16.426,25,3.853,7824.362,176.957,17.11,0.708,0
20,191,67,2310,0,34,0,0,69.44,397621,16.426,25,3.853,7824.362,176.957,17.11,0.708,0
20,192,63,2373,0,34,0,0,69.44,397621,16.426,25,3.853,7824.362,176.957,17.11,0.708,0
20,193,0,2373,0,34,0,0,69.44,397621,16.426,25,3.853,7824.362,176.957,17.11,0.708,0
20,194,54,2427,1,35,0,0,69.44,397621,16.426,25,3.853,7824.362,176.957,17.11,0.708,0
20,195,0,2427,0,35,0,0,69.44,397621,16.426,25,3.853,7824.362,176.957,17.11,0.708,0
20,196,142,2569,2,37,0,0,69.44,397621,16.426,25,3.853,7824.362,176.957,17.11,0.708,0
20,197,16,2585,2,39,0,0,69.44,397621,16.426,25,3.853,7824.362,176.957,17.11,0.708,0
20,198,34,2619,1,40,0,0,69.44,397621,16.426,25,3.853,7824.362,176.957,17.11,0.708,0
20,199,63,2682,1,41,0,0,69.44,397621,16.426,25,3.853,7824.362,176.957,17.11,0.708,0
20,200,46,2728,2,43,0,0,69.44,397621,16.426,25,3.853,7824.362,176.957,17.11,0.708,0
20,201,47,2775,0,43,0,0,69.44,397621,16.426,25,3.853,7824.362,176.957,17.11,0.708,0
20,202,38,2813,1,44,0,0,69.44,397621,16.426,25,3.853,7824.362,176.957,17.11,0.708,0
20,203,20,2833,1,45,0,0,69.44,397621,16.426,25,3.853,7824.362,176.957,17.11,0.708,0
20,204,53,2886,0,45,0,0,69.44,397621,16.426,25,3.853,7824.362,176.957,17.11,0.708,0
21,1,2,8,0,0,0,0,70.83,12123198,99.11,18.8,3.244,2064.236,235.848,0.99,0.515,0
21,2,5,13,0,0,0,0,70.83,12123198,99.11,18.8,3.244,2064.236,235.848,0.99,0.515,0
21,3,0,13,0,0,0,0,70.83,12123198,99.11,18.8,3.244,2064.236,235.848,0.99,0.515,0
21,4,3,16,0,0,0,0,70.83,12123198,99.11,18.8,3.244,2064.236,235.848,0.99,0.515,0
21,5,0,16,0,0,0,0,70.83,12123198,99.11,18.8,3.244,2064.236,235.848,0.99,0.515,0
21,6,6,22,0,0,0,0,70.83,12123198,99.11,18.8,3.244,2064.236,235.848,0.99,0.515,0
21,7,4,26,1,1,0,0,70.83,12123198,99.11,18.8,3.244,2064.236,235.848,0.99,0.515,0
21,8,0,26,0,1,0,0,70.83,12123198,99.11,18.8,3.244,2064.236,235.848,0.99,0.515,0
21,9,0,26,0,1,0,0,70.83,12123198,99.11,18.8,3.244,2064.236,235.848,0.99,0.515,0
21,10,4,30,0,1,0,0,70.83,12123198,99.11,18.8,3.244,2064.236,235.848,0.99,0.515,0
21,11,5,35,0,1,0,0,70.83,12123198,99.11,18.8,3.244,2064.236,235.848,0.99,0.515,0
21,12,0,35,0,1,0,0,70.83,12123198,99.11,18.8,3.244,2064.236,235.848,0.99,0.515,0
21,13,0,35,0,1,0,0,70.83,12123198,99.11,18.8,3.244,2064.236,235.848,0.99,0.515,0
21,14,0,35,0,1,0,0,70.83,12123198,99.11,18.8,3.244,2064.236,235.848,0.99,0.515,0
21,15,0,35,0,1,0,0,70.83,12123198,99.11,18.8,3.244,2064.236,235.848,0.99,0.515,0
21,16,0,35,0,1,0,0,70.83,12123198,99.11,18.8,3.244,2064.236,235.848,0.99,0.515,0
21,17,2,37,0,1,0,0,70.83,12123198,99.11,18.8,3.244,2064.236,235.848,0.99,0.515,0
21,18,0,37,0,1,0,0,70.83,12123198,99.11,18.8,3.244,2064.236,235.848,0.99,0.515,0
21,19,0,37,0,1,0,0,70.83,12123198,99.11,18.8,3.244,2064.236,235.848,0.99,0.515,0
21,20,0,37,0,1,0,0,70.83,12123198,99.11,18.8,3.244,2064.236,235.848,0.99,0.515,0
21,21,17,54,0,1,0,0,70.83,12123198,99.11,18.8,3.244,2064.236,235.848,0.99,0.515,0
21,22,0,54,0,1,0,0,70.83,12123198,99.11,18.8,3.244,2064.236,235.848,0.99,0.515,0
21,23,0,54,0,1,0,0,70.83,12123198,99.11,18.8,3.244,2064.236,235.848,0.99,0.515,0
21,24,4,58,0,1,0,0,70.83,12123198,99.11,18.8,3.244,2064.236,235.848,0.99,0.515,0
21,25,0,58,0,1,0,0,70.83,12123198,99.11,18.8,3.244,2064.236,235.848,0.99,0.515,0
21,26,0,58,0,1,0,0,70.83,12123198,99.11,18.8,3.244,2064.236,235.848,0.99,0.515,0
21,27,6,64,0,1,0,0,70.83,12123198,99.11,18.8,3.244,2064.236,235.848,0.99,0.515,0
21,28,0,64,0,1,0,0,70.83,12123198,99.11,18.8,3.244,2064.236,235.848,0.99,0.515,0
21,29,0,64,0,1,0,0,70.83,12123198,99.11,18.8,3.244,2064.236,235.848,0.99,0.515,0
21,30,5,69,1,2,0,0,70.83,12123198,99.11,18.8,3.244,2064.236,235.848,0.99,0.515,0
21,31,15,84,0,2,0,0,70.83,12123198,99.11,18.8,3.244,2064.236,235.848,0.99,0.515,0
21,32,6,90,0,2,0,0,70.83,12123198,99.11,18.8,3.244,2064.236,235.848,0.99,0.515,0
21,33,0,90,0,2,0,0,70.83,12123198,99.11,18.8,3.244,2064.236,235.848,0.99,0.515,0
21,34,0,90,0,2,0,0,70.83,12123198,99.11,18.8,3.244,2064.236,235.848,0.99,0.515,0
21,35,6,96,0,2,0,0,70.83,12123198,99.11,18.8,3.244,2064.236,235.848,0.99,0.515,0
21,36,0,96,0,2,0,0,70.83,12123198,99.11,18.8,3.244,2064.236,235.848,0.99,0.515,0
21,37,6,102,0,2,0,0,70.83,12123198,99.11,18.8,3.244,2064.236,235.848,0.99,0.515,0
21,38,38,140,0,2,0,0,70.83,12123198,99.11,18.8,3.244,2064.236,235.848,0.99,0.515,0
21,39,102,242,0,2,0,0,70.83,12123198,99.11,18.8,3.244,2064.236,235.848,0.99,0.515,0
21,40,42,284,0,2,0,0,70.83,12123198,99.11,18.8,3.244,2064.236,235.848,0.99,0.515,0
21,41,35,319,0,2,0,0,57.41,12123198,99.11,18.8,3.244,2064.236,235.848,0.99,0.515,0
21,42,0,319,0,2,0,0,57.41,12123198,99.11,18.8,3.244,2064.236,235.848,0.99,0.515,0
21,43,8,327,0,2,0,0,57.41,12123198,99.11,18.8,3.244,2064.236,235.848,0.99,0.515,0
21,44,0,327,0,2,0,0,57.41,12123198,99.11,18.8,3.244,2064.236,235.848,0.99,0.515,0
21,45,12,339,0,2,0,0,57.41,12123198,99.11,18.8,3.244,2064.236,235.848,0.99,0.515,0
21,46,0,339,0,2,0,0,57.41,12123198,99.11,18.8,3.244,2064.236,235.848,0.99,0.515,0
21,47,0,339,0,2,0,0,62.96,12123198,99.11,18.8,3.244,2064.236,235.848,0.99,0.515,0
21,48,0,339,0,2,0,0,57.41,12123198,99.11,18.8,3.244,2064.236,235.848,0.99,0.515,0
21,49,0,339,0,2,0,0,57.41,12123198,99.11,18.8,3.244,2064.236,235.848,0.99,0.515,0
21,50,-209,130,0,2,0,0,57.41,12123198,99.11,18.8,3.244,2064.236,235.848,0.99,0.515,0
21,51,0,130,0,2,0,0,57.41,12123198,99.11,18.8,3.244,2064.236,235.848,0.99,0.515,0
21,52,5,135,1,3,0,0,57.41,12123198,99.11,18.8,3.244,2064.236,235.848,0.99,0.515,0
21,53,0,135,0,3,0,0,57.41,12123198,99.11,18.8,3.244,2064.236,235.848,0.99,0.515,0
21,54,0,135,0,3,0,0,57.41,12123198,99.11,18.8,3.244,2064.236,235.848,0.99,0.515,0
21,55,56,191,0,3,0,0,57.41,12123198,99.11,18.8,3.244,2064.236,235.848,0.99,0.515,0
21,56,0,191,0,3,0,0,57.41,12123198,99.11,18.8,3.244,2064.236,235.848,0.99,0.515,0
21,57,17,208,0,3,0,0,57.41,12123198,99.11,18.8,3.244,2064.236,235.848,0.99,0.515,0
21,58,2,210,0,3,0,0,57.41,12123198,99.11,18.8,3.244,2064.236,235.848,0.99,0.515,0
21,59,0,210,0,3,0,0,57.41,12123198,99.11,18.8,3.244,2064.236,235.848,0.99,0.515,0
21,60,14,224,0,3,0,0,57.41,12123198,99.11,18.8,3.244,2064.236,235.848,0.99,0.515,0
21,61,8,232,0,3,0,0,57.41,12123198,99.11,18.8,3.244,2064.236,235.848,0.99,0.515,0
21,62,0,232,0,3,0,0,57.41,12123198,99.11,18.8,3.244,2064.236,235.848,0.99,0.515,0
21,63,11,243,0,3,0,0,41.67,12123198,99.11,18.8,3.244,2064.236,235.848,0.99,0.515,0
21,64,1,244,0,3,0,0,41.67,12123198,99.11,18.8,3.244,2064.236,235.848,0.99,0.515,0
21,65,0,244,0,3,0,0,41.67,12123198,99.11,18.8,3.244,2064.236,235.848,0.99,0.515,0
21,66,17,261,0,3,0,0,41.67,12123198,99.11,18.8,3.244,2064.236,235.848,0.99,0.515,0
21,67,0,261,0,3,0,0,41.67,12123198,99.11,18.8,3.244,2064.236,235.848,0.99,0.515,0
21,68,7,268,1,4,0,0,41.67,12123198,99.11,18.8,3.244,2064.236,235.848,0.99,0.515,0
21,69,0,268,0,4,0,0,41.67,12123198,99.11,18.8,3.244,2064.236,235.848,0.99,0.515,0
21,70,37,305,0,4,0,0,41.67,12123198,99.11,18.8,3.244,2064.236,235.848,0.99,0.515,0
21,71,0,305,0,4,0,0,41.67,12123198,99.11,18.8,3.244,2064.236,235.848,0.99,0.515,0
21,72,0,305,0,4,0,0,41.67,12123198,99.11,18.8,3.244,2064.236,235.848,0.99,0.515,0
21,73,0,305,0,4,0,0,41.67,12123198,99.11,18.8,3.244,2064.236,235.848,0.99,0.515,0
21,74,83,388,1,5,0,0,41.67,12123198,99.11,18.8,3.244,2064.236,235.848,0.99,0.515,0
21,75,24,412,1,6,0,0,41.67,12123198,99.11,18.8,3.244,2064.236,235.848,0.99,0.515,0
21,76,58,470,1,7,0,0,41.67,12123198,99.11,18.8,3.244,2064.236,235.848,0.99,0.515,0
21,77,13,483,2,9,0,0,41.67,12123198,99.11,18.8,3.244,2064.236,235.848,0.99,0.515,0
21,78,49,532,0,9,0,0,41.67,12123198,99.11,18.8,3.244,2064.236,235.848,0.99,0.515,0
21,79,40,572,0,9,0,0,41.67,12123198,99.11,18.8,3.244,2064.236,235.848,0.99,0.515,0
21,80,25,597,2,11,0,0,41.67,12123198,99.11,18.8,3.244,2064.236,235.848,0.99,0.515,0
21,81,53,650,0,11,0,0,41.67,12123198,99.11,18.8,3.244,2064.236,235.848,0.99,0.515,0
21,82,0,650,0,11,0,0,41.67,12123198,99.11,18.8,3.244,2064.236,235.848,0.99,0.515,0
21,83,115,765,2,13,0,0,41.67,12123198,99.11,18.8,3.244,2064.236,235.848,0.99,0.515,0
21,84,42,807,0,13,0,0,41.67,12123198,99.11,18.8,3.244,2064.236,235.848,0.99,0.515,0
21,85,43,850,0,13,0,0,41.67,12123198,99.11,18.8,3.244,2064.236,235.848,0.99,0.515,0
21,86,52,902,0,13,0,0,41.67,12123198,99.11,18.8,3.244,2064.236,235.848,0.99,0.515,0
21,87,115,1017,1,14,0,0,41.67,12123198,99.11,18.8,3.244,2064.236,235.848,0.99,0.515,0
21,88,36,1053,0,14,0,0,41.67,12123198,99.11,18.8,3.244,2064.236,235.848,0.99,0.515,0
21,89,71,1124,0,14,0,0,41.67,12123198,99.11,18.8,3.244,2064.236,235.848,0.99,0.515,0
21,90,25,1149,2,16,0,0,41.67,12123198,99.11,18.8,3.244,2064.236,235.848,0.99,0.515,0
21,91,38,1187,3,19,0,0,41.67,12123198,99.11,18.8,3.244,2064.236,235.848,0.99,0.515,0
21,92,12,1199,2,21,0,0,41.67,12123198,99.11,18.8,3.244,2064.236,235.848,0.99,0.515,0
21,93,0,1199,0,21,0,0,41.67,12123198,99.11,18.8,3.244,2064.236,235.848,0.99,0.515,0
21,94,0,1199,0,21,0,0,41.67,12123198,99.11,18.8,3.244,2064.236,235.848,0.99,0.515,0
21,95,0,1199,0,21,0,0,41.67,12123198,99.11,18.8,3.244,2064.236,235.848,0.99,0.515,0
21,96,0,1199,0,21,0,0,41.67,12123198,99.11,18.8,3.244,2064.236,235.848,0.99,0.515,0
21,97,0,1199,0,21,0,0,41.67,12123198,99.11,18.8,3.244,2064.236,235.848,0.99,0.515,0
21,98,0,1199,0,21,0,0,41.67,12123198,99.11,18.8,3.244,2064.236,235.848,0.99,0.515,0
21,99,0,1199,0,21,0,0,41.67,12123198,99.11,18.8,3.244,2064.236,235.848,0.99,0.515,0
21,100,86,1285,2,23,0,0,41.67,12123198,99.11,18.8,3.244,2064.236,235.848,0.99,0.515,0
21,101,0,1285,0,23,0,0,41.67,12123198,99.11,18.8,3.244,2064.236,235.848,0.99,0.515,0
21,102,0,1285,0,23,0,0,41.67,12123198,99.11,18.8,3.244,2064.236,235.848,0.99,0.515,0
21,103,93,1378,3,26,0,0,41.67,12123198,99.11,18.8,3.244,2064.236,235.848,0.99,0.515,0
21,104,0,1378,0,26,0,0,41.67,12123198,99.11,18.8,3.244,2064.236,235.848,0.99,0.515,0
21,105,0,1378,0,26,0,0,41.67,12123198,99.11,18.8,3.244,2064.236,235.848,0.99,0.515,0
21,106,0,1378,0,26,0,0,41.67,12123198,99.11,18.8,3.244,2064.236,235.848,0.99,0.515,0
21,107,0,1378,0,26,0,0,41.67,12123198,99.11,18.8,3.244,2064.236,235.848,0.99,0.515,0
21,108,85,1463,2,28,0,0,41.67,12123198,99.11,18.8,3.244,2064.236,235.848,0.99,0.515,0
21,109,139,1602,3,31,0,0,41.67,12123198,99.11,18.8,3.244,2064.236,235.848,0.99,0.515,0
21,110,0,1602,0,31,0,0,41.67,12123198,99.11,18.8,3.244,2064.236,235.848,0.99,0.515,0
21,111,0,1602,0,31,0,0,41.67,12123198,99.11,18.8,3.244,2064.236,235.848,0.99,0.515,0
21,112,0,1602,0,31,0,0,41.67,12123198,99.11,18.8,3.244,2064.236,235.848,0.99,0.515,0
21,113,0,1602,0,31,0,0,41.67,12123198,99.11,18.8,3.244,2064.236,235.848,0.99,0.515,0
21,114,0,1602,0,31,0,0,41.67,12123198,99.11,18.8,3.244,2064.236,235.848,0.99,0.515,0
21,115,92,1694,3,34,0,0,41.67,12123198,99.11,18.8,3.244,2064.236,235.848,0.99,0.515,0
21,116,0,1694,0,34,0,0,41.67,12123198,99.11,18.8,3.244,2064.236,235.848,0.99,0.515,0
21,117,0,1694,0,34,0,0,41.67,12123198,99.11,18.8,3.244,2064.236,235.848,0.99,0.515,0
21,118,76,1770,1,35,0,0,41.67,12123198,99.11,18.8,3.244,2064.236,235.848,0.99,0.515,0
21,119,0,1770,0,35,0,0,41.67,12123198,99.11,18.8,3.244,2064.236,235.848,0.99,0.515,0
21,120,0,1770,0,35,0,0,41.67,12123198,99.11,18.8,3.244,2064.236,235.848,0.99,0.515,0
21,121,0,1770,0,35,0,0,41.67,12123198,99.11,18.8,3.244,2064.236,235.848,0.99,0.515,0
21,122,0,1770,0,35,0,0,41.67,12123198,99.11,18.8,3.244,2064.236,235.848,0.99,0.515,0
21,123,35,1805,1,36,0,0,41.67,12123198,99.11,18.8,3.244,2064.236,235.848,0.99,0.515,0
21,124,0,1805,0,36,0,0,41.67,12123198,99.11,18.8,3.244,2064.236,235.848,0.99,0.515,0
21,125,0,1805,0,36,0,0,41.67,12123198,99.11,18.8,3.244,2064.236,235.848,0.99,0.515,0
21,126,0,1805,0,36,0,0,41.67,12123198,99.11,18.8,3.244,2064.236,235.848,0.99,0.515,0
21,127,109,1914,2,38,0,0,41.67,12123198,99.11,18.8,3.244,2064.236,235.848,0.99,0.515,0
21,128,0,1914,0,38,0,0,41.67,12123198,99.11,18.8,3.244,2064.236,235.848,0.99,0.515,0
21,129,22,1936,0,38,0,0,41.67,12123198,99.11,18.8,3.244,2064.236,235.848,0.99,0.515,0
21,130,0,1936,0,38,0,0,41.67,12123198,99.11,18.8,3.244,2064.236,235.848,0.99,0.515,0
21,131,0,1936,0,38,0,0,41.67,12123198,99.11,18.8,3.244,2064.236,235.848,0.99,0.515,0
21,132,0,1936,0,38,0,0,41.67,12123198,99.11,18.8,3.244,2064.236,235.848,0.99,0.515,0
21,133,0,1936,0,38,0,0,41.67,12123198,99.11,18.8,3.244,2064.236,235.848,0.99,0.515,0
21,134,65,2001,0,38,0,0,41.67,12123198,99.11,18.8,3.244,2064.236,235.848,0.99,0.515,0
21,135,0,2001,0,38,0,0,41.67,12123198,99.11,18.8,3.244,2064.236,235.848,0.99,0.515,0
21,136,0,2001,0,38,0,0,41.67,12123198,99.11,18.8,3.244,2064.236,235.848,0.99,0.515,0
21,137,0,2001,0,38,0,0,41.67,12123198,99.11,18.8,3.244,2064.236,235.848,0.99,0.515,0
21,138,62,2063,1,39,0,0,41.67,12123198,99.11,18.8,3.244,2064.236,235.848,0.99,0.515,0
21,139,0,2063,0,39,0,0,41.67,12123198,99.11,18.8,3.244,2064.236,235.848,0.99,0.515,0
21,140,0,2063,0,39,0,0,41.67,12123198,99.11,18.8,3.244,2064.236,235.848,0.99,0.515,0
21,141,0,2063,0,39,0,0,41.67,12123198,99.11,18.8,3.244,2064.236,235.848,0.99,0.515,0
21,142,0,2063,0,39,0,0,41.67,12123198,99.11,18.8,3.244,2064.236,235.848,0.99,0.515,0
21,143,32,2095,0,39,0,0,41.67,12123198,99.11,18.8,3.244,2064.236,235.848,0.99,0.515,0
21,144,0,2095,0,39,0,0,41.67,12123198,99.11,18.8,3.244,2064.236,235.848,0.99,0.515,0
21,145,20,2115,0,39,0,0,41.67,12123198,99.11,18.8,3.244,2064.236,235.848,0.99,0.515,0
21,146,0,2115,0,39,0,0,41.67,12123198,99.11,18.8,3.244,2064.236,235.848,0.99,0.515,0
21,147,0,2115,0,39,0,0,41.67,12123198,99.11,18.8,3.244,2064.236,235.848,0.99,0.515,0
21,148,0,2115,0,39,0,0,41.67,12123198,99.11,18.8,3.244,2064.236,235.848,0.99,0.515,0
21,149,30,2145,1,40,0,0,41.67,12123198,99.11,18.8,3.244,2064.236,235.848,0.99,0.515,0
21,150,0,2145,0,40,0,0,41.67,12123198,99.11,18.8,3.244,2064.236,235.848,0.99,0.515,0
21,151,0,2145,0,40,0,0,41.67,12123198,99.11,18.8,3.244,2064.236,235.848,0.99,0.515,0
21,152,0,2145,0,40,0,0,41.67,12123198,99.11,18.8,3.244,2064.236,235.848,0.99,0.515,0
21,153,0,2145,0,40,0,0,41.67,12123198,99.11,18.8,3.244,2064.236,235.848,0.99,0.515,0
21,154,0,2145,0,40,0,0,41.67,12123198,99.11,18.8,3.244,2064.236,235.848,0.99,0.515,0
21,155,0,2145,0,40,0,0,41.67,12123198,99.11,18.8,3.244,2064.236,235.848,0.99,0.515,0
21,156,49,2194,0,40,0,0,41.67,12123198,99.11,18.8,3.244,2064.236,235.848,0.99,0.515,0
21,157,0,2194,0,40,0,0,41.67,12123198,99.11,18.8,3.244,2064.236,235.848,0.99,0.515,0
21,158,0,2194,0,40,0,0,41.67,12123198,99.11,18.8,3.244,2064.236,235.848,0.99,0.515,0
21,159,19,2213,0,40,0,0,41.67,12123198,99.11,18.8,3.244,2064.236,235.848,0.99,0.515,0
21,160,0,2213,0,40,0,0,41.67,12123198,99.11,18.8,3.244,2064.236,235.848,0.99,0.515,0
21,161,0,2213,0,40,0,0,41.67,12123198,99.11,18.8,3.244,2064.236,235.848,0.99,0.515,0
21,162,0,2213,0,40,0,0,41.67,12123198,99.11,18.8,3.244,2064.236,235.848,0.99,0.515,0
21,163,29,2242,0,40,0,0,41.67,12123198,99.11,18.8,3.244,2064.236,235.848,0.99,0.515,0
21,164,0,2242,0,40,0,0,41.67,12123198,99.11,18.8,3.244,2064.236,235.848,0.99,0.515,0
21,165,0,2242,0,40,0,0,41.67,12123198,99.11,18.8,3.244,2064.236,235.848,0.99,0.515,0
21,166,0,2242,0,40,0,0,41.67,12123198,99.11,18.8,3.244,2064.236,235.848,0.99,0.515,0
21,167,25,2267,0,40,0,0,41.67,12123198,99.11,18.8,3.244,2064.236,235.848,0.99,0.515,0
21,168,0,2267,0,40,0,0,47.22,12123198,99.11,18.8,3.244,2064.236,235.848,0.99,0.515,0
21,169,0,2267,0,40,0,0,47.22,12123198,99.11,18.8,3.244,2064.236,235.848,0.99,0.515,0
21,170,13,2280,0,40,0,0,47.22,12123198,99.11,18.8,3.244,2064.236,235.848,0.99,0.515,0
21,171,0,2280,0,40,0,0,47.22,12123198,99.11,18.8,3.244,2064.236,235.848,0.99,0.515,0
21,172,0,2280,0,40,0,0,47.22,12123198,99.11,18.8,3.244,2064.236,235.848,0.99,0.515,0
21,173,0,2280,0,40,0,0,47.22,12123198,99.11,18.8,3.244,2064.236,235.848,0.99,0.515,0
21,174,0,2280,0,40,0,0,47.22,12123198,99.11,18.8,3.244,2064.236,235.848,0.99,0.515,0
21,175,14,2294,0,40,0,0,47.22,12123198,99.11,18.8,3.244,2064.236,235.848,0.99,0.515,0
21,176,0,2294,0,40,0,0,47.22,12123198,99.11,18.8,3.244,2064.236,235.848,0.99,0.515,0
21,177,31,2325,0,40,0,0,47.22,12123198,99.11,18.8,3.244,2064.236,235.848,0.99,0.515,0
21,178,0,2325,0,40,0,0,47.22,12123198,99.11,18.8,3.244,2064.236,235.848,0.99,0.515,0
21,179,0,2325,0,40,0,0,47.22,12123198,99.11,18.8,3.244,2064.236,235.848,0.99,0.515,0
21,180,0,2325,0,40,0,0,47.22,12123198,99.11,18.8,3.244,2064.236,235.848,0.99,0.515,0
21,181,15,2340,0,40,0,0,47.22,12123198,99.11,18.8,3.244,2064.236,235.848,0.99,0.515,0
21,182,0,2340,0,40,0,0,47.22,12123198,99.11,18.8,3.244,2064.236,235.848,0.99,0.515,0
21,183,0,2340,0,40,0,0,47.22,12123198,99.11,18.8,3.244,2064.236,235.848,0.99,0.515,0
21,184,17,2357,1,41,0,0,47.22,12123198,99.11,18.8,3.244,2064.236,235.848,0.99,0.515,0
21,185,0,2357,0,41,0,0,47.22,12123198,99.11,18.8,3.244,2064.236,235.848,0.99,0.515,0
21,186,0,2357,0,41,0,0,47.22,12123198,99.11,18.8,3.244,2064.236,235.848,0.99,0.515,0
21,187,0,2357,0,41,0,0,47.22,12123198,99.11,18.8,3.244,2064.236,235.848,0.99,0.515,0
21,188,0,2357,0,41,0,0,47.22,12123198,99.11,18.8,3.244,2064.236,235.848,0.99,0.515,0
21,189,0,2357,0,41,0,0,47.22,12123198,99.11,18.8,3.244,2064.236,235.848,0.99,0.515,0
21,190,0,2357,0,41,0,0,47.22,12123198,99.11,18.8,3.244,2064.236,235.848,0.99,0.515,0
21,191,54,2411,0,41,0,0,47.22,12123198,99.11,18.8,3.244,2064.236,235.848,0.99,0.515,0
21,192,0,2411,0,41,0,0,47.22,12123198,99.11,18.8,3.244,2064.236,235.848,0.99,0.515,0
21,193,0,2411,0,41,0,0,47.22,12123198,99.11,18.8,3.244,2064.236,235.848,0.99,0.515,0
21,194,0,2411,0,41,0,0,47.22,12123198,99.11,18.8,3.244,2064.236,235.848,0.99,0.515,0
21,195,0,2411,0,41,0,0,47.22,12123198,99.11,18.8,3.244,2064.236,235.848,0.99,0.515,0
21,196,0,2411,0,41,0,0,47.22,12123198,99.11,18.8,3.244,2064.236,235.848,0.99,0.515,0
21,197,0,2411,0,41,0,0,47.22,12123198,99.11,18.8,3.244,2064.236,235.848,0.99,0.515,0
21,198,67,2478,0,41,0,0,47.22,12123198,99.11,18.8,3.244,2064.236,235.848,0.99,0.515,0
21,199,18,2496,0,41,0,0,47.22,12123198,99.11,18.8,3.244,2064.236,235.848,0.99,0.515,0
21,200,0,2496,0,41,0,0,47.22,12123198,99.11,18.8,3.244,2064.236,235.848,0.99,0.515,0
21,201,0,2496,0,41,0,0,47.22,12123198,99.11,18.8,3.244,2064.236,235.848,0.99,0.515,0
21,202,0,2496,0,41,0,0,47.22,12123198,99.11,18.8,3.244,2064.236,235.848,0.99,0.515,0
21,203,0,2496,0,41,0,0,47.22,12123198,99.11,18.8,3.244,2064.236,235.848,0.99,0.515,0
21,204,0,2496,0,41,0,0,47.22,12123198,99.11,18.8,3.244,2064.236,235.848,0.99,0.515,0
23,1,0,4,0,0,0,0,83.33,771612,21.188,28.6,4.885,8708.597,217.066,9.75,0.612,0
23,2,1,5,0,0,0,0,83.33,771612,21.188,28.6,4.885,8708.597,217.066,9.75,0.612,0
23,3,0,5,0,0,0,0,83.33,771612,21.188,28.6,4.885,8708.597,217.066,9.75,0.612,0
23,4,0,5,0,0,0,0,83.33,771612,21.188,28.6,4.885,8708.597,217.066,9.75,0.612,0
23,5,0,5,0,0,0,0,83.33,771612,21.188,28.6,4.885,8708.597,217.066,9.75,0.612,0
23,6,0,5,0,0,0,0,83.33,771612,21.188,28.6,4.885,8708.597,217.066,9.75,0.612,0
23,7,0,5,0,0,0,0,83.33,771612,21.188,28.6,4.885,8708.597,217.066,9.75,0.612,0
23,8,0,5,0,0,0,0,83.33,771612,21.188,28.6,4.885,8708.597,217.066,9.75,0.612,0
23,9,0,5,0,0,0,0,83.33,771612,21.188,28.6,4.885,8708.597,217.066,9.75,0.612,0
23,10,0,5,0,0,0,0,83.33,771612,21.188,28.6,4.885,8708.597,217.066,9.75,0.612,0
23,11,0,5,0,0,0,0,83.33,771612,21.188,28.6,4.885,8708.597,217.066,9.75,0.612,0
23,12,0,5,0,0,0,0,83.33,771612,21.188,28.6,4.885,8708.597,217.066,9.75,0.612,0
23,13,0,5,0,0,0,0,83.33,771612,21.188,28.6,4.885,8708.597,217.066,9.75,0.612,0
23,14,0,5,0,0,0,0,83.33,771612,21.188,28.6,4.885,8708.597,217.066,9.75,0.612,0
23,15,0,5,0,0,0,0,83.33,771612,21.188,28.6,4.885,8708.597,217.066,9.75,0.612,0
23,16,0,5,0,0,0,0,83.33,771612,21.188,28.6,4.885,8708.597,217.066,9.75,0.612,0
23,17,0,5,0,0,0,0,83.33,771612,21.188,28.6,4.885,8708.597,217.066,9.75,0.612,0
23,18,0,5,0,0,0,0,83.33,771612,21.188,28.6,4.885,8708.597,217.066,9.75,0.612,0
23,19,0,5,0,0,0,0,83.33,771612,21.188,28.6,4.885,8708.597,217.066,9.75,0.612,0
23,20,0,5,0,0,0,0,83.33,771612,21.188,28.6,4.885,8708.597,217.066,9.75,0.612,0
23,21,1,6,0,0,0,0,83.33,771612,21.188,28.6,4.885,8708.597,217.066,9.75,0.612,0
23,22,0,6,0,0,0,0,83.33,771612,21.188,28.6,4.885,8708.597,217.066,9.75,0.612,0
23,23,1,7,0,0,0,0,83.33,771612,21.188,28.6,4.885,8708.597,217.066,9.75,0.612,0
23,24,0,7,0,0,0,0,83.33,771612,21.188,28.6,4.885,8708.597,217.066,9.75,0.612,0
23,25,0,7,0,0,0,0,83.33,771612,21.188,28.6,4.885,8708.597,217.066,9.75,0.612,0
23,26,0,7,0,0,0,0,83.33,771612,21.188,28.6,4.885,8708.597,217.066,9.75,0.612,0
23,27,0,7,0,0,0,0,83.33,771612,21.188,28.6,4.885,8708.597,217.066,9.75,0.612,0
23,28,0,7,0,0,0,0,83.33,771612,21.188,28.6,4.885,8708.597,217.066,9.75,0.612,0
23,29,0,7,0,0,0,0,83.33,771612,21.188,28.6,4.885,8708.597,217.066,9.75,0.612,0
23,30,0,7,0,0,0,0,83.33,771612,21.188,28.6,4.885,8708.597,217.066,9.75,0.612,0
23,31,0,7,0,0,0,0,83.33,771612,21.188,28.6,4.885,8708.597,217.066,9.75,0.612,0
23,32,0,7,0,0,0,0,83.33,771612,21.188,28.6,4.885,8708.597,217.066,9.75,0.612,0
23,33,0,7,0,0,0,0,83.33,771612,21.188,28.6,4.885,8708.597,217.066,9.75,0.612,0
23,34,0,7,0,0,0,0,83.33,771612,21.188,28.6,4.885,8708.597,217.066,9.75,0.612,0
23,35,0,7,0,0,0,0,83.33,771612,21.188,28.6,4.885,8708.597,217.066,9.75,0.612,0
23,36,0,7,0,0,0,0,83.33,771612,21.188,28.6,4.885,8708.597,217.066,9.75,0.612,0
23,37,0,7,0,0,0,0,83.33,771612,21.188,28.6,4.885,8708.597,217.066,9.75,0.612,0
23,38,0,7,0,0,0,0,83.33,771612,21.188,28.6,4.885,8708.597,217.066,9.75,0.612,0
23,39,0,7,0,0,0,0,83.33,771612,21.188,28.6,4.885,8708.597,217.066,9.75,0.612,0
23,40,0,7,0,0,0,0,83.33,771612,21.188,28.6,4.885,8708.597,217.066,9.75,0.612,0
23,41,2,9,0,0,0,0,83.33,771612,21.188,28.6,4.885,8708.597,217.066,9.75,0.612,0
23,42,2,11,0,0,0,0,83.33,771612,21.188,28.6,4.885,8708.597,217.066,9.75,0.612,0
23,43,0,11,0,0,0,0,83.33,771612,21.188,28.6,4.885,8708.597,217.066,9.75,0.612,0
23,44,4,15,0,0,0,0,83.33,771612,21.188,28.6,4.885,8708.597,217.066,9.75,0.612,0
23,45,5,20,0,0,0,0,83.33,771612,21.188,28.6,4.885,8708.597,217.066,9.75,0.612,0
23,46,1,21,0,0,0,0,83.33,771612,21.188,28.6,4.885,8708.597,217.066,9.75,0.612,0
23,47,0,21,0,0,0,0,83.33,771612,21.188,28.6,4.885,8708.597,217.066,9.75,0.612,0
23,48,0,21,0,0,0,0,83.33,771612,21.188,28.6,4.885,8708.597,217.066,9.75,0.612,0
23,49,0,21,0,0,0,0,83.33,771612,21.188,28.6,4.885,8708.597,217.066,9.75,0.612,0
23,50,0,21,0,0,0,0,83.33,771612,21.188,28.6,4.885,8708.597,217.066,9.75,0.612,0
23,51,0,21,0,0,0,0,83.33,771612,21.188,28.6,4.885,8708.597,217.066,9.75,0.612,0
23,52,0,21,0,0,0,0,83.33,771612,21.188,28.6,4.885,8708.597,217.066,9.75,0.612,0
23,53,3,24,0,0,0,0,83.33,771612,21.188,28.6,4.885,8708.597,217.066,9.75,0.612,0
23,54,0,24,0,0,0,0,83.33,771612,21.188,28.6,4.885,8708.597,217.066,9.75,0.612,0
23,55,3,27,0,0,0,0,83.33,771612,21.188,28.6,4.885,8708.597,217.066,9.75,0.612,0
23,56,0,27,0,0,0,0,83.33,771612,21.188,28.6,4.885,8708.597,217.066,9.75,0.612,0
23,57,0,27,0,0,0,0,83.33,771612,21.188,28.6,4.885,8708.597,217.066,9.75,0.612,0
23,58,1,28,0,0,0,0,83.33,771612,21.188,28.6,4.885,8708.597,217.066,9.75,0.612,0
23,59,3,31,0,0,0,0,83.33,771612,21.188,28.6,4.885,8708.597,217.066,9.75,0.612,0
23,60,2,33,0,0,0,0,83.33,771612,21.188,28.6,4.885,8708.597,217.066,9.75,0.612,0
23,61,10,43,0,0,0,0,83.33,771612,21.188,28.6,4.885,8708.597,217.066,9.75,0.612,0
23,62,0,43,0,0,0,0,83.33,771612,21.188,28.6,4.885,8708.597,217.066,9.75,0.612,0
23,63,4,47,0,0,0,0,83.33,771612,21.188,28.6,4.885,8708.597,217.066,9.75,0.612,0
23,64,0,47,0,0,0,0,83.33,771612,21.188,28.6,4.885,8708.597,217.066,9.75,0.612,0
23,65,0,47,0,0,0,0,83.33,771612,21.188,28.6,4.885,8708.597,217.066,9.75,0.612,0
23,66,1,48,0,0,0,0,83.33,771612,21.188,28.6,4.885,8708.597,217.066,9.75,0.612,0
23,67,0,48,0,0,0,0,83.33,771612,21.188,28.6,4.885,8708.597,217.066,9.75,0.612,0
23,68,0,48,0,0,0,0,83.33,771612,21.188,28.6,4.885,8708.597,217.066,9.75,0.612,0
23,69,11,59,0,0,0,0,83.33,771612,21.188,28.6,4.885,8708.597,217.066,9.75,0.612,0
23,70,0,59,0,0,0,0,83.33,771612,21.188,28.6,4.885,8708.597,217.066,9.75,0.612,0
23,71,0,59,0,0,0,0,83.33,771612,21.188,28.6,4.885,8708.597,217.066,9.75,0.612,0
23,72,3,62,0,0,0,0,83.33,771612,21.188,28.6,4.885,8708.597,217.066,9.75,0.612,0
23,73,0,62,0,0,0,0,83.33,771612,21.188,28.6,4.885,8708.597,217.066,9.75,0.612,0
23,74,0,62,0,0,0,0,83.33,771612,21.188,28.6,4.885,8708.597,217.066,9.75,0.612,0
23,75,4,66,0,0,0,0,83.33,771612,21.188,28.6,4.885,8708.597,217.066,9.75,0.612,0
23,76,0,66,0,0,0,0,83.33,771612,21.188,28.6,4.885,8708.597,217.066,9.75,0.612,0
23,77,1,67,0,0,0,0,83.33,771612,21.188,28.6,4.885,8708.597,217.066,9.75,0.612,0
23,78,0,67,0,0,0,0,83.33,771612,21.188,28.6,4.885,8708.597,217.066,9.75,0.612,0
23,79,0,67,0,0,0,0,83.33,771612,21.188,28.6,4.885,8708.597,217.066,9.75,0.612,0
23,80,0,67,0,0,0,0,83.33,771612,21.188,28.6,4.885,8708.597,217.066,9.75,0.612,0
23,81,1,68,0,0,0,0,83.33,771612,21.188,28.6,4.885,8708.597,217.066,9.75,0.612,0
23,82,0,68,0,0,0,0,83.33,771612,21.188,28.6,4.885,8708.597,217.066,9.75,0.612,0
23,83,0,68,0,0,0,0,83.33,771612,21.188,28.6,4.885,8708.597,217.066,9.75,0.612,0
23,84,1,69,0,0,0,0,83.33,771612,21.188,28.6,4.885,8708.597,217.066,9.75,0.612,0
23,85,1,70,0,0,0,0,83.33,771612,21.188,28.6,4.885,8708.597,217.066,9.75,0.612,0
23,86,0,70,0,0,0,0,83.33,771612,21.188,28.6,4.885,8708.597,217.066,9.75,0.612,0
23,87,0,70,0,0,0,0,83.33,771612,21.188,28.6,4.885,8708.597,217.066,9.75,0.612,0
23,88,5,75,0,0,0,0,83.33,771612,21.188,28.6,4.885,8708.597,217.066,9.75,0.612,0
23,89,1,76,0,0,0,0,83.33,771612,21.188,28.6,4.885,8708.597,217.066,9.75,0.612,0
23,90,0,76,0,0,0,0,83.33,771612,21.188,28.6,4.885,8708.597,217.066,9.75,0.612,0
23,91,1,77,0,0,0,0,83.33,771612,21.188,28.6,4.885,8708.597,217.066,9.75,0.612,0
23,92,0,77,0,0,0,0,71.3,771612,21.188,28.6,4.885,8708.597,217.066,9.75,0.612,0
23,93,0,77,0,0,0,0,71.3,771612,21.188,28.6,4.885,8708.597,217.066,9.75,0.612,0
23,94,0,77,0,0,0,0,71.3,771612,21.188,28.6,4.885,8708.597,217.066,9.75,0.612,0
23,95,1,78,0,0,0,0,71.3,771612,21.188,28.6,4.885,8708.597,217.066,9.75,0.612,0
23,96,0,78,0,0,0,0,71.3,771612,21.188,28.6,4.885,8708.597,217.066,9.75,0.612,0
23,97,2,80,0,0,0,0,71.3,771612,21.188,28.6,4.885,8708.597,217.066,9.75,0.612,0
23,98,0,80,0,0,0,0,71.3,771612,21.188,28.6,4.885,8708.597,217.066,9.75,0.612,0
23,99,0,80,0,0,0,0,71.3,771612,21.188,28.6,4.885,8708.597,217.066,9.75,0.612,0
23,100,0,80,0,0,0,0,71.3,771612,21.188,28.6,4.885,8708.597,217.066,9.75,0.612,0
23,101,0,80,0,0,0,0,71.3,771612,21.188,28.6,4.885,8708.597,217.066,9.75,0.612,0
23,102,2,82,0,0,0,0,71.3,771612,21.188,28.6,4.885,8708.597,217.066,9.75,0.612,0
23,103,0,82,0,0,0,0,71.3,771612,21.188,28.6,4.885,8708.597,217.066,9.75,0.612,0
23,104,2,84,0,0,0,0,71.3,771612,21.188,28.6,4.885,8708.597,217.066,9.75,0.612,0
23,105,0,84,0,0,0,0,65.74,771612,21.188,28.6,4.885,8708.597,217.066,9.75,0.612,0
23,106,0,84,0,0,0,0,65.74,771612,21.188,28.6,4.885,8708.597,217.066,9.75,0.612,0
23,107,0,84,0,0,0,0,65.74,771612,21.188,28.6,4.885,8708.597,217.066,9.75,0.612,0
23,108,2,86,0,0,0,0,65.74,771612,21.188,28.6,4.885,8708.597,217.066,9.75,0.612,0
23,109,1,87,0,0,0,0,65.74,771612,21.188,28.6,4.885,8708.597,217.066,9.75,0.612,0
23,110,0,87,0,0,0,0,65.74,771612,21.188,28.6,4.885,8708.597,217.066,9.75,0.612,0
23,111,2,89,0,0,0,0,65.74,771612,21.188,28.6,4.885,8708.597,217.066,9.75,0.612,0
23,112,1,90,0,0,0,0,65.74,771612,21.188,28.6,4.885,8708.597,217.066,9.75,0.612,0
23,113,2,92,0,0,0,0,65.74,771612,21.188,28.6,4.885,8708.597,217.066,9.75,0.612,0
23,114,0,92,0,0,0,0,65.74,771612,21.188,28.6,4.885,8708.597,217.066,9.75,0.612,0
23,115,0,92,0,0,0,0,65.74,771612,21.188,28.6,4.885,8708.597,217.066,9.75,0.612,0
23,116,0,92,0,0,0,0,65.74,771612,21.188,28.6,4.885,8708.597,217.066,9.75,0.612,0
23,117,1,93,0,0,0,0,65.74,771612,21.188,28.6,4.885,8708.597,217.066,9.75,0.612,0
23,118,2,95,0,0,0,0,65.74,771612,21.188,28.6,4.885,8708.597,217.066,9.75,0.612,0
23,119,4,99,0,0,0,0,65.74,771612,21.188,28.6,4.885,8708.597,217.066,9.75,0.612,0
23,120,0,99,0,0,0,0,65.74,771612,21.188,28.6,4.885,8708.597,217.066,9.75,0.612,0
23,121,2,101,0,0,0,0,65.74,771612,21.188,28.6,4.885,8708.597,217.066,9.75,0.612,0
23,122,0,101,0,0,0,0,65.74,771612,21.188,28.6,4.885,8708.597,217.066,9.75,0.612,0
23,123,0,101,0,0,0,0,65.74,771612,21.188,28.6,4.885,8708.597,217.066,9.75,0.612,0
23,124,1,102,0,0,0,0,65.74,771612,21.188,28.6,4.885,8708.597,217.066,9.75,0.612,0
23,125,1,103,0,0,0,0,65.74,771612,21.188,28.6,4.885,8708.597,217.066,9.75,0.612,0
23,126,0,103,0,0,0,0,65.74,771612,21.188,28.6,4.885,8708.597,217.066,9.75,0.612,0
23,127,2,105,0,0,0,0,65.74,771612,21.188,28.6,4.885,8708.597,217.066,9.75,0.612,0
23,128,0,105,0,0,0,0,65.74,771612,21.188,28.6,4.885,8708.597,217.066,9.75,0.612,0
23,129,3,108,0,0,0,0,65.74,771612,21.188,28.6,4.885,8708.597,217.066,9.75,0.612,0
23,130,0,108,0,0,0,0,65.74,771612,21.188,28.6,4.885,8708.597,217.066,9.75,0.612,0
23,131,0,108,0,0,0,0,65.74,771612,21.188,28.6,4.885,8708.597,217.066,9.75,0.612,0
23,132,2,110,0,0,0,0,65.74,771612,21.188,28.6,4.885,8708.597,217.066,9.75,0.612,0
23,133,3,113,0,0,0,0,65.74,771612,21.188,28.6,4.885,8708.597,217.066,9.75,0.612,0
23,134,0,113,0,0,0,0,65.74,771612,21.188,28.6,4.885,8708.597,217.066,9.75,0.612,0
23,135,15,128,0,0,0,0,65.74,771612,21.188,28.6,4.885,8708.597,217.066,9.75,0.612,0
23,136,3,131,0,0,0,0,65.74,771612,21.188,28.6,4.885,8708.597,217.066,9.75,0.612,0
23,137,2,133,0,0,0,0,65.74,771612,21.188,28.6,4.885,8708.597,217.066,9.75,0.612,0
23,138,0,133,0,0,0,0,65.74,771612,21.188,28.6,4.885,8708.597,217.066,9.75,0.612,0
23,139,8,141,0,0,0,0,65.74,771612,21.188,28.6,4.885,8708.597,217.066,9.75,0.612,0
23,140,5,146,0,0,0,0,65.74,771612,21.188,28.6,4.885,8708.597,217.066,9.75,0.612,0
23,141,1,147,0,0,0,0,65.74,771612,21.188,28.6,4.885,8708.597,217.066,9.75,0.612,0
23,142,3,150,0,0,0,0,65.74,771612,21.188,28.6,4.885,8708.597,217.066,9.75,0.612,0
23,143,3,153,0,0,0,0,65.74,771612,21.188,28.6,4.885,8708.597,217.066,9.75,0.612,0
23,144,0,153,0,0,0,0,65.74,771612,21.188,28.6,4.885,8708.597,217.066,9.75,0.612,0
23,145,2,155,0,0,0,0,65.74,771612,21.188,28.6,4.885,8708.597,217.066,9.75,0.612,0
23,146,0,155,0,0,0,0,65.74,771612,21.188,28.6,4.885,8708.597,217.066,9.75,0.612,0
23,147,1,156,0,0,0,0,65.74,771612,21.188,28.6,4.885,8708.597,217.066,9.75,0.612,0
23,148,17,173,0,0,0,0,65.74,771612,21.188,28.6,4.885,8708.597,217.066,9.75,0.612,0
23,149,10,183,0,0,0,0,65.74,771612,21.188,28.6,4.885,8708.597,217.066,9.75,0.612,0
23,150,1,184,0,0,0,0,65.74,771612,21.188,28.6,4.885,8708.597,217.066,9.75,0.612,0
23,151,11,195,0,0,0,0,65.74,771612,21.188,28.6,4.885,8708.597,217.066,9.75,0.612,0
23,152,0,195,0,0,0,0,65.74,771612,21.188,28.6,4.885,8708.597,217.066,9.75,0.612,0
23,153,29,224,0,0,0,0,65.74,771612,21.188,28.6,4.885,8708.597,217.066,9.75,0.612,0
23,154,1,225,0,0,0,0,74.07,771612,21.188,28.6,4.885,8708.597,217.066,9.75,0.612,0
23,155,2,227,0,0,0,0,74.07,771612,21.188,28.6,4.885,8708.597,217.066,9.75,0.612,0
23,156,0,227,0,0,0,0,74.07,771612,21.188,28.6,4.885,8708.597,217.066,9.75,0.612,0
23,157,0,227,0,0,0,0,71.3,771612,21.188,28.6,4.885,8708.597,217.066,9.75,0.612,0
23,158,1,228,0,0,0,0,71.3,771612,21.188,28.6,4.885,8708.597,217.066,9.75,0.612,0
23,159,0,228,0,0,0,0,71.3,771612,21.188,28.6,4.885,8708.597,217.066,9.75,0.612,0
23,160,2,230,0,0,0,0,68.52,771612,21.188,28.6,4.885,8708.597,217.066,9.75,0.612,0
23,161,3,233,0,0,0,0,68.52,771612,21.188,28.6,4.885,8708.597,217.066,9.75,0.612,0
23,162,1,234,0,0,0,0,68.52,771612,21.188,28.6,4.885,8708.597,217.066,9.75,0.612,0
23,163,0,234,0,0,0,0,68.52,771612,21.188,28.6,4.885,8708.597,217.066,9.75,0.612,0
23,164,4,238,0,0,0,0,68.52,771612,21.188,28.6,4.885,8708.597,217.066,9.75,0.612,0
23,165,3,241,0,0,0,0,68.52,771612,21.188,28.6,4.885,8708.597,217.066,9.75,0.612,0
23,166,3,244,0,0,0,0,68.52,771612,21.188,28.6,4.885,8708.597,217.066,9.75,0.612,0
23,167,1,245,0,0,0,0,68.52,771612,21.188,28.6,4.885,8708.597,217.066,9.75,0.612,0
23,168,1,246,0,0,0,0,68.52,771612,21.188,28.6,4.885,8708.597,217.066,9.75,0.612,0
23,169,0,246,0,0,0,0,68.52,771612,21.188,28.6,4.885,8708.597,217.066,9.75,0.612,0
23,170,0,246,0,0,0,0,68.52,771612,21.188,28.6,4.885,8708.597,217.066,9.75,0.612,0
23,171,6,252,0,0,0,0,68.52,771612,21.188,28.6,4.885,8708.597,217.066,9.75,0.612,0
23,172,6,258,0,0,0,0,68.52,771612,21.188,28.6,4.885,8708.597,217.066,9.75,0.612,0
23,173,1,259,0,0,0,0,68.52,771612,21.188,28.6,4.885,8708.597,217.066,9.75,0.612,0
23,174,2,261,0,0,0,0,68.52,771612,21.188,28.6,4.885,8708.597,217.066,9.75,0.612,0
23,175,0,261,0,0,0,0,68.52,771612,21.188,28.6,4.885,8708.597,217.066,9.75,0.612,0
23,176,0,261,0,0,0,0,68.52,771612,21.188,28.6,4.885,8708.597,217.066,9.75,0.612,0
23,177,0,261,0,0,0,0,68.52,771612,21.188,28.6,4.885,8708.597,217.066,9.75,0.612,0
23,178,2,263,0,0,0,0,68.52,771612,21.188,28.6,4.885,8708.597,217.066,9.75,0.612,0
23,179,0,263,0,0,0,0,68.52,771612,21.188,28.6,4.885,8708.597,217.066,9.75,0.612,0
23,180,8,271,0,0,0,0,68.52,771612,21.188,28.6,4.885,8708.597,217.066,9.75,0.612,0
23,181,2,273,0,0,0,0,68.52,771612,21.188,28.6,4.885,8708.597,217.066,9.75,0.612,0
23,182,7,280,0,0,0,0,75,771612,21.188,28.6,4.885,8708.597,217.066,9.75,0.612,0
23,183,1,281,0,0,0,0,75,771612,21.188,28.6,4.885,8708.597,217.066,9.75,0.612,0
23,184,1,282,0,0,0,0,75,771612,21.188,28.6,4.885,8708.597,217.066,9.75,0.612,0
23,185,0,282,0,0,0,0,75,771612,21.188,28.6,4.885,8708.597,217.066,9.75,0.612,0
23,186,1,283,0,0,0,0,75,771612,21.188,28.6,4.885,8708.597,217.066,9.75,0.612,0
23,187,0,283,0,0,0,0,75,771612,21.188,28.6,4.885,8708.597,217.066,9.75,0.612,0
23,188,15,298,0,0,0,0,75,771612,21.188,28.6,4.885,8708.597,217.066,9.75,0.612,0
23,189,1,299,0,0,0,0,75,771612,21.188,28.6,4.885,8708.597,217.066,9.75,0.612,0
23,190,1,300,0,0,0,0,75,771612,21.188,28.6,4.885,8708.597,217.066,9.75,0.612,0
23,191,4,304,0,0,0,0,75,771612,21.188,28.6,4.885,8708.597,217.066,9.75,0.612,0
23,192,0,304,0,0,0,0,75,771612,21.188,28.6,4.885,8708.597,217.066,9.75,0.612,0
23,193,2,306,0,0,0,0,75,771612,21.188,28.6,4.885,8708.597,217.066,9.75,0.612,0
23,194,0,306,0,0,0,0,75,771612,21.188,28.6,4.885,8708.597,217.066,9.75,0.612,0
23,195,3,309,0,0,0,0,75,771612,21.188,28.6,4.885,8708.597,217.066,9.75,0.612,0
23,196,0,309,0,0,0,0,75,771612,21.188,28.6,4.885,8708.597,217.066,9.75,0.612,0
23,197,4,313,0,0,0,0,75,771612,21.188,28.6,4.885,8708.597,217.066,9.75,0.612,0
23,198,3,316,0,0,0,0,75,771612,21.188,28.6,4.885,8708.597,217.066,9.75,0.612,0
23,199,0,316,0,0,0,0,75,771612,21.188,28.6,4.885,8708.597,217.066,9.75,0.612,0
23,200,0,316,0,0,0,0,75,771612,21.188,28.6,4.885,8708.597,217.066,9.75,0.612,0
23,201,9,325,0,0,0,0,75,771612,21.188,28.6,4.885,8708.597,217.066,9.75,0.612,0
23,202,2,327,0,0,0,0,75,771612,21.188,28.6,4.885,8708.597,217.066,9.75,0.612,0
23,203,3,330,0,0,0,0,75,771612,21.188,28.6,4.885,8708.597,217.066,9.75,0.612,0
23,204,1,331,0,0,0,0,75,771612,21.188,28.6,4.885,8708.597,217.066,9.75,0.612,0
24,1,8,115,1,7,57,836,96.3,11673029,10.202,25.4,6.704,6885.829,204.299,6.89,0.693,0
24,2,8,123,1,8,149,985,96.3,11673029,10.202,25.4,6.704,6885.829,204.299,6.89,0.693,0
24,3,9,132,1,9,133,1118,96.3,11673029,10.202,25.4,6.704,6885.829,204.299,6.89,0.693,0
24,4,7,139,1,10,18,1136,96.3,11673029,10.202,25.4,6.704,6885.829,204.299,6.89,0.693,0
24,5,18,157,0,10,0,1136,96.3,11673029,10.202,25.4,6.704,6885.829,204.299,6.89,0.693,0
24,6,26,183,1,11,0,1549,96.3,11673029,10.202,25.4,6.704,6885.829,204.299,6.89,0.693,0
24,7,11,194,3,14,132,1681,96.3,11673029,10.202,25.4,6.704,6885.829,204.299,6.89,0.693,0
24,8,16,210,1,15,194,1875,96.3,11673029,10.202,25.4,6.704,6885.829,204.299,6.89,0.693,0
24,9,54,264,3,18,122,1997,96.3,11673029,10.202,25.4,6.704,6885.829,204.299,6.89,0.693,0
24,10,4,268,1,19,188,2185,96.3,11673029,10.202,25.4,6.704,6885.829,204.299,6.89,0.693,0
24,11,8,276,1,20,171,2356,96.3,11673029,10.202,25.4,6.704,6885.829,204.299,6.89,0.693,0
24,12,24,300,4,24,172,2528,96.3,11673029,10.202,25.4,6.704,6885.829,204.299,6.89,0.693,0
24,13,30,330,3,27,165,2693,96.3,11673029,10.202,25.4,6.704,6885.829,204.299,6.89,0.693,0
24,14,24,354,1,28,226,2919,96.3,11673029,10.202,25.4,6.704,6885.829,204.299,6.89,0.693,0
24,15,43,397,0,28,311,3230,96.3,11673029,10.202,25.4,6.704,6885.829,204.299,6.89,0.693,0
24,16,44,441,1,29,189,3419,96.3,11673029,10.202,25.4,6.704,6885.829,204.299,6.89,0.693,0
24,17,24,465,2,31,154,3573,96.3,11673029,10.202,25.4,6.704,6885.829,204.299,6.89,0.693,0
24,18,28,493,0,31,350,3923,96.3,11673029,10.202,25.4,6.704,6885.829,204.299,6.89,0.693,0
24,19,27,520,1,32,212,4135,96.3,11673029,10.202,25.4,6.704,6885.829,204.299,6.89,0.693,0
24,20,44,564,1,33,163,4298,96.3,11673029,10.202,25.4,6.704,6885.829,204.299,6.89,0.693,0
24,21,34,598,1,34,122,4420,96.3,11673029,10.202,25.4,6.704,6885.829,204.299,6.89,0.693,0
24,22,11,609,3,37,435,4855,96.3,11673029,10.202,25.4,6.704,6885.829,204.299,6.89,0.693,0
24,23,63,672,3,40,140,4995,96.3,11673029,10.202,25.4,6.704,6885.829,204.299,6.89,0.693,0
24,24,31,703,3,43,302,5297,96.3,11673029,10.202,25.4,6.704,6885.829,204.299,6.89,0.693,0
24,25,104,807,1,44,275,5572,96.3,11673029,10.202,25.4,6.704,6885.829,204.299,6.89,0.693,0
24,26,59,866,2,46,219,5791,96.3,11673029,10.202,25.4,6.704,6885.829,204.299,6.89,0.693,0
24,27,84,950,4,50,197,5988,96.3,11673029,10.202,25.4,6.704,6885.829,204.299,6.89,0.693,0
24,28,64,1014,3,53,133,6121,96.3,11673029,10.202,25.4,6.704,6885.829,204.299,6.89,0.693,0
24,29,39,1053,2,55,288,6409,96.3,11673029,10.202,25.4,6.704,6885.829,204.299,6.89,0.693,0
24,30,57,1110,4,59,142,6551,96.3,11673029,10.202,25.4,6.704,6885.829,204.299,6.89,0.693,0
24,31,57,1167,3,62,424,6975,96.3,11673029,10.202,25.4,6.704,6885.829,204.299,6.89,0.693,0
24,32,62,1229,4,66,676,7651,96.3,11673029,10.202,25.4,6.704,6885.829,204.299,6.89,0.693,0
24,33,241,1470,5,71,429,8080,96.3,11673029,10.202,25.4,6.704,6885.829,204.299,6.89,0.693,0
24,34,124,1594,5,76,531,8611,96.3,11673029,10.202,25.4,6.704,6885.829,204.299,6.89,0.693,0
24,35,87,1681,6,82,384,8995,96.3,11673029,10.202,25.4,6.704,6885.829,204.299,6.89,0.693,0
24,36,121,1802,4,86,161,9156,96.3,11673029,10.202,25.4,6.704,6885.829,204.299,6.89,0.693,0
24,37,84,1886,5,91,943,10099,96.3,11673029,10.202,25.4,6.704,6885.829,204.299,6.89,0.693,0
24,38,195,2081,11,102,552,10651,96.3,11673029,10.202,25.4,6.704,6885.829,204.299,6.89,0.693,0
24,39,185,2266,4,106,0,10651,96.3,11673029,10.202,25.4,6.704,6885.829,204.299,6.89,0.693,0
24,40,171,2437,8,114,0,11671,96.3,11673029,10.202,25.4,6.704,6885.829,204.299,6.89,0.693,0
24,41,119,2556,4,118,882,12553,96.3,11673029,10.202,25.4,6.704,6885.829,204.299,6.89,0.693,0
24,42,275,2831,4,122,527,13080,96.3,11673029,10.202,25.4,6.704,6885.829,204.299,6.89,0.693,0
24,43,133,2964,6,128,525,13605,96.3,11673029,10.202,25.4,6.704,6885.829,204.299,6.89,0.693,0
24,44,184,3148,14,142,554,14159,96.3,11673029,10.202,25.4,6.704,6885.829,204.299,6.89,0.693,0
24,45,224,3372,10,152,644,14803,96.3,11673029,10.202,25.4,6.704,6885.829,204.299,6.89,0.693,0
24,46,205,3577,12,164,853,15656,96.3,11673029,10.202,25.4,6.704,6885.829,204.299,6.89,0.693,0
24,47,249,3826,1,165,748,16404,96.3,11673029,10.202,25.4,6.704,6885.829,204.299,6.89,0.693,0
24,48,262,4088,4,169,377,16781,96.3,11673029,10.202,25.4,6.704,6885.829,204.299,6.89,0.693,0
24,49,175,4263,5,174,779,17560,96.3,11673029,10.202,25.4,6.704,6885.829,204.299,6.89,0.693,0
24,50,218,4481,15,189,1006,18566,96.3,11673029,10.202,25.4,6.704,6885.829,204.299,6.89,0.693,0
24,51,438,4919,10,199,723,19289,96.3,11673029,10.202,25.4,6.704,6885.829,204.299,6.89,0.693,0
24,52,268,5187,16,215,807,20096,96.3,11673029,10.202,25.4,6.704,6885.829,204.299,6.89,0.693,0
24,53,392,5579,15,230,1109,21205,96.3,11673029,10.202,25.4,6.704,6885.829,204.299,6.89,0.693,0
24,54,336,5915,10,240,789,21994,96.3,11673029,10.202,25.4,6.704,6885.829,204.299,6.89,0.693,0
24,55,348,6263,10,250,779,22773,93.52,11673029,10.202,25.4,6.704,6885.829,204.299,6.89,0.693,0
24,56,397,6660,11,261,866,23639,93.52,11673029,10.202,25.4,6.704,6885.829,204.299,6.89,0.693,0
24,57,476,7136,13,274,1426,25065,93.52,11673029,10.202,25.4,6.704,6885.829,204.299,6.89,0.693,0
24,58,632,7768,6,280,1125,26190,93.52,11673029,10.202,25.4,6.704,6885.829,204.299,6.89,0.693,0
24,59,619,8387,13,293,775,26965,93.52,11673029,10.202,25.4,6.704,6885.829,204.299,6.89,0.693,0
24,60,344,8731,7,300,1274,28239,93.52,11673029,10.202,25.4,6.704,6885.829,204.299,6.89,0.693,0
24,61,861,9592,10,310,718,28957,93.52,11673029,10.202,25.4,6.704,6885.829,204.299,6.89,0.693,0
24,62,390,9982,3,313,1083,30040,88.89,11673029,10.202,25.4,6.704,6885.829,204.299,6.89,0.693,0
24,63,549,10531,30,343,1146,31186,88.89,11673029,10.202,25.4,6.704,6885.829,204.299,6.89,0.693,0
24,64,460,10991,33,376,1300,32486,88.89,11673029,10.202,25.4,6.704,6885.829,204.299,6.89,0.693,0
24,65,647,11638,24,400,1460,33946,88.89,11673029,10.202,25.4,6.704,6885.829,204.299,6.89,0.693,0
24,66,607,12245,15,415,1304,35250,88.89,11673029,10.202,25.4,6.704,6885.829,204.299,6.89,0.693,0
24,67,483,12728,12,427,1280,36530,88.89,11673029,10.202,25.4,6.704,6885.829,204.299,6.89,0.693,0
24,68,630,13358,27,454,746,37276,88.89,11673029,10.202,25.4,6.704,6885.829,204.299,6.89,0.693,0
24,69,285,13643,11,465,816,38092,88.89,11673029,10.202,25.4,6.704,6885.829,204.299,6.89,0.693,0
24,70,306,13949,10,475,1518,39610,88.89,11673029,10.202,25.4,6.704,6885.829,204.299,6.89,0.693,0
24,71,695,14644,12,487,1425,41035,88.89,11673029,10.202,25.4,6.704,6885.829,204.299,6.89,0.693,0
24,72,637,15281,25,512,1706,42741,88.89,11673029,10.202,25.4,6.704,6885.829,204.299,6.89,0.693,0
24,73,884,16165,21,533,1774,44515,88.89,11673029,10.202,25.4,6.704,6885.829,204.299,6.89,0.693,0
24,74,764,16929,26,559,1554,46069,88.89,11673029,10.202,25.4,6.704,6885.829,204.299,6.89,0.693,0
24,75,913,17842,26,585,1303,47372,88.89,11673029,10.202,25.4,6.704,6885.829,204.299,6.89,0.693,0
24,76,617,18459,26,611,1384,48756,88.89,11673029,10.202,25.4,6.704,6885.829,204.299,6.89,0.693,0
24,77,614,19073,21,632,1358,50114,88.89,11673029,10.202,25.4,6.704,6885.829,204.299,6.89,0.693,0
24,78,810,19883,27,659,1222,51336,88.89,11673029,10.202,25.4,6.704,6885.829,204.299,6.89,0.693,0
24,79,802,20685,20,679,1420,52756,88.89,11673029,10.202,25.4,6.704,6885.829,204.299,6.89,0.693,0
24,80,814,21499,18,697,2358,55114,88.89,11673029,10.202,25.4,6.704,6885.829,204.299,6.89,0.693,0
24,81,977,22476,18,715,1850,56964,90.74,11673029,10.202,25.4,6.704,6885.829,204.299,6.89,0.693,0
24,82,1036,23512,25,740,1825,58789,90.74,11673029,10.202,25.4,6.704,6885.829,204.299,6.89,0.693,0
24,83,876,24388,33,773,2666,61455,90.74,11673029,10.202,25.4,6.704,6885.829,204.299,6.89,0.693,0
24,84,1105,25493,47,820,1756,63211,90.74,11673029,10.202,25.4,6.704,6885.829,204.299,6.89,0.693,0
24,85,896,26389,26,846,1735,64946,88.89,11673029,10.202,25.4,6.704,6885.829,204.299,6.89,0.693,0
24,86,1098,27487,30,876,1651,66597,88.89,11673029,10.202,25.4,6.704,6885.829,204.299,6.89,0.693,0
24,87,1016,28503,37,913,2033,68630,89.81,11673029,10.202,25.4,6.704,6885.829,204.299,6.89,0.693,0
24,88,920,29423,21,934,2242,70872,89.81,11673029,10.202,25.4,6.704,6885.829,204.299,6.89,0.693,0
24,89,1253,30676,36,970,1364,72236,89.81,11673029,10.202,25.4,6.704,6885.829,204.299,6.89,0.693,0
24,90,848,31524,44,1014,1036,73272,89.81,11673029,10.202,25.4,6.704,6885.829,204.299,6.89,0.693,0
24,91,601,32125,57,1071,2194,75466,89.81,11673029,10.202,25.4,6.704,6885.829,204.299,6.89,0.693,0
24,92,1094,33219,52,1123,1947,77413,89.81,11673029,10.202,25.4,6.704,6885.829,204.299,6.89,0.693,0
24,93,1008,34227,78,1201,2154,79567,89.81,11673029,10.202,25.4,6.704,6885.829,204.299,6.89,0.693,0
24,94,1301,35528,70,1271,2219,81786,89.81,11673029,10.202,25.4,6.704,6885.829,204.299,6.89,0.693,0
24,95,1290,36818,49,1320,2172,83958,89.81,11673029,10.202,25.4,6.704,6885.829,204.299,6.89,0.693,0
24,96,1253,38071,58,1378,2920,86878,89.81,11673029,10.202,25.4,6.704,6885.829,204.299,6.89,0.693,0
24,97,1226,39297,56,1434,1940,88818,89.81,11673029,10.202,25.4,6.704,6885.829,204.299,6.89,0.693,0
24,98,1212,40509,42,1476,1833,90651,89.81,11673029,10.202,25.4,6.704,6885.829,204.299,6.89,0.693,0
24,99,1036,41545,54,1530,2177,92828,89.81,11673029,10.202,25.4,6.704,6885.829,204.299,6.89,0.693,0
24,100,1439,42984,47,1577,2031,94859,89.81,11673029,10.202,25.4,6.704,6885.829,204.299,6.89,0.693,0
24,101,1129,44113,61,1638,2196,97055,89.81,11673029,10.202,25.4,6.704,6885.829,204.299,6.89,0.693,0
24,102,1452,45565,64,1702,2699,99754,89.81,11673029,10.202,25.4,6.704,6885.829,204.299,6.89,0.693,0
24,103,1635,47200,52,1754,1869,101623,89.81,11673029,10.202,25.4,6.704,6885.829,204.299,6.89,0.693,0
24,104,987,48187,53,1807,1705,103328,89.81,11673029,10.202,25.4,6.704,6885.829,204.299,6.89,0.693,0
24,105,1063,49250,59,1866,2449,105777,89.81,11673029,10.202,25.4,6.704,6885.829,204.299,6.89,0.693,0
24,106,1617,50867,32,1898,2460,108237,89.81,11673029,10.202,25.4,6.704,6885.829,204.299,6.89,0.693,0
24,107,1351,52218,44,1942,2875,111112,89.81,11673029,10.202,25.4,6.704,6885.829,204.299,6.89,0.693,0
24,108,1938,54156,42,1984,3070,114182,89.81,11673029,10.202,25.4,6.704,6885.829,204.299,6.89,0.693,0
24,109,1946,56102,65,2049,2982,117164,89.81,11673029,10.202,25.4,6.704,6885.829,204.299,6.89,0.693,0
24,110,2036,58138,57,2106,2600,119764,89.81,11673029,10.202,25.4,6.704,6885.829,204.299,6.89,0.693,0
24,111,1444,59582,45,2151,2023,121787,89.81,11673029,10.202,25.4,6.704,6885.829,204.299,6.89,0.693,0
24,112,1409,60991,67,2218,2548,124335,89.81,11673029,10.202,25.4,6.704,6885.829,204.299,6.89,0.693,0
24,113,1366,62357,55,2273,2832,127167,89.81,11673029,10.202,25.4,6.704,6885.829,204.299,6.89,0.693,0
24,114,1778,64135,55,2328,2240,129407,89.81,11673029,10.202,25.4,6.704,6885.829,204.299,6.89,0.693,0
24,115,1117,65252,79,2407,1935,131342,89.81,11673029,10.202,25.4,6.704,6885.829,204.299,6.89,0.693,0
24,116,1204,66456,66,2473,3427,134769,89.81,11673029,10.202,25.4,6.704,6885.829,204.299,6.89,0.693,0
24,117,1825,68281,62,2535,2156,136925,89.81,11673029,10.202,25.4,6.704,6885.829,204.299,6.89,0.693,0
24,118,1148,69429,48,2583,2941,139866,89.81,11673029,10.202,25.4,6.704,6885.829,204.299,6.89,0.693,0
24,119,2382,71811,64,2647,2252,142118,89.81,11673029,10.202,25.4,6.704,6885.829,204.299,6.89,0.693,0
24,120,516,72327,73,2720,2035,144153,89.81,11673029,10.202,25.4,6.704,6885.829,204.299,6.89,0.693,0
24,121,1207,73534,88,2808,3305,147458,89.81,11673029,10.202,25.4,6.704,6885.829,204.299,6.89,0.693,0
24,122,1700,75234,86,2894,3012,150470,89.81,11673029,10.202,25.4,6.704,6885.829,204.299,6.89,0.693,0
24,123,1555,76789,83,2977,3484,153954,89.81,11673029,10.202,25.4,6.704,6885.829,204.299,6.89,0.693,0
24,124,2004,78793,87,3064,2970,156924,89.81,11673029,10.202,25.4,6.704,6885.829,204.299,6.89,0.693,0
24,125,1360,80153,89,3153,2903,159827,89.81,11673029,10.202,25.4,6.704,6885.829,204.299,6.89,0.693,0
24,126,1693,81846,75,3228,2834,162661,89.81,11673029,10.202,25.4,6.704,6885.829,204.299,6.89,0.693,0
24,127,1515,83361,92,3320,3443,166104,89.81,11673029,10.202,25.4,6.704,6885.829,204.299,6.89,0.693,0
24,128,1780,85141,65,3385,2459,168563,89.81,11673029,10.202,25.4,6.704,6885.829,204.299,6.89,0.693,0
24,129,1282,86423,80,3465,3140,171703,89.81,11673029,10.202,25.4,6.704,6885.829,204.299,6.89,0.693,0
24,130,1468,87891,59,3524,2438,174141,89.81,11673029,10.202,25.4,6.704,6885.829,204.299,6.89,0.693,0
24,131,1164,89055,63,3587,2167,176308,89.81,11673029,10.202,25.4,6.704,6885.829,204.299,6.89,0.693,0
24,132,944,89999,53,3640,3245,179553,89.81,11673029,10.202,25.4,6.704,6885.829,204.299,6.89,0.693,0
24,133,1636,91635,72,3712,3759,183312,89.81,11673029,10.202,25.4,6.704,6885.829,204.299,6.89,0.693,0
24,134,1693,93328,49,3761,3652,186964,89.81,11673029,10.202,25.4,6.704,6885.829,204.299,6.89,0.693,0
24,135,1743,95071,66,3827,2470,189434,89.81,11673029,10.202,25.4,6.704,6885.829,204.299,6.89,0.693,0
24,136,0,95071,0,3827,2991,192425,89.81,11673029,10.202,25.4,6.704,6885.829,204.299,6.89,0.693,0
24,137,1388,96459,57,3884,3552,195977,89.81,11673029,10.202,25.4,6.704,6885.829,204.299,6.89,0.693,0
24,138,2687,99146,119,4003,2721,198698,89.81,11673029,10.202,25.4,6.704,6885.829,204.299,6.89,0.693,0
24,139,1198,100344,45,4048,1513,200211,89.81,11673029,10.202,25.4,6.704,6885.829,204.299,6.89,0.693,0
24,140,879,101223,75,4123,4607,204818,89.81,11673029,10.202,25.4,6.704,6885.829,204.299,6.89,0.693,0
24,141,1796,103019,49,4172,3820,208638,89.81,11673029,10.202,25.4,6.704,6885.829,204.299,6.89,0.693,0
24,142,2031,105050,61,4233,2680,211318,89.81,11673029,10.202,25.4,6.704,6885.829,204.299,6.89,0.693,0
24,143,1015,106065,72,4305,2595,213913,89.81,11673029,10.202,25.4,6.704,6885.829,204.299,6.89,0.693,0
24,144,1370,107435,61,4366,2566,216479,89.81,11673029,10.202,25.4,6.704,6885.829,204.299,6.89,0.693,0
24,145,992,108427,76,4442,2385,218864,89.81,11673029,10.202,25.4,6.704,6885.829,204.299,6.89,0.693,0
24,146,722,109149,67,4509,2222,221086,89.81,11673029,10.202,25.4,6.704,6885.829,204.299,6.89,0.693,0
24,147,999,110148,69,4578,2114,223200,89.81,11673029,10.202,25.4,6.704,6885.829,204.299,6.89,0.693,0
24,148,851,110999,86,4664,2274,225474,89.81,11673029,10.202,25.4,6.704,6885.829,204.299,6.89,0.693,0
24,149,1095,112094,62,4726,3869,229343,89.81,11673029,10.202,25.4,6.704,6885.829,204.299,6.89,0.693,0
24,150,1035,113129,65,4791,3632,232975,89.81,11673029,10.202,25.4,6.704,6885.829,204.299,6.89,0.693,0
24,151,1280,114409,55,4846,2615,235590,89.81,11673029,10.202,25.4,6.704,6885.829,204.299,6.89,0.693,0
24,152,945,115354,92,4938,0,235590,89.81,11673029,10.202,25.4,6.704,6885.829,204.299,6.89,0.693,0
24,153,614,115968,28,4966,0,238965,89.81,11673029,10.202,25.4,6.704,6885.829,204.299,6.89,0.693,0
24,154,630,116598,61,5027,1693,240658,81.48,11673029,10.202,25.4,6.704,6885.829,204.299,6.89,0.693,0
24,155,669,117267,74,5101,2166,242824,81.48,11673029,10.202,25.4,6.704,6885.829,204.299,6.89,0.693,0
24,156,661,117928,102,5203,2426,245250,81.48,11673029,10.202,25.4,6.704,6885.829,204.299,6.89,0.693,0
24,157,0,117928,0,5203,2286,247536,81.48,11673029,10.202,25.4,6.704,6885.829,204.299,6.89,0.693,0
24,158,1652,119580,140,5343,2770,250306,81.48,11673029,10.202,25.4,6.704,6885.829,204.299,6.89,0.693,0
24,159,661,120241,55,5398,1625,251931,81.48,11673029,10.202,25.4,6.704,6885.829,204.299,6.89,0.693,0
24,160,528,120769,1610,7008,2557,254488,81.48,11673029,10.202,25.4,6.704,6885.829,204.299,6.89,0.693,0
24,161,835,121604,46,7054,2737,257225,81.48,11673029,10.202,25.4,6.704,6885.829,204.299,6.89,0.693,0
24,162,704,122308,43,7097,2691,259916,81.48,11673029,10.202,25.4,6.704,6885.829,204.299,6.89,0.693,0
24,163,1037,123345,49,7146,3985,263901,81.48,11673029,10.202,25.4,6.704,6885.829,204.299,6.89,0.693,0
24,164,860,124205,47,7193,2637,266538,81.48,11673029,10.202,25.4,6.704,6885.829,204.299,6.89,0.693,0
24,165,967,125172,57,7250,3090,269628,81.48,11673029,10.202,25.4,6.704,6885.829,204.299,6.89,0.693,0
24,166,810,125982,47,7297,1895,271523,81.48,11673029,10.202,25.4,6.704,6885.829,204.299,6.89,0.693,0
24,167,809,126791,47,7344,1513,273036,81.48,11673029,10.202,25.4,6.704,6885.829,204.299,6.89,0.693,0
24,168,828,127619,50,7394,2925,275961,81.48,11673029,10.202,25.4,6.704,6885.829,204.299,6.89,0.693,0
24,169,667,128286,53,7447,1684,277645,81.48,11673029,10.202,25.4,6.704,6885.829,204.299,6.89,0.693,0
24,170,586,128872,31,7478,2196,279841,81.48,11673029,10.202,25.4,6.704,6885.829,204.299,6.89,0.693,0
24,171,547,129419,33,7511,2300,282141,81.48,11673029,10.202,25.4,6.704,6885.829,204.299,6.89,0.693,0
24,172,632,130051,39,7550,1651,283792,81.48,11673029,10.202,25.4,6.704,6885.829,204.299,6.89,0.693,0
24,173,419,130470,36,7586,766,284558,81.48,11673029,10.202,25.4,6.704,6885.829,204.299,6.89,0.693,0
24,174,206,130676,31,7617,1097,285655,81.48,11673029,10.202,25.4,6.704,6885.829,204.299,6.89,0.693,0
24,175,310,130986,37,7654,1605,287260,81.48,11673029,10.202,25.4,6.704,6885.829,204.299,6.89,0.693,0
24,176,467,131453,39,7693,1870,289130,81.48,11673029,10.202,25.4,6.704,6885.829,204.299,6.89,0.693,0
24,177,537,131990,38,7731,1871,291001,81.48,11673029,10.202,25.4,6.704,6885.829,204.299,6.89,0.693,0
24,178,628,132618,34,7765,1571,292572,81.48,11673029,10.202,25.4,6.704,6885.829,204.299,6.89,0.693,0
24,179,604,133222,35,7800,1461,294033,81.48,11673029,10.202,25.4,6.704,6885.829,204.299,6.89,0.693,0
24,180,370,133592,28,7828,850,294883,81.48,11673029,10.202,25.4,6.704,6885.829,204.299,6.89,0.693,0
24,181,309,133901,30,7858,1040,295923,81.48,11673029,10.202,25.4,6.704,6885.829,204.299,6.89,0.693,0
24,182,407,134308,42,7900,1178,297101,81.48,11673029,10.202,25.4,6.704,6885.829,204.299,6.89,0.693,0
24,183,333,134641,31,7931,1896,298997,81.48,11673029,10.202,25.4,6.704,6885.829,204.299,6.89,0.693,0
24,184,670,135311,34,7965,1412,300409,81.48,11673029,10.202,25.4,6.704,6885.829,204.299,6.89,0.693,0
24,185,405,135716,36,8001,2098,302507,81.48,11673029,10.202,25.4,6.704,6885.829,204.299,6.89,0.693,0
24,186,503,136219,44,8045,1466,303973,81.48,11673029,10.202,25.4,6.704,6885.829,204.299,6.89,0.693,0
24,187,350,136569,28,8073,765,304738,81.48,11673029,10.202,25.4,6.704,6885.829,204.299,6.89,0.693,0
24,188,299,136868,28,8101,989,305727,81.48,11673029,10.202,25.4,6.704,6885.829,204.299,6.89,0.693,0
24,189,239,137107,28,8129,1218,306945,81.48,11673029,10.202,25.4,6.704,6885.829,204.299,6.89,0.693,0
24,190,361,137468,27,8156,1425,308370,81.48,11673029,10.202,25.4,6.704,6885.829,204.299,6.89,0.693,0
24,191,238,137706,36,8192,1139,309509,81.48,11673029,10.202,25.4,6.704,6885.829,204.299,6.89,0.693,0
24,192,263,137969,36,8228,1262,310771,81.48,11673029,10.202,25.4,6.704,6885.829,204.299,6.89,0.693,0
24,193,257,138226,34,8262,967,311738,81.48,11673029,10.202,25.4,6.704,6885.829,204.299,6.89,0.693,0
24,194,237,138463,30,8292,521,312259,81.48,11673029,10.202,25.4,6.704,6885.829,204.299,6.89,0.693,0
24,195,111,138574,16,8308,723,312982,81.48,11673029,10.202,25.4,6.704,6885.829,204.299,6.89,0.693,0
24,196,121,138695,18,8326,1251,314233,81.48,11673029,10.202,25.4,6.704,6885.829,204.299,6.89,0.693,0
24,197,227,138922,25,8351,1166,315399,81.48,11673029,10.202,25.4,6.704,6885.829,204.299,6.89,0.693,0
24,198,219,139141,26,8377,964,316363,81.48,11673029,10.202,25.4,6.704,6885.829,204.299,6.89,0.693,0
24,199,178,139319,30,8407,1170,317533,81.48,11673029,10.202,25.4,6.704,6885.829,204.299,6.89,0.693,0
24,200,243,139562,32,8439,1002,318535,81.48,11673029,10.202,25.4,6.704,6885.829,204.299,6.89,0.693,0
24,201,148,139710,24,8463,0,318535,81.48,11673029,10.202,25.4,6.704,6885.829,204.299,6.89,0.693,0
24,202,61,139771,18,8481,0,318535,81.48,11673029,10.202,25.4,6.704,6885.829,204.299,6.89,0.693,0
24,203,119,139890,21,8502,0,318535,81.48,11673029,10.202,25.4,6.704,6885.829,204.299,6.89,0.693,0
24,204,147,140037,24,8526,0,318535,81.48,11673029,10.202,25.4,6.704,6885.829,204.299,6.89,0.693,0
26,1,60,413,4,12,0,0,89.81,3280815,68.496,42.5,16.569,11713.895,329.635,10.08,0.768,0
26,2,51,464,1,13,0,0,89.81,3280815,68.496,42.5,16.569,11713.895,329.635,10.08,0.768,0
26,3,68,532,4,17,0,0,89.81,3280815,68.496,42.5,16.569,11713.895,329.635,10.08,0.768,0
26,4,54,586,1,18,0,0,89.81,3280815,68.496,42.5,16.569,11713.895,329.635,10.08,0.768,0
26,5,46,632,3,21,0,0,89.81,3280815,68.496,42.5,16.569,11713.895,329.635,10.08,0.768,0
26,6,31,663,3,24,0,0,89.81,3280815,68.496,42.5,16.569,11713.895,329.635,10.08,0.768,0
26,7,32,695,4,28,0,0,89.81,3280815,68.496,42.5,16.569,11713.895,329.635,10.08,0.768,0
26,8,86,781,4,32,0,0,89.81,3280815,68.496,42.5,16.569,11713.895,329.635,10.08,0.768,0
26,9,35,816,3,35,0,0,89.81,3280815,68.496,42.5,16.569,11713.895,329.635,10.08,0.768,0
26,10,59,875,1,36,0,0,92.59,3280815,68.496,42.5,16.569,11713.895,329.635,10.08,0.768,0
26,11,26,901,1,37,0,0,92.59,3280815,68.496,42.5,16.569,11713.895,329.635,10.08,0.768,0
26,12,47,948,0,37,0,0,92.59,3280815,68.496,42.5,16.569,11713.895,329.635,10.08,0.768,0
26,13,59,1007,1,38,0,0,92.59,3280815,68.496,42.5,16.569,11713.895,329.635,10.08,0.768,0
26,14,21,1028,0,38,0,0,92.59,3280815,68.496,42.5,16.569,11713.895,329.635,10.08,0.768,0
26,15,45,1073,1,39,0,0,92.59,3280815,68.496,42.5,16.569,11713.895,329.635,10.08,0.768,0
26,16,27,1100,1,40,0,0,92.59,3280815,68.496,42.5,16.569,11713.895,329.635,10.08,0.768,0
26,17,52,1152,1,41,0,0,92.59,3280815,68.496,42.5,16.569,11713.895,329.635,10.08,0.768,0
26,18,58,1210,3,44,0,0,92.59,3280815,68.496,42.5,16.569,11713.895,329.635,10.08,0.768,0
26,19,44,1254,1,45,0,0,92.59,3280815,68.496,42.5,16.569,11713.895,329.635,10.08,0.768,0
26,20,15,1269,1,46,0,0,92.59,3280815,68.496,42.5,16.569,11713.895,329.635,10.08,0.768,0
26,21,31,1300,2,48,0,0,92.59,3280815,68.496,42.5,16.569,11713.895,329.635,10.08,0.768,0
26,22,40,1340,2,50,0,0,92.59,3280815,68.496,42.5,16.569,11713.895,329.635,10.08,0.768,0
26,23,27,1367,2,52,0,0,92.59,3280815,68.496,42.5,16.569,11713.895,329.635,10.08,0.768,0
26,24,46,1413,1,53,0,0,90.74,3280815,68.496,42.5,16.569,11713.895,329.635,10.08,0.768,0
26,25,7,1420,1,54,0,0,90.74,3280815,68.496,42.5,16.569,11713.895,329.635,10.08,0.768,0
26,26,65,1485,2,56,0,0,90.74,3280815,68.496,42.5,16.569,11713.895,329.635,10.08,0.768,0
26,27,31,1516,2,58,0,0,90.74,3280815,68.496,42.5,16.569,11713.895,329.635,10.08,0.768,0
26,28,48,1564,2,60,0,0,90.74,3280815,68.496,42.5,16.569,11713.895,329.635,10.08,0.768,0
26,29,24,1588,2,62,0,0,90.74,3280815,68.496,42.5,16.569,11713.895,329.635,10.08,0.768,0
26,30,101,1689,2,64,0,0,90.74,3280815,68.496,42.5,16.569,11713.895,329.635,10.08,0.768,0
26,31,68,1757,4,68,0,0,90.74,3280815,68.496,42.5,16.569,11713.895,329.635,10.08,0.768,0
26,32,25,1782,1,69,0,0,90.74,3280815,68.496,42.5,16.569,11713.895,329.635,10.08,0.768,0
26,33,58,1840,2,71,0,0,90.74,3280815,68.496,42.5,16.569,11713.895,329.635,10.08,0.768,0
26,34,17,1857,5,76,0,0,90.74,3280815,68.496,42.5,16.569,11713.895,329.635,10.08,0.768,0
26,35,69,1926,1,77,0,0,90.74,3280815,68.496,42.5,16.569,11713.895,329.635,10.08,0.768,0
26,36,20,1946,1,78,0,0,90.74,3280815,68.496,42.5,16.569,11713.895,329.635,10.08,0.768,0
26,37,40,1986,6,84,0,0,90.74,3280815,68.496,42.5,16.569,11713.895,329.635,10.08,0.768,0
26,38,41,2027,6,90,0,0,90.74,3280815,68.496,42.5,16.569,11713.895,329.635,10.08,0.768,0
26,39,43,2070,8,98,0,0,90.74,3280815,68.496,42.5,16.569,11713.895,329.635,10.08,0.768,0
26,40,22,2092,3,101,0,0,90.74,3280815,68.496,42.5,16.569,11713.895,329.635,10.08,0.768,0
26,41,25,2117,6,107,0,0,81.48,3280815,68.496,42.5,16.569,11713.895,329.635,10.08,0.768,0
26,42,25,2142,5,112,0,0,81.48,3280815,68.496,42.5,16.569,11713.895,329.635,10.08,0.768,0
26,43,16,2158,4,116,0,0,81.48,3280815,68.496,42.5,16.569,11713.895,329.635,10.08,0.768,0
26,44,23,2181,4,120,0,0,79.63,3280815,68.496,42.5,16.569,11713.895,329.635,10.08,0.768,0
26,45,35,2216,3,123,0,0,76.85,3280815,68.496,42.5,16.569,11713.895,329.635,10.08,0.768,0
26,46,21,2237,4,127,0,0,76.85,3280815,68.496,42.5,16.569,11713.895,329.635,10.08,0.768,0
26,47,30,2267,2,129,0,0,76.85,3280815,68.496,42.5,16.569,11713.895,329.635,10.08,0.768,0
26,48,22,2289,3,132,0,0,76.85,3280815,68.496,42.5,16.569,11713.895,329.635,10.08,0.768,0
26,49,14,2303,0,132,0,0,76.85,3280815,68.496,42.5,16.569,11713.895,329.635,10.08,0.768,0
26,50,16,2319,1,133,0,0,76.85,3280815,68.496,42.5,16.569,11713.895,329.635,10.08,0.768,0
26,51,15,2334,2,135,0,0,71.3,3280815,68.496,42.5,16.569,11713.895,329.635,10.08,0.768,0
26,52,18,2352,4,139,0,0,71.3,3280815,68.496,42.5,16.569,11713.895,329.635,10.08,0.768,0
26,53,20,2372,2,141,0,0,71.3,3280815,68.496,42.5,16.569,11713.895,329.635,10.08,0.768,0
26,54,19,2391,0,141,0,0,71.3,3280815,68.496,42.5,16.569,11713.895,329.635,10.08,0.768,0
26,55,9,2400,2,143,0,0,71.3,3280815,68.496,42.5,16.569,11713.895,329.635,10.08,0.768,0
26,56,5,2405,2,145,0,0,71.3,3280815,68.496,42.5,16.569,11713.895,329.635,10.08,0.768,0
26,57,10,2415,4,149,0,0,71.3,3280815,68.496,42.5,16.569,11713.895,329.635,10.08,0.768,0
26,58,19,2434,1,150,0,0,71.3,3280815,68.496,42.5,16.569,11713.895,329.635,10.08,0.768,0
26,59,28,2462,2,152,0,0,65.74,3280815,68.496,42.5,16.569,11713.895,329.635,10.08,0.768,0
26,60,22,2484,0,152,0,0,65.74,3280815,68.496,42.5,16.569,11713.895,329.635,10.08,0.768,0
26,61,9,2493,0,152,0,0,65.74,3280815,68.496,42.5,16.569,11713.895,329.635,10.08,0.768,0
26,62,16,2509,0,152,0,0,54.63,3280815,68.496,42.5,16.569,11713.895,329.635,10.08,0.768,0
26,63,14,2523,1,153,0,0,54.63,3280815,68.496,42.5,16.569,11713.895,329.635,10.08,0.768,0
26,64,11,2534,3,156,0,0,54.63,3280815,68.496,42.5,16.569,11713.895,329.635,10.08,0.768,0
26,65,16,2550,0,156,0,0,54.63,3280815,68.496,42.5,16.569,11713.895,329.635,10.08,0.768,0
26,66,43,2593,2,158,0,0,54.63,3280815,68.496,42.5,16.569,11713.895,329.635,10.08,0.768,0
26,67,12,2605,0,158,0,0,54.63,3280815,68.496,42.5,16.569,11713.895,329.635,10.08,0.768,0
26,68,31,2636,0,158,0,0,54.63,3280815,68.496,42.5,16.569,11713.895,329.635,10.08,0.768,0
26,69,37,2673,1,159,0,0,54.63,3280815,68.496,42.5,16.569,11713.895,329.635,10.08,0.768,0
26,70,30,2703,0,159,0,0,54.63,3280815,68.496,42.5,16.569,11713.895,329.635,10.08,0.768,0
26,71,24,2727,0,159,0,0,54.63,3280815,68.496,42.5,16.569,11713.895,329.635,10.08,0.768,0
26,72,49,2776,1,160,0,0,54.63,3280815,68.496,42.5,16.569,11713.895,329.635,10.08,0.768,0
26,73,55,2831,0,160,0,0,54.63,3280815,68.496,42.5,16.569,11713.895,329.635,10.08,0.768,0
26,74,61,2892,2,162,0,0,51.85,3280815,68.496,42.5,16.569,11713.895,329.635,10.08,0.768,0
26,75,48,2940,1,163,0,0,51.85,3280815,68.496,42.5,16.569,11713.895,329.635,10.08,0.768,0
26,76,61,3001,0,163,0,0,51.85,3280815,68.496,42.5,16.569,11713.895,329.635,10.08,0.768,0
26,77,38,3039,1,164,0,0,51.85,3280815,68.496,42.5,16.569,11713.895,329.635,10.08,0.768,0
26,78,45,3084,3,167,0,0,51.85,3280815,68.496,42.5,16.569,11713.895,329.635,10.08,0.768,0
26,79,60,3144,0,167,0,0,51.85,3280815,68.496,42.5,16.569,11713.895,329.635,10.08,0.768,0
26,80,58,3202,0,167,0,0,51.85,3280815,68.496,42.5,16.569,11713.895,329.635,10.08,0.768,0
26,81,86,3288,1,168,0,0,51.85,3280815,68.496,42.5,16.569,11713.895,329.635,10.08,0.768,0
26,82,66,3354,1,169,0,0,51.85,3280815,68.496,42.5,16.569,11713.895,329.635,10.08,0.768,0
26,83,77,3431,0,169,0,0,51.85,3280815,68.496,42.5,16.569,11713.895,329.635,10.08,0.768,0
26,84,93,3524,1,170,0,0,51.85,3280815,68.496,42.5,16.569,11713.895,329.635,10.08,0.768,0
26,85,63,3587,1,171,0,0,51.85,3280815,68.496,42.5,16.569,11713.895,329.635,10.08,0.768,0
26,86,88,3675,1,172,0,0,51.85,3280815,68.496,42.5,16.569,11713.895,329.635,10.08,0.768,0
26,87,119,3794,2,174,0,0,51.85,3280815,68.496,42.5,16.569,11713.895,329.635,10.08,0.768,0
26,88,140,3934,3,177,0,0,51.85,3280815,68.496,42.5,16.569,11713.895,329.635,10.08,0.768,0
26,89,173,4107,2,179,0,0,51.85,3280815,68.496,42.5,16.569,11713.895,329.635,10.08,0.768,0
26,90,108,4215,3,182,0,0,51.85,3280815,68.496,42.5,16.569,11713.895,329.635,10.08,0.768,0
26,91,128,4343,1,183,0,0,51.85,3280815,68.496,42.5,16.569,11713.895,329.635,10.08,0.768,0
26,92,110,4453,2,185,0,0,51.85,3280815,68.496,42.5,16.569,11713.895,329.635,10.08,0.768,0
26,93,153,4606,2,187,0,0,51.85,3280815,68.496,42.5,16.569,11713.895,329.635,10.08,0.768,0
26,94,182,4788,1,188,0,0,51.85,3280815,68.496,42.5,16.569,11713.895,329.635,10.08,0.768,0
26,95,172,4960,2,190,0,0,51.85,3280815,68.496,42.5,16.569,11713.895,329.635,10.08,0.768,0
26,96,289,5249,0,190,0,0,56.48,3280815,68.496,42.5,16.569,11713.895,329.635,10.08,0.768,0
26,97,144,5393,3,193,0,0,56.48,3280815,68.496,42.5,16.569,11713.895,329.635,10.08,0.768,0
26,98,64,5457,3,196,0,0,56.48,3280815,68.496,42.5,16.569,11713.895,329.635,10.08,0.768,0
26,99,161,5618,10,206,0,0,56.48,3280815,68.496,42.5,16.569,11713.895,329.635,10.08,0.768,0
26,100,250,5868,1,207,0,0,56.48,3280815,68.496,42.5,16.569,11713.895,329.635,10.08,0.768,0
26,101,219,6087,6,213,0,0,56.48,3280815,68.496,42.5,16.569,11713.895,329.635,10.08,0.768,0
26,102,315,6402,2,215,0,0,56.48,3280815,68.496,42.5,16.569,11713.895,329.635,10.08,0.768,0
26,103,318,6720,3,218,0,0,56.48,3280815,68.496,42.5,16.569,11713.895,329.635,10.08,0.768,0
26,104,164,6884,2,220,0,0,56.48,3280815,68.496,42.5,16.569,11713.895,329.635,10.08,0.768,0
26,105,95,6979,4,224,0,0,56.48,3280815,68.496,42.5,16.569,11713.895,329.635,10.08,0.768,0
26,106,197,7176,1,225,0,0,56.48,3280815,68.496,42.5,16.569,11713.895,329.635,10.08,0.768,0
26,107,231,7407,8,233,0,0,56.48,3280815,68.496,42.5,16.569,11713.895,329.635,10.08,0.768,0
26,108,274,7681,6,239,0,0,56.48,3280815,68.496,42.5,16.569,11713.895,329.635,10.08,0.768,0
26,109,227,7908,4,243,0,0,56.48,3280815,68.496,42.5,16.569,11713.895,329.635,10.08,0.768,0
26,110,256,8164,2,245,0,0,56.48,3280815,68.496,42.5,16.569,11713.895,329.635,10.08,0.768,0
26,111,288,8452,5,250,0,0,56.48,3280815,68.496,42.5,16.569,11713.895,329.635,10.08,0.768,0
26,112,139,8591,6,256,0,0,56.48,3280815,68.496,42.5,16.569,11713.895,329.635,10.08,0.768,0
26,113,195,8786,5,261,0,0,56.48,3280815,68.496,42.5,16.569,11713.895,329.635,10.08,0.768,0
26,114,330,9116,6,267,0,0,56.48,3280815,68.496,42.5,16.569,11713.895,329.635,10.08,0.768,0
26,115,344,9460,5,272,0,0,59.26,3280815,68.496,42.5,16.569,11713.895,329.635,10.08,0.768,0
26,116,2,9462,2,274,0,0,59.26,3280815,68.496,42.5,16.569,11713.895,329.635,10.08,0.768,0
26,117,302,9764,4,278,0,0,59.26,3280815,68.496,42.5,16.569,11713.895,329.635,10.08,0.768,0
26,118,305,10069,5,283,0,0,59.26,3280815,68.496,42.5,16.569,11713.895,329.635,10.08,0.768,0
26,119,429,10498,11,294,0,0,59.26,3280815,68.496,42.5,16.569,11713.895,329.635,10.08,0.768,0
26,120,268,10766,3,297,0,0,59.26,3280815,68.496,42.5,16.569,11713.895,329.635,10.08,0.768,0
26,121,0,10766,0,297,0,0,59.26,3280815,68.496,42.5,16.569,11713.895,329.635,10.08,0.768,0
26,122,678,11444,31,328,0,0,59.26,3280815,68.496,42.5,16.569,11713.895,329.635,10.08,0.768,0
26,123,0,11444,0,328,0,0,59.26,3280815,68.496,42.5,16.569,11713.895,329.635,10.08,0.768,0
26,124,431,11875,7,335,0,0,59.26,3280815,68.496,42.5,16.569,11713.895,329.635,10.08,0.768,0
26,125,233,12108,8,343,0,0,59.26,3280815,68.496,42.5,16.569,11713.895,329.635,10.08,0.768,0
26,126,188,12296,4,347,0,0,59.26,3280815,68.496,42.5,16.569,11713.895,329.635,10.08,0.768,0
26,127,562,12858,21,368,0,0,59.26,3280815,68.496,42.5,16.569,11713.895,329.635,10.08,0.768,0
26,128,288,13146,6,374,0,0,59.26,3280815,68.496,42.5,16.569,11713.895,329.635,10.08,0.768,0
26,129,251,13397,5,379,0,0,59.26,3280815,68.496,42.5,16.569,11713.895,329.635,10.08,0.768,0
26,130,290,13687,15,394,0,0,59.26,3280815,68.496,42.5,16.569,11713.895,329.635,10.08,0.768,0
26,131,402,14089,2,396,0,0,59.26,3280815,68.496,42.5,16.569,11713.895,329.635,10.08,0.768,0
26,132,236,14325,6,402,0,0,59.26,3280815,68.496,42.5,16.569,11713.895,329.635,10.08,0.768,0
26,133,173,14498,23,425,0,0,59.26,3280815,68.496,42.5,16.569,11713.895,329.635,10.08,0.768,0
26,134,210,14708,22,447,0,0,59.26,3280815,68.496,42.5,16.569,11713.895,329.635,10.08,0.768,0
26,135,253,14961,6,453,0,0,59.26,3280815,68.496,42.5,16.569,11713.895,329.635,10.08,0.768,0
26,136,223,15184,5,458,0,0,59.26,3280815,68.496,42.5,16.569,11713.895,329.635,10.08,0.768,0
26,137,350,15534,6,464,0,0,59.26,3280815,68.496,42.5,16.569,11713.895,329.635,10.08,0.768,0
26,138,1,15535,5,469,0,0,59.26,3280815,68.496,42.5,16.569,11713.895,329.635,10.08,0.768,0
26,139,0,15535,0,469,0,0,59.26,3280815,68.496,42.5,16.569,11713.895,329.635,10.08,0.768,0
26,140,500,16035,6,475,0,0,59.26,3280815,68.496,42.5,16.569,11713.895,329.635,10.08,0.768,0
26,141,316,16351,20,495,0,0,59.26,3280815,68.496,42.5,16.569,11713.895,329.635,10.08,0.768,0
26,142,340,16691,12,507,0,0,59.26,3280815,68.496,42.5,16.569,11713.895,329.635,10.08,0.768,0
26,143,338,17029,8,515,0,0,53.7,3280815,68.496,42.5,16.569,11713.895,329.635,10.08,0.768,0
26,144,363,17392,5,520,0,0,53.7,3280815,68.496,42.5,16.569,11713.895,329.635,10.08,0.768,0
26,145,0,17392,0,520,0,0,53.7,3280815,68.496,42.5,16.569,11713.895,329.635,10.08,0.768,0
26,146,508,17900,9,529,0,0,53.7,3280815,68.496,42.5,16.569,11713.895,329.635,10.08,0.768,0
26,147,127,18027,11,540,0,0,53.7,3280815,68.496,42.5,16.569,11713.895,329.635,10.08,0.768,0
26,148,297,18324,14,554,0,0,53.7,3280815,68.496,42.5,16.569,11713.895,329.635,10.08,0.768,0
26,149,285,18609,17,571,0,0,53.7,3280815,68.496,42.5,16.569,11713.895,329.635,10.08,0.768,0
26,150,311,18920,11,582,0,0,53.7,3280815,68.496,42.5,16.569,11713.895,329.635,10.08,0.768,0
26,151,294,19214,3,585,0,0,53.7,3280815,68.496,42.5,16.569,11713.895,329.635,10.08,0.768,0
26,152,0,19214,3,588,0,0,53.7,3280815,68.496,42.5,16.569,11713.895,329.635,10.08,0.768,0
26,153,575,19789,4,592,0,0,46.3,3280815,68.496,42.5,16.569,11713.895,329.635,10.08,0.768,0
26,154,175,19964,17,609,0,0,46.3,3280815,68.496,42.5,16.569,11713.895,329.635,10.08,0.768,0
26,155,270,20234,11,620,0,0,46.3,3280815,68.496,42.5,16.569,11713.895,329.635,10.08,0.768,0
26,156,283,20517,7,627,0,0,46.3,3280815,68.496,42.5,16.569,11713.895,329.635,10.08,0.768,0
26,157,287,20804,9,636,0,0,46.3,3280815,68.496,42.5,16.569,11713.895,329.635,10.08,0.768,0
26,158,338,21142,3,639,0,0,46.3,3280815,68.496,42.5,16.569,11713.895,329.635,10.08,0.768,0
26,159,0,21142,0,639,0,0,46.3,3280815,68.496,42.5,16.569,11713.895,329.635,10.08,0.768,0
26,160,0,21142,0,639,0,0,40.74,3280815,68.496,42.5,16.569,11713.895,329.635,10.08,0.768,0
26,161,518,21660,25,664,0,0,40.74,3280815,68.496,42.5,16.569,11713.895,329.635,10.08,0.768,0
26,162,301,21961,5,669,0,0,40.74,3280815,68.496,42.5,16.569,11713.895,329.635,10.08,0.768,0
26,163,297,22258,6,675,0,0,40.74,3280815,68.496,42.5,16.569,11713.895,329.635,10.08,0.768,0
26,164,286,22544,5,680,0,0,40.74,3280815,68.496,42.5,16.569,11713.895,329.635,10.08,0.768,0
26,165,290,22834,6,686,0,0,40.74,3280815,68.496,42.5,16.569,11713.895,329.635,10.08,0.768,0
26,166,300,23134,0,686,0,0,40.74,3280815,68.496,42.5,16.569,11713.895,329.635,10.08,0.768,0
26,167,328,23462,3,689,0,0,40.74,3280815,68.496,42.5,16.569,11713.895,329.635,10.08,0.768,0
26,168,168,23630,9,698,0,0,40.74,3280815,68.496,42.5,16.569,11713.895,329.635,10.08,0.768,0
26,169,294,23924,20,718,0,0,40.74,3280815,68.496,42.5,16.569,11713.895,329.635,10.08,0.768,0
26,170,282,24206,11,729,0,0,40.74,3280815,68.496,42.5,16.569,11713.895,329.635,10.08,0.768,0
26,171,394,24600,12,741,0,0,40.74,3280815,68.496,42.5,16.569,11713.895,329.635,10.08,0.768,0
26,172,292,24892,5,746,0,0,40.74,3280815,68.496,42.5,16.569,11713.895,329.635,10.08,0.768,0
26,173,320,25212,6,752,0,0,40.74,3280815,68.496,42.5,16.569,11713.895,329.635,10.08,0.768,0
26,174,212,25424,5,757,0,0,40.74,3280815,68.496,42.5,16.569,11713.895,329.635,10.08,0.768,0
26,175,92,25516,6,763,0,0,40.74,3280815,68.496,42.5,16.569,11713.895,329.635,10.08,0.768,0
26,176,221,25737,15,778,0,0,40.74,3280815,68.496,42.5,16.569,11713.895,329.635,10.08,0.768,0
26,177,344,26081,12,790,0,0,40.74,3280815,68.496,42.5,16.569,11713.895,329.635,10.08,0.768,0
26,178,235,26316,12,802,0,0,40.74,3280815,68.496,42.5,16.569,11713.895,329.635,10.08,0.768,0
26,179,248,26564,6,808,0,0,40.74,3280815,68.496,42.5,16.569,11713.895,329.635,10.08,0.768,0
26,180,231,26795,0,808,0,0,40.74,3280815,68.496,42.5,16.569,11713.895,329.635,10.08,0.768,0
26,181,122,26917,2,810,0,0,40.74,3280815,68.496,42.5,16.569,11713.895,329.635,10.08,0.768,0
26,182,80,26997,12,822,0,0,40.74,3280815,68.496,42.5,16.569,11713.895,329.635,10.08,0.768,0
26,183,225,27222,14,836,0,0,40.74,3280815,68.496,42.5,16.569,11713.895,329.635,10.08,0.768,0
26,184,243,27465,13,849,0,0,40.74,3280815,68.496,42.5,16.569,11713.895,329.635,10.08,0.768,0
26,185,280,27745,5,854,0,0,40.74,3280815,68.496,42.5,16.569,11713.895,329.635,10.08,0.768,0
26,186,0,27745,0,854,0,0,40.74,3280815,68.496,42.5,16.569,11713.895,329.635,10.08,0.768,0
26,187,226,27971,10,864,0,0,40.74,3280815,68.496,42.5,16.569,11713.895,329.635,10.08,0.768,0
26,188,4,27975,7,871,0,0,40.74,3280815,68.496,42.5,16.569,11713.895,329.635,10.08,0.768,0
26,189,474,28449,17,888,0,0,40.74,3280815,68.496,42.5,16.569,11713.895,329.635,10.08,0.768,0
26,190,261,28710,15,903,0,0,40.74,3280815,68.496,42.5,16.569,11713.895,329.635,10.08,0.768,0
26,191,365,29075,5,908,0,0,40.74,3280815,68.496,42.5,16.569,11713.895,329.635,10.08,0.768,0
26,192,453,29528,5,913,0,0,40.74,3280815,68.496,42.5,16.569,11713.895,329.635,10.08,0.768,0
26,193,389,29917,13,926,0,0,40.74,3280815,68.496,42.5,16.569,11713.895,329.635,10.08,0.768,0
26,194,0,29917,0,926,0,0,40.74,3280815,68.496,42.5,16.569,11713.895,329.635,10.08,0.768,0
26,195,0,29917,0,926,0,0,40.74,3280815,68.496,42.5,16.569,11713.895,329.635,10.08,0.768,0
26,196,920,30837,10,936,0,0,40.74,3280815,68.496,42.5,16.569,11713.895,329.635,10.08,0.768,0
26,197,336,31173,11,947,0,0,40.74,3280815,68.496,42.5,16.569,11713.895,329.635,10.08,0.768,0
26,198,482,31655,11,958,0,0,40.74,3280815,68.496,42.5,16.569,11713.895,329.635,10.08,0.768,0
26,199,569,32224,14,972,0,0,40.74,3280815,68.496,42.5,16.569,11713.895,329.635,10.08,0.768,0
26,200,621,32845,8,980,0,0,40.74,3280815,68.496,42.5,16.569,11713.895,329.635,10.08,0.768,0
26,201,0,32845,0,980,0,0,40.74,3280815,68.496,42.5,16.569,11713.895,329.635,10.08,0.768,0
26,202,716,33561,0,980,0,0,40.74,3280815,68.496,42.5,16.569,11713.895,329.635,10.08,0.768,0
26,203,1100,34661,17,997,0,0,40.74,3280815,68.496,42.5,16.569,11713.895,329.635,10.08,0.768,0
26,204,728,35389,20,1017,0,0,40.74,3280815,68.496,42.5,16.569,11713.895,329.635,10.08,0.768,0
28,1,1138,5717,42,201,0,0,74.54,212559409,25.04,33.5,8.552,14103.452,177.961,8.11,0.759,2
28,2,1119,6836,40,241,0,0,74.54,212559409,25.04,33.5,8.552,14103.452,177.961,8.11,0.759,2
28,3,1074,7910,58,299,0,0,74.54,212559409,25.04,33.5,8.552,14103.452,177.961,8.11,0.759,2
28,4,1146,9056,60,359,0,0,74.54,212559409,25.04,33.5,8.552,14103.452,177.961,8.11,0.759,2
28,5,1222,10278,73,432,0,0,74.54,212559409,25.04,33.5,8.552,14103.452,177.961,8.11,0.759,2
28,6,852,11130,54,486,0,0,74.54,212559409,25.04,33.5,8.552,14103.452,177.961,8.11,0.759,2
28,7,926,12056,67,553,0,62985,74.54,212559409,25.04,33.5,8.552,14103.452,177.961,8.11,0.759,2
28,8,1661,13717,114,667,0,62985,74.54,212559409,25.04,33.5,8.552,14103.452,177.961,8.11,0.759,2
28,9,2210,15927,133,800,0,62985,74.54,212559409,25.04,33.5,8.552,14103.452,177.961,8.11,0.759,2
28,10,1930,17857,141,941,0,62985,74.54,212559409,25.04,33.5,8.552,14103.452,177.961,8.11,0.759,2
28,11,1781,19638,115,1056,0,62985,74.54,212559409,25.04,33.5,8.552,14103.452,177.961,8.11,0.759,2
28,12,1089,20727,68,1124,0,62985,74.54,212559409,25.04,33.5,8.552,14103.452,177.961,8.11,0.759,2
28,13,1442,22169,99,1223,0,62985,74.54,212559409,25.04,33.5,8.552,14103.452,177.961,8.11,0.759,2
28,14,1261,23430,105,1328,0,62985,74.54,212559409,25.04,33.5,8.552,14103.452,177.961,8.11,0.759,2
28,15,1832,25262,204,1532,0,62985,74.54,212559409,25.04,33.5,8.552,14103.452,177.961,8.11,0.759,2
28,16,3058,28320,204,1736,0,62985,74.54,212559409,25.04,33.5,8.552,14103.452,177.961,8.11,0.759,2
28,17,2105,30425,188,1924,0,62985,74.54,212559409,25.04,33.5,8.552,14103.452,177.961,8.11,0.759,2
28,18,3257,33682,217,2141,0,62985,74.54,212559409,25.04,33.5,8.552,14103.452,177.961,8.11,0.759,2
28,19,2917,36599,206,2347,0,62985,74.54,212559409,25.04,33.5,8.552,14103.452,177.961,8.11,0.759,2
28,20,2055,38654,115,2462,0,132467,74.54,212559409,25.04,33.5,8.552,14103.452,177.961,8.11,0.759,2
28,21,1927,40581,113,2575,0,132467,74.54,212559409,25.04,33.5,8.552,14103.452,177.961,8.11,0.759,2
28,22,2498,43079,166,2741,0,132467,74.54,212559409,25.04,33.5,8.552,14103.452,177.961,8.11,0.759,2
28,23,2678,45757,165,2906,0,132467,74.54,212559409,25.04,33.5,8.552,14103.452,177.961,8.11,0.759,2
28,24,3735,49492,407,3313,0,132467,74.54,212559409,25.04,33.5,8.552,14103.452,177.961,8.11,0.759,2
28,25,3503,52995,357,3670,0,132467,74.54,212559409,25.04,33.5,8.552,14103.452,177.961,8.11,0.759,2
28,26,5514,58509,346,4016,0,132467,77.31,212559409,25.04,33.5,8.552,14103.452,177.961,8.11,0.759,2
28,27,3379,61888,189,4205,0,132467,77.31,212559409,25.04,33.5,8.552,14103.452,177.961,8.11,0.759,2
28,28,4613,66501,338,4543,0,132467,77.31,212559409,25.04,33.5,8.552,14103.452,177.961,8.11,0.759,2
28,29,5385,71886,474,5017,0,132467,77.31,212559409,25.04,33.5,8.552,14103.452,177.961,8.11,0.759,2
28,30,6276,78162,449,5466,0,132467,77.31,212559409,25.04,33.5,8.552,14103.452,177.961,8.11,0.759,2
28,31,7218,85380,435,5901,0,132467,77.31,212559409,25.04,33.5,8.552,14103.452,177.961,8.11,0.759,2
28,32,6209,91589,428,6329,0,132467,77.31,212559409,25.04,33.5,8.552,14103.452,177.961,8.11,0.759,2
28,33,4970,96559,421,6750,0,132467,77.31,212559409,25.04,33.5,8.552,14103.452,177.961,8.11,0.759,2
28,34,4588,101147,275,7025,0,132467,77.31,212559409,25.04,33.5,8.552,14103.452,177.961,8.11,0.759,2
28,35,6633,107780,296,7321,0,132467,81.02,212559409,25.04,33.5,8.552,14103.452,177.961,8.11,0.759,2
28,36,6935,114715,600,7921,0,132467,81.02,212559409,25.04,33.5,8.552,14103.452,177.961,8.11,0.759,2
28,37,10503,125218,615,8536,0,132467,81.02,212559409,25.04,33.5,8.552,14103.452,177.961,8.11,0.759,2
28,38,9888,135106,610,9146,0,132467,81.02,212559409,25.04,33.5,8.552,14103.452,177.961,8.11,0.759,2
28,39,10222,145328,751,9897,0,132467,81.02,212559409,25.04,33.5,8.552,14103.452,177.961,8.11,0.759,2
28,40,10611,155939,730,10627,0,132467,81.02,212559409,25.04,33.5,8.552,14103.452,177.961,8.11,0.759,2
28,41,6760,162699,496,11123,0,132467,81.02,212559409,25.04,33.5,8.552,14103.452,177.961,8.11,0.759,2
28,42,5632,168331,396,11519,0,132467,81.02,212559409,25.04,33.5,8.552,14103.452,177.961,8.11,0.759,2
28,43,9258,177589,881,12400,0,132467,81.02,212559409,25.04,33.5,8.552,14103.452,177.961,8.11,0.759,2
28,44,11385,188974,749,13149,0,132467,81.02,212559409,25.04,33.5,8.552,14103.452,177.961,8.11,0.759,2
28,45,13944,202918,844,13993,0,132467,81.02,212559409,25.04,33.5,8.552,14103.452,177.961,8.11,0.759,2
28,46,15305,218223,824,14817,0,132467,81.02,212559409,25.04,33.5,8.552,14103.452,177.961,8.11,0.759,2
28,47,14919,233142,816,15633,0,132467,81.02,212559409,25.04,33.5,8.552,14103.452,177.961,8.11,0.759,2
28,48,7938,241080,485,16118,0,132467,81.02,212559409,25.04,33.5,8.552,14103.452,177.961,8.11,0.759,2
28,49,13140,254220,674,16792,0,132467,81.02,212559409,25.04,33.5,8.552,14103.452,177.961,8.11,0.759,2
28,50,17408,271628,1179,17971,0,132467,81.02,212559409,25.04,33.5,8.552,14103.452,177.961,8.11,0.759,2
28,51,19951,291579,888,18859,0,132467,81.02,212559409,25.04,33.5,8.552,14103.452,177.961,8.11,0.759,2
28,52,18508,310087,1188,20047,0,132467,81.02,212559409,25.04,33.5,8.552,14103.452,177.961,8.11,0.759,2
28,53,20803,330890,1001,21048,0,132467,81.02,212559409,25.04,33.5,8.552,14103.452,177.961,8.11,0.759,2
28,54,16508,347398,965,22013,0,132467,81.02,212559409,25.04,33.5,8.552,14103.452,177.961,8.11,0.759,2
28,55,15813,363211,653,22666,0,132467,81.02,212559409,25.04,33.5,8.552,14103.452,177.961,8.11,0.759,2
28,56,11687,374898,807,23473,0,132467,81.02,212559409,25.04,33.5,8.552,14103.452,177.961,8.11,0.759,2
28,57,16324,391222,1039,24512,0,132467,81.02,212559409,25.04,33.5,8.552,14103.452,177.961,8.11,0.759,2
28,58,20599,411821,1086,25598,0,132467,81.02,212559409,25.04,33.5,8.552,14103.452,177.961,8.11,0.759,2
28,59,26417,438238,1156,26754,0,485000,81.02,212559409,25.04,33.5,8.552,14103.452,177.961,8.11,0.759,2
28,60,26928,465166,1124,27878,0,485000,81.02,212559409,25.04,33.5,8.552,14103.452,177.961,8.11,0.759,2
28,61,33274,498440,956,28834,0,485000,81.02,212559409,25.04,33.5,8.552,14103.452,177.961,8.11,0.759,2
28,62,16409,514849,480,29314,0,485000,77.31,212559409,25.04,33.5,8.552,14103.452,177.961,8.11,0.759,2
28,63,11598,526447,623,29937,0,485000,77.31,212559409,25.04,33.5,8.552,14103.452,177.961,8.11,0.759,2
28,64,28936,555383,1262,31199,0,485000,77.31,212559409,25.04,33.5,8.552,14103.452,177.961,8.11,0.759,2
28,65,28633,584016,1349,32548,0,485000,77.31,212559409,25.04,33.5,8.552,14103.452,177.961,8.11,0.759,2
28,66,30916,614932,1473,34021,0,485000,77.31,212559409,25.04,33.5,8.552,14103.452,177.961,8.11,0.759,2
28,67,30830,645762,1005,35026,0,485000,77.31,212559409,25.04,33.5,8.552,14103.452,177.961,8.11,0.759,2
28,68,27075,672837,904,35930,0,485000,77.31,212559409,25.04,33.5,8.552,14103.452,177.961,8.11,0.759,2
28,69,18921,691758,525,36455,0,485000,77.31,212559409,25.04,33.5,8.552,14103.452,177.961,8.11,0.759,2
28,70,15654,707412,679,37134,0,485000,77.31,212559409,25.04,33.5,8.552,14103.452,177.961,8.11,0.759,2
28,71,32091,739503,1272,38406,0,485000,77.31,212559409,25.04,33.5,8.552,14103.452,177.961,8.11,0.759,2
28,72,32913,772416,1274,39680,0,485000,77.31,212559409,25.04,33.5,8.552,14103.452,177.961,8.11,0.759,2
28,73,30412,802828,1239,40919,0,485000,77.31,212559409,25.04,33.5,8.552,14103.452,177.961,8.11,0.759,2
28,74,25982,828810,909,41828,0,485000,77.31,212559409,25.04,33.5,8.552,14103.452,177.961,8.11,0.759,2
28,75,21704,850514,892,42720,0,485000,77.31,212559409,25.04,33.5,8.552,14103.452,177.961,8.11,0.759,2
28,76,17110,867624,612,43332,0,485000,77.31,212559409,25.04,33.5,8.552,14103.452,177.961,8.11,0.759,2
28,77,20647,888271,627,43959,0,485000,77.31,212559409,25.04,33.5,8.552,14103.452,177.961,8.11,0.759,2
28,78,34918,923189,1282,45241,0,485000,77.31,212559409,25.04,33.5,8.552,14103.452,177.961,8.11,0.759,2
28,79,32188,955377,1269,46510,0,485000,77.31,212559409,25.04,33.5,8.552,14103.452,177.961,8.11,0.759,2
28,80,22765,978142,1238,47748,0,485000,77.31,212559409,25.04,33.5,8.552,14103.452,177.961,8.11,0.759,2
28,81,54771,1032913,1206,48954,0,485000,77.31,212559409,25.04,33.5,8.552,14103.452,177.961,8.11,0.759,2
28,82,34666,1067579,1022,49976,0,485000,77.31,212559409,25.04,33.5,8.552,14103.452,177.961,8.11,0.759,2
28,83,17459,1085038,641,50617,0,485000,77.31,212559409,25.04,33.5,8.552,14103.452,177.961,8.11,0.759,2
28,84,21432,1106470,654,51271,0,485000,77.31,212559409,25.04,33.5,8.552,14103.452,177.961,8.11,0.759,2
28,85,39436,1145906,1374,52645,0,485000,77.31,212559409,25.04,33.5,8.552,14103.452,177.961,8.11,0.759,2
28,86,42725,1188631,1185,53830,0,485000,77.31,212559409,25.04,33.5,8.552,14103.452,177.961,8.11,0.759,2
28,87,39483,1228114,1141,54971,0,485000,77.31,212559409,25.04,33.5,8.552,14103.452,177.961,8.11,0.759,2
28,88,46860,1274974,990,55961,0,485000,77.31,212559409,25.04,33.5,8.552,14103.452,177.961,8.11,0.759,2
28,89,38693,1313667,1109,57070,0,485000,77.31,212559409,25.04,33.5,8.552,14103.452,177.961,8.11,0.759,2
28,90,30476,1344143,552,57622,0,485000,77.31,212559409,25.04,33.5,8.552,14103.452,177.961,8.11,0.759,2
28,91,24052,1368195,692,58314,0,1478671,77.31,212559409,25.04,33.5,8.552,14103.452,177.961,8.11,0.759,2
28,92,33846,1402041,1280,59594,0,1478671,77.31,212559409,25.04,33.5,8.552,14103.452,177.961,8.11,0.759,2
28,93,46712,1448753,1038,60632,0,1478671,77.31,212559409,25.04,33.5,8.552,14103.452,177.961,8.11,0.759,2
28,94,48105,1496858,1252,61884,0,1478671,81.02,212559409,25.04,33.5,8.552,14103.452,177.961,8.11,0.759,2
28,95,42223,1539081,1290,63174,0,2124223,81.02,212559409,25.04,33.5,8.552,14103.452,177.961,8.11,0.759,2
28,96,37923,1577004,1091,64265,0,2124223,81.02,212559409,25.04,33.5,8.552,14103.452,177.961,8.11,0.759,2
28,97,26051,1603055,602,64867,0,2124223,81.02,212559409,25.04,33.5,8.552,14103.452,177.961,8.11,0.759,2
28,98,20229,1623284,620,65487,0,2124223,81.02,212559409,25.04,33.5,8.552,14103.452,177.961,8.11,0.759,2
28,99,45305,1668589,1254,66741,0,2124223,81.02,212559409,25.04,33.5,8.552,14103.452,177.961,8.11,0.759,2
28,100,44571,1713160,1223,67964,0,2124223,81.02,212559409,25.04,33.5,8.552,14103.452,177.961,8.11,0.759,2
28,101,42619,1755779,1220,69184,0,2124223,81.02,212559409,25.04,33.5,8.552,14103.452,177.961,8.11,0.759,2
28,102,45048,1800827,1214,70398,0,2223803,81.02,212559409,25.04,33.5,8.552,14103.452,177.961,8.11,0.759,2
28,103,39023,1839850,1071,71469,0,2223803,81.02,212559409,25.04,33.5,8.552,14103.452,177.961,8.11,0.759,2
28,104,24831,1864681,631,72100,0,2223803,81.02,212559409,25.04,33.5,8.552,14103.452,177.961,8.11,0.759,2
28,105,20286,1884967,733,72833,0,2223803,81.02,212559409,25.04,33.5,8.552,14103.452,177.961,8.11,0.759,2
28,106,41857,1926824,1300,74133,0,2223803,81.02,212559409,25.04,33.5,8.552,14103.452,177.961,8.11,0.759,2
28,107,39924,1966748,1233,75366,0,2223803,81.02,212559409,25.04,33.5,8.552,14103.452,177.961,8.11,0.759,2
28,108,45403,2012151,1322,76688,0,2223803,81.02,212559409,25.04,33.5,8.552,14103.452,177.961,8.11,0.759,2
28,109,34177,2046328,1163,77851,0,2223803,81.02,212559409,25.04,33.5,8.552,14103.452,177.961,8.11,0.759,2
28,110,28532,2074860,921,78772,0,2223803,81.02,212559409,25.04,33.5,8.552,14103.452,177.961,8.11,0.759,2
28,111,23529,2098389,716,79488,0,2223803,81.02,212559409,25.04,33.5,8.552,14103.452,177.961,8.11,0.759,2
28,112,20257,2118646,632,80120,0,2536552,81.02,212559409,25.04,33.5,8.552,14103.452,177.961,8.11,0.759,2
28,113,41008,2159654,1367,81487,0,2536552,81.02,212559409,25.04,33.5,8.552,14103.452,177.961,8.11,0.759,2
28,114,67860,2227514,1284,82771,0,2536552,81.02,212559409,25.04,33.5,8.552,14103.452,177.961,8.11,0.759,2
28,115,59961,2287475,1311,84082,0,2536552,81.02,212559409,25.04,33.5,8.552,14103.452,177.961,8.11,0.759,2
28,116,55891,2343366,1156,85238,0,2678927,81.02,212559409,25.04,33.5,8.552,14103.452,177.961,8.11,0.759,2
28,117,51147,2394513,1211,86449,0,2678927,81.02,212559409,25.04,33.5,8.552,14103.452,177.961,8.11,0.759,2
28,118,24578,2419091,555,87004,0,2678927,81.02,212559409,25.04,33.5,8.552,14103.452,177.961,8.11,0.759,2
28,119,23284,2442375,614,87618,0,2678927,81.02,212559409,25.04,33.5,8.552,14103.452,177.961,8.11,0.759,2
28,120,40816,2483191,921,88539,0,2678927,72.69,212559409,25.04,33.5,8.552,14103.452,177.961,8.11,0.759,2
28,121,69074,2552265,1595,90134,0,2678927,72.69,212559409,25.04,33.5,8.552,14103.452,177.961,8.11,0.759,2
28,122,57837,2610102,1129,91263,0,2678927,72.69,212559409,25.04,33.5,8.552,14103.452,177.961,8.11,0.759,2
28,123,52383,2662485,1212,92475,0,2678927,72.69,212559409,25.04,33.5,8.552,14103.452,177.961,8.11,0.759,2
28,124,45392,2707877,1088,93563,0,3316167,72.69,212559409,25.04,33.5,8.552,14103.452,177.961,8.11,0.759,2
28,125,25800,2733677,541,94104,0,3316167,72.69,212559409,25.04,33.5,8.552,14103.452,177.961,8.11,0.759,2
28,126,16641,2750318,561,94665,0,3316167,72.69,212559409,25.04,33.5,8.552,14103.452,177.961,8.11,0.759,2
28,127,51603,2801921,1154,95819,0,3316167,72.69,212559409,25.04,33.5,8.552,14103.452,177.961,8.11,0.759,2
28,128,57152,2859073,1437,97256,0,3316167,72.69,212559409,25.04,33.5,8.552,14103.452,177.961,8.11,0.759,2
28,129,53139,2912212,1237,98493,0,3316167,72.69,212559409,25.04,33.5,8.552,14103.452,177.961,8.11,0.759,2
28,130,50230,2962442,1079,99572,0,3810322,72.69,212559409,25.04,33.5,8.552,14103.452,177.961,8.11,0.759,2
28,131,49970,3012412,905,100477,0,3810322,72.69,212559409,25.04,33.5,8.552,14103.452,177.961,8.11,0.759,2
28,132,23010,3035422,572,101049,0,3810322,72.69,212559409,25.04,33.5,8.552,14103.452,177.961,8.11,0.759,2
28,133,22048,3057470,703,101752,0,3810322,72.69,212559409,25.04,33.5,8.552,14103.452,177.961,8.11,0.759,2
28,134,52160,3109630,1274,103026,0,3810322,72.69,212559409,25.04,33.5,8.552,14103.452,177.961,8.11,0.759,2
28,135,55155,3164785,1175,104201,0,3810322,72.69,212559409,25.04,33.5,8.552,14103.452,177.961,8.11,0.759,2
28,136,60091,3224876,1262,105463,0,3810322,72.69,212559409,25.04,33.5,8.552,14103.452,177.961,8.11,0.759,2
28,137,50644,3275520,1060,106523,0,4152652,69.91,212559409,25.04,33.5,8.552,14103.452,177.961,8.11,0.759,2
28,138,41576,3317096,709,107232,0,4152652,69.91,212559409,25.04,33.5,8.552,14103.452,177.961,8.11,0.759,2
28,139,23101,3340197,620,107852,0,4152652,69.91,212559409,25.04,33.5,8.552,14103.452,177.961,8.11,0.759,2
28,140,19373,3359570,684,108536,0,4152652,69.91,212559409,25.04,33.5,8.552,14103.452,177.961,8.11,0.759,2
28,141,47784,3407354,1352,109888,0,4152652,69.91,212559409,25.04,33.5,8.552,14103.452,177.961,8.11,0.759,2
28,142,49298,3456652,1212,111100,0,4152652,69.91,212559409,25.04,33.5,8.552,14103.452,177.961,8.11,0.759,2
28,143,45323,3501975,1204,112304,0,4152652,69.91,212559409,25.04,33.5,8.552,14103.452,177.961,8.11,0.759,2
28,144,30355,3532330,1054,113358,0,4797948,69.91,212559409,25.04,33.5,8.552,14103.452,177.961,8.11,0.759,2
28,145,50032,3582362,892,114250,0,4797948,69.91,212559409,25.04,33.5,8.552,14103.452,177.961,8.11,0.759,2
28,146,23421,3605783,494,114744,0,4797948,73.61,212559409,25.04,33.5,8.552,14103.452,177.961,8.11,0.759,2
28,147,17078,3622861,565,115309,0,4797948,73.61,212559409,25.04,33.5,8.552,14103.452,177.961,8.11,0.759,2
28,148,47134,3669995,1271,116580,0,4797948,73.61,212559409,25.04,33.5,8.552,14103.452,177.961,8.11,0.759,2
28,149,47161,3717156,1085,117665,0,4797948,73.61,212559409,25.04,33.5,8.552,14103.452,177.961,8.11,0.759,2
28,150,44235,3761391,984,118649,0,4797948,73.61,212559409,25.04,33.5,8.552,14103.452,177.961,8.11,0.759,2
28,151,43412,3804803,855,119504,0,4797948,73.61,212559409,25.04,33.5,8.552,14103.452,177.961,8.11,0.759,2
28,152,41350,3846153,958,120462,0,4797948,73.61,212559409,25.04,33.5,8.552,14103.452,177.961,8.11,0.759,2
28,153,16158,3862311,366,120828,0,5183751,69.91,212559409,25.04,33.5,8.552,14103.452,177.961,8.11,0.759,2
28,154,45961,3908272,553,121381,0,5183751,69.91,212559409,25.04,33.5,8.552,14103.452,177.961,8.11,0.759,2
28,155,42659,3950931,1215,122596,0,5183751,69.91,212559409,25.04,33.5,8.552,14103.452,177.961,8.11,0.759,2
28,156,46934,3997865,1184,123780,0,5183751,69.91,212559409,25.04,33.5,8.552,14103.452,177.961,8.11,0.759,2
28,157,43773,4041638,834,124614,0,5183751,69.91,212559409,25.04,33.5,8.552,14103.452,177.961,8.11,0.759,2
28,158,51194,4092832,907,125521,0,5600000,69.91,212559409,25.04,33.5,8.552,14103.452,177.961,8.11,0.759,2
28,159,30168,4123000,682,126203,0,5600000,69.91,212559409,25.04,33.5,8.552,14103.452,177.961,8.11,0.759,2
28,160,14521,4137521,447,126650,0,5600000,69.91,212559409,25.04,33.5,8.552,14103.452,177.961,8.11,0.759,2
28,161,10273,4147794,310,126960,0,5600000,69.91,212559409,25.04,33.5,8.552,14103.452,177.961,8.11,0.759,2
28,162,14279,4162073,504,127464,0,5600000,69.91,212559409,25.04,33.5,8.552,14103.452,177.961,8.11,0.759,2
28,163,35816,4197889,1075,128539,0,5600000,69.91,212559409,25.04,33.5,8.552,14103.452,177.961,8.11,0.759,2
28,164,40557,4238446,983,129522,0,5600000,69.91,212559409,25.04,33.5,8.552,14103.452,177.961,8.11,0.759,2
28,165,43718,4282164,874,130396,0,5900000,69.91,212559409,25.04,33.5,8.552,14103.452,177.961,8.11,0.759,2
28,166,33523,4315687,814,131210,0,5900000,69.91,212559409,25.04,33.5,8.552,14103.452,177.961,8.11,0.759,2
28,167,14768,4330455,415,131625,0,5900000,69.91,212559409,25.04,33.5,8.552,14103.452,177.961,8.11,0.759,2
28,168,15155,4345610,381,132006,0,5900000,69.91,212559409,25.04,33.5,8.552,14103.452,177.961,8.11,0.759,2
28,169,36653,4382263,1113,133119,0,5900000,69.91,212559409,25.04,33.5,8.552,14103.452,177.961,8.11,0.759,2
28,170,36820,4419083,987,134106,0,5900000,69.91,212559409,25.04,33.5,8.552,14103.452,177.961,8.11,0.759,2
28,171,36303,4455386,829,134935,0,5900000,69.91,212559409,25.04,33.5,8.552,14103.452,177.961,8.11,0.759,2
28,172,39797,4495183,858,135793,0,6421441,69.91,212559409,25.04,33.5,8.552,14103.452,177.961,8.11,0.759,2
28,173,33057,4528240,739,136532,0,6421441,69.91,212559409,25.04,33.5,8.552,14103.452,177.961,8.11,0.759,2
28,174,16389,4544629,363,136895,0,6421441,69.91,212559409,25.04,33.5,8.552,14103.452,177.961,8.11,0.759,2
28,175,13439,4558068,377,137272,0,6421441,69.91,212559409,25.04,33.5,8.552,14103.452,177.961,8.11,0.759,2
28,176,33536,4591604,836,138108,0,6421441,67.13,212559409,25.04,33.5,8.552,14103.452,177.961,8.11,0.759,2
28,177,33281,4624885,869,138977,0,6421441,67.13,212559409,25.04,33.5,8.552,14103.452,177.961,8.11,0.759,2
28,178,32817,4657702,831,139808,0,6421441,67.13,212559409,25.04,33.5,8.552,14103.452,177.961,8.11,0.759,2
28,179,31911,4689613,729,140537,0,6421441,67.13,212559409,25.04,33.5,8.552,14103.452,177.961,8.11,0.759,2
28,180,28378,4717991,869,141406,0,6421441,67.13,212559409,25.04,33.5,8.552,14103.452,177.961,8.11,0.759,2
28,181,14318,4732309,335,141741,0,6421441,67.13,212559409,25.04,33.5,8.552,14103.452,177.961,8.11,0.759,2
28,182,13155,4745464,317,142058,0,6421441,67.13,212559409,25.04,33.5,8.552,14103.452,177.961,8.11,0.759,2
28,183,32058,4777522,863,142921,0,6421441,67.13,212559409,25.04,33.5,8.552,14103.452,177.961,8.11,0.759,2
28,184,33413,4810935,1031,143952,0,6421441,67.13,212559409,25.04,33.5,8.552,14103.452,177.961,8.11,0.759,2
28,185,36157,4847092,728,144680,0,6421441,67.13,212559409,25.04,33.5,8.552,14103.452,177.961,8.11,0.759,2
28,186,33431,4880523,708,145388,0,6421441,67.13,212559409,25.04,33.5,8.552,14103.452,177.961,8.11,0.759,2
28,187,26310,4906833,599,145987,0,6421441,67.13,212559409,25.04,33.5,8.552,14103.452,177.961,8.11,0.759,2
28,188,8456,4915289,365,146352,0,6421441,67.13,212559409,25.04,33.5,8.552,14103.452,177.961,8.11,0.759,2
28,189,11946,4927235,323,146675,0,6421441,67.13,212559409,25.04,33.5,8.552,14103.452,177.961,8.11,0.759,2
28,190,41906,4969141,819,147494,0,6421441,67.13,212559409,25.04,33.5,8.552,14103.452,177.961,8.11,0.759,2
28,191,31553,5000694,734,148228,0,6421441,63.43,212559409,25.04,33.5,8.552,14103.452,177.961,8.11,0.759,2
28,192,27750,5028444,729,148957,0,6421441,63.43,212559409,25.04,33.5,8.552,14103.452,177.961,8.11,0.759,2
28,193,27444,5055888,682,149639,0,6421441,63.43,212559409,25.04,33.5,8.552,14103.452,177.961,8.11,0.759,2
28,194,26749,5082637,559,150198,0,6421441,63.43,212559409,25.04,33.5,8.552,14103.452,177.961,8.11,0.759,2
28,195,12345,5094982,290,150488,0,6421441,63.43,212559409,25.04,33.5,8.552,14103.452,177.961,8.11,0.759,2
28,196,8426,5103408,201,150689,0,6421441,63.43,212559409,25.04,33.5,8.552,14103.452,177.961,8.11,0.759,2
28,197,10220,5113628,309,150998,0,6421441,63.43,212559409,25.04,33.5,8.552,14103.452,177.961,8.11,0.759,2
28,198,27235,5140863,749,151747,0,6421441,63.43,212559409,25.04,33.5,8.552,14103.452,177.961,8.11,0.759,2
28,199,28523,5169386,713,152460,0,6421441,63.43,212559409,25.04,33.5,8.552,14103.452,177.961,8.11,0.759,2
28,200,30914,5200300,754,153214,0,6421441,63.43,212559409,25.04,33.5,8.552,14103.452,177.961,8.11,0.759,2
28,201,24062,5224362,461,153675,0,6421441,63.43,212559409,25.04,33.5,8.552,14103.452,177.961,8.11,0.759,2
28,202,10982,5235344,230,153905,0,6421441,63.43,212559409,25.04,33.5,8.552,14103.452,177.961,8.11,0.759,2
28,203,15383,5250727,271,154176,0,6421441,63.43,212559409,25.04,33.5,8.552,14103.452,177.961,8.11,0.759,2
28,204,23227,5273954,661,154837,0,6421441,63.43,212559409,25.04,33.5,8.552,14103.452,177.961,8.11,0.759,2
30,1,2,129,0,1,0,0,52.78,437483,81.347,32.4,4.591,71809.251,201.285,12.79,0.853,0
30,2,2,131,0,1,0,0,52.78,437483,81.347,32.4,4.591,71809.251,201.285,12.79,0.853,0
30,3,2,133,0,1,0,0,52.78,437483,81.347,32.4,4.591,71809.251,201.285,12.79,0.853,0
30,4,0,133,0,1,0,0,52.78,437483,81.347,32.4,4.591,71809.251,201.285,12.79,0.853,0
30,5,2,135,0,1,0,0,52.78,437483,81.347,32.4,4.591,71809.251,201.285,12.79,0.853,0
30,6,0,135,0,1,0,0,52.78,437483,81.347,32.4,4.591,71809.251,201.285,12.79,0.853,0
30,7,0,135,0,1,0,0,52.78,437483,81.347,32.4,4.591,71809.251,201.285,12.79,0.853,0
30,8,0,135,0,1,0,0,52.78,437483,81.347,32.4,4.591,71809.251,201.285,12.79,0.853,0
30,9,0,135,0,1,0,0,52.78,437483,81.347,32.4,4.591,71809.251,201.285,12.79,0.853,0
30,10,0,135,0,1,0,0,52.78,437483,81.347,32.4,4.591,71809.251,201.285,12.79,0.853,0
30,11,1,136,0,1,0,0,58.33,437483,81.347,32.4,4.591,71809.251,201.285,12.79,0.853,0
30,12,0,136,0,1,0,0,58.33,437483,81.347,32.4,4.591,71809.251,201.285,12.79,0.853,0
30,13,0,136,0,1,0,0,58.33,437483,81.347,32.4,4.591,71809.251,201.285,12.79,0.853,0
30,14,0,136,0,1,0,0,58.33,437483,81.347,32.4,4.591,71809.251,201.285,12.79,0.853,0
30,15,0,136,0,1,0,0,58.33,437483,81.347,32.4,4.591,71809.251,201.285,12.79,0.853,0
30,16,0,136,0,1,0,0,58.33,437483,81.347,32.4,4.591,71809.251,201.285,12.79,0.853,0
30,17,0,136,0,1,0,0,58.33,437483,81.347,32.4,4.591,71809.251,201.285,12.79,0.853,0
30,18,0,136,0,1,0,0,58.33,437483,81.347,32.4,4.591,71809.251,201.285,12.79,0.853,0
30,19,1,137,0,1,0,0,58.33,437483,81.347,32.4,4.591,71809.251,201.285,12.79,0.853,0
30,20,1,138,0,1,0,0,58.33,437483,81.347,32.4,4.591,71809.251,201.285,12.79,0.853,0
30,21,0,138,0,1,0,0,58.33,437483,81.347,32.4,4.591,71809.251,201.285,12.79,0.853,0
30,22,0,138,0,1,0,0,58.33,437483,81.347,32.4,4.591,71809.251,201.285,12.79,0.853,0
30,23,0,138,0,1,0,0,58.33,437483,81.347,32.4,4.591,71809.251,201.285,12.79,0.853,0
30,24,0,138,0,1,0,0,58.33,437483,81.347,32.4,4.591,71809.251,201.285,12.79,0.853,0
30,25,0,138,0,1,0,0,58.33,437483,81.347,32.4,4.591,71809.251,201.285,12.79,0.853,0
30,26,0,138,0,1,0,0,58.33,437483,81.347,32.4,4.591,71809.251,201.285,12.79,0.853,0
30,27,0,138,0,1,0,0,58.33,437483,81.347,32.4,4.591,71809.251,201.285,12.79,0.853,0
30,28,0,138,0,1,0,0,58.33,437483,81.347,32.4,4.591,71809.251,201.285,12.79,0.853,0
30,29,0,138,0,1,0,0,58.33,437483,81.347,32.4,4.591,71809.251,201.285,12.79,0.853,0
30,30,0,138,0,1,0,0,58.33,437483,81.347,32.4,4.591,71809.251,201.285,12.79,0.853,0
30,31,0,138,0,1,0,0,58.33,437483,81.347,32.4,4.591,71809.251,201.285,12.79,0.853,0
30,32,0,138,0,1,0,0,58.33,437483,81.347,32.4,4.591,71809.251,201.285,12.79,0.853,0
30,33,0,138,0,1,0,0,58.33,437483,81.347,32.4,4.591,71809.251,201.285,12.79,0.853,0
30,34,0,138,0,1,0,0,58.33,437483,81.347,32.4,4.591,71809.251,201.285,12.79,0.853,0
30,35,0,138,0,1,0,0,58.33,437483,81.347,32.4,4.591,71809.251,201.285,12.79,0.853,0
30,36,0,138,0,1,0,0,58.33,437483,81.347,32.4,4.591,71809.251,201.285,12.79,0.853,0
30,37,1,139,0,1,0,0,58.33,437483,81.347,32.4,4.591,71809.251,201.285,12.79,0.853,0
30,38,2,141,0,1,0,0,58.33,437483,81.347,32.4,4.591,71809.251,201.285,12.79,0.853,0
30,39,0,141,0,1,0,0,58.33,437483,81.347,32.4,4.591,71809.251,201.285,12.79,0.853,0
30,40,0,141,0,1,0,0,58.33,437483,81.347,32.4,4.591,71809.251,201.285,12.79,0.853,0
30,41,0,141,0,1,0,0,58.33,437483,81.347,32.4,4.591,71809.251,201.285,12.79,0.853,0
30,42,0,141,0,1,0,0,58.33,437483,81.347,32.4,4.591,71809.251,201.285,12.79,0.853,0
30,43,0,141,0,1,0,0,58.33,437483,81.347,32.4,4.591,71809.251,201.285,12.79,0.853,0
30,44,0,141,0,1,0,0,58.33,437483,81.347,32.4,4.591,71809.251,201.285,12.79,0.853,0
30,45,0,141,0,1,0,0,52.78,437483,81.347,32.4,4.591,71809.251,201.285,12.79,0.853,0
30,46,0,141,0,1,0,0,52.78,437483,81.347,32.4,4.591,71809.251,201.285,12.79,0.853,0
30,47,0,141,0,1,0,0,52.78,437483,81.347,32.4,4.591,71809.251,201.285,12.79,0.853,0
30,48,0,141,0,1,0,0,52.78,437483,81.347,32.4,4.591,71809.251,201.285,12.79,0.853,0
30,49,0,141,0,1,0,0,52.78,437483,81.347,32.4,4.591,71809.251,201.285,12.79,0.853,0
30,50,0,141,0,1,0,0,52.78,437483,81.347,32.4,4.591,71809.251,201.285,12.79,0.853,0
30,51,0,141,0,1,0,0,52.78,437483,81.347,32.4,4.591,71809.251,201.285,12.79,0.853,0
30,52,0,141,0,1,0,0,52.78,437483,81.347,32.4,4.591,71809.251,201.285,12.79,0.853,0
30,53,0,141,0,1,0,0,52.78,437483,81.347,32.4,4.591,71809.251,201.285,12.79,0.853,0
30,54,0,141,0,1,0,0,52.78,437483,81.347,32.4,4.591,71809.251,201.285,12.79,0.853,0
30,55,0,141,0,1,0,0,52.78,437483,81.347,32.4,4.591,71809.251,201.285,12.79,0.853,0
30,56,0,141,0,1,0,0,52.78,437483,81.347,32.4,4.591,71809.251,201.285,12.79,0.853,0
30,57,0,141,0,1,0,0,52.78,437483,81.347,32.4,4.591,71809.251,201.285,12.79,0.853,0
30,58,0,141,1,2,0,0,52.78,437483,81.347,32.4,4.591,71809.251,201.285,12.79,0.853,0
30,59,0,141,0,2,0,0,52.78,437483,81.347,32.4,4.591,71809.251,201.285,12.79,0.853,0
30,60,0,141,0,2,0,0,52.78,437483,81.347,32.4,4.591,71809.251,201.285,12.79,0.853,0
30,61,0,141,0,2,0,0,52.78,437483,81.347,32.4,4.591,71809.251,201.285,12.79,0.853,0
30,62,0,141,0,2,0,0,52.78,437483,81.347,32.4,4.591,71809.251,201.285,12.79,0.853,0
30,63,0,141,0,2,0,0,49.07,437483,81.347,32.4,4.591,71809.251,201.285,12.79,0.853,0
30,64,0,141,0,2,0,0,49.07,437483,81.347,32.4,4.591,71809.251,201.285,12.79,0.853,0
30,65,0,141,0,2,0,0,49.07,437483,81.347,32.4,4.591,71809.251,201.285,12.79,0.853,0
30,66,0,141,0,2,0,0,49.07,437483,81.347,32.4,4.591,71809.251,201.285,12.79,0.853,0
30,67,0,141,0,2,0,0,49.07,437483,81.347,32.4,4.591,71809.251,201.285,12.79,0.853,0
30,68,0,141,0,2,0,0,49.07,437483,81.347,32.4,4.591,71809.251,201.285,12.79,0.853,0
30,69,0,141,0,2,0,0,49.07,437483,81.347,32.4,4.591,71809.251,201.285,12.79,0.853,0
30,70,0,141,0,2,0,0,49.07,437483,81.347,32.4,4.591,71809.251,201.285,12.79,0.853,0
30,71,0,141,0,2,0,0,49.07,437483,81.347,32.4,4.591,71809.251,201.285,12.79,0.853,0
30,72,0,141,0,2,0,0,49.07,437483,81.347,32.4,4.591,71809.251,201.285,12.79,0.853,0
30,73,0,141,0,2,0,0,49.07,437483,81.347,32.4,4.591,71809.251,201.285,12.79,0.853,0
30,74,0,141,0,2,0,0,49.07,437483,81.347,32.4,4.591,71809.251,201.285,12.79,0.853,0
30,75,0,141,0,2,0,0,49.07,437483,81.347,32.4,4.591,71809.251,201.285,12.79,0.853,0
30,76,0,141,0,2,0,0,49.07,437483,81.347,32.4,4.591,71809.251,201.285,12.79,0.853,0
30,77,0,141,0,2,0,0,49.07,437483,81.347,32.4,4.591,71809.251,201.285,12.79,0.853,0
30,78,0,141,1,3,0,0,49.07,437483,81.347,32.4,4.591,71809.251,201.285,12.79,0.853,0
30,79,0,141,0,3,0,0,49.07,437483,81.347,32.4,4.591,71809.251,201.285,12.79,0.853,0
30,80,0,141,0,3,0,0,49.07,437483,81.347,32.4,4.591,71809.251,201.285,12.79,0.853,0
30,81,0,141,0,3,0,0,49.07,437483,81.347,32.4,4.591,71809.251,201.285,12.79,0.853,0
30,82,0,141,0,3,0,0,49.07,437483,81.347,32.4,4.591,71809.251,201.285,12.79,0.853,0
30,83,0,141,0,3,0,0,49.07,437483,81.347,32.4,4.591,71809.251,201.285,12.79,0.853,0
30,84,0,141,0,3,0,0,49.07,437483,81.347,32.4,4.591,71809.251,201.285,12.79,0.853,0
30,85,0,141,0,3,0,0,49.07,437483,81.347,32.4,4.591,71809.251,201.285,12.79,0.853,0
30,86,0,141,0,3,0,0,49.07,437483,81.347,32.4,4.591,71809.251,201.285,12.79,0.853,0
30,87,0,141,0,3,0,0,49.07,437483,81.347,32.4,4.591,71809.251,201.285,12.79,0.853,0
30,88,0,141,0,3,0,0,49.07,437483,81.347,32.4,4.591,71809.251,201.285,12.79,0.853,0
30,89,0,141,0,3,0,0,49.07,437483,81.347,32.4,4.591,71809.251,201.285,12.79,0.853,0
30,90,0,141,0,3,0,0,49.07,437483,81.347,32.4,4.591,71809.251,201.285,12.79,0.853,0
30,91,0,141,0,3,0,0,49.07,437483,81.347,32.4,4.591,71809.251,201.285,12.79,0.853,0
30,92,0,141,0,3,0,0,49.07,437483,81.347,32.4,4.591,71809.251,201.285,12.79,0.853,0
30,93,0,141,0,3,0,0,49.07,437483,81.347,32.4,4.591,71809.251,201.285,12.79,0.853,0
30,94,0,141,0,3,0,0,49.07,437483,81.347,32.4,4.591,71809.251,201.285,12.79,0.853,0
30,95,0,141,0,3,0,0,49.07,437483,81.347,32.4,4.591,71809.251,201.285,12.79,0.853,0
30,96,0,141,0,3,0,0,49.07,437483,81.347,32.4,4.591,71809.251,201.285,12.79,0.853,0
30,97,0,141,0,3,0,0,49.07,437483,81.347,32.4,4.591,71809.251,201.285,12.79,0.853,0
30,98,0,141,0,3,0,0,49.07,437483,81.347,32.4,4.591,71809.251,201.285,12.79,0.853,0
30,99,0,141,0,3,0,0,49.07,437483,81.347,32.4,4.591,71809.251,201.285,12.79,0.853,0
30,100,0,141,0,3,0,0,49.07,437483,81.347,32.4,4.591,71809.251,201.285,12.79,0.853,0
30,101,0,141,0,3,0,0,49.07,437483,81.347,32.4,4.591,71809.251,201.285,12.79,0.853,0
30,102,0,141,0,3,0,0,49.07,437483,81.347,32.4,4.591,71809.251,201.285,12.79,0.853,0
30,103,0,141,0,3,0,0,49.07,437483,81.347,32.4,4.591,71809.251,201.285,12.79,0.853,0
30,104,0,141,0,3,0,0,49.07,437483,81.347,32.4,4.591,71809.251,201.285,12.79,0.853,0
30,105,0,141,0,3,0,0,49.07,437483,81.347,32.4,4.591,71809.251,201.285,12.79,0.853,0
30,106,0,141,0,3,0,0,49.07,437483,81.347,32.4,4.591,71809.251,201.285,12.79,0.853,0
30,107,0,141,0,3,0,0,49.07,437483,81.347,32.4,4.591,71809.251,201.285,12.79,0.853,0
30,108,0,141,0,3,0,0,49.07,437483,81.347,32.4,4.591,71809.251,201.285,12.79,0.853,0
30,109,0,141,0,3,0,0,49.07,437483,81.347,32.4,4.591,71809.251,201.285,12.79,0.853,0
30,110,0,141,0,3,0,0,49.07,437483,81.347,32.4,4.591,71809.251,201.285,12.79,0.853,0
30,111,0,141,0,3,0,0,49.07,437483,81.347,32.4,4.591,71809.251,201.285,12.79,0.853,0
30,112,0,141,0,3,0,0,49.07,437483,81.347,32.4,4.591,71809.251,201.285,12.79,0.853,0
30,113,0,141,0,3,0,0,49.07,437483,81.347,32.4,4.591,71809.251,201.285,12.79,0.853,0
30,114,0,141,0,3,0,0,49.07,437483,81.347,32.4,4.591,71809.251,201.285,12.79,0.853,0
30,115,0,141,0,3,0,0,49.07,437483,81.347,32.4,4.591,71809.251,201.285,12.79,0.853,0
30,116,0,141,0,3,0,0,49.07,437483,81.347,32.4,4.591,71809.251,201.285,12.79,0.853,0
30,117,0,141,0,3,0,0,49.07,437483,81.347,32.4,4.591,71809.251,201.285,12.79,0.853,0
30,118,0,141,0,3,0,0,36.11,437483,81.347,32.4,4.591,71809.251,201.285,12.79,0.853,0
30,119,0,141,0,3,0,0,36.11,437483,81.347,32.4,4.591,71809.251,201.285,12.79,0.853,0
30,120,0,141,0,3,0,0,36.11,437483,81.347,32.4,4.591,71809.251,201.285,12.79,0.853,0
30,121,0,141,0,3,0,0,36.11,437483,81.347,32.4,4.591,71809.251,201.285,12.79,0.853,0
30,122,0,141,0,3,0,0,36.11,437483,81.347,32.4,4.591,71809.251,201.285,12.79,0.853,0
30,123,0,141,0,3,0,0,36.11,437483,81.347,32.4,4.591,71809.251,201.285,12.79,0.853,0
30,124,0,141,0,3,0,0,36.11,437483,81.347,32.4,4.591,71809.251,201.285,12.79,0.853,0
30,125,0,141,0,3,0,0,36.11,437483,81.347,32.4,4.591,71809.251,201.285,12.79,0.853,0
30,126,0,141,0,3,0,0,36.11,437483,81.347,32.4,4.591,71809.251,201.285,12.79,0.853,0
30,127,0,141,0,3,0,0,36.11,437483,81.347,32.4,4.591,71809.251,201.285,12.79,0.853,0
30,128,0,141,0,3,0,0,36.11,437483,81.347,32.4,4.591,71809.251,201.285,12.79,0.853,0
30,129,0,141,0,3,0,0,36.11,437483,81.347,32.4,4.591,71809.251,201.285,12.79,0.853,0
30,130,1,142,0,3,0,0,36.11,437483,81.347,32.4,4.591,71809.251,201.285,12.79,0.853,0
30,131,0,142,0,3,0,0,36.11,437483,81.347,32.4,4.591,71809.251,201.285,12.79,0.853,0
30,132,0,142,0,3,0,0,36.11,437483,81.347,32.4,4.591,71809.251,201.285,12.79,0.853,0
30,133,0,142,0,3,0,0,36.11,437483,81.347,32.4,4.591,71809.251,201.285,12.79,0.853,0
30,134,0,142,0,3,0,0,36.11,437483,81.347,32.4,4.591,71809.251,201.285,12.79,0.853,0
30,135,0,142,0,3,0,0,33.33,437483,81.347,32.4,4.591,71809.251,201.285,12.79,0.853,0
30,136,0,142,0,3,0,0,33.33,437483,81.347,32.4,4.591,71809.251,201.285,12.79,0.853,0
30,137,0,142,0,3,0,0,33.33,437483,81.347,32.4,4.591,71809.251,201.285,12.79,0.853,0
30,138,0,142,0,3,0,0,33.33,437483,81.347,32.4,4.591,71809.251,201.285,12.79,0.853,0
30,139,0,142,0,3,0,0,37.04,437483,81.347,32.4,4.591,71809.251,201.285,12.79,0.853,0
30,140,0,142,0,3,0,0,37.04,437483,81.347,32.4,4.591,71809.251,201.285,12.79,0.853,0
30,141,0,142,0,3,0,0,37.04,437483,81.347,32.4,4.591,71809.251,201.285,12.79,0.853,0
30,142,0,142,0,3,0,0,37.04,437483,81.347,32.4,4.591,71809.251,201.285,12.79,0.853,0
30,143,1,143,0,3,0,0,37.04,437483,81.347,32.4,4.591,71809.251,201.285,12.79,0.853,0
30,144,0,143,0,3,0,0,37.04,437483,81.347,32.4,4.591,71809.251,201.285,12.79,0.853,0
30,145,0,143,0,3,0,0,37.04,437483,81.347,32.4,4.591,71809.251,201.285,12.79,0.853,0
30,146,0,143,0,3,0,0,37.04,437483,81.347,32.4,4.591,71809.251,201.285,12.79,0.853,0
30,147,0,143,0,3,0,0,37.04,437483,81.347,32.4,4.591,71809.251,201.285,12.79,0.853,0
30,148,1,144,0,3,0,0,37.04,437483,81.347,32.4,4.591,71809.251,201.285,12.79,0.853,0
30,149,0,144,0,3,0,0,37.04,437483,81.347,32.4,4.591,71809.251,201.285,12.79,0.853,0
30,150,0,144,0,3,0,0,37.04,437483,81.347,32.4,4.591,71809.251,201.285,12.79,0.853,0
30,151,0,144,0,3,0,0,37.04,437483,81.347,32.4,4.591,71809.251,201.285,12.79,0.853,0
30,152,0,144,0,3,0,0,37.04,437483,81.347,32.4,4.591,71809.251,201.285,12.79,0.853,0
30,153,0,144,0,3,0,0,37.04,437483,81.347,32.4,4.591,71809.251,201.285,12.79,0.853,0
30,154,0,144,0,3,0,0,34.26,437483,81.347,32.4,4.591,71809.251,201.285,12.79,0.853,0
30,155,0,144,0,3,0,0,34.26,437483,81.347,32.4,4.591,71809.251,201.285,12.79,0.853,0
30,156,0,144,0,3,0,0,34.26,437483,81.347,32.4,4.591,71809.251,201.285,12.79,0.853,0
30,157,0,144,0,3,0,0,34.26,437483,81.347,32.4,4.591,71809.251,201.285,12.79,0.853,0
30,158,1,145,0,3,0,0,34.26,437483,81.347,32.4,4.591,71809.251,201.285,12.79,0.853,0
30,159,0,145,0,3,0,0,34.26,437483,81.347,32.4,4.591,71809.251,201.285,12.79,0.853,0
30,160,0,145,0,3,0,0,34.26,437483,81.347,32.4,4.591,71809.251,201.285,12.79,0.853,0
30,161,0,145,0,3,0,0,34.26,437483,81.347,32.4,4.591,71809.251,201.285,12.79,0.853,0
30,162,0,145,0,3,0,0,34.26,437483,81.347,32.4,4.591,71809.251,201.285,12.79,0.853,0
30,163,0,145,0,3,0,0,34.26,437483,81.347,32.4,4.591,71809.251,201.285,12.79,0.853,0
30,164,0,145,0,3,0,0,34.26,437483,81.347,32.4,4.591,71809.251,201.285,12.79,0.853,0
30,165,0,145,0,3,0,0,34.26,437483,81.347,32.4,4.591,71809.251,201.285,12.79,0.853,0
30,166,0,145,0,3,0,0,34.26,437483,81.347,32.4,4.591,71809.251,201.285,12.79,0.853,0
30,167,0,145,0,3,0,0,34.26,437483,81.347,32.4,4.591,71809.251,201.285,12.79,0.853,0
30,168,0,145,0,3,0,0,31.48,437483,81.347,32.4,4.591,71809.251,201.285,12.79,0.853,0
30,169,0,145,0,3,0,0,31.48,437483,81.347,32.4,4.591,71809.251,201.285,12.79,0.853,0
30,170,0,145,0,3,0,0,31.48,437483,81.347,32.4,4.591,71809.251,201.285,12.79,0.853,0
30,171,0,145,0,3,0,0,31.48,437483,81.347,32.4,4.591,71809.251,201.285,12.79,0.853,0
30,172,0,145,0,3,0,0,31.48,437483,81.347,32.4,4.591,71809.251,201.285,12.79,0.853,0
30,173,0,145,0,3,0,0,31.48,437483,81.347,32.4,4.591,71809.251,201.285,12.79,0.853,0
30,174,0,145,0,3,0,0,31.48,437483,81.347,32.4,4.591,71809.251,201.285,12.79,0.853,0
30,175,0,145,0,3,0,0,31.48,437483,81.347,32.4,4.591,71809.251,201.285,12.79,0.853,0
30,176,0,145,0,3,0,0,31.48,437483,81.347,32.4,4.591,71809.251,201.285,12.79,0.853,0
30,177,0,145,0,3,0,0,31.48,437483,81.347,32.4,4.591,71809.251,201.285,12.79,0.853,0
30,178,0,145,0,3,0,0,31.48,437483,81.347,32.4,4.591,71809.251,201.285,12.79,0.853,0
30,179,0,145,0,3,0,0,31.48,437483,81.347,32.4,4.591,71809.251,201.285,12.79,0.853,0
30,180,1,146,0,3,0,0,31.48,437483,81.347,32.4,4.591,71809.251,201.285,12.79,0.853,0
30,181,0,146,0,3,0,0,31.48,437483,81.347,32.4,4.591,71809.251,201.285,12.79,0.853,0
30,182,0,146,0,3,0,0,35.19,437483,81.347,32.4,4.591,71809.251,201.285,12.79,0.853,0
30,183,0,146,0,3,0,0,35.19,437483,81.347,32.4,4.591,71809.251,201.285,12.79,0.853,0
30,184,0,146,0,3,0,0,35.19,437483,81.347,32.4,4.591,71809.251,201.285,12.79,0.853,0
30,185,0,146,0,3,0,0,35.19,437483,81.347,32.4,4.591,71809.251,201.285,12.79,0.853,0
30,186,0,146,0,3,0,0,35.19,437483,81.347,32.4,4.591,71809.251,201.285,12.79,0.853,0
30,187,0,146,0,3,0,0,35.19,437483,81.347,32.4,4.591,71809.251,201.285,12.79,0.853,0
30,188,0,146,0,3,0,0,35.19,437483,81.347,32.4,4.591,71809.251,201.285,12.79,0.853,0
30,189,0,146,0,3,0,0,35.19,437483,81.347,32.4,4.591,71809.251,201.285,12.79,0.853,0
30,190,0,146,0,3,0,0,35.19,437483,81.347,32.4,4.591,71809.251,201.285,12.79,0.853,0
30,191,0,146,0,3,0,0,35.19,437483,81.347,32.4,4.591,71809.251,201.285,12.79,0.853,0
30,192,0,146,0,3,0,0,35.19,437483,81.347,32.4,4.591,71809.251,201.285,12.79,0.853,0
30,193,0,146,0,3,0,0,35.19,437483,81.347,32.4,4.591,71809.251,201.285,12.79,0.853,0
30,194,0,146,0,3,0,0,35.19,437483,81.347,32.4,4.591,71809.251,201.285,12.79,0.853,0
30,195,0,146,0,3,0,0,35.19,437483,81.347,32.4,4.591,71809.251,201.285,12.79,0.853,0
30,196,0,146,0,3,0,0,35.19,437483,81.347,32.4,4.591,71809.251,201.285,12.79,0.853,0
30,197,0,146,0,3,0,0,35.19,437483,81.347,32.4,4.591,71809.251,201.285,12.79,0.853,0
30,198,1,147,0,3,0,0,35.19,437483,81.347,32.4,4.591,71809.251,201.285,12.79,0.853,0
30,199,0,147,0,3,0,0,35.19,437483,81.347,32.4,4.591,71809.251,201.285,12.79,0.853,0
30,200,0,147,0,3,0,0,35.19,437483,81.347,32.4,4.591,71809.251,201.285,12.79,0.853,0
30,201,0,147,0,3,0,0,35.19,437483,81.347,32.4,4.591,71809.251,201.285,12.79,0.853,0
30,202,0,147,0,3,0,0,35.19,437483,81.347,32.4,4.591,71809.251,201.285,12.79,0.853,0
30,203,0,147,0,3,0,0,35.19,437483,81.347,32.4,4.591,71809.251,201.285,12.79,0.853,0
30,204,0,147,0,3,0,0,35.19,437483,81.347,32.4,4.591,71809.251,201.285,12.79,0.853,0
31,1,40,399,0,8,0,0,71.3,6948445,65.18,44.7,20.801,18563.307,424.688,5.81,0.813,0
31,2,23,422,2,10,0,0,71.3,6948445,65.18,44.7,20.801,18563.307,424.688,5.81,0.813,0
31,3,35,457,0,10,0,0,71.3,6948445,65.18,44.7,20.801,18563.307,424.688,5.81,0.813,0
31,4,28,485,4,14,0,0,71.3,6948445,65.18,44.7,20.801,18563.307,424.688,5.81,0.813,0
31,5,18,503,3,17,0,0,71.3,6948445,65.18,44.7,20.801,18563.307,424.688,5.81,0.813,0
31,6,28,531,3,20,0,0,71.3,6948445,65.18,44.7,20.801,18563.307,424.688,5.81,0.813,0
31,7,18,549,2,22,0,0,71.3,6948445,65.18,44.7,20.801,18563.307,424.688,5.81,0.813,0
31,8,28,577,1,23,0,0,71.3,6948445,65.18,44.7,20.801,18563.307,424.688,5.81,0.813,0
31,9,16,593,1,24,0,0,71.3,6948445,65.18,44.7,20.801,18563.307,424.688,5.81,0.813,0
31,10,31,624,0,24,0,0,71.3,6948445,65.18,44.7,20.801,18563.307,424.688,5.81,0.813,0
31,11,11,635,1,25,0,18502,71.3,6948445,65.18,44.7,20.801,18563.307,424.688,5.81,0.813,0
31,12,26,661,3,28,0,18502,71.3,6948445,65.18,44.7,20.801,18563.307,424.688,5.81,0.813,0
31,13,14,675,1,29,0,18502,71.3,6948445,65.18,44.7,20.801,18563.307,424.688,5.81,0.813,0
31,14,10,685,3,32,0,18502,71.3,6948445,65.18,44.7,20.801,18563.307,424.688,5.81,0.813,0
31,15,28,713,3,35,0,18502,73.15,6948445,65.18,44.7,20.801,18563.307,424.688,5.81,0.813,0
31,16,34,747,1,36,0,18502,73.15,6948445,65.18,44.7,20.801,18563.307,424.688,5.81,0.813,0
31,17,53,800,2,38,0,18502,73.15,6948445,65.18,44.7,20.801,18563.307,424.688,5.81,0.813,0
31,18,46,846,3,41,0,18502,73.15,6948445,65.18,44.7,20.801,18563.307,424.688,5.81,0.813,0
31,19,32,878,0,41,0,26417,73.15,6948445,65.18,44.7,20.801,18563.307,424.688,5.81,0.813,0
31,20,37,915,2,43,0,26417,73.15,6948445,65.18,44.7,20.801,18563.307,424.688,5.81,0.813,0
31,21,14,929,0,43,0,26417,73.15,6948445,65.18,44.7,20.801,18563.307,424.688,5.81,0.813,0
31,22,46,975,2,45,0,27000,73.15,6948445,65.18,44.7,20.801,18563.307,424.688,5.81,0.813,0
31,23,49,1024,4,49,0,27000,73.15,6948445,65.18,44.7,20.801,18563.307,424.688,5.81,0.813,0
31,24,73,1097,3,52,0,27000,73.15,6948445,65.18,44.7,20.801,18563.307,424.688,5.81,0.813,0
31,25,91,1188,2,54,0,27000,73.15,6948445,65.18,44.7,20.801,18563.307,424.688,5.81,0.813,0
31,26,59,1247,1,55,0,27000,73.15,6948445,65.18,44.7,20.801,18563.307,424.688,5.81,0.813,0
31,27,53,1300,1,56,0,27000,73.15,6948445,65.18,44.7,20.801,18563.307,424.688,5.81,0.813,0
31,28,63,1363,2,58,0,27000,73.15,6948445,65.18,44.7,20.801,18563.307,424.688,5.81,0.813,0
31,29,36,1399,0,58,0,45208,73.15,6948445,65.18,44.7,20.801,18563.307,424.688,5.81,0.813,0
31,30,48,1447,6,64,0,45208,73.15,6948445,65.18,44.7,20.801,18563.307,424.688,5.81,0.813,0
31,31,59,1506,2,66,0,46510,73.15,6948445,65.18,44.7,20.801,18563.307,424.688,5.81,0.813,0
31,32,82,1588,3,69,1126,47636,73.15,6948445,65.18,44.7,20.801,18563.307,424.688,5.81,0.813,0
31,33,6,1594,3,72,982,48618,73.15,6948445,65.18,44.7,20.801,18563.307,424.688,5.81,0.813,0
31,34,24,1618,1,73,527,49145,73.15,6948445,65.18,44.7,20.801,18563.307,424.688,5.81,0.813,0
31,35,34,1652,5,78,1158,50303,73.15,6948445,65.18,44.7,20.801,18563.307,424.688,5.81,0.813,0
31,36,37,1689,0,78,1465,51768,62.04,6948445,65.18,44.7,20.801,18563.307,424.688,5.81,0.813,0
31,37,89,1778,6,84,1163,52931,62.04,6948445,65.18,44.7,20.801,18563.307,424.688,5.81,0.813,0
31,38,51,1829,0,84,1397,54328,60.19,6948445,65.18,44.7,20.801,18563.307,424.688,5.81,0.813,0
31,39,82,1911,4,88,1777,56105,60.19,6948445,65.18,44.7,20.801,18563.307,424.688,5.81,0.813,0
31,40,44,1955,2,90,1126,57231,60.19,6948445,65.18,44.7,20.801,18563.307,424.688,5.81,0.813,0
31,41,10,1965,1,91,403,57634,60.19,6948445,65.18,44.7,20.801,18563.307,424.688,5.81,0.813,0
31,42,25,1990,2,93,1079,58713,60.19,6948445,65.18,44.7,20.801,18563.307,424.688,5.81,0.813,0
31,43,33,2023,2,95,1387,60100,60.19,6948445,65.18,44.7,20.801,18563.307,424.688,5.81,0.813,0
31,44,46,2069,1,96,1611,61711,62.96,6948445,65.18,44.7,20.801,18563.307,424.688,5.81,0.813,0
31,45,31,2100,3,99,1608,63319,62.96,6948445,65.18,44.7,20.801,18563.307,424.688,5.81,0.813,0
31,46,38,2138,3,102,1161,64480,62.96,6948445,65.18,44.7,20.801,18563.307,424.688,5.81,0.813,0
31,47,73,2211,6,108,1094,65574,62.96,6948445,65.18,44.7,20.801,18563.307,424.688,5.81,0.813,0
31,48,24,2235,2,110,362,65936,62.96,6948445,65.18,44.7,20.801,18563.307,424.688,5.81,0.813,0
31,49,24,2259,2,112,874,66810,62.96,6948445,65.18,44.7,20.801,18563.307,424.688,5.81,0.813,0
31,50,33,2292,4,116,1433,68243,62.96,6948445,65.18,44.7,20.801,18563.307,424.688,5.81,0.813,0
31,51,39,2331,4,120,0,68243,59.26,6948445,65.18,44.7,20.801,18563.307,424.688,5.81,0.813,0
31,52,41,2372,5,125,0,71605,56.48,6948445,65.18,44.7,20.801,18563.307,424.688,5.81,0.813,0
31,53,36,2408,1,126,1605,73210,56.48,6948445,65.18,44.7,20.801,18563.307,424.688,5.81,0.813,0
31,54,0,2408,0,126,886,74096,56.48,6948445,65.18,44.7,20.801,18563.307,424.688,5.81,0.813,0
31,55,25,2433,4,130,443,74539,56.48,6948445,65.18,44.7,20.801,18563.307,424.688,5.81,0.813,0
31,56,0,2433,0,130,295,74834,56.48,6948445,65.18,44.7,20.801,18563.307,424.688,5.81,0.813,0
31,57,27,2460,3,133,1557,76391,56.48,6948445,65.18,44.7,20.801,18563.307,424.688,5.81,0.813,0
31,58,0,2460,0,133,1273,77664,56.48,6948445,65.18,44.7,20.801,18563.307,424.688,5.81,0.813,0
31,59,25,2485,3,136,1725,79389,56.48,6948445,65.18,44.7,20.801,18563.307,424.688,5.81,0.813,0
31,60,14,2499,3,139,1353,80742,50.93,6948445,65.18,44.7,20.801,18563.307,424.688,5.81,0.813,0
31,61,14,2513,1,140,606,81348,44.44,6948445,65.18,44.7,20.801,18563.307,424.688,5.81,0.813,0
31,62,0,2513,0,140,346,81694,44.44,6948445,65.18,44.7,20.801,18563.307,424.688,5.81,0.813,0
31,63,0,2513,4,144,1220,82914,44.44,6948445,65.18,44.7,20.801,18563.307,424.688,5.81,0.813,0
31,64,25,2538,0,144,1347,84261,44.44,6948445,65.18,44.7,20.801,18563.307,424.688,5.81,0.813,0
31,65,47,2585,3,147,1569,85830,44.44,6948445,65.18,44.7,20.801,18563.307,424.688,5.81,0.813,0
31,66,0,2585,0,147,2060,87890,44.44,6948445,65.18,44.7,20.801,18563.307,424.688,5.81,0.813,0
31,67,83,2668,13,160,1196,89086,44.44,6948445,65.18,44.7,20.801,18563.307,424.688,5.81,0.813,0
31,68,43,2711,0,160,816,89902,44.44,6948445,65.18,44.7,20.801,18563.307,424.688,5.81,0.813,0
31,69,16,2727,0,160,427,90329,44.44,6948445,65.18,44.7,20.801,18563.307,424.688,5.81,0.813,0
31,70,83,2810,4,164,1406,91735,44.44,6948445,65.18,44.7,20.801,18563.307,424.688,5.81,0.813,0
31,71,79,2889,3,167,1777,93512,38.89,6948445,65.18,44.7,20.801,18563.307,424.688,5.81,0.813,0
31,72,104,2993,0,167,2308,95820,38.89,6948445,65.18,44.7,20.801,18563.307,424.688,5.81,0.813,0
31,73,93,3086,1,168,2640,98460,38.89,6948445,65.18,44.7,20.801,18563.307,424.688,5.81,0.813,0
31,74,105,3191,4,172,2642,101102,38.89,6948445,65.18,44.7,20.801,18563.307,424.688,5.81,0.813,0
31,75,75,3266,0,172,1975,103077,38.89,6948445,65.18,44.7,20.801,18563.307,424.688,5.81,0.813,0
31,76,24,3290,2,174,1409,104486,38.89,6948445,65.18,44.7,20.801,18563.307,424.688,5.81,0.813,0
31,77,51,3341,2,176,3839,108325,38.89,6948445,65.18,44.7,20.801,18563.307,424.688,5.81,0.813,0
31,78,112,3453,5,181,0,108325,38.89,6948445,65.18,44.7,20.801,18563.307,424.688,5.81,0.813,0
31,79,89,3542,3,184,0,112483,38.89,6948445,65.18,44.7,20.801,18563.307,424.688,5.81,0.813,0
31,80,132,3674,6,190,0,112483,36.11,6948445,65.18,44.7,20.801,18563.307,424.688,5.81,0.813,0
31,81,81,3755,3,193,0,116214,36.11,6948445,65.18,44.7,20.801,18563.307,424.688,5.81,0.813,0
31,82,117,3872,6,199,0,116214,36.11,6948445,65.18,44.7,20.801,18563.307,424.688,5.81,0.813,0
31,83,33,3905,0,199,0,116780,36.11,6948445,65.18,44.7,20.801,18563.307,424.688,5.81,0.813,0
31,84,79,3984,8,207,2776,119556,36.11,6948445,65.18,44.7,20.801,18563.307,424.688,5.81,0.813,0
31,85,130,4114,1,208,2946,122502,36.11,6948445,65.18,44.7,20.801,18563.307,424.688,5.81,0.813,0
31,86,128,4242,1,209,3016,125518,36.11,6948445,65.18,44.7,20.801,18563.307,424.688,5.81,0.813,0
31,87,166,4408,2,211,2775,128293,36.11,6948445,65.18,44.7,20.801,18563.307,424.688,5.81,0.813,0
31,88,105,4513,4,215,2750,131043,36.11,6948445,65.18,44.7,20.801,18563.307,424.688,5.81,0.813,0
31,89,112,4625,1,216,1528,132571,36.11,6948445,65.18,44.7,20.801,18563.307,424.688,5.81,0.813,0
31,90,66,4691,3,219,1034,133605,36.11,6948445,65.18,44.7,20.801,18563.307,424.688,5.81,0.813,0
31,91,140,4831,4,223,4525,138130,36.11,6948445,65.18,44.7,20.801,18563.307,424.688,5.81,0.813,0
31,92,158,4989,7,230,3343,141473,36.11,6948445,65.18,44.7,20.801,18563.307,424.688,5.81,0.813,0
31,93,165,5154,2,232,2896,144369,36.11,6948445,65.18,44.7,20.801,18563.307,424.688,5.81,0.813,0
31,94,161,5315,0,232,3155,147524,36.11,6948445,65.18,44.7,20.801,18563.307,424.688,5.81,0.813,0
31,95,182,5497,7,239,2538,150062,36.11,6948445,65.18,44.7,20.801,18563.307,424.688,5.81,0.813,0
31,96,180,5677,2,241,3514,153576,36.11,6948445,65.18,44.7,20.801,18563.307,424.688,5.81,0.813,0
31,97,63,5740,5,246,2775,156351,36.11,6948445,65.18,44.7,20.801,18563.307,424.688,5.81,0.813,0
31,98,174,5914,4,250,0,156351,36.11,6948445,65.18,44.7,20.801,18563.307,424.688,5.81,0.813,0
31,99,188,6102,4,254,0,159818,36.11,6948445,65.18,44.7,20.801,18563.307,424.688,5.81,0.813,0
31,100,240,6342,5,259,4286,164104,44.44,6948445,65.18,44.7,20.801,18563.307,424.688,5.81,0.813,0
31,101,330,6672,3,262,3686,167790,47.22,6948445,65.18,44.7,20.801,18563.307,424.688,5.81,0.813,0
31,102,292,6964,0,262,4540,172330,47.22,6948445,65.18,44.7,20.801,18563.307,424.688,5.81,0.813,0
31,103,211,7175,0,262,2806,175136,47.22,6948445,65.18,44.7,20.801,18563.307,424.688,5.81,0.813,0
31,104,77,7252,6,268,1198,176334,36.11,6948445,65.18,44.7,20.801,18563.307,424.688,5.81,0.813,0
31,105,159,7411,8,276,3341,179675,36.11,6948445,65.18,44.7,20.801,18563.307,424.688,5.81,0.813,0
31,106,234,7645,7,283,4885,184560,36.11,6948445,65.18,44.7,20.801,18563.307,424.688,5.81,0.813,0
31,107,232,7877,6,289,5393,189953,36.11,6948445,65.18,44.7,20.801,18563.307,424.688,5.81,0.813,0
31,108,267,8144,4,293,6526,196479,36.11,6948445,65.18,44.7,20.801,18563.307,424.688,5.81,0.813,0
31,109,298,8442,4,297,4884,201363,36.11,6948445,65.18,44.7,20.801,18563.307,424.688,5.81,0.813,0
31,110,196,8638,2,299,2003,203366,36.11,6948445,65.18,44.7,20.801,18563.307,424.688,5.81,0.813,0
31,111,95,8733,1,300,3155,206521,36.11,6948445,65.18,44.7,20.801,18563.307,424.688,5.81,0.813,0
31,112,196,8929,8,308,9051,215572,36.11,6948445,65.18,44.7,20.801,18563.307,424.688,5.81,0.813,0
31,113,325,9254,5,313,0,215572,36.11,6948445,65.18,44.7,20.801,18563.307,424.688,5.81,0.813,0
31,114,330,9584,8,321,0,221755,36.11,6948445,65.18,44.7,20.801,18563.307,424.688,5.81,0.813,0
31,115,269,9853,8,329,5913,227668,36.11,6948445,65.18,44.7,20.801,18563.307,424.688,5.81,0.813,0
31,116,270,10123,8,337,8124,235792,36.11,6948445,65.18,44.7,20.801,18563.307,424.688,5.81,0.813,0
31,117,189,10312,1,338,0,235792,36.11,6948445,65.18,44.7,20.801,18563.307,424.688,5.81,0.813,0
31,118,115,10427,2,340,0,243126,36.11,6948445,65.18,44.7,20.801,18563.307,424.688,5.81,0.813,0
31,119,194,10621,7,347,5303,248429,36.11,6948445,65.18,44.7,20.801,18563.307,424.688,5.81,0.813,0
31,120,250,10871,8,355,6395,254824,36.11,6948445,65.18,44.7,20.801,18563.307,424.688,5.81,0.813,0
31,121,284,11155,13,368,6639,261463,36.11,6948445,65.18,44.7,20.801,18563.307,424.688,5.81,0.813,0
31,122,265,11420,6,374,5582,267045,41.67,6948445,65.18,44.7,20.801,18563.307,424.688,5.81,0.813,0
31,123,270,11690,9,383,3955,271000,41.67,6948445,65.18,44.7,20.801,18563.307,424.688,5.81,0.813,0
31,124,146,11836,2,385,1491,272491,41.67,6948445,65.18,44.7,20.801,18563.307,424.688,5.81,0.813,0
31,125,119,11955,3,388,4137,276628,41.67,6948445,65.18,44.7,20.801,18563.307,424.688,5.81,0.813,0
31,126,0,11955,0,388,5325,281953,38.89,6948445,65.18,44.7,20.801,18563.307,424.688,5.81,0.813,0
31,127,204,12159,16,404,0,281953,38.89,6948445,65.18,44.7,20.801,18563.307,424.688,5.81,0.813,0
31,128,255,12414,11,415,0,287654,38.89,6948445,65.18,44.7,20.801,18563.307,424.688,5.81,0.813,0
31,129,303,12717,9,424,6433,294087,38.89,6948445,65.18,44.7,20.801,18563.307,424.688,5.81,0.813,0
31,130,297,13014,11,435,5837,299924,38.89,6948445,65.18,44.7,20.801,18563.307,424.688,5.81,0.813,0
31,131,329,13343,10,445,3612,303536,38.89,6948445,65.18,44.7,20.801,18563.307,424.688,5.81,0.813,0
31,132,53,13396,2,447,1275,304811,38.89,6948445,65.18,44.7,20.801,18563.307,424.688,5.81,0.813,0
31,133,116,13512,12,459,3667,308478,38.89,6948445,65.18,44.7,20.801,18563.307,424.688,5.81,0.813,0
31,134,210,13722,12,471,5388,313866,38.89,6948445,65.18,44.7,20.801,18563.307,424.688,5.81,0.813,0
31,135,171,13893,11,482,5108,318974,38.89,6948445,65.18,44.7,20.801,18563.307,424.688,5.81,0.813,0
31,136,176,14069,2,484,5877,324851,38.89,6948445,65.18,44.7,20.801,18563.307,424.688,5.81,0.813,0
31,137,174,14243,8,492,5934,330785,38.89,6948445,65.18,44.7,20.801,18563.307,424.688,5.81,0.813,0
31,138,90,14333,3,495,2745,333530,38.89,6948445,65.18,44.7,20.801,18563.307,424.688,5.81,0.813,0
31,139,32,14365,3,498,781,334311,38.89,6948445,65.18,44.7,20.801,18563.307,424.688,5.81,0.813,0
31,140,135,14500,14,512,5252,339563,38.89,6948445,65.18,44.7,20.801,18563.307,424.688,5.81,0.813,0
31,141,169,14669,7,519,3667,343230,38.89,6948445,65.18,44.7,20.801,18563.307,424.688,5.81,0.813,0
31,142,151,14820,8,527,8649,351879,38.89,6948445,65.18,44.7,20.801,18563.307,424.688,5.81,0.813,0
31,143,142,14962,5,532,6844,358723,38.89,6948445,65.18,44.7,20.801,18563.307,424.688,5.81,0.813,0
31,144,169,15131,7,539,6373,365096,38.89,6948445,65.18,44.7,20.801,18563.307,424.688,5.81,0.813,0
31,145,96,15227,6,545,3402,368498,38.89,6948445,65.18,44.7,20.801,18563.307,424.688,5.81,0.813,0
31,146,60,15287,0,545,2288,370786,38.89,6948445,65.18,44.7,20.801,18563.307,424.688,5.81,0.813,0
31,147,99,15386,18,563,3588,374374,38.89,6948445,65.18,44.7,20.801,18563.307,424.688,5.81,0.813,0
31,148,203,15589,9,572,10076,384450,38.89,6948445,65.18,44.7,20.801,18563.307,424.688,5.81,0.813,0
31,149,162,15751,14,586,0,384450,38.89,6948445,65.18,44.7,20.801,18563.307,424.688,5.81,0.813,0
31,150,157,15908,8,594,0,392089,38.89,6948445,65.18,44.7,20.801,18563.307,424.688,5.81,0.813,0
31,151,157,16065,9,603,6337,398426,38.89,6948445,65.18,44.7,20.801,18563.307,424.688,5.81,0.813,0
31,152,99,16164,2,605,6257,404683,38.89,6948445,65.18,44.7,20.801,18563.307,424.688,5.81,0.813,0
31,153,26,16190,8,613,0,404683,38.89,6948445,65.18,44.7,20.801,18563.307,424.688,5.81,0.813,0
31,154,76,16266,16,629,0,409013,38.89,6948445,65.18,44.7,20.801,18563.307,424.688,5.81,0.813,0
31,155,0,16266,0,629,6784,415797,38.89,6948445,65.18,44.7,20.801,18563.307,424.688,5.81,0.813,0
31,156,188,16454,13,642,5443,421240,38.89,6948445,65.18,44.7,20.801,18563.307,424.688,5.81,0.813,0
31,157,163,16617,6,648,7026,428266,38.89,6948445,65.18,44.7,20.801,18563.307,424.688,5.81,0.813,0
31,158,158,16775,10,658,8129,436395,38.89,6948445,65.18,44.7,20.801,18563.307,424.688,5.81,0.813,0
31,159,179,16954,7,665,4765,441160,38.89,6948445,65.18,44.7,20.801,18563.307,424.688,5.81,0.813,0
31,160,96,17050,6,671,0,441160,38.89,6948445,65.18,44.7,20.801,18563.307,424.688,5.81,0.813,0
31,161,96,17146,6,677,0,446303,38.89,6948445,65.18,44.7,20.801,18563.307,424.688,5.81,0.813,0
31,162,167,17313,15,692,5145,451448,38.89,6948445,65.18,44.7,20.801,18563.307,424.688,5.81,0.813,0
31,163,122,17435,10,702,0,451448,38.89,6948445,65.18,44.7,20.801,18563.307,424.688,5.81,0.813,0
31,164,163,17598,4,706,0,461403,38.89,6948445,65.18,44.7,20.801,18563.307,424.688,5.81,0.813,0
31,165,201,17799,7,713,2330,463733,38.89,6948445,65.18,44.7,20.801,18563.307,424.688,5.81,0.813,0
31,166,92,17891,4,717,0,463733,38.89,6948445,65.18,44.7,20.801,18563.307,424.688,5.81,0.813,0
31,167,27,17918,3,720,0,464657,38.89,6948445,65.18,44.7,20.801,18563.307,424.688,5.81,0.813,0
31,168,143,18061,10,730,7475,472132,35.19,6948445,65.18,44.7,20.801,18563.307,424.688,5.81,0.813,0
31,169,155,18216,6,736,4835,476967,35.19,6948445,65.18,44.7,20.801,18563.307,424.688,5.81,0.813,0
31,170,174,18390,8,744,0,476967,35.19,6948445,65.18,44.7,20.801,18563.307,424.688,5.81,0.813,0
31,171,154,18544,0,744,0,482823,35.19,6948445,65.18,44.7,20.801,18563.307,424.688,5.81,0.813,0
31,172,189,18733,9,753,8957,491780,35.19,6948445,65.18,44.7,20.801,18563.307,424.688,5.81,0.813,0
31,173,86,18819,2,755,0,491780,35.19,6948445,65.18,44.7,20.801,18563.307,424.688,5.81,0.813,0
31,174,44,18863,6,761,0,493029,35.19,6948445,65.18,44.7,20.801,18563.307,424.688,5.81,0.813,0
31,175,151,19014,4,765,2988,496017,35.19,6948445,65.18,44.7,20.801,18563.307,424.688,5.81,0.813,0
31,176,109,19123,2,767,3049,499066,35.19,6948445,65.18,44.7,20.801,18563.307,424.688,5.81,0.813,0
31,177,160,19283,12,779,8385,507451,35.19,6948445,65.18,44.7,20.801,18563.307,424.688,5.81,0.813,0
31,178,290,19573,6,785,0,507451,35.19,6948445,65.18,44.7,20.801,18563.307,424.688,5.81,0.813,0
31,179,255,19828,4,789,0,512498,35.19,6948445,65.18,44.7,20.801,18563.307,424.688,5.81,0.813,0
31,180,169,19997,0,789,2710,515208,35.19,6948445,65.18,44.7,20.801,18563.307,424.688,5.81,0.813,0
31,181,58,20055,7,796,1103,516311,35.19,6948445,65.18,44.7,20.801,18563.307,424.688,5.81,0.813,0
31,182,216,20271,11,807,3302,519613,35.19,6948445,65.18,44.7,20.801,18563.307,424.688,5.81,0.813,0
31,183,276,20547,7,814,4736,524349,35.19,6948445,65.18,44.7,20.801,18563.307,424.688,5.81,0.813,0
31,184,286,20833,11,825,4943,529292,35.19,6948445,65.18,44.7,20.801,18563.307,424.688,5.81,0.813,0
31,185,263,21096,7,832,4843,534135,35.19,6948445,65.18,44.7,20.801,18563.307,424.688,5.81,0.813,0
31,186,240,21336,6,838,4820,538955,35.19,6948445,65.18,44.7,20.801,18563.307,424.688,5.81,0.813,0
31,187,182,21518,3,841,2843,541798,35.19,6948445,65.18,44.7,20.801,18563.307,424.688,5.81,0.813,0
31,188,69,21587,3,844,1278,543076,35.19,6948445,65.18,44.7,20.801,18563.307,424.688,5.81,0.813,0
31,189,283,21870,10,854,3713,546789,35.19,6948445,65.18,44.7,20.801,18563.307,424.688,5.81,0.813,0
31,190,436,22306,8,862,5431,552220,35.19,6948445,65.18,44.7,20.801,18563.307,424.688,5.81,0.813,0
31,191,437,22743,11,873,4541,556761,35.19,6948445,65.18,44.7,20.801,18563.307,424.688,5.81,0.813,0
31,192,516,23259,7,880,5209,561970,35.19,6948445,65.18,44.7,20.801,18563.307,424.688,5.81,0.813,0
31,193,612,23871,7,887,6048,568018,35.19,6948445,65.18,44.7,20.801,18563.307,424.688,5.81,0.813,0
31,194,0,23871,0,887,3795,571813,35.19,6948445,65.18,44.7,20.801,18563.307,424.688,5.81,0.813,0
31,195,531,24402,5,892,1191,573004,35.19,6948445,65.18,44.7,20.801,18563.307,424.688,5.81,0.813,0
31,196,587,24989,23,915,4320,577324,35.19,6948445,65.18,44.7,20.801,18563.307,424.688,5.81,0.813,0
31,197,785,25774,8,923,5819,583143,35.19,6948445,65.18,44.7,20.801,18563.307,424.688,5.81,0.813,0
31,198,819,26593,6,929,5898,589041,35.19,6948445,65.18,44.7,20.801,18563.307,424.688,5.81,0.813,0
31,199,914,27507,15,944,6324,595365,35.19,6948445,65.18,44.7,20.801,18563.307,424.688,5.81,0.813,0
31,200,998,28505,14,958,7442,602807,35.19,6948445,65.18,44.7,20.801,18563.307,424.688,5.81,0.813,0
31,201,603,29108,10,968,4602,607409,35.19,6948445,65.18,44.7,20.801,18563.307,424.688,5.81,0.813,0
31,202,395,29503,18,986,1581,608990,35.19,6948445,65.18,44.7,20.801,18563.307,424.688,5.81,0.813,0
31,203,1024,30527,22,1008,4406,613396,35.19,6948445,65.18,44.7,20.801,18563.307,424.688,5.81,0.813,0
31,204,1336,31863,11,1019,0,613396,35.19,6948445,65.18,44.7,20.801,18563.307,424.688,5.81,0.813,0
32,1,24,246,0,12,0,0,84.26,20903278,70.151,17.6,2.409,1703.102,269.048,2.42,0.423,0
32,2,15,261,2,14,0,0,84.26,20903278,70.151,17.6,2.409,1703.102,269.048,2.42,0.423,0
32,3,27,288,2,16,0,0,84.26,20903278,70.151,17.6,2.409,1703.102,269.048,2.42,0.423,0
32,4,0,288,0,16,0,0,84.26,20903278,70.151,17.6,2.409,1703.102,269.048,2.42,0.423,0
32,5,14,302,0,16,0,0,84.26,20903278,70.151,17.6,2.409,1703.102,269.048,2.42,0.423,0
32,6,43,345,1,17,0,0,84.26,20903278,70.151,17.6,2.409,1703.102,269.048,2.42,0.423,0
32,7,19,364,0,17,0,0,84.26,20903278,70.151,17.6,2.409,1703.102,269.048,2.42,0.423,0
32,8,20,384,2,19,0,0,84.26,20903278,70.151,17.6,2.409,1703.102,269.048,2.42,0.423,0
32,9,30,414,4,23,0,0,84.26,20903278,70.151,17.6,2.409,1703.102,269.048,2.42,0.423,0
32,10,29,443,1,24,0,0,84.26,20903278,70.151,17.6,2.409,1703.102,269.048,2.42,0.423,0
32,11,5,448,2,26,0,0,84.26,20903278,70.151,17.6,2.409,1703.102,269.048,2.42,0.423,0
32,12,36,484,1,27,0,0,84.26,20903278,70.151,17.6,2.409,1703.102,269.048,2.42,0.423,0
32,13,13,497,0,27,0,0,84.26,20903278,70.151,17.6,2.409,1703.102,269.048,2.42,0.423,0
32,14,18,515,1,28,0,0,84.26,20903278,70.151,17.6,2.409,1703.102,269.048,2.42,0.423,0
32,15,13,528,2,30,0,0,84.26,20903278,70.151,17.6,2.409,1703.102,269.048,2.42,0.423,0
32,16,14,542,2,32,0,0,84.26,20903278,70.151,17.6,2.409,1703.102,269.048,2.42,0.423,0
32,17,1,543,0,32,0,0,84.26,20903278,70.151,17.6,2.409,1703.102,269.048,2.42,0.423,0
32,18,14,557,3,35,0,0,84.26,20903278,70.151,17.6,2.409,1703.102,269.048,2.42,0.423,0
32,19,8,565,1,36,0,0,84.26,20903278,70.151,17.6,2.409,1703.102,269.048,2.42,0.423,0
32,20,11,576,0,36,0,0,84.26,20903278,70.151,17.6,2.409,1703.102,269.048,2.42,0.423,0
32,21,5,581,2,38,0,0,84.26,20903278,70.151,17.6,2.409,1703.102,269.048,2.42,0.423,0
32,22,19,600,0,38,0,0,84.26,20903278,70.151,17.6,2.409,1703.102,269.048,2.42,0.423,0
32,23,9,609,1,39,0,0,84.26,20903278,70.151,17.6,2.409,1703.102,269.048,2.42,0.423,0
32,24,7,616,2,41,0,0,84.26,20903278,70.151,17.6,2.409,1703.102,269.048,2.42,0.423,0
32,25,10,626,0,41,0,0,84.26,20903278,70.151,17.6,2.409,1703.102,269.048,2.42,0.423,0
32,26,3,629,0,41,0,0,84.26,20903278,70.151,17.6,2.409,1703.102,269.048,2.42,0.423,0
32,27,3,632,1,42,0,0,84.26,20903278,70.151,17.6,2.409,1703.102,269.048,2.42,0.423,0
32,28,3,635,0,42,0,0,84.26,20903278,70.151,17.6,2.409,1703.102,269.048,2.42,0.423,0
32,29,3,638,0,42,0,0,84.26,20903278,70.151,17.6,2.409,1703.102,269.048,2.42,0.423,0
32,30,3,641,1,43,0,0,84.26,20903278,70.151,17.6,2.409,1703.102,269.048,2.42,0.423,0
32,31,4,645,0,43,0,0,84.26,20903278,70.151,17.6,2.409,1703.102,269.048,2.42,0.423,0
32,32,4,649,1,44,0,0,84.26,20903278,70.151,17.6,2.409,1703.102,269.048,2.42,0.423,0
32,33,3,652,0,44,0,0,84.26,20903278,70.151,17.6,2.409,1703.102,269.048,2.42,0.423,0
32,34,10,662,1,45,0,0,89.81,20903278,70.151,17.6,2.409,1703.102,269.048,2.42,0.423,0
32,35,10,672,1,46,0,0,67.59,20903278,70.151,17.6,2.409,1703.102,269.048,2.42,0.423,0
32,36,16,688,2,48,0,0,67.59,20903278,70.151,17.6,2.409,1703.102,269.048,2.42,0.423,0
32,37,41,729,0,48,0,0,67.59,20903278,70.151,17.6,2.409,1703.102,269.048,2.42,0.423,0
32,38,7,736,0,48,0,0,67.59,20903278,70.151,17.6,2.409,1703.102,269.048,2.42,0.423,0
32,39,8,744,0,48,0,0,67.59,20903278,70.151,17.6,2.409,1703.102,269.048,2.42,0.423,0
32,40,4,748,0,48,0,0,67.59,20903278,70.151,17.6,2.409,1703.102,269.048,2.42,0.423,0
32,41,3,751,1,49,0,0,67.59,20903278,70.151,17.6,2.409,1703.102,269.048,2.42,0.423,0
32,42,9,760,1,50,0,0,67.59,20903278,70.151,17.6,2.409,1703.102,269.048,2.42,0.423,0
32,43,6,766,1,51,0,0,67.59,20903278,70.151,17.6,2.409,1703.102,269.048,2.42,0.423,0
32,44,7,773,0,51,0,0,60.19,20903278,70.151,17.6,2.409,1703.102,269.048,2.42,0.423,0
32,45,0,773,0,51,0,0,60.19,20903278,70.151,17.6,2.409,1703.102,269.048,2.42,0.423,0
32,46,9,782,0,51,0,0,60.19,20903278,70.151,17.6,2.409,1703.102,269.048,2.42,0.423,0
32,47,0,782,0,51,0,0,60.19,20903278,70.151,17.6,2.409,1703.102,269.048,2.42,0.423,0
32,48,14,796,0,51,0,0,60.19,20903278,70.151,17.6,2.409,1703.102,269.048,2.42,0.423,0
32,49,0,796,0,51,0,0,60.19,20903278,70.151,17.6,2.409,1703.102,269.048,2.42,0.423,0
32,50,10,806,1,52,0,0,60.19,20903278,70.151,17.6,2.409,1703.102,269.048,2.42,0.423,0
32,51,3,809,0,52,0,0,60.19,20903278,70.151,17.6,2.409,1703.102,269.048,2.42,0.423,0
32,52,3,812,0,52,0,0,60.19,20903278,70.151,17.6,2.409,1703.102,269.048,2.42,0.423,0
32,53,2,814,0,52,0,0,60.19,20903278,70.151,17.6,2.409,1703.102,269.048,2.42,0.423,0
32,54,0,814,0,52,0,0,60.19,20903278,70.151,17.6,2.409,1703.102,269.048,2.42,0.423,0
32,55,18,832,0,52,0,0,60.19,20903278,70.151,17.6,2.409,1703.102,269.048,2.42,0.423,0
32,56,9,841,0,52,0,0,60.19,20903278,70.151,17.6,2.409,1703.102,269.048,2.42,0.423,0
32,57,4,845,1,53,0,0,60.19,20903278,70.151,17.6,2.409,1703.102,269.048,2.42,0.423,0
32,58,0,845,0,53,0,0,60.19,20903278,70.151,17.6,2.409,1703.102,269.048,2.42,0.423,0
32,59,2,847,0,53,0,0,60.19,20903278,70.151,17.6,2.409,1703.102,269.048,2.42,0.423,0
32,60,0,847,0,53,0,0,60.19,20903278,70.151,17.6,2.409,1703.102,269.048,2.42,0.423,0
32,61,6,853,0,53,0,0,60.19,20903278,70.151,17.6,2.409,1703.102,269.048,2.42,0.423,0
32,62,28,881,0,53,0,0,45.37,20903278,70.151,17.6,2.409,1703.102,269.048,2.42,0.423,0
32,63,0,881,0,53,0,0,45.37,20903278,70.151,17.6,2.409,1703.102,269.048,2.42,0.423,0
32,64,2,883,0,53,0,0,45.37,20903278,70.151,17.6,2.409,1703.102,269.048,2.42,0.423,0
32,65,1,884,0,53,0,0,45.37,20903278,70.151,17.6,2.409,1703.102,269.048,2.42,0.423,0
32,66,1,885,0,53,0,0,45.37,20903278,70.151,17.6,2.409,1703.102,269.048,2.42,0.423,0
32,67,3,888,0,53,0,0,45.37,20903278,70.151,17.6,2.409,1703.102,269.048,2.42,0.423,0
32,68,0,888,0,53,0,0,45.37,20903278,70.151,17.6,2.409,1703.102,269.048,2.42,0.423,0
32,69,1,889,0,53,0,0,45.37,20903278,70.151,17.6,2.409,1703.102,269.048,2.42,0.423,0
32,70,1,890,0,53,0,0,45.37,20903278,70.151,17.6,2.409,1703.102,269.048,2.42,0.423,0
32,71,1,891,0,53,0,0,45.37,20903278,70.151,17.6,2.409,1703.102,269.048,2.42,0.423,0
32,72,0,891,0,53,0,0,45.37,20903278,70.151,17.6,2.409,1703.102,269.048,2.42,0.423,0
32,73,1,892,0,53,0,0,45.37,20903278,70.151,17.6,2.409,1703.102,269.048,2.42,0.423,0
32,74,0,892,0,53,0,0,45.37,20903278,70.151,17.6,2.409,1703.102,269.048,2.42,0.423,0
32,75,2,894,0,53,0,0,45.37,20903278,70.151,17.6,2.409,1703.102,269.048,2.42,0.423,0
32,76,0,894,0,53,0,0,45.37,20903278,70.151,17.6,2.409,1703.102,269.048,2.42,0.423,0
32,77,0,894,0,53,0,0,45.37,20903278,70.151,17.6,2.409,1703.102,269.048,2.42,0.423,0
32,78,1,895,0,53,0,0,45.37,20903278,70.151,17.6,2.409,1703.102,269.048,2.42,0.423,0
32,79,4,899,0,53,0,0,45.37,20903278,70.151,17.6,2.409,1703.102,269.048,2.42,0.423,0
32,80,0,899,0,53,0,0,45.37,20903278,70.151,17.6,2.409,1703.102,269.048,2.42,0.423,0
32,81,1,900,0,53,0,0,45.37,20903278,70.151,17.6,2.409,1703.102,269.048,2.42,0.423,0
32,82,2,902,0,53,0,0,45.37,20903278,70.151,17.6,2.409,1703.102,269.048,2.42,0.423,0
32,83,1,903,0,53,0,0,45.37,20903278,70.151,17.6,2.409,1703.102,269.048,2.42,0.423,0
32,84,4,907,0,53,0,0,45.37,20903278,70.151,17.6,2.409,1703.102,269.048,2.42,0.423,0
32,85,12,919,0,53,0,0,45.37,20903278,70.151,17.6,2.409,1703.102,269.048,2.42,0.423,0
32,86,15,934,0,53,0,0,45.37,20903278,70.151,17.6,2.409,1703.102,269.048,2.42,0.423,0
32,87,7,941,0,53,0,0,45.37,20903278,70.151,17.6,2.409,1703.102,269.048,2.42,0.423,0
32,88,0,941,0,53,0,0,45.37,20903278,70.151,17.6,2.409,1703.102,269.048,2.42,0.423,0
32,89,0,941,0,53,0,0,45.37,20903278,70.151,17.6,2.409,1703.102,269.048,2.42,0.423,0
32,90,18,959,0,53,0,0,45.37,20903278,70.151,17.6,2.409,1703.102,269.048,2.42,0.423,0
32,91,0,959,0,53,0,0,45.37,20903278,70.151,17.6,2.409,1703.102,269.048,2.42,0.423,0
32,92,3,962,0,53,0,0,45.37,20903278,70.151,17.6,2.409,1703.102,269.048,2.42,0.423,0
32,93,0,962,0,53,0,0,45.37,20903278,70.151,17.6,2.409,1703.102,269.048,2.42,0.423,0
32,94,18,980,0,53,0,0,45.37,20903278,70.151,17.6,2.409,1703.102,269.048,2.42,0.423,0
32,95,7,987,0,53,0,0,45.37,20903278,70.151,17.6,2.409,1703.102,269.048,2.42,0.423,0
32,96,0,987,0,53,0,0,45.37,20903278,70.151,17.6,2.409,1703.102,269.048,2.42,0.423,0
32,97,0,987,0,53,0,0,45.37,20903278,70.151,17.6,2.409,1703.102,269.048,2.42,0.423,0
32,98,13,1000,0,53,0,0,45.37,20903278,70.151,17.6,2.409,1703.102,269.048,2.42,0.423,0
32,99,3,1003,0,53,0,0,45.37,20903278,70.151,17.6,2.409,1703.102,269.048,2.42,0.423,0
32,100,2,1005,0,53,0,0,45.37,20903278,70.151,17.6,2.409,1703.102,269.048,2.42,0.423,0
32,101,15,1020,0,53,0,0,45.37,20903278,70.151,17.6,2.409,1703.102,269.048,2.42,0.423,0
32,102,0,1020,0,53,0,0,45.37,20903278,70.151,17.6,2.409,1703.102,269.048,2.42,0.423,0
32,103,13,1033,0,53,0,0,45.37,20903278,70.151,17.6,2.409,1703.102,269.048,2.42,0.423,0
32,104,3,1036,0,53,0,0,45.37,20903278,70.151,17.6,2.409,1703.102,269.048,2.42,0.423,0
32,105,0,1036,0,53,0,0,45.37,20903278,70.151,17.6,2.409,1703.102,269.048,2.42,0.423,0
32,106,2,1038,0,53,0,0,45.37,20903278,70.151,17.6,2.409,1703.102,269.048,2.42,0.423,0
32,107,0,1038,0,53,0,0,45.37,20903278,70.151,17.6,2.409,1703.102,269.048,2.42,0.423,0
32,108,0,1038,0,53,0,0,45.37,20903278,70.151,17.6,2.409,1703.102,269.048,2.42,0.423,0
32,109,9,1047,0,53,0,0,45.37,20903278,70.151,17.6,2.409,1703.102,269.048,2.42,0.423,0
32,110,5,1052,0,53,0,0,45.37,20903278,70.151,17.6,2.409,1703.102,269.048,2.42,0.423,0
32,111,13,1065,0,53,0,0,45.37,20903278,70.151,17.6,2.409,1703.102,269.048,2.42,0.423,0
32,112,0,1065,0,53,0,0,45.37,20903278,70.151,17.6,2.409,1703.102,269.048,2.42,0.423,0
32,113,0,1065,0,53,0,0,45.37,20903278,70.151,17.6,2.409,1703.102,269.048,2.42,0.423,0
32,114,1,1066,0,53,0,0,45.37,20903278,70.151,17.6,2.409,1703.102,269.048,2.42,0.423,0
32,115,9,1075,0,53,0,0,45.37,20903278,70.151,17.6,2.409,1703.102,269.048,2.42,0.423,0
32,116,6,1081,0,53,0,0,45.37,20903278,70.151,17.6,2.409,1703.102,269.048,2.42,0.423,0
32,117,5,1086,0,53,0,0,45.37,20903278,70.151,17.6,2.409,1703.102,269.048,2.42,0.423,0
32,118,14,1100,0,53,0,0,45.37,20903278,70.151,17.6,2.409,1703.102,269.048,2.42,0.423,0
32,119,0,1100,0,53,0,0,45.37,20903278,70.151,17.6,2.409,1703.102,269.048,2.42,0.423,0
32,120,6,1106,0,53,0,0,45.37,20903278,70.151,17.6,2.409,1703.102,269.048,2.42,0.423,0
32,121,11,1117,0,53,0,0,45.37,20903278,70.151,17.6,2.409,1703.102,269.048,2.42,0.423,0
32,122,0,1117,0,53,0,0,56.48,20903278,70.151,17.6,2.409,1703.102,269.048,2.42,0.423,0
32,123,26,1143,0,53,0,0,56.48,20903278,70.151,17.6,2.409,1703.102,269.048,2.42,0.423,0
32,124,6,1149,0,53,0,0,56.48,20903278,70.151,17.6,2.409,1703.102,269.048,2.42,0.423,0
32,125,1,1150,0,53,0,0,56.48,20903278,70.151,17.6,2.409,1703.102,269.048,2.42,0.423,0
32,126,3,1153,1,54,0,0,56.48,20903278,70.151,17.6,2.409,1703.102,269.048,2.42,0.423,0
32,127,3,1156,0,54,0,0,56.48,20903278,70.151,17.6,2.409,1703.102,269.048,2.42,0.423,0
32,128,2,1158,0,54,0,0,56.48,20903278,70.151,17.6,2.409,1703.102,269.048,2.42,0.423,0
32,129,4,1162,0,54,0,0,56.48,20903278,70.151,17.6,2.409,1703.102,269.048,2.42,0.423,0
32,130,13,1175,0,54,0,0,56.48,20903278,70.151,17.6,2.409,1703.102,269.048,2.42,0.423,0
32,131,5,1180,0,54,0,0,48.15,20903278,70.151,17.6,2.409,1703.102,269.048,2.42,0.423,0
32,132,24,1204,0,54,0,0,48.15,20903278,70.151,17.6,2.409,1703.102,269.048,2.42,0.423,0
32,133,7,1211,0,54,0,0,48.15,20903278,70.151,17.6,2.409,1703.102,269.048,2.42,0.423,0
32,134,2,1213,0,54,0,0,48.15,20903278,70.151,17.6,2.409,1703.102,269.048,2.42,0.423,0
32,135,15,1228,0,54,0,0,48.15,20903278,70.151,17.6,2.409,1703.102,269.048,2.42,0.423,0
32,136,10,1238,0,54,0,0,48.15,20903278,70.151,17.6,2.409,1703.102,269.048,2.42,0.423,0
32,137,2,1240,0,54,0,0,48.15,20903278,70.151,17.6,2.409,1703.102,269.048,2.42,0.423,0
32,138,9,1249,0,54,0,0,48.15,20903278,70.151,17.6,2.409,1703.102,269.048,2.42,0.423,0
32,139,18,1267,1,55,0,0,48.15,20903278,70.151,17.6,2.409,1703.102,269.048,2.42,0.423,0
32,140,13,1280,0,55,0,0,48.15,20903278,70.151,17.6,2.409,1703.102,269.048,2.42,0.423,0
32,141,5,1285,0,55,0,0,48.15,20903278,70.151,17.6,2.409,1703.102,269.048,2.42,0.423,0
32,142,7,1292,0,55,0,0,48.15,20903278,70.151,17.6,2.409,1703.102,269.048,2.42,0.423,0
32,143,5,1297,0,55,0,0,48.15,20903278,70.151,17.6,2.409,1703.102,269.048,2.42,0.423,0
32,144,16,1313,0,55,0,0,48.15,20903278,70.151,17.6,2.409,1703.102,269.048,2.42,0.423,0
32,145,7,1320,0,55,0,0,48.15,20903278,70.151,17.6,2.409,1703.102,269.048,2.42,0.423,0
32,146,8,1328,0,55,0,0,48.15,20903278,70.151,17.6,2.409,1703.102,269.048,2.42,0.423,0
32,147,10,1338,0,55,0,0,48.15,20903278,70.151,17.6,2.409,1703.102,269.048,2.42,0.423,0
32,148,14,1352,0,55,0,0,48.15,20903278,70.151,17.6,2.409,1703.102,269.048,2.42,0.423,0
32,149,0,1352,0,55,0,0,48.15,20903278,70.151,17.6,2.409,1703.102,269.048,2.42,0.423,0
32,150,5,1357,0,55,0,0,48.15,20903278,70.151,17.6,2.409,1703.102,269.048,2.42,0.423,0
32,151,1,1358,0,55,0,0,48.15,20903278,70.151,17.6,2.409,1703.102,269.048,2.42,0.423,0
32,152,4,1362,0,55,0,0,48.15,20903278,70.151,17.6,2.409,1703.102,269.048,2.42,0.423,0
32,153,6,1368,0,55,0,0,48.15,20903278,70.151,17.6,2.409,1703.102,269.048,2.42,0.423,0
32,154,2,1370,0,55,0,0,48.15,20903278,70.151,17.6,2.409,1703.102,269.048,2.42,0.423,0
32,155,5,1375,0,55,0,0,48.15,20903278,70.151,17.6,2.409,1703.102,269.048,2.42,0.423,0
32,156,3,1378,0,55,0,0,48.15,20903278,70.151,17.6,2.409,1703.102,269.048,2.42,0.423,0
32,157,8,1386,0,55,0,0,48.15,20903278,70.151,17.6,2.409,1703.102,269.048,2.42,0.423,0
32,158,22,1408,0,55,0,0,48.15,20903278,70.151,17.6,2.409,1703.102,269.048,2.42,0.423,0
32,159,39,1447,0,55,0,0,48.15,20903278,70.151,17.6,2.409,1703.102,269.048,2.42,0.423,0
32,160,5,1452,0,55,0,0,48.15,20903278,70.151,17.6,2.409,1703.102,269.048,2.42,0.423,0
32,161,11,1463,1,56,0,0,48.15,20903278,70.151,17.6,2.409,1703.102,269.048,2.42,0.423,0
32,162,3,1466,0,56,0,0,48.15,20903278,70.151,17.6,2.409,1703.102,269.048,2.42,0.423,0
32,163,10,1476,0,56,0,0,36.11,20903278,70.151,17.6,2.409,1703.102,269.048,2.42,0.423,0
32,164,10,1486,0,56,0,0,36.11,20903278,70.151,17.6,2.409,1703.102,269.048,2.42,0.423,0
32,165,13,1499,0,56,0,0,36.11,20903278,70.151,17.6,2.409,1703.102,269.048,2.42,0.423,0
32,166,15,1514,0,56,0,0,36.11,20903278,70.151,17.6,2.409,1703.102,269.048,2.42,0.423,0
32,167,193,1707,0,56,0,0,36.11,20903278,70.151,17.6,2.409,1703.102,269.048,2.42,0.423,0
32,168,10,1717,0,56,0,0,36.11,20903278,70.151,17.6,2.409,1703.102,269.048,2.42,0.423,0
32,169,16,1733,0,56,0,0,36.11,20903278,70.151,17.6,2.409,1703.102,269.048,2.42,0.423,0
32,170,15,1748,0,56,0,0,36.11,20903278,70.151,17.6,2.409,1703.102,269.048,2.42,0.423,0
32,171,19,1767,0,56,0,0,36.11,20903278,70.151,17.6,2.409,1703.102,269.048,2.42,0.423,0
32,172,30,1797,0,56,0,0,36.11,20903278,70.151,17.6,2.409,1703.102,269.048,2.42,0.423,0
32,173,19,1816,0,56,0,0,36.11,20903278,70.151,17.6,2.409,1703.102,269.048,2.42,0.423,0
32,174,30,1846,0,56,0,0,36.11,20903278,70.151,17.6,2.409,1703.102,269.048,2.42,0.423,0
32,175,50,1896,0,56,0,0,36.11,20903278,70.151,17.6,2.409,1703.102,269.048,2.42,0.423,0
32,176,11,1907,0,56,0,0,36.11,20903278,70.151,17.6,2.409,1703.102,269.048,2.42,0.423,0
32,177,22,1929,0,56,0,0,36.11,20903278,70.151,17.6,2.409,1703.102,269.048,2.42,0.423,0
32,178,21,1950,0,56,0,0,36.11,20903278,70.151,17.6,2.409,1703.102,269.048,2.42,0.423,0
32,179,12,1962,0,56,0,0,36.11,20903278,70.151,17.6,2.409,1703.102,269.048,2.42,0.423,0
32,180,11,1973,0,56,0,0,36.11,20903278,70.151,17.6,2.409,1703.102,269.048,2.42,0.423,0
32,181,35,2008,0,56,0,0,36.11,20903278,70.151,17.6,2.409,1703.102,269.048,2.42,0.423,0
32,182,20,2028,1,57,0,0,36.11,20903278,70.151,17.6,2.409,1703.102,269.048,2.42,0.423,0
32,183,4,2032,1,58,0,0,36.11,20903278,70.151,17.6,2.409,1703.102,269.048,2.42,0.423,0
32,184,24,2056,0,58,0,0,36.11,20903278,70.151,17.6,2.409,1703.102,269.048,2.42,0.423,0
32,185,32,2088,0,58,0,0,36.11,20903278,70.151,17.6,2.409,1703.102,269.048,2.42,0.423,0
32,186,35,2123,0,58,0,0,36.11,20903278,70.151,17.6,2.409,1703.102,269.048,2.42,0.423,0
32,187,31,2154,1,59,0,0,36.11,20903278,70.151,17.6,2.409,1703.102,269.048,2.42,0.423,0
32,188,13,2167,0,59,0,0,36.11,20903278,70.151,17.6,2.409,1703.102,269.048,2.42,0.423,0
32,189,17,2184,0,59,0,0,36.11,20903278,70.151,17.6,2.409,1703.102,269.048,2.42,0.423,0
32,190,13,2197,0,59,0,0,36.11,20903278,70.151,17.6,2.409,1703.102,269.048,2.42,0.423,0
32,191,25,2222,0,59,0,0,36.11,20903278,70.151,17.6,2.409,1703.102,269.048,2.42,0.423,0
32,192,19,2241,1,60,0,0,36.11,20903278,70.151,17.6,2.409,1703.102,269.048,2.42,0.423,0
32,193,13,2254,0,60,0,0,36.11,20903278,70.151,17.6,2.409,1703.102,269.048,2.42,0.423,0
32,194,17,2271,1,61,0,0,36.11,20903278,70.151,17.6,2.409,1703.102,269.048,2.42,0.423,0
32,195,9,2280,2,63,0,0,36.11,20903278,70.151,17.6,2.409,1703.102,269.048,2.42,0.423,0
32,196,14,2294,0,63,0,0,36.11,20903278,70.151,17.6,2.409,1703.102,269.048,2.42,0.423,0
32,197,11,2305,0,63,0,0,36.11,20903278,70.151,17.6,2.409,1703.102,269.048,2.42,0.423,0
32,198,0,2305,0,63,0,0,36.11,20903278,70.151,17.6,2.409,1703.102,269.048,2.42,0.423,0
32,199,30,2335,2,65,0,0,36.11,20903278,70.151,17.6,2.409,1703.102,269.048,2.42,0.423,0
32,200,8,2343,0,65,0,0,36.11,20903278,70.151,17.6,2.409,1703.102,269.048,2.42,0.423,0
32,201,0,2343,0,65,0,0,36.11,20903278,70.151,17.6,2.409,1703.102,269.048,2.42,0.423,0
32,202,38,2381,0,65,0,0,36.11,20903278,70.151,17.6,2.409,1703.102,269.048,2.42,0.423,0
32,203,6,2387,0,65,0,0,36.11,20903278,70.151,17.6,2.409,1703.102,269.048,2.42,0.423,0
32,204,19,2406,0,65,0,0,36.11,20903278,70.151,17.6,2.409,1703.102,269.048,2.42,0.423,0
34,1,0,109,0,0,0,0,57.41,16718971,90.672,25.6,4.412,3645.07,270.892,4,0.582,0
34,2,1,110,0,0,0,0,57.41,16718971,90.672,25.6,4.412,3645.07,270.892,4,0.582,0
34,3,4,114,0,0,0,0,57.41,16718971,90.672,25.6,4.412,3645.07,270.892,4,0.582,0
34,4,0,114,0,0,0,0,57.41,16718971,90.672,25.6,4.412,3645.07,270.892,4,0.582,0
34,5,0,114,0,0,0,0,57.41,16718971,90.672,25.6,4.412,3645.07,270.892,4,0.582,0
34,6,0,114,0,0,0,0,57.41,16718971,90.672,25.6,4.412,3645.07,270.892,4,0.582,0
34,7,1,115,0,0,0,0,60.19,16718971,90.672,25.6,4.412,3645.07,270.892,4,0.582,0
34,8,2,117,0,0,0,0,57.41,16718971,90.672,25.6,4.412,3645.07,270.892,4,0.582,0
34,9,1,118,0,0,0,0,68.52,16718971,90.672,25.6,4.412,3645.07,270.892,4,0.582,0
34,10,1,119,0,0,0,0,68.52,16718971,90.672,25.6,4.412,3645.07,270.892,4,0.582,0
34,11,1,120,0,0,0,0,68.52,16718971,90.672,25.6,4.412,3645.07,270.892,4,0.582,0
34,12,2,122,0,0,0,0,68.52,16718971,90.672,25.6,4.412,3645.07,270.892,4,0.582,0
34,13,0,122,0,0,0,0,68.52,16718971,90.672,25.6,4.412,3645.07,270.892,4,0.582,0
34,14,0,122,0,0,0,0,68.52,16718971,90.672,25.6,4.412,3645.07,270.892,4,0.582,0
34,15,0,122,0,0,0,0,68.52,16718971,90.672,25.6,4.412,3645.07,270.892,4,0.582,0
34,16,0,122,0,0,0,0,68.52,16718971,90.672,25.6,4.412,3645.07,270.892,4,0.582,0
34,17,0,122,0,0,0,0,57.41,16718971,90.672,25.6,4.412,3645.07,270.892,4,0.582,0
34,18,0,122,0,0,0,0,57.41,16718971,90.672,25.6,4.412,3645.07,270.892,4,0.582,0
34,19,0,122,0,0,0,0,57.41,16718971,90.672,25.6,4.412,3645.07,270.892,4,0.582,0
34,20,0,122,0,0,0,0,57.41,16718971,90.672,25.6,4.412,3645.07,270.892,4,0.582,0
34,21,0,122,0,0,0,0,57.41,16718971,90.672,25.6,4.412,3645.07,270.892,4,0.582,0
34,22,0,122,0,0,0,0,57.41,16718971,90.672,25.6,4.412,3645.07,270.892,4,0.582,0
34,23,0,122,0,0,0,0,57.41,16718971,90.672,25.6,4.412,3645.07,270.892,4,0.582,0
34,24,0,122,0,0,0,0,57.41,16718971,90.672,25.6,4.412,3645.07,270.892,4,0.582,0
34,25,0,122,0,0,0,0,57.41,16718971,90.672,25.6,4.412,3645.07,270.892,4,0.582,0
34,26,0,122,0,0,0,0,57.41,16718971,90.672,25.6,4.412,3645.07,270.892,4,0.582,0
34,27,0,122,0,0,0,0,57.41,16718971,90.672,25.6,4.412,3645.07,270.892,4,0.582,0
34,28,0,122,0,0,0,0,57.41,16718971,90.672,25.6,4.412,3645.07,270.892,4,0.582,0
34,29,0,122,0,0,0,0,57.41,16718971,90.672,25.6,4.412,3645.07,270.892,4,0.582,0
34,30,0,122,0,0,0,0,57.41,16718971,90.672,25.6,4.412,3645.07,270.892,4,0.582,0
34,31,0,122,0,0,0,0,57.41,16718971,90.672,25.6,4.412,3645.07,270.892,4,0.582,0
34,32,0,122,0,0,0,0,57.41,16718971,90.672,25.6,4.412,3645.07,270.892,4,0.582,0
34,33,0,122,0,0,0,0,57.41,16718971,90.672,25.6,4.412,3645.07,270.892,4,0.582,0
34,34,0,122,0,0,0,0,57.41,16718971,90.672,25.6,4.412,3645.07,270.892,4,0.582,0
34,35,0,122,0,0,0,0,57.41,16718971,90.672,25.6,4.412,3645.07,270.892,4,0.582,0
34,36,0,122,0,0,0,0,57.41,16718971,90.672,25.6,4.412,3645.07,270.892,4,0.582,0
34,37,0,122,0,0,0,0,57.41,16718971,90.672,25.6,4.412,3645.07,270.892,4,0.582,0
34,38,0,122,0,0,0,0,57.41,16718971,90.672,25.6,4.412,3645.07,270.892,4,0.582,0
34,39,0,122,0,0,0,0,57.41,16718971,90.672,25.6,4.412,3645.07,270.892,4,0.582,0
34,40,0,122,0,0,0,0,57.41,16718971,90.672,25.6,4.412,3645.07,270.892,4,0.582,0
34,41,0,122,0,0,0,0,57.41,16718971,90.672,25.6,4.412,3645.07,270.892,4,0.582,0
34,42,0,122,0,0,0,0,57.41,16718971,90.672,25.6,4.412,3645.07,270.892,4,0.582,0
34,43,0,122,0,0,0,0,57.41,16718971,90.672,25.6,4.412,3645.07,270.892,4,0.582,0
34,44,0,122,0,0,0,0,57.41,16718971,90.672,25.6,4.412,3645.07,270.892,4,0.582,0
34,45,0,122,0,0,0,0,57.41,16718971,90.672,25.6,4.412,3645.07,270.892,4,0.582,0
34,46,0,122,0,0,0,0,57.41,16718971,90.672,25.6,4.412,3645.07,270.892,4,0.582,0
34,47,0,122,0,0,0,0,57.41,16718971,90.672,25.6,4.412,3645.07,270.892,4,0.582,0
34,48,0,122,0,0,0,0,57.41,16718971,90.672,25.6,4.412,3645.07,270.892,4,0.582,0
34,49,0,122,0,0,0,0,57.41,16718971,90.672,25.6,4.412,3645.07,270.892,4,0.582,0
34,50,0,122,0,0,0,0,57.41,16718971,90.672,25.6,4.412,3645.07,270.892,4,0.582,0
34,51,0,122,0,0,0,0,57.41,16718971,90.672,25.6,4.412,3645.07,270.892,4,0.582,0
34,52,1,123,0,0,0,0,57.41,16718971,90.672,25.6,4.412,3645.07,270.892,4,0.582,0
34,53,1,124,0,0,0,0,57.41,16718971,90.672,25.6,4.412,3645.07,270.892,4,0.582,0
34,54,0,124,0,0,0,0,57.41,16718971,90.672,25.6,4.412,3645.07,270.892,4,0.582,0
34,55,0,124,0,0,0,0,57.41,16718971,90.672,25.6,4.412,3645.07,270.892,4,0.582,0
34,56,0,124,0,0,0,0,57.41,16718971,90.672,25.6,4.412,3645.07,270.892,4,0.582,0
34,57,0,124,0,0,0,0,57.41,16718971,90.672,25.6,4.412,3645.07,270.892,4,0.582,0
34,58,0,124,0,0,0,0,57.41,16718971,90.672,25.6,4.412,3645.07,270.892,4,0.582,0
34,59,0,124,0,0,0,0,57.41,16718971,90.672,25.6,4.412,3645.07,270.892,4,0.582,0
34,60,1,125,0,0,0,0,57.41,16718971,90.672,25.6,4.412,3645.07,270.892,4,0.582,0
34,61,0,125,0,0,0,0,57.41,16718971,90.672,25.6,4.412,3645.07,270.892,4,0.582,0
34,62,0,125,0,0,0,0,40.74,16718971,90.672,25.6,4.412,3645.07,270.892,4,0.582,0
34,63,0,125,0,0,0,0,40.74,16718971,90.672,25.6,4.412,3645.07,270.892,4,0.582,0
34,64,0,125,0,0,0,0,40.74,16718971,90.672,25.6,4.412,3645.07,270.892,4,0.582,0
34,65,0,125,0,0,0,0,40.74,16718971,90.672,25.6,4.412,3645.07,270.892,4,0.582,0
34,66,0,125,0,0,0,0,40.74,16718971,90.672,25.6,4.412,3645.07,270.892,4,0.582,0
34,67,0,125,0,0,0,0,40.74,16718971,90.672,25.6,4.412,3645.07,270.892,4,0.582,0
34,68,0,125,0,0,0,0,40.74,16718971,90.672,25.6,4.412,3645.07,270.892,4,0.582,0
34,69,1,126,0,0,0,0,40.74,16718971,90.672,25.6,4.412,3645.07,270.892,4,0.582,0
34,70,0,126,0,0,0,0,40.74,16718971,90.672,25.6,4.412,3645.07,270.892,4,0.582,0
34,71,0,126,0,0,0,0,40.74,16718971,90.672,25.6,4.412,3645.07,270.892,4,0.582,0
34,72,0,126,0,0,0,0,40.74,16718971,90.672,25.6,4.412,3645.07,270.892,4,0.582,0
34,73,0,126,0,0,0,0,40.74,16718971,90.672,25.6,4.412,3645.07,270.892,4,0.582,0
34,74,0,126,0,0,0,0,40.74,16718971,90.672,25.6,4.412,3645.07,270.892,4,0.582,0
34,75,2,128,0,0,0,0,40.74,16718971,90.672,25.6,4.412,3645.07,270.892,4,0.582,0
34,76,0,128,0,0,0,0,40.74,16718971,90.672,25.6,4.412,3645.07,270.892,4,0.582,0
34,77,0,128,0,0,0,0,40.74,16718971,90.672,25.6,4.412,3645.07,270.892,4,0.582,0
34,78,0,128,0,0,0,0,40.74,16718971,90.672,25.6,4.412,3645.07,270.892,4,0.582,0
34,79,1,129,0,0,0,0,40.74,16718971,90.672,25.6,4.412,3645.07,270.892,4,0.582,0
34,80,0,129,0,0,0,0,40.74,16718971,90.672,25.6,4.412,3645.07,270.892,4,0.582,0
34,81,0,129,0,0,0,0,40.74,16718971,90.672,25.6,4.412,3645.07,270.892,4,0.582,0
34,82,0,129,0,0,0,0,40.74,16718971,90.672,25.6,4.412,3645.07,270.892,4,0.582,0
34,83,0,129,0,0,0,0,40.74,16718971,90.672,25.6,4.412,3645.07,270.892,4,0.582,0
34,84,1,130,0,0,0,0,40.74,16718971,90.672,25.6,4.412,3645.07,270.892,4,0.582,0
34,85,0,130,0,0,0,0,40.74,16718971,90.672,25.6,4.412,3645.07,270.892,4,0.582,0
34,86,0,130,0,0,0,0,40.74,16718971,90.672,25.6,4.412,3645.07,270.892,4,0.582,0
34,87,0,130,0,0,0,0,40.74,16718971,90.672,25.6,4.412,3645.07,270.892,4,0.582,0
34,88,9,139,0,0,0,0,40.74,16718971,90.672,25.6,4.412,3645.07,270.892,4,0.582,0
34,89,2,141,0,0,0,0,40.74,16718971,90.672,25.6,4.412,3645.07,270.892,4,0.582,0
34,90,0,141,0,0,0,0,40.74,16718971,90.672,25.6,4.412,3645.07,270.892,4,0.582,0
34,91,0,141,0,0,0,0,40.74,16718971,90.672,25.6,4.412,3645.07,270.892,4,0.582,0
34,92,0,141,0,0,0,0,40.74,16718971,90.672,25.6,4.412,3645.07,270.892,4,0.582,0
34,93,0,141,0,0,0,0,40.74,16718971,90.672,25.6,4.412,3645.07,270.892,4,0.582,0
34,94,0,141,0,0,0,0,40.74,16718971,90.672,25.6,4.412,3645.07,270.892,4,0.582,0
34,95,0,141,0,0,0,0,40.74,16718971,90.672,25.6,4.412,3645.07,270.892,4,0.582,0
34,96,0,141,0,0,0,0,40.74,16718971,90.672,25.6,4.412,3645.07,270.892,4,0.582,0
34,97,0,141,0,0,0,0,40.74,16718971,90.672,25.6,4.412,3645.07,270.892,4,0.582,0
34,98,0,141,0,0,0,0,40.74,16718971,90.672,25.6,4.412,3645.07,270.892,4,0.582,0
34,99,0,141,0,0,0,0,38.89,16718971,90.672,25.6,4.412,3645.07,270.892,4,0.582,0
34,100,0,141,0,0,0,0,38.89,16718971,90.672,25.6,4.412,3645.07,270.892,4,0.582,0
34,101,0,141,0,0,0,0,38.89,16718971,90.672,25.6,4.412,3645.07,270.892,4,0.582,0
34,102,0,141,0,0,0,0,38.89,16718971,90.672,25.6,4.412,3645.07,270.892,4,0.582,0
34,103,15,156,0,0,0,0,38.89,16718971,90.672,25.6,4.412,3645.07,270.892,4,0.582,0
34,104,0,156,0,0,0,0,38.89,16718971,90.672,25.6,4.412,3645.07,270.892,4,0.582,0
34,105,9,165,0,0,0,0,38.89,16718971,90.672,25.6,4.412,3645.07,270.892,4,0.582,0
34,106,0,165,0,0,0,0,38.89,16718971,90.672,25.6,4.412,3645.07,270.892,4,0.582,0
34,107,1,166,0,0,0,0,38.89,16718971,90.672,25.6,4.412,3645.07,270.892,4,0.582,0
34,108,5,171,0,0,0,0,38.89,16718971,90.672,25.6,4.412,3645.07,270.892,4,0.582,0
34,109,0,171,0,0,0,0,38.89,16718971,90.672,25.6,4.412,3645.07,270.892,4,0.582,0
34,110,0,171,0,0,0,0,38.89,16718971,90.672,25.6,4.412,3645.07,270.892,4,0.582,0
34,111,0,171,0,0,0,0,38.89,16718971,90.672,25.6,4.412,3645.07,270.892,4,0.582,0
34,112,26,197,0,0,0,0,38.89,16718971,90.672,25.6,4.412,3645.07,270.892,4,0.582,0
34,113,0,197,0,0,0,0,38.89,16718971,90.672,25.6,4.412,3645.07,270.892,4,0.582,0
34,114,1,198,0,0,0,0,38.89,16718971,90.672,25.6,4.412,3645.07,270.892,4,0.582,0
34,115,4,202,0,0,0,0,38.89,16718971,90.672,25.6,4.412,3645.07,270.892,4,0.582,0
34,116,0,202,0,0,0,0,38.89,16718971,90.672,25.6,4.412,3645.07,270.892,4,0.582,0
34,117,23,225,0,0,0,0,38.89,16718971,90.672,25.6,4.412,3645.07,270.892,4,0.582,0
34,118,0,225,0,0,0,0,38.89,16718971,90.672,25.6,4.412,3645.07,270.892,4,0.582,0
34,119,0,225,0,0,0,0,38.89,16718971,90.672,25.6,4.412,3645.07,270.892,4,0.582,0
34,120,1,226,0,0,0,0,38.89,16718971,90.672,25.6,4.412,3645.07,270.892,4,0.582,0
34,121,8,234,0,0,0,0,38.89,16718971,90.672,25.6,4.412,3645.07,270.892,4,0.582,0
34,122,0,234,0,0,0,0,38.89,16718971,90.672,25.6,4.412,3645.07,270.892,4,0.582,0
34,123,5,239,0,0,0,0,38.89,16718971,90.672,25.6,4.412,3645.07,270.892,4,0.582,0
34,124,1,240,0,0,0,0,38.89,16718971,90.672,25.6,4.412,3645.07,270.892,4,0.582,0
34,125,0,240,0,0,0,0,42.59,16718971,90.672,25.6,4.412,3645.07,270.892,4,0.582,0
34,126,0,240,0,0,0,0,42.59,16718971,90.672,25.6,4.412,3645.07,270.892,4,0.582,0
34,127,3,243,0,0,0,0,42.59,16718971,90.672,25.6,4.412,3645.07,270.892,4,0.582,0
34,128,0,243,0,0,0,0,47.22,16718971,90.672,25.6,4.412,3645.07,270.892,4,0.582,0
34,129,0,243,0,0,0,0,47.22,16718971,90.672,25.6,4.412,3645.07,270.892,4,0.582,0
34,130,3,246,0,0,0,0,47.22,16718971,90.672,25.6,4.412,3645.07,270.892,4,0.582,0
34,131,0,246,0,0,0,0,47.22,16718971,90.672,25.6,4.412,3645.07,270.892,4,0.582,0
34,132,5,251,0,0,0,0,47.22,16718971,90.672,25.6,4.412,3645.07,270.892,4,0.582,0
34,133,15,266,0,0,0,0,47.22,16718971,90.672,25.6,4.412,3645.07,270.892,4,0.582,0
34,134,2,268,0,0,0,0,47.22,16718971,90.672,25.6,4.412,3645.07,270.892,4,0.582,0
34,135,4,272,0,0,0,0,47.22,16718971,90.672,25.6,4.412,3645.07,270.892,4,0.582,0
34,136,1,273,0,0,0,0,47.22,16718971,90.672,25.6,4.412,3645.07,270.892,4,0.582,0
34,137,0,273,0,0,0,0,47.22,16718971,90.672,25.6,4.412,3645.07,270.892,4,0.582,0
34,138,0,273,0,0,0,0,47.22,16718971,90.672,25.6,4.412,3645.07,270.892,4,0.582,0
34,139,0,273,0,0,0,0,47.22,16718971,90.672,25.6,4.412,3645.07,270.892,4,0.582,0
34,140,0,273,0,0,0,0,47.22,16718971,90.672,25.6,4.412,3645.07,270.892,4,0.582,0
34,141,0,273,0,0,0,0,47.22,16718971,90.672,25.6,4.412,3645.07,270.892,4,0.582,0
34,142,0,273,0,0,0,0,47.22,16718971,90.672,25.6,4.412,3645.07,270.892,4,0.582,0
34,143,0,273,0,0,0,0,47.22,16718971,90.672,25.6,4.412,3645.07,270.892,4,0.582,0
34,144,0,273,0,0,0,0,47.22,16718971,90.672,25.6,4.412,3645.07,270.892,4,0.582,0
34,145,0,273,0,0,0,0,47.22,16718971,90.672,25.6,4.412,3645.07,270.892,4,0.582,0
34,146,0,273,0,0,0,0,44.44,16718971,90.672,25.6,4.412,3645.07,270.892,4,0.582,0
34,147,0,273,0,0,0,0,44.44,16718971,90.672,25.6,4.412,3645.07,270.892,4,0.582,0
34,148,0,273,0,0,0,0,44.44,16718971,90.672,25.6,4.412,3645.07,270.892,4,0.582,0
34,149,0,273,0,0,0,0,44.44,16718971,90.672,25.6,4.412,3645.07,270.892,4,0.582,0
34,150,0,273,0,0,0,0,44.44,16718971,90.672,25.6,4.412,3645.07,270.892,4,0.582,0
34,151,0,273,0,0,0,0,44.44,16718971,90.672,25.6,4.412,3645.07,270.892,4,0.582,0
34,152,0,273,0,0,0,0,44.44,16718971,90.672,25.6,4.412,3645.07,270.892,4,0.582,0
34,153,1,274,0,0,0,0,44.44,16718971,90.672,25.6,4.412,3645.07,270.892,4,0.582,0
34,154,0,274,0,0,0,0,44.44,16718971,90.672,25.6,4.412,3645.07,270.892,4,0.582,0
34,155,0,274,0,0,0,0,44.44,16718971,90.672,25.6,4.412,3645.07,270.892,4,0.582,0
34,156,0,274,0,0,0,0,44.44,16718971,90.672,25.6,4.412,3645.07,270.892,4,0.582,0
34,157,0,274,0,0,0,0,44.44,16718971,90.672,25.6,4.412,3645.07,270.892,4,0.582,0
34,158,0,274,0,0,0,0,44.44,16718971,90.672,25.6,4.412,3645.07,270.892,4,0.582,0
34,159,0,274,0,0,0,0,44.44,16718971,90.672,25.6,4.412,3645.07,270.892,4,0.582,0
34,160,0,274,0,0,0,0,37.04,16718971,90.672,25.6,4.412,3645.07,270.892,4,0.582,0
34,161,0,274,0,0,0,0,37.04,16718971,90.672,25.6,4.412,3645.07,270.892,4,0.582,0
34,162,0,274,0,0,0,0,37.04,16718971,90.672,25.6,4.412,3645.07,270.892,4,0.582,0
34,163,0,274,0,0,0,0,37.04,16718971,90.672,25.6,4.412,3645.07,270.892,4,0.582,0
34,164,0,274,0,0,0,0,37.04,16718971,90.672,25.6,4.412,3645.07,270.892,4,0.582,0
34,165,0,274,0,0,0,0,37.04,16718971,90.672,25.6,4.412,3645.07,270.892,4,0.582,0
34,166,1,275,0,0,0,0,37.04,16718971,90.672,25.6,4.412,3645.07,270.892,4,0.582,0
34,167,0,275,0,0,0,0,37.04,16718971,90.672,25.6,4.412,3645.07,270.892,4,0.582,0
34,168,0,275,0,0,0,0,37.04,16718971,90.672,25.6,4.412,3645.07,270.892,4,0.582,0
34,169,0,275,0,0,0,0,37.04,16718971,90.672,25.6,4.412,3645.07,270.892,4,0.582,0
34,170,0,275,0,0,0,0,37.04,16718971,90.672,25.6,4.412,3645.07,270.892,4,0.582,0
34,171,0,275,0,0,0,0,37.04,16718971,90.672,25.6,4.412,3645.07,270.892,4,0.582,0
34,172,0,275,0,0,0,0,37.04,16718971,90.672,25.6,4.412,3645.07,270.892,4,0.582,0
34,173,0,275,0,0,0,0,37.04,16718971,90.672,25.6,4.412,3645.07,270.892,4,0.582,0
34,174,0,275,0,0,0,0,37.04,16718971,90.672,25.6,4.412,3645.07,270.892,4,0.582,0
34,175,0,275,0,0,0,0,37.04,16718971,90.672,25.6,4.412,3645.07,270.892,4,0.582,0
34,176,0,275,0,0,0,0,37.04,16718971,90.672,25.6,4.412,3645.07,270.892,4,0.582,0
34,177,0,275,0,0,0,0,37.04,16718971,90.672,25.6,4.412,3645.07,270.892,4,0.582,0
34,178,0,275,0,0,0,0,37.04,16718971,90.672,25.6,4.412,3645.07,270.892,4,0.582,0
34,179,0,275,0,0,0,0,37.04,16718971,90.672,25.6,4.412,3645.07,270.892,4,0.582,0
34,180,1,276,0,0,0,0,37.04,16718971,90.672,25.6,4.412,3645.07,270.892,4,0.582,0
34,181,0,276,0,0,0,0,37.04,16718971,90.672,25.6,4.412,3645.07,270.892,4,0.582,0
34,182,1,277,0,0,0,0,37.04,16718971,90.672,25.6,4.412,3645.07,270.892,4,0.582,0
34,183,0,277,0,0,0,0,37.04,16718971,90.672,25.6,4.412,3645.07,270.892,4,0.582,0
34,184,0,277,0,0,0,0,37.04,16718971,90.672,25.6,4.412,3645.07,270.892,4,0.582,0
34,185,0,277,0,0,0,0,37.04,16718971,90.672,25.6,4.412,3645.07,270.892,4,0.582,0
34,186,1,278,0,0,0,0,37.04,16718971,90.672,25.6,4.412,3645.07,270.892,4,0.582,0
34,187,0,278,0,0,0,0,37.04,16718971,90.672,25.6,4.412,3645.07,270.892,4,0.582,0
34,188,2,280,0,0,0,0,37.04,16718971,90.672,25.6,4.412,3645.07,270.892,4,0.582,0
34,189,0,280,0,0,0,0,37.04,16718971,90.672,25.6,4.412,3645.07,270.892,4,0.582,0
34,190,0,280,0,0,0,0,37.04,16718971,90.672,25.6,4.412,3645.07,270.892,4,0.582,0
34,191,1,281,0,0,0,0,37.04,16718971,90.672,25.6,4.412,3645.07,270.892,4,0.582,0
34,192,1,282,0,0,0,0,37.04,16718971,90.672,25.6,4.412,3645.07,270.892,4,0.582,0
34,193,1,283,0,0,0,0,37.04,16718971,90.672,25.6,4.412,3645.07,270.892,4,0.582,0
34,194,0,283,0,0,0,0,37.04,16718971,90.672,25.6,4.412,3645.07,270.892,4,0.582,0
34,195,0,283,0,0,0,0,37.04,16718971,90.672,25.6,4.412,3645.07,270.892,4,0.582,0
34,196,0,283,0,0,0,0,37.04,16718971,90.672,25.6,4.412,3645.07,270.892,4,0.582,0
34,197,0,283,0,0,0,0,37.04,16718971,90.672,25.6,4.412,3645.07,270.892,4,0.582,0
34,198,0,283,0,0,0,0,37.04,16718971,90.672,25.6,4.412,3645.07,270.892,4,0.582,0
34,199,0,283,0,0,0,0,37.04,16718971,90.672,25.6,4.412,3645.07,270.892,4,0.582,0
34,200,0,283,0,0,0,0,37.04,16718971,90.672,25.6,4.412,3645.07,270.892,4,0.582,0
34,201,0,283,0,0,0,0,37.04,16718971,90.672,25.6,4.412,3645.07,270.892,4,0.582,0
34,202,0,283,0,0,0,0,37.04,16718971,90.672,25.6,4.412,3645.07,270.892,4,0.582,0
34,203,2,285,0,0,0,0,37.04,16718971,90.672,25.6,4.412,3645.07,270.892,4,0.582,0
34,204,1,286,0,0,0,0,37.04,16718971,90.672,25.6,4.412,3645.07,270.892,4,0.582,0
35,1,51,193,4,6,0,0,57.41,26545864,50.885,18.8,3.165,3364.926,244.661,7.2,0.556,4
35,2,40,233,0,6,0,0,57.41,26545864,50.885,18.8,3.165,3364.926,244.661,7.2,0.556,4
35,3,38,271,1,7,0,0,57.41,26545864,50.885,18.8,3.165,3364.926,244.661,7.2,0.556,4
35,4,238,509,1,8,0,0,68.52,26545864,50.885,18.8,3.165,3364.926,244.661,7.2,0.556,4
35,5,46,555,1,9,0,0,68.52,26545864,50.885,18.8,3.165,3364.926,244.661,7.2,0.556,4
35,6,95,650,0,9,0,0,68.52,26545864,50.885,18.8,3.165,3364.926,244.661,7.2,0.556,4
35,7,8,658,0,9,0,0,68.52,26545864,50.885,18.8,3.165,3364.926,244.661,7.2,0.556,4
35,8,27,685,0,9,0,0,68.52,26545864,50.885,18.8,3.165,3364.926,244.661,7.2,0.556,4
35,9,45,730,1,10,0,0,68.52,26545864,50.885,18.8,3.165,3364.926,244.661,7.2,0.556,4
35,10,0,730,0,10,0,0,68.52,26545864,50.885,18.8,3.165,3364.926,244.661,7.2,0.556,4
35,11,73,803,0,10,0,0,68.52,26545864,50.885,18.8,3.165,3364.926,244.661,7.2,0.556,4
35,12,17,820,1,11,0,0,68.52,26545864,50.885,18.8,3.165,3364.926,244.661,7.2,0.556,4
35,13,0,820,1,12,0,0,68.52,26545864,50.885,18.8,3.165,3364.926,244.661,7.2,0.556,4
35,14,0,820,0,12,0,0,68.52,26545864,50.885,18.8,3.165,3364.926,244.661,7.2,0.556,4
35,15,35,855,5,17,0,0,68.52,26545864,50.885,18.8,3.165,3364.926,244.661,7.2,0.556,4
35,16,0,855,0,17,0,0,68.52,26545864,50.885,18.8,3.165,3364.926,244.661,7.2,0.556,4
35,17,0,855,4,21,0,0,68.52,26545864,50.885,18.8,3.165,3364.926,244.661,7.2,0.556,4
35,18,161,1016,0,21,0,0,71.3,26545864,50.885,18.8,3.165,3364.926,244.661,7.2,0.556,4
35,19,0,1016,0,21,0,0,71.3,26545864,50.885,18.8,3.165,3364.926,244.661,7.2,0.556,4
35,20,0,1016,21,42,0,0,71.3,26545864,50.885,18.8,3.165,3364.926,244.661,7.2,0.556,4
35,21,1,1017,0,42,0,0,71.3,26545864,50.885,18.8,3.165,3364.926,244.661,7.2,0.556,4
35,22,146,1163,0,42,0,0,71.3,26545864,50.885,18.8,3.165,3364.926,244.661,7.2,0.556,4
35,23,0,1163,1,43,0,0,71.3,26545864,50.885,18.8,3.165,3364.926,244.661,7.2,0.556,4
35,24,238,1401,6,49,0,0,71.3,26545864,50.885,18.8,3.165,3364.926,244.661,7.2,0.556,4
35,25,2,1403,0,49,0,0,71.3,26545864,50.885,18.8,3.165,3364.926,244.661,7.2,0.556,4
35,26,115,1518,4,53,0,0,71.3,26545864,50.885,18.8,3.165,3364.926,244.661,7.2,0.556,4
35,27,103,1621,3,56,0,0,71.3,26545864,50.885,18.8,3.165,3364.926,244.661,7.2,0.556,4
35,28,0,1621,2,58,0,0,71.3,26545864,50.885,18.8,3.165,3364.926,244.661,7.2,0.556,4
35,29,185,1806,1,59,0,0,71.3,26545864,50.885,18.8,3.165,3364.926,244.661,7.2,0.556,4
35,30,26,1832,2,61,0,0,71.3,26545864,50.885,18.8,3.165,3364.926,244.661,7.2,0.556,4
35,31,0,1832,0,61,0,0,63.89,26545864,50.885,18.8,3.165,3364.926,244.661,7.2,0.556,4
35,32,237,2069,0,61,0,0,63.89,26545864,50.885,18.8,3.165,3364.926,244.661,7.2,0.556,4
35,33,8,2077,3,64,0,0,63.89,26545864,50.885,18.8,3.165,3364.926,244.661,7.2,0.556,4
35,34,0,2077,0,64,0,0,63.89,26545864,50.885,18.8,3.165,3364.926,244.661,7.2,0.556,4
35,35,27,2104,0,64,0,0,63.89,26545864,50.885,18.8,3.165,3364.926,244.661,7.2,0.556,4
35,36,0,2104,0,64,0,0,63.89,26545864,50.885,18.8,3.165,3364.926,244.661,7.2,0.556,4
35,37,161,2265,44,108,0,0,63.89,26545864,50.885,18.8,3.165,3364.926,244.661,7.2,0.556,4
35,38,0,2265,0,108,0,0,63.89,26545864,50.885,18.8,3.165,3364.926,244.661,7.2,0.556,4
35,39,0,2265,0,108,0,0,63.89,26545864,50.885,18.8,3.165,3364.926,244.661,7.2,0.556,4
35,40,9,2274,0,108,0,0,63.89,26545864,50.885,18.8,3.165,3364.926,244.661,7.2,0.556,4
35,41,305,2579,6,114,0,0,63.89,26545864,50.885,18.8,3.165,3364.926,244.661,7.2,0.556,4
35,42,110,2689,11,125,0,0,63.89,26545864,50.885,18.8,3.165,3364.926,244.661,7.2,0.556,4
35,43,0,2689,0,125,0,0,63.89,26545864,50.885,18.8,3.165,3364.926,244.661,7.2,0.556,4
35,44,111,2800,11,136,0,0,63.89,26545864,50.885,18.8,3.165,3364.926,244.661,7.2,0.556,4
35,45,154,2954,3,139,0,0,63.89,26545864,50.885,18.8,3.165,3364.926,244.661,7.2,0.556,4
35,46,151,3105,1,140,0,0,63.89,26545864,50.885,18.8,3.165,3364.926,244.661,7.2,0.556,4
35,47,187,3292,0,140,0,0,63.89,26545864,50.885,18.8,3.165,3364.926,244.661,7.2,0.556,4
35,48,0,3292,0,140,0,0,63.89,26545864,50.885,18.8,3.165,3364.926,244.661,7.2,0.556,4
35,49,0,3292,0,140,0,0,63.89,26545864,50.885,18.8,3.165,3364.926,244.661,7.2,0.556,4
35,50,237,3529,0,140,0,0,63.89,26545864,50.885,18.8,3.165,3364.926,244.661,7.2,0.556,4
35,51,204,3733,6,146,0,0,63.89,26545864,50.885,18.8,3.165,3364.926,244.661,7.2,0.556,4
35,52,555,4288,10,156,0,0,63.89,26545864,50.885,18.8,3.165,3364.926,244.661,7.2,0.556,4
35,53,112,4400,3,159,0,0,63.89,26545864,50.885,18.8,3.165,3364.926,244.661,7.2,0.556,4
35,54,197,4597,0,159,0,0,63.89,26545864,50.885,18.8,3.165,3364.926,244.661,7.2,0.556,4
35,55,293,4890,6,165,0,0,63.89,26545864,50.885,18.8,3.165,3364.926,244.661,7.2,0.556,4
35,56,154,5044,6,171,0,0,63.89,26545864,50.885,18.8,3.165,3364.926,244.661,7.2,0.556,4
35,57,312,5356,4,175,0,0,63.89,26545864,50.885,18.8,3.165,3364.926,244.661,7.2,0.556,4
35,58,0,5356,2,177,0,0,63.89,26545864,50.885,18.8,3.165,3364.926,244.661,7.2,0.556,4
35,59,0,5356,0,177,0,0,63.89,26545864,50.885,18.8,3.165,3364.926,244.661,7.2,0.556,4
35,60,80,5436,0,177,0,0,63.89,26545864,50.885,18.8,3.165,3364.926,244.661,7.2,0.556,4
35,61,468,5904,14,191,0,0,63.89,26545864,50.885,18.8,3.165,3364.926,244.661,7.2,0.556,4
35,62,0,5904,0,191,0,0,60.19,26545864,50.885,18.8,3.165,3364.926,244.661,7.2,0.556,4
35,63,493,6397,8,199,0,0,60.19,26545864,50.885,18.8,3.165,3364.926,244.661,7.2,0.556,4
35,64,188,6585,1,200,0,0,60.19,26545864,50.885,18.8,3.165,3364.926,244.661,7.2,0.556,4
35,65,167,6752,0,200,0,0,60.19,26545864,50.885,18.8,3.165,3364.926,244.661,7.2,0.556,4
35,66,37,6789,3,203,0,0,60.19,26545864,50.885,18.8,3.165,3364.926,244.661,7.2,0.556,4
35,67,810,7599,0,203,0,0,60.19,26545864,50.885,18.8,3.165,3364.926,244.661,7.2,0.556,4
35,68,0,7599,0,203,0,0,60.19,26545864,50.885,18.8,3.165,3364.926,244.661,7.2,0.556,4
35,69,309,7908,0,203,0,0,60.19,26545864,50.885,18.8,3.165,3364.926,244.661,7.2,0.556,4
35,70,404,8312,5,208,0,0,60.19,26545864,50.885,18.8,3.165,3364.926,244.661,7.2,0.556,4
35,71,369,8681,0,208,0,0,60.19,26545864,50.885,18.8,3.165,3364.926,244.661,7.2,0.556,4
35,72,248,8929,6,214,0,0,60.19,26545864,50.885,18.8,3.165,3364.926,244.661,7.2,0.556,4
35,73,0,8929,0,214,0,0,60.19,26545864,50.885,18.8,3.165,3364.926,244.661,7.2,0.556,4
35,74,267,9196,59,273,0,0,60.19,26545864,50.885,18.8,3.165,3364.926,244.661,7.2,0.556,4
35,75,376,9572,2,275,0,0,60.19,26545864,50.885,18.8,3.165,3364.926,244.661,7.2,0.556,4
35,76,292,9864,1,276,0,0,60.19,26545864,50.885,18.8,3.165,3364.926,244.661,7.2,0.556,4
35,77,0,9864,0,276,0,0,60.19,26545864,50.885,18.8,3.165,3364.926,244.661,7.2,0.556,4
35,78,0,9864,0,276,0,0,60.19,26545864,50.885,18.8,3.165,3364.926,244.661,7.2,0.556,4
35,79,0,9864,0,276,0,0,60.19,26545864,50.885,18.8,3.165,3364.926,244.661,7.2,0.556,4
35,80,774,10638,6,282,0,0,60.19,26545864,50.885,18.8,3.165,3364.926,244.661,7.2,0.556,4
35,81,643,11281,18,300,0,0,60.19,26545864,50.885,18.8,3.165,3364.926,244.661,7.2,0.556,4
35,82,0,11281,0,300,0,0,60.19,26545864,50.885,18.8,3.165,3364.926,244.661,7.2,0.556,4
35,83,329,11610,1,301,0,0,60.19,26545864,50.885,18.8,3.165,3364.926,244.661,7.2,0.556,4
35,84,282,11892,2,303,0,0,60.19,26545864,50.885,18.8,3.165,3364.926,244.661,7.2,0.556,4
35,85,149,12041,5,308,0,0,60.19,26545864,50.885,18.8,3.165,3364.926,244.661,7.2,0.556,4
35,86,229,12270,5,313,0,0,60.19,26545864,50.885,18.8,3.165,3364.926,244.661,7.2,0.556,4
35,87,322,12592,0,313,0,0,60.19,26545864,50.885,18.8,3.165,3364.926,244.661,7.2,0.556,4
35,88,0,12592,0,313,0,0,60.19,26545864,50.885,18.8,3.165,3364.926,244.661,7.2,0.556,4
35,89,0,12592,0,313,0,0,60.19,26545864,50.885,18.8,3.165,3364.926,244.661,7.2,0.556,4
35,90,0,12592,0,313,0,0,60.19,26545864,50.885,18.8,3.165,3364.926,244.661,7.2,0.556,4
35,91,0,12592,0,313,0,0,60.19,26545864,50.885,18.8,3.165,3364.926,244.661,7.2,0.556,4
35,92,0,12592,0,313,0,0,60.19,26545864,50.885,18.8,3.165,3364.926,244.661,7.2,0.556,4
35,93,0,12592,0,313,0,0,60.19,26545864,50.885,18.8,3.165,3364.926,244.661,7.2,0.556,4
35,94,0,12592,0,313,0,0,60.19,26545864,50.885,18.8,3.165,3364.926,244.661,7.2,0.556,4
35,95,0,12592,0,313,0,0,60.19,26545864,50.885,18.8,3.165,3364.926,244.661,7.2,0.556,4
35,96,0,12592,0,313,0,0,60.19,26545864,50.885,18.8,3.165,3364.926,244.661,7.2,0.556,4
35,97,1119,13711,15,328,0,0,60.19,26545864,50.885,18.8,3.165,3364.926,244.661,7.2,0.556,4
35,98,326,14037,2,330,0,0,60.19,26545864,50.885,18.8,3.165,3364.926,244.661,7.2,0.556,4
35,99,879,14916,29,359,0,0,60.19,26545864,50.885,18.8,3.165,3364.926,244.661,7.2,0.556,4
35,100,0,14916,0,359,0,0,60.19,26545864,50.885,18.8,3.165,3364.926,244.661,7.2,0.556,4
35,101,0,14916,0,359,0,0,60.19,26545864,50.885,18.8,3.165,3364.926,244.661,7.2,0.556,4
35,102,0,14916,0,359,0,0,60.19,26545864,50.885,18.8,3.165,3364.926,244.661,7.2,0.556,4
35,103,0,14916,0,359,0,0,60.19,26545864,50.885,18.8,3.165,3364.926,244.661,7.2,0.556,4
35,104,257,15173,0,359,0,0,60.19,26545864,50.885,18.8,3.165,3364.926,244.661,7.2,0.556,4
35,105,0,15173,0,359,0,0,60.19,26545864,50.885,18.8,3.165,3364.926,244.661,7.2,0.556,4
35,106,0,15173,0,359,0,0,60.19,26545864,50.885,18.8,3.165,3364.926,244.661,7.2,0.556,4
35,107,0,15173,0,359,0,0,60.19,26545864,50.885,18.8,3.165,3364.926,244.661,7.2,0.556,4
35,108,984,16157,14,373,0,0,60.19,26545864,50.885,18.8,3.165,3364.926,244.661,7.2,0.556,4
35,109,0,16157,0,373,0,0,60.19,26545864,50.885,18.8,3.165,3364.926,244.661,7.2,0.556,4
35,110,0,16157,0,373,0,0,60.19,26545864,50.885,18.8,3.165,3364.926,244.661,7.2,0.556,4
35,111,0,16157,0,373,0,0,60.19,26545864,50.885,18.8,3.165,3364.926,244.661,7.2,0.556,4
35,112,0,16157,0,373,0,0,60.19,26545864,50.885,18.8,3.165,3364.926,244.661,7.2,0.556,4
35,113,0,16157,0,373,0,0,60.19,26545864,50.885,18.8,3.165,3364.926,244.661,7.2,0.556,4
35,114,365,16522,9,382,0,0,60.19,26545864,50.885,18.8,3.165,3364.926,244.661,7.2,0.556,4
35,115,186,16708,3,385,0,0,60.19,26545864,50.885,18.8,3.165,3364.926,244.661,7.2,0.556,4
35,116,0,16708,0,385,0,0,60.19,26545864,50.885,18.8,3.165,3364.926,244.661,7.2,0.556,4
35,117,0,16708,0,385,0,0,60.19,26545864,50.885,18.8,3.165,3364.926,244.661,7.2,0.556,4
35,118,0,16708,0,385,0,0,60.19,26545864,50.885,18.8,3.165,3364.926,244.661,7.2,0.556,4
35,119,0,16708,0,385,0,0,60.19,26545864,50.885,18.8,3.165,3364.926,244.661,7.2,0.556,4
35,120,0,16708,0,385,0,0,60.19,26545864,50.885,18.8,3.165,3364.926,244.661,7.2,0.556,4
35,121,547,17255,2,387,0,0,60.19,26545864,50.885,18.8,3.165,3364.926,244.661,7.2,0.556,4
35,122,0,17255,0,387,0,0,60.19,26545864,50.885,18.8,3.165,3364.926,244.661,7.2,0.556,4
35,123,0,17255,0,387,0,0,60.19,26545864,50.885,18.8,3.165,3364.926,244.661,7.2,0.556,4
35,124,0,17255,0,387,0,0,60.19,26545864,50.885,18.8,3.165,3364.926,244.661,7.2,0.556,4
35,125,0,17255,0,387,0,0,60.19,26545864,50.885,18.8,3.165,3364.926,244.661,7.2,0.556,4
35,126,0,17255,0,387,0,0,60.19,26545864,50.885,18.8,3.165,3364.926,244.661,7.2,0.556,4
35,127,463,17718,4,391,0,0,60.19,26545864,50.885,18.8,3.165,3364.926,244.661,7.2,0.556,4
35,128,0,17718,0,391,0,0,60.19,26545864,50.885,18.8,3.165,3364.926,244.661,7.2,0.556,4
35,129,0,17718,0,391,0,0,60.19,26545864,50.885,18.8,3.165,3364.926,244.661,7.2,0.556,4
35,130,0,17718,0,391,0,0,60.19,26545864,50.885,18.8,3.165,3364.926,244.661,7.2,0.556,4
35,131,0,17718,0,391,0,0,60.19,26545864,50.885,18.8,3.165,3364.926,244.661,7.2,0.556,4
35,132,324,18042,4,395,0,0,60.19,26545864,50.885,18.8,3.165,3364.926,244.661,7.2,0.556,4
35,133,0,18042,0,395,0,0,60.19,26545864,50.885,18.8,3.165,3364.926,244.661,7.2,0.556,4
35,134,171,18213,3,398,0,0,60.19,26545864,50.885,18.8,3.165,3364.926,244.661,7.2,0.556,4
35,135,50,18263,3,401,0,0,60.19,26545864,50.885,18.8,3.165,3364.926,244.661,7.2,0.556,4
35,136,45,18308,0,401,0,0,60.19,26545864,50.885,18.8,3.165,3364.926,244.661,7.2,0.556,4
35,137,161,18469,0,401,0,0,60.19,26545864,50.885,18.8,3.165,3364.926,244.661,7.2,0.556,4
35,138,0,18469,0,401,0,0,60.19,26545864,50.885,18.8,3.165,3364.926,244.661,7.2,0.556,4
35,139,0,18469,0,401,0,0,60.19,26545864,50.885,18.8,3.165,3364.926,244.661,7.2,0.556,4
35,140,113,18582,2,403,0,0,60.19,26545864,50.885,18.8,3.165,3364.926,244.661,7.2,0.556,4
35,141,17,18599,3,406,0,0,60.19,26545864,50.885,18.8,3.165,3364.926,244.661,7.2,0.556,4
35,142,25,18624,0,406,0,0,60.19,26545864,50.885,18.8,3.165,3364.926,244.661,7.2,0.556,4
35,143,138,18762,2,408,0,0,60.19,26545864,50.885,18.8,3.165,3364.926,244.661,7.2,0.556,4
35,144,0,18762,0,408,0,0,60.19,26545864,50.885,18.8,3.165,3364.926,244.661,7.2,0.556,4
35,145,0,18762,0,408,0,0,60.19,26545864,50.885,18.8,3.165,3364.926,244.661,7.2,0.556,4
35,146,0,18762,0,408,0,0,60.19,26545864,50.885,18.8,3.165,3364.926,244.661,7.2,0.556,4
35,147,0,18762,0,408,0,0,60.19,26545864,50.885,18.8,3.165,3364.926,244.661,7.2,0.556,4
35,148,211,18973,2,410,0,0,60.19,26545864,50.885,18.8,3.165,3364.926,244.661,7.2,0.556,4
35,149,0,18973,0,410,0,0,57.41,26545864,50.885,18.8,3.165,3364.926,244.661,7.2,0.556,4
35,150,169,19142,1,411,0,0,57.41,26545864,50.885,18.8,3.165,3364.926,244.661,7.2,0.556,4
35,151,0,19142,0,411,0,0,57.41,26545864,50.885,18.8,3.165,3364.926,244.661,7.2,0.556,4
35,152,0,19142,0,411,0,0,57.41,26545864,50.885,18.8,3.165,3364.926,244.661,7.2,0.556,4
35,153,0,19142,0,411,0,0,57.41,26545864,50.885,18.8,3.165,3364.926,244.661,7.2,0.556,4
35,154,0,19142,0,411,0,0,57.41,26545864,50.885,18.8,3.165,3364.926,244.661,7.2,0.556,4
35,155,267,19409,3,414,0,0,57.41,26545864,50.885,18.8,3.165,3364.926,244.661,7.2,0.556,4
35,156,51,19460,0,414,0,0,57.41,26545864,50.885,18.8,3.165,3364.926,244.661,7.2,0.556,4
35,157,144,19604,0,414,0,0,57.41,26545864,50.885,18.8,3.165,3364.926,244.661,7.2,0.556,4
35,158,0,19604,0,414,0,0,57.41,26545864,50.885,18.8,3.165,3364.926,244.661,7.2,0.556,4
35,159,0,19604,0,414,0,0,57.41,26545864,50.885,18.8,3.165,3364.926,244.661,7.2,0.556,4
35,160,0,19604,0,414,0,0,57.41,26545864,50.885,18.8,3.165,3364.926,244.661,7.2,0.556,4
35,161,0,19604,0,414,0,0,57.41,26545864,50.885,18.8,3.165,3364.926,244.661,7.2,0.556,4
35,162,0,19604,0,414,0,0,57.41,26545864,50.885,18.8,3.165,3364.926,244.661,7.2,0.556,4
35,163,244,19848,1,415,0,0,57.41,26545864,50.885,18.8,3.165,3364.926,244.661,7.2,0.556,4
35,164,161,20009,0,415,0,0,55.56,26545864,50.885,18.8,3.165,3364.926,244.661,7.2,0.556,4
35,165,0,20009,0,415,0,0,55.56,26545864,50.885,18.8,3.165,3364.926,244.661,7.2,0.556,4
35,166,0,20009,0,415,0,0,55.56,26545864,50.885,18.8,3.165,3364.926,244.661,7.2,0.556,4
35,167,158,20167,0,415,0,0,55.56,26545864,50.885,18.8,3.165,3364.926,244.661,7.2,0.556,4
35,168,61,20228,0,415,0,0,55.56,26545864,50.885,18.8,3.165,3364.926,244.661,7.2,0.556,4
35,169,43,20271,0,415,0,0,55.56,26545864,50.885,18.8,3.165,3364.926,244.661,7.2,0.556,4
35,170,32,20303,0,415,0,0,55.56,26545864,50.885,18.8,3.165,3364.926,244.661,7.2,0.556,4
35,171,68,20371,1,416,0,0,55.56,26545864,50.885,18.8,3.165,3364.926,244.661,7.2,0.556,4
35,172,0,20371,0,416,0,0,55.56,26545864,50.885,18.8,3.165,3364.926,244.661,7.2,0.556,4
35,173,60,20431,0,416,0,0,55.56,26545864,50.885,18.8,3.165,3364.926,244.661,7.2,0.556,4
35,174,0,20431,0,416,0,0,55.56,26545864,50.885,18.8,3.165,3364.926,244.661,7.2,0.556,4
35,175,167,20598,0,416,0,0,52.78,26545864,50.885,18.8,3.165,3364.926,244.661,7.2,0.556,4
35,176,0,20598,0,416,0,0,52.78,26545864,50.885,18.8,3.165,3364.926,244.661,7.2,0.556,4
35,177,92,20690,0,416,0,0,52.78,26545864,50.885,18.8,3.165,3364.926,244.661,7.2,0.556,4
35,178,22,20712,2,418,0,0,52.78,26545864,50.885,18.8,3.165,3364.926,244.661,7.2,0.556,4
35,179,0,20712,0,418,0,0,52.78,26545864,50.885,18.8,3.165,3364.926,244.661,7.2,0.556,4
35,180,23,20735,0,418,0,0,52.78,26545864,50.885,18.8,3.165,3364.926,244.661,7.2,0.556,4
35,181,0,20735,0,418,0,0,52.78,26545864,50.885,18.8,3.165,3364.926,244.661,7.2,0.556,4
35,182,103,20838,0,418,0,0,52.78,26545864,50.885,18.8,3.165,3364.926,244.661,7.2,0.556,4
35,183,0,20838,0,418,0,0,52.78,26545864,50.885,18.8,3.165,3364.926,244.661,7.2,0.556,4
35,184,0,20838,0,418,0,0,52.78,26545864,50.885,18.8,3.165,3364.926,244.661,7.2,0.556,4
35,185,0,20838,0,418,0,0,47.22,26545864,50.885,18.8,3.165,3364.926,244.661,7.2,0.556,4
35,186,86,20924,2,420,0,0,47.22,26545864,50.885,18.8,3.165,3364.926,244.661,7.2,0.556,4
35,187,0,20924,0,420,0,0,47.22,26545864,50.885,18.8,3.165,3364.926,244.661,7.2,0.556,4
35,188,0,20924,0,420,0,0,47.22,26545864,50.885,18.8,3.165,3364.926,244.661,7.2,0.556,4
35,189,0,20924,0,420,0,0,47.22,26545864,50.885,18.8,3.165,3364.926,244.661,7.2,0.556,4
35,190,0,20924,0,420,0,0,47.22,26545864,50.885,18.8,3.165,3364.926,244.661,7.2,0.556,4
35,191,0,20924,0,420,0,0,47.22,26545864,50.885,18.8,3.165,3364.926,244.661,7.2,0.556,4
35,192,279,21203,3,423,0,0,41.67,26545864,50.885,18.8,3.165,3364.926,244.661,7.2,0.556,4
35,193,0,21203,0,423,0,0,41.67,26545864,50.885,18.8,3.165,3364.926,244.661,7.2,0.556,4
35,194,0,21203,0,423,0,0,41.67,26545864,50.885,18.8,3.165,3364.926,244.661,7.2,0.556,4
35,195,0,21203,0,423,0,0,41.67,26545864,50.885,18.8,3.165,3364.926,244.661,7.2,0.556,4
35,196,0,21203,0,423,0,0,41.67,26545864,50.885,18.8,3.165,3364.926,244.661,7.2,0.556,4
35,197,130,21333,0,423,0,0,41.67,26545864,50.885,18.8,3.165,3364.926,244.661,7.2,0.556,4
35,198,108,21441,0,423,0,0,36.11,26545864,50.885,18.8,3.165,3364.926,244.661,7.2,0.556,4
35,199,0,21441,0,423,0,0,36.11,26545864,50.885,18.8,3.165,3364.926,244.661,7.2,0.556,4
35,200,0,21441,0,423,0,0,36.11,26545864,50.885,18.8,3.165,3364.926,244.661,7.2,0.556,4
35,201,0,21441,0,423,0,0,36.11,26545864,50.885,18.8,3.165,3364.926,244.661,7.2,0.556,4
35,202,0,21441,0,423,0,0,36.11,26545864,50.885,18.8,3.165,3364.926,244.661,7.2,0.556,4
35,203,65,21506,1,424,0,0,36.11,26545864,50.885,18.8,3.165,3364.926,244.661,7.2,0.556,4
35,204,64,21570,1,425,0,0,36.11,26545864,50.885,18.8,3.165,3364.926,244.661,7.2,0.556,4
36,1,1112,8536,7,96,0,256933,74.54,37742157,4.037,41.4,16.984,44017.591,105.599,7.37,0.926,4
36,2,1059,9595,13,109,11221,268154,74.54,37742157,4.037,41.4,16.984,44017.591,105.599,7.37,0.926,4
36,3,1673,11268,29,138,26911,295065,74.54,37742157,4.037,41.4,16.984,44017.591,105.599,7.37,0.926,4
36,4,1251,12519,49,187,16906,311971,72.69,37742157,4.037,41.4,16.984,44017.591,105.599,7.37,0.926,4
36,5,1363,13882,44,231,22878,334849,72.69,37742157,4.037,41.4,16.984,44017.591,105.599,7.37,0.926,4
36,6,1614,15496,49,280,1957,336806,72.69,37742157,4.037,41.4,16.984,44017.591,105.599,7.37,0.926,4
36,7,1157,16653,43,323,9701,346507,72.69,37742157,4.037,41.4,16.984,44017.591,105.599,7.37,0.926,4
36,8,1230,17883,57,380,12762,359269,72.69,37742157,4.037,41.4,16.984,44017.591,105.599,7.37,0.926,4
36,9,1391,19274,55,435,14312,373581,72.69,37742157,4.037,41.4,16.984,44017.591,105.599,7.37,0.926,4
36,10,1474,20748,74,509,9741,383322,72.69,37742157,4.037,41.4,16.984,44017.591,105.599,7.37,0.926,4
36,11,1385,22133,60,569,18230,401552,72.69,37742157,4.037,41.4,16.984,44017.591,105.599,7.37,0.926,4
36,12,1168,23301,84,653,3099,404651,72.69,37742157,4.037,41.4,16.984,44017.591,105.599,7.37,0.926,4
36,13,1064,24365,64,717,24269,428920,72.69,37742157,4.037,41.4,16.984,44017.591,105.599,7.37,0.926,4
36,14,1298,25663,63,780,21797,450717,72.69,37742157,4.037,41.4,16.984,44017.591,105.599,7.37,0.926,4
36,15,1383,27046,123,903,11636,462353,72.69,37742157,4.037,41.4,16.984,44017.591,105.599,7.37,0.926,4
36,16,1318,28364,107,1010,24707,487060,72.69,37742157,4.037,41.4,16.984,44017.591,105.599,7.37,0.926,4
36,17,1717,30081,183,1193,15943,503003,72.69,37742157,4.037,41.4,16.984,44017.591,105.599,7.37,0.926,4
36,18,1791,31872,116,1309,13213,516216,72.69,37742157,4.037,41.4,16.984,44017.591,105.599,7.37,0.926,4
36,19,1469,33341,158,1467,19846,536062,72.69,37742157,4.037,41.4,16.984,44017.591,105.599,7.37,0.926,4
36,20,1436,34777,113,1580,19489,555551,72.69,37742157,4.037,41.4,16.984,44017.591,105.599,7.37,0.926,4
36,21,2046,36823,110,1690,10380,565931,72.69,37742157,4.037,41.4,16.984,44017.591,105.599,7.37,0.926,4
36,22,1590,38413,144,1834,10417,576348,72.69,37742157,4.037,41.4,16.984,44017.591,105.599,7.37,0.926,4
36,23,1766,40179,140,1974,43753,620101,72.69,37742157,4.037,41.4,16.984,44017.591,105.599,7.37,0.926,4
36,24,1920,42099,172,2146,23297,643398,72.69,37742157,4.037,41.4,16.984,44017.591,105.599,7.37,0.926,4
36,25,1778,43877,156,2302,26160,669558,72.69,37742157,4.037,41.4,16.984,44017.591,105.599,7.37,0.926,4
36,26,1464,45341,163,2465,22105,691663,72.69,37742157,4.037,41.4,16.984,44017.591,105.599,7.37,0.926,4
36,27,1543,46884,95,2560,25788,717451,72.69,37742157,4.037,41.4,16.984,44017.591,105.599,7.37,0.926,4
36,28,1605,48489,147,2707,23408,740859,72.69,37742157,4.037,41.4,16.984,44017.591,105.599,7.37,0.926,4
36,29,1526,50015,152,2859,17553,758412,72.69,37742157,4.037,41.4,16.984,44017.591,105.599,7.37,0.926,4
36,30,1572,51587,137,2996,29871,788283,72.69,37742157,4.037,41.4,16.984,44017.591,105.599,7.37,0.926,4
36,31,1649,53236,188,3184,43939,832222,72.69,37742157,4.037,41.4,16.984,44017.591,105.599,7.37,0.926,4
36,32,1825,55061,207,3391,0,832222,72.69,37742157,4.037,41.4,16.984,44017.591,105.599,7.37,0.926,4
36,33,1653,56714,175,3566,0,893490,72.69,37742157,4.037,41.4,16.984,44017.591,105.599,7.37,0.926,4
36,34,2760,59474,116,3682,25878,919368,72.69,37742157,4.037,41.4,16.984,44017.591,105.599,7.37,0.926,4
36,35,1298,60772,172,3854,21199,940567,72.69,37742157,4.037,41.4,16.984,44017.591,105.599,7.37,0.926,4
36,36,1274,62046,189,4043,1959,942526,72.69,37742157,4.037,41.4,16.984,44017.591,105.599,7.37,0.926,4
36,37,1450,63496,189,4232,59356,1001882,72.69,37742157,4.037,41.4,16.984,44017.591,105.599,7.37,0.926,4
36,38,1426,64922,176,4408,30130,1032012,72.69,37742157,4.037,41.4,16.984,44017.591,105.599,7.37,0.926,4
36,39,1512,66434,161,4569,35583,1067595,72.69,37742157,4.037,41.4,16.984,44017.591,105.599,7.37,0.926,4
36,40,1268,67702,124,4693,25633,1093228,72.69,37742157,4.037,41.4,16.984,44017.591,105.599,7.37,0.926,4
36,41,1146,68848,178,4871,25722,1118950,70.83,37742157,4.037,41.4,16.984,44017.591,105.599,7.37,0.926,4
36,42,1133,69981,122,4993,26733,1145683,70.83,37742157,4.037,41.4,16.984,44017.591,105.599,7.37,0.926,4
36,43,1176,71157,176,5169,23697,1169380,70.83,37742157,4.037,41.4,16.984,44017.591,105.599,7.37,0.926,4
36,44,1121,72278,135,5304,3416,1172796,70.83,37742157,4.037,41.4,16.984,44017.591,105.599,7.37,0.926,4
36,45,1123,73401,168,5472,60116,1232912,70.83,37742157,4.037,41.4,16.984,44017.591,105.599,7.37,0.926,4
36,46,1201,74602,90,5562,32590,1265502,70.83,37742157,4.037,41.4,16.984,44017.591,105.599,7.37,0.926,4
36,47,1251,75853,117,5679,31193,1296695,70.83,37742157,4.037,41.4,16.984,44017.591,105.599,7.37,0.926,4
36,48,1138,76991,103,5782,23292,1319987,70.83,37742157,4.037,41.4,16.984,44017.591,105.599,7.37,0.926,4
36,49,1070,78061,60,5842,16980,1336967,70.83,37742157,4.037,41.4,16.984,44017.591,105.599,7.37,0.926,4
36,50,1040,79101,70,5912,35962,1372929,70.83,37742157,4.037,41.4,16.984,44017.591,105.599,7.37,0.926,4
36,51,990,80091,118,6030,2121,1375050,70.83,37742157,4.037,41.4,16.984,44017.591,105.599,7.37,0.926,4
36,52,1222,81313,122,6152,26514,1401564,70.83,37742157,4.037,41.4,16.984,44017.591,105.599,7.37,0.926,4
36,53,1156,82469,98,6250,30347,1431911,70.83,37742157,4.037,41.4,16.984,44017.591,105.599,7.37,0.926,4
36,54,1141,83610,105,6355,22979,1454890,70.83,37742157,4.037,41.4,16.984,44017.591,105.599,7.37,0.926,4
36,55,1078,84688,69,6424,24872,1479762,70.83,37742157,4.037,41.4,16.984,44017.591,105.599,7.37,0.926,4
36,56,1012,85700,121,6545,20719,1500481,70.83,37742157,4.037,41.4,16.984,44017.591,105.599,7.37,0.926,4
36,57,936,86636,94,6639,27758,1528239,70.83,37742157,4.037,41.4,16.984,44017.591,105.599,7.37,0.926,4
36,58,872,87508,126,6765,30965,1559204,70.83,37742157,4.037,41.4,16.984,44017.591,105.599,7.37,0.926,4
36,59,993,88501,112,6877,34173,1593377,70.83,37742157,4.037,41.4,16.984,44017.591,105.599,7.37,0.926,4
36,60,906,89407,102,6979,37797,1631174,70.83,37742157,4.037,41.4,16.984,44017.591,105.599,7.37,0.926,4
36,61,772,90179,94,7073,31868,1663042,70.83,37742157,4.037,41.4,16.984,44017.591,105.599,7.37,0.926,4
36,62,757,90936,222,7295,28255,1691297,70.83,37742157,4.037,41.4,16.984,44017.591,105.599,7.37,0.926,4
36,63,758,91694,31,7326,30138,1721435,70.83,37742157,4.037,41.4,16.984,44017.591,105.599,7.37,0.926,4
36,64,705,92399,69,7395,30112,1751547,70.83,37742157,4.037,41.4,16.984,44017.591,105.599,7.37,0.926,4
36,65,675,93074,103,7498,35823,1787370,70.83,37742157,4.037,41.4,16.984,44017.591,105.599,7.37,0.926,4
36,66,641,93715,139,7637,37411,1824781,70.83,37742157,4.037,41.4,16.984,44017.591,105.599,7.37,0.926,4
36,67,609,94324,66,7703,5641,1830422,70.83,37742157,4.037,41.4,16.984,44017.591,105.599,7.37,0.926,4
36,68,722,95046,70,7773,37779,1868201,70.83,37742157,4.037,41.4,16.984,44017.591,105.599,7.37,0.926,4
36,69,642,95688,27,7800,28545,1896746,70.83,37742157,4.037,41.4,16.984,44017.591,105.599,7.37,0.926,4
36,70,545,96233,35,7835,33319,1930065,70.83,37742157,4.037,41.4,16.984,44017.591,105.599,7.37,0.926,4
36,71,409,96642,62,7897,25578,1955643,70.83,37742157,4.037,41.4,16.984,44017.591,105.599,7.37,0.926,4
36,72,472,97114,63,7960,33536,1989179,70.83,37742157,4.037,41.4,16.984,44017.591,105.599,7.37,0.926,4
36,73,405,97519,34,7994,39241,2028420,70.83,37742157,4.037,41.4,16.984,44017.591,105.599,7.37,0.926,4
36,74,413,97932,55,8049,43600,2072020,70.83,37742157,4.037,41.4,16.984,44017.591,105.599,7.37,0.926,4
36,75,467,98399,58,8107,41828,2113848,70.83,37742157,4.037,41.4,16.984,44017.591,105.599,7.37,0.926,4
36,76,377,98776,39,8146,38852,2152700,70.83,37742157,4.037,41.4,16.984,44017.591,105.599,7.37,0.926,4
36,77,360,99136,29,8175,30700,2183400,70.83,37742157,4.037,41.4,16.984,44017.591,105.599,7.37,0.926,4
36,78,320,99456,38,8213,33254,2216654,70.83,37742157,4.037,41.4,16.984,44017.591,105.599,7.37,0.926,4
36,79,386,99842,41,8254,37751,2254405,70.83,37742157,4.037,41.4,16.984,44017.591,105.599,7.37,0.926,4
36,80,367,100209,46,8300,40959,2295364,70.83,37742157,4.037,41.4,16.984,44017.591,105.599,7.37,0.926,4
36,81,409,100618,46,8346,44123,2339487,70.83,37742157,4.037,41.4,16.984,44017.591,105.599,7.37,0.926,4
36,82,390,101008,64,8410,43218,2382705,70.83,37742157,4.037,41.4,16.984,44017.591,105.599,7.37,0.926,4
36,83,318,101326,20,8430,32660,2415365,68.98,37742157,4.037,41.4,16.984,44017.591,105.599,7.37,0.926,4
36,84,311,101637,6,8436,28677,2444042,68.98,37742157,4.037,41.4,16.984,44017.591,105.599,7.37,0.926,4
36,85,326,101963,18,8454,38751,2482793,68.98,37742157,4.037,41.4,16.984,44017.591,105.599,7.37,0.926,4
36,86,279,102242,30,8484,35781,2518574,68.98,37742157,4.037,41.4,16.984,44017.591,105.599,7.37,0.926,4
36,87,369,102611,20,8504,39713,2558287,68.98,37742157,4.037,41.4,16.984,44017.591,105.599,7.37,0.926,4
36,88,172,102783,4,8508,39880,2598167,68.98,37742157,4.037,41.4,16.984,44017.591,105.599,7.37,0.926,4
36,89,238,103021,8,8516,42072,2640239,68.98,37742157,4.037,41.4,16.984,44017.591,105.599,7.37,0.926,4
36,90,218,103239,6,8522,36390,2676629,68.98,37742157,4.037,41.4,16.984,44017.591,105.599,7.37,0.926,4
36,91,668,103907,44,8566,44980,2721609,68.98,37742157,4.037,41.4,16.984,44017.591,105.599,7.37,0.926,4
36,92,286,104193,25,8591,48468,2770077,68.98,37742157,4.037,41.4,16.984,44017.591,105.599,7.37,0.926,4
36,93,0,104193,0,8591,0,2770077,68.98,37742157,4.037,41.4,16.984,44017.591,105.599,7.37,0.926,4
36,94,567,104760,51,8642,0,2848168,68.98,37742157,4.037,41.4,16.984,44017.591,105.599,7.37,0.926,4
36,95,319,105079,21,8663,37502,2885670,68.98,37742157,4.037,41.4,16.984,44017.591,105.599,7.37,0.926,4
36,96,226,105305,11,8674,29208,2914878,68.98,37742157,4.037,41.4,16.984,44017.591,105.599,7.37,0.926,4
36,97,219,105524,10,8684,25971,2940849,68.98,37742157,4.037,41.4,16.984,44017.591,105.599,7.37,0.926,4
36,98,399,105923,9,8693,34786,2975635,68.98,37742157,4.037,41.4,16.984,44017.591,105.599,7.37,0.926,4
36,99,232,106155,18,8711,44461,3020096,68.98,37742157,4.037,41.4,16.984,44017.591,105.599,7.37,0.926,4
36,100,267,106422,26,8737,35169,3055265,67.13,37742157,4.037,41.4,16.984,44017.591,105.599,7.37,0.926,4
36,101,371,106793,12,8749,42852,3098117,67.13,37742157,4.037,41.4,16.984,44017.591,105.599,7.37,0.926,4
36,102,321,107114,10,8759,44509,3142626,67.13,37742157,4.037,41.4,16.984,44017.591,105.599,7.37,0.926,4
36,103,221,107335,14,8773,40814,3183440,67.13,37742157,4.037,41.4,16.984,44017.591,105.599,7.37,0.926,4
36,104,244,107579,10,8783,29363,3212803,67.13,37742157,4.037,41.4,16.984,44017.591,105.599,7.37,0.926,4
36,105,565,108144,7,8790,44729,3257532,67.13,37742157,4.037,41.4,16.984,44017.591,105.599,7.37,0.926,4
36,106,331,108475,8,8798,44875,3302407,67.13,37742157,4.037,41.4,16.984,44017.591,105.599,7.37,0.926,4
36,107,341,108816,12,8810,39410,3341817,67.13,37742157,4.037,41.4,16.984,44017.591,105.599,7.37,0.926,4
36,108,437,109253,17,8827,45862,3387679,67.13,37742157,4.037,41.4,16.984,44017.591,105.599,7.37,0.926,4
36,109,405,109658,12,8839,50286,3437965,67.13,37742157,4.037,41.4,16.984,44017.591,105.599,7.37,0.926,4
36,110,0,109658,0,8839,43763,3481728,67.13,37742157,4.037,41.4,16.984,44017.591,105.599,7.37,0.926,4
36,111,680,110338,13,8852,38738,3520466,67.13,37742157,4.037,41.4,16.984,44017.591,105.599,7.37,0.926,4
36,112,775,111113,6,8858,53088,3573554,67.13,37742157,4.037,41.4,16.984,44017.591,105.599,7.37,0.926,4
36,113,571,111684,4,8862,43098,3616652,67.13,37742157,4.037,41.4,16.984,44017.591,105.599,7.37,0.926,4
36,114,543,112227,8,8870,43126,3659778,67.13,37742157,4.037,41.4,16.984,44017.591,105.599,7.37,0.926,4
36,115,432,112659,4,8874,37544,3697322,67.13,37742157,4.037,41.4,16.984,44017.591,105.599,7.37,0.926,4
36,116,534,113193,7,8881,20161,3717483,67.13,37742157,4.037,41.4,16.984,44017.591,105.599,7.37,0.926,4
36,117,350,113543,4,8885,44444,3761927,67.13,37742157,4.037,41.4,16.984,44017.591,105.599,7.37,0.926,4
36,118,355,113898,5,8890,102003,3863930,67.13,37742157,4.037,41.4,16.984,44017.591,105.599,7.37,0.926,4
36,119,699,114597,11,8901,35262,3899192,67.13,37742157,4.037,41.4,16.984,44017.591,105.599,7.37,0.926,4
36,120,383,114980,11,8912,47373,3946565,67.13,37742157,4.037,41.4,16.984,44017.591,105.599,7.37,0.926,4
36,121,476,115456,5,8917,50060,3996625,67.13,37742157,4.037,41.4,16.984,44017.591,105.599,7.37,0.926,4
36,122,329,115785,12,8929,53733,4050358,67.13,37742157,4.037,41.4,16.984,44017.591,105.599,7.37,0.926,4
36,123,513,116298,6,8935,48394,4098752,67.13,37742157,4.037,41.4,16.984,44017.591,105.599,7.37,0.926,4
36,124,287,116585,6,8941,44707,4143459,67.13,37742157,4.037,41.4,16.984,44017.591,105.599,7.37,0.926,4
36,125,285,116870,4,8945,34736,4178195,67.13,37742157,4.037,41.4,16.984,44017.591,105.599,7.37,0.926,4
36,126,147,117017,2,8947,58326,4236521,67.13,37742157,4.037,41.4,16.984,44017.591,105.599,7.37,0.926,4
36,127,760,117777,11,8958,0,4236521,67.13,37742157,4.037,41.4,16.984,44017.591,105.599,7.37,0.926,4
36,128,395,118172,4,8962,0,4272606,67.13,37742157,4.037,41.4,16.984,44017.591,105.599,7.37,0.926,4
36,129,374,118546,4,8966,46566,4319172,67.13,37742157,4.037,41.4,16.984,44017.591,105.599,7.37,0.926,4
36,130,424,118970,4,8970,48036,4367208,67.13,37742157,4.037,41.4,16.984,44017.591,105.599,7.37,0.926,4
36,131,236,119206,6,8976,36830,4404038,67.13,37742157,4.037,41.4,16.984,44017.591,105.599,7.37,0.926,4
36,132,245,119451,5,8981,43772,4447810,67.13,37742157,4.037,41.4,16.984,44017.591,105.599,7.37,0.926,4
36,133,666,120117,6,8987,57408,4505218,67.13,37742157,4.037,41.4,16.984,44017.591,105.599,7.37,0.926,4
36,134,289,120406,4,8991,36529,4541747,64.35,37742157,4.037,41.4,16.984,44017.591,105.599,7.37,0.926,4
36,135,423,120829,15,9006,39336,4581083,64.35,37742157,4.037,41.4,16.984,44017.591,105.599,7.37,0.926,4
36,136,405,121234,9,9015,54022,4635105,64.35,37742157,4.037,41.4,16.984,44017.591,105.599,7.37,0.926,4
36,137,418,121652,5,9020,50558,4685663,64.35,37742157,4.037,41.4,16.984,44017.591,105.599,7.37,0.926,4
36,138,237,121889,4,9024,55483,4741146,64.35,37742157,4.037,41.4,16.984,44017.591,105.599,7.37,0.926,4
36,139,198,122087,2,9026,37214,4778360,64.35,37742157,4.037,41.4,16.984,44017.591,105.599,7.37,0.926,4
36,140,785,122872,6,9032,61683,4840043,64.35,37742157,4.037,41.4,16.984,44017.591,105.599,7.37,0.926,4
36,141,282,123154,13,9045,40129,4880172,64.35,37742157,4.037,41.4,16.984,44017.591,105.599,7.37,0.926,4
36,142,336,123490,4,9049,45274,4925446,64.35,37742157,4.037,41.4,16.984,44017.591,105.599,7.37,0.926,4
36,143,383,123873,5,9054,48769,4974215,64.35,37742157,4.037,41.4,16.984,44017.591,105.599,7.37,0.926,4
36,144,499,124372,10,9064,59844,5034059,64.35,37742157,4.037,41.4,16.984,44017.591,105.599,7.37,0.926,4
36,145,257,124629,7,9071,42675,5076734,64.35,37742157,4.037,41.4,16.984,44017.591,105.599,7.37,0.926,4
36,146,267,124896,2,9073,38756,5115490,64.35,37742157,4.037,41.4,16.984,44017.591,105.599,7.37,0.926,4
36,147,751,125647,10,9083,53676,5169166,61.57,37742157,4.037,41.4,16.984,44017.591,105.599,7.37,0.926,4
36,148,322,125969,7,9090,35844,5205010,61.57,37742157,4.037,41.4,16.984,44017.591,105.599,7.37,0.926,4
36,149,448,126417,4,9094,41255,5246265,61.57,37742157,4.037,41.4,16.984,44017.591,105.599,7.37,0.926,4
36,150,431,126848,8,9102,47671,5293936,64.35,37742157,4.037,41.4,16.984,44017.591,105.599,7.37,0.926,4
36,151,510,127358,6,9108,61328,5355264,64.35,37742157,4.037,41.4,16.984,44017.591,105.599,7.37,0.926,4
36,152,315,127673,5,9113,85107,5440371,64.35,37742157,4.037,41.4,16.984,44017.591,105.599,7.37,0.926,4
36,153,267,127940,4,9117,0,5440371,64.35,37742157,4.037,41.4,16.984,44017.591,105.599,7.37,0.926,4
36,154,1008,128948,9,9126,0,5504316,64.35,37742157,4.037,41.4,16.984,44017.591,105.599,7.37,0.926,4
36,155,477,129425,6,9132,41157,5545473,64.35,37742157,4.037,41.4,16.984,44017.591,105.599,7.37,0.926,4
36,156,498,129923,3,9135,44595,5590068,64.35,37742157,4.037,41.4,16.984,44017.591,105.599,7.37,0.926,4
36,157,570,130493,6,9141,48635,5638703,64.35,37742157,4.037,41.4,16.984,44017.591,105.599,7.37,0.926,4
36,158,631,131124,0,9141,58677,5697380,64.35,37742157,4.037,41.4,16.984,44017.591,105.599,7.37,0.926,4
36,159,371,131495,2,9143,83647,5781027,64.35,37742157,4.037,41.4,16.984,44017.591,105.599,7.37,0.926,4
36,160,400,131895,2,9145,0,5781027,64.35,37742157,4.037,41.4,16.984,44017.591,105.599,7.37,0.926,4
36,161,247,132142,1,9146,0,5841880,60.65,37742157,4.037,41.4,16.984,44017.591,105.599,7.37,0.926,4
36,162,1606,133748,7,9153,49241,5891121,60.65,37742157,4.037,41.4,16.984,44017.591,105.599,7.37,0.926,4
36,163,546,134294,2,9155,38727,5929848,60.65,37742157,4.037,41.4,16.984,44017.591,105.599,7.37,0.926,4
36,164,630,134924,8,9163,49718,5979566,60.65,37742157,4.037,41.4,16.984,44017.591,105.599,7.37,0.926,4
36,165,702,135626,0,9163,89686,6069252,60.65,37742157,4.037,41.4,16.984,44017.591,105.599,7.37,0.926,4
36,166,515,136141,7,9170,0,6069252,60.65,37742157,4.037,41.4,16.984,44017.591,105.599,7.37,0.926,4
36,167,518,136659,1,9171,0,6154468,60.65,37742157,4.037,41.4,16.984,44017.591,105.599,7.37,0.926,4
36,168,1351,138010,8,9179,80997,6235465,60.65,37742157,4.037,41.4,16.984,44017.591,105.599,7.37,0.926,4
36,169,793,138803,9,9188,56695,6292160,60.65,37742157,4.037,41.4,16.984,44017.591,105.599,7.37,0.926,4
36,170,944,139747,5,9193,62421,6354581,60.65,37742157,4.037,41.4,16.984,44017.591,105.599,7.37,0.926,4
36,171,1120,140867,7,9200,67482,6422063,60.65,37742157,4.037,41.4,16.984,44017.591,105.599,7.37,0.926,4
36,172,1044,141911,5,9205,132084,6554147,60.65,37742157,4.037,41.4,16.984,44017.591,105.599,7.37,0.926,4
36,173,863,142774,6,9211,0,6554147,60.65,37742157,4.037,41.4,16.984,44017.591,105.599,7.37,0.926,4
36,174,875,143649,6,9217,0,6618481,60.65,37742157,4.037,41.4,16.984,44017.591,105.599,7.37,0.926,4
36,175,1766,145415,11,9228,80063,6698544,60.65,37742157,4.037,41.4,16.984,44017.591,105.599,7.37,0.926,4
36,176,1248,146663,6,9234,68438,6766982,60.65,37742157,4.037,41.4,16.984,44017.591,105.599,7.37,0.926,4
36,177,1090,147753,9,9243,66679,6833661,60.65,37742157,4.037,41.4,16.984,44017.591,105.599,7.37,0.926,4
36,178,1341,149094,6,9249,67590,6901251,60.65,37742157,4.037,41.4,16.984,44017.591,105.599,7.37,0.926,4
36,179,1362,150456,6,9255,77991,6979242,60.65,37742157,4.037,41.4,16.984,44017.591,105.599,7.37,0.926,4
36,180,1215,151671,7,9262,70216,7049458,60.65,37742157,4.037,41.4,16.984,44017.591,105.599,7.37,0.926,4
36,181,1454,153125,6,9268,68251,7117709,60.65,37742157,4.037,41.4,16.984,44017.591,105.599,7.37,0.926,4
36,182,2176,155301,10,9278,102399,7220108,60.65,37742157,4.037,41.4,16.984,44017.591,105.599,7.37,0.926,4
36,183,1660,156961,13,9291,74916,7295024,60.65,37742157,4.037,41.4,16.984,44017.591,105.599,7.37,0.926,4
36,184,1797,158758,6,9297,60936,7355960,60.65,37742157,4.037,41.4,16.984,44017.591,105.599,7.37,0.926,4
36,185,1777,160535,22,9319,67092,7423052,60.65,37742157,4.037,41.4,16.984,44017.591,105.599,7.37,0.926,4
36,186,2124,162659,90,9409,67153,7490205,60.65,37742157,4.037,41.4,16.984,44017.591,105.599,7.37,0.926,4
36,187,1812,164471,53,9462,73410,7563615,60.65,37742157,4.037,41.4,16.984,44017.591,105.599,7.37,0.926,4
36,188,1685,166156,19,9481,62178,7625793,60.65,37742157,4.037,41.4,16.984,44017.591,105.599,7.37,0.926,4
36,189,2804,168960,23,9504,69466,7695259,60.65,37742157,4.037,41.4,16.984,44017.591,105.599,7.37,0.926,4
36,190,2363,171323,26,9530,64042,7759301,60.65,37742157,4.037,41.4,16.984,44017.591,105.599,7.37,0.926,4
36,191,1800,173123,11,9541,66301,7825602,60.65,37742157,4.037,41.4,16.984,44017.591,105.599,7.37,0.926,4
36,192,2436,175559,16,9557,149255,7974857,60.65,37742157,4.037,41.4,16.984,44017.591,105.599,7.37,0.926,4
36,193,2558,178117,28,9585,73117,8047974,60.65,37742157,4.037,41.4,16.984,44017.591,105.599,7.37,0.926,4
36,194,0,178117,0,9585,0,8047974,60.65,37742157,4.037,41.4,16.984,44017.591,105.599,7.37,0.926,4
36,195,0,178117,0,9585,0,8047974,60.65,37742157,4.037,41.4,16.984,44017.591,105.599,7.37,0.926,4
36,196,4722,182839,42,9627,0,8191592,60.65,37742157,4.037,41.4,16.984,44017.591,105.599,7.37,0.926,4
36,197,4042,186881,27,9654,78084,8269676,60.65,37742157,4.037,41.4,16.984,44017.591,105.599,7.37,0.926,4
36,198,2506,189387,10,9664,83393,8353069,60.65,37742157,4.037,41.4,16.984,44017.591,105.599,7.37,0.926,4
36,199,2345,191732,35,9699,50075,8403144,60.65,37742157,4.037,41.4,16.984,44017.591,105.599,7.37,0.926,4
36,200,2374,194106,23,9722,159915,8563059,60.65,37742157,4.037,41.4,16.984,44017.591,105.599,7.37,0.926,4
36,201,2215,196321,24,9746,81210,8644269,60.65,37742157,4.037,41.4,16.984,44017.591,105.599,7.37,0.926,4
36,202,1827,198148,14,9760,54435,8698704,60.65,37742157,4.037,41.4,16.984,44017.591,105.599,7.37,0.926,4
36,203,3289,201437,18,9778,49371,8748075,60.65,37742157,4.037,41.4,16.984,44017.591,105.599,7.37,0.926,4
36,204,2251,203688,16,9794,0,8748075,60.65,37742157,4.037,41.4,16.984,44017.591,105.599,7.37,0.926,4
37,1,1,6,0,1,0,0,79.63,555988,135.58,25.7,4.46,6222.554,182.219,2.42,0.654,0
37,2,0,6,0,1,0,0,79.63,555988,135.58,25.7,4.46,6222.554,182.219,2.42,0.654,0
37,3,0,6,0,1,0,0,79.63,555988,135.58,25.7,4.46,6222.554,182.219,2.42,0.654,0
37,4,0,6,0,1,0,0,79.63,555988,135.58,25.7,4.46,6222.554,182.219,2.42,0.654,0
37,5,1,7,0,1,0,0,79.63,555988,135.58,25.7,4.46,6222.554,182.219,2.42,0.654,0
37,6,0,7,0,1,0,0,79.63,555988,135.58,25.7,4.46,6222.554,182.219,2.42,0.654,0
37,7,0,7,0,1,0,0,79.63,555988,135.58,25.7,4.46,6222.554,182.219,2.42,0.654,0
37,8,0,7,0,1,0,0,79.63,555988,135.58,25.7,4.46,6222.554,182.219,2.42,0.654,0
37,9,0,7,0,1,0,0,79.63,555988,135.58,25.7,4.46,6222.554,182.219,2.42,0.654,0
37,10,0,7,0,1,0,0,79.63,555988,135.58,25.7,4.46,6222.554,182.219,2.42,0.654,0
37,11,0,7,0,1,0,0,79.63,555988,135.58,25.7,4.46,6222.554,182.219,2.42,0.654,0
37,12,1,8,0,1,0,0,79.63,555988,135.58,25.7,4.46,6222.554,182.219,2.42,0.654,0
37,13,2,10,0,1,0,0,79.63,555988,135.58,25.7,4.46,6222.554,182.219,2.42,0.654,0
37,14,0,10,0,1,0,0,79.63,555988,135.58,25.7,4.46,6222.554,182.219,2.42,0.654,0
37,15,1,11,0,1,0,0,79.63,555988,135.58,25.7,4.46,6222.554,182.219,2.42,0.654,0
37,16,44,55,0,1,0,0,79.63,555988,135.58,25.7,4.46,6222.554,182.219,2.42,0.654,0
37,17,0,55,0,1,0,0,79.63,555988,135.58,25.7,4.46,6222.554,182.219,2.42,0.654,0
37,18,1,56,0,1,0,0,79.63,555988,135.58,25.7,4.46,6222.554,182.219,2.42,0.654,0
37,19,2,58,0,1,0,0,79.63,555988,135.58,25.7,4.46,6222.554,182.219,2.42,0.654,0
37,20,3,61,0,1,0,0,79.63,555988,135.58,25.7,4.46,6222.554,182.219,2.42,0.654,0
37,21,6,67,0,1,0,0,79.63,555988,135.58,25.7,4.46,6222.554,182.219,2.42,0.654,0
37,22,0,67,0,1,0,0,79.63,555988,135.58,25.7,4.46,6222.554,182.219,2.42,0.654,0
37,23,6,73,0,1,0,0,79.63,555988,135.58,25.7,4.46,6222.554,182.219,2.42,0.654,0
37,24,9,82,0,1,0,0,79.63,555988,135.58,25.7,4.46,6222.554,182.219,2.42,0.654,0
37,25,6,88,0,1,0,0,79.63,555988,135.58,25.7,4.46,6222.554,182.219,2.42,0.654,0
37,26,2,90,0,1,0,0,79.63,555988,135.58,25.7,4.46,6222.554,182.219,2.42,0.654,0
37,27,16,106,0,1,0,0,79.63,555988,135.58,25.7,4.46,6222.554,182.219,2.42,0.654,0
37,28,3,109,0,1,0,0,79.63,555988,135.58,25.7,4.46,6222.554,182.219,2.42,0.654,0
37,29,4,113,0,1,0,0,79.63,555988,135.58,25.7,4.46,6222.554,182.219,2.42,0.654,0
37,30,0,113,0,1,0,0,79.63,555988,135.58,25.7,4.46,6222.554,182.219,2.42,0.654,0
37,31,8,121,0,1,0,0,79.63,555988,135.58,25.7,4.46,6222.554,182.219,2.42,0.654,0
37,32,2,123,1,2,0,0,87.96,555988,135.58,25.7,4.46,6222.554,182.219,2.42,0.654,0
37,33,29,152,0,2,0,0,87.96,555988,135.58,25.7,4.46,6222.554,182.219,2.42,0.654,0
37,34,13,165,0,2,0,0,87.96,555988,135.58,25.7,4.46,6222.554,182.219,2.42,0.654,0
37,35,10,175,0,2,0,0,79.63,555988,135.58,25.7,4.46,6222.554,182.219,2.42,0.654,0
37,36,11,186,0,2,0,0,79.63,555988,135.58,25.7,4.46,6222.554,182.219,2.42,0.654,0
37,37,5,191,0,2,0,0,79.63,555988,135.58,25.7,4.46,6222.554,182.219,2.42,0.654,0
37,38,27,218,0,2,0,0,79.63,555988,135.58,25.7,4.46,6222.554,182.219,2.42,0.654,0
37,39,12,230,0,2,0,0,79.63,555988,135.58,25.7,4.46,6222.554,182.219,2.42,0.654,0
37,40,6,236,0,2,0,0,79.63,555988,135.58,25.7,4.46,6222.554,182.219,2.42,0.654,0
37,41,10,246,0,2,0,0,79.63,555988,135.58,25.7,4.46,6222.554,182.219,2.42,0.654,0
37,42,14,260,0,2,0,0,79.63,555988,135.58,25.7,4.46,6222.554,182.219,2.42,0.654,0
37,43,10,270,0,2,0,0,79.63,555988,135.58,25.7,4.46,6222.554,182.219,2.42,0.654,0
37,44,19,289,0,2,0,0,79.63,555988,135.58,25.7,4.46,6222.554,182.219,2.42,0.654,0
37,45,26,315,0,2,0,0,79.63,555988,135.58,25.7,4.46,6222.554,182.219,2.42,0.654,0
37,46,11,326,0,2,0,0,79.63,555988,135.58,25.7,4.46,6222.554,182.219,2.42,0.654,0
37,47,2,328,1,3,0,0,79.63,555988,135.58,25.7,4.46,6222.554,182.219,2.42,0.654,0
37,48,0,328,0,3,0,0,79.17,555988,135.58,25.7,4.46,6222.554,182.219,2.42,0.654,0
37,49,0,328,0,3,0,0,79.17,555988,135.58,25.7,4.46,6222.554,182.219,2.42,0.654,0
37,50,7,335,0,3,0,0,79.17,555988,135.58,25.7,4.46,6222.554,182.219,2.42,0.654,0
37,51,14,349,0,3,0,0,79.17,555988,135.58,25.7,4.46,6222.554,182.219,2.42,0.654,0
37,52,7,356,0,3,0,0,79.17,555988,135.58,25.7,4.46,6222.554,182.219,2.42,0.654,0
37,53,6,362,0,3,0,0,79.17,555988,135.58,25.7,4.46,6222.554,182.219,2.42,0.654,0
37,54,9,371,0,3,0,0,79.17,555988,135.58,25.7,4.46,6222.554,182.219,2.42,0.654,0
37,55,9,380,0,3,0,0,79.17,555988,135.58,25.7,4.46,6222.554,182.219,2.42,0.654,0
37,56,10,390,0,3,0,0,79.17,555988,135.58,25.7,4.46,6222.554,182.219,2.42,0.654,0
37,57,0,390,1,4,0,0,79.17,555988,135.58,25.7,4.46,6222.554,182.219,2.42,0.654,0
37,58,0,390,0,4,0,0,79.17,555988,135.58,25.7,4.46,6222.554,182.219,2.42,0.654,0
37,59,0,390,0,4,0,0,79.17,555988,135.58,25.7,4.46,6222.554,182.219,2.42,0.654,0
37,60,15,405,0,4,0,0,79.17,555988,135.58,25.7,4.46,6222.554,182.219,2.42,0.654,0
37,61,16,421,0,4,0,0,79.17,555988,135.58,25.7,4.46,6222.554,182.219,2.42,0.654,0
37,62,14,435,0,4,0,0,79.17,555988,135.58,25.7,4.46,6222.554,182.219,2.42,0.654,0
37,63,23,458,0,4,0,0,79.17,555988,135.58,25.7,4.46,6222.554,182.219,2.42,0.654,0
37,64,8,466,1,5,0,0,79.17,555988,135.58,25.7,4.46,6222.554,182.219,2.42,0.654,0
37,65,11,477,0,5,0,0,79.17,555988,135.58,25.7,4.46,6222.554,182.219,2.42,0.654,0
37,66,25,502,0,5,0,0,79.17,555988,135.58,25.7,4.46,6222.554,182.219,2.42,0.654,0
37,67,34,536,0,5,0,0,79.17,555988,135.58,25.7,4.46,6222.554,182.219,2.42,0.654,0
37,68,6,542,0,5,0,0,79.17,555988,135.58,25.7,4.46,6222.554,182.219,2.42,0.654,0
37,69,12,554,0,5,0,0,79.17,555988,135.58,25.7,4.46,6222.554,182.219,2.42,0.654,0
37,70,13,567,0,5,0,0,79.17,555988,135.58,25.7,4.46,6222.554,182.219,2.42,0.654,0
37,71,18,585,0,5,0,0,79.17,555988,135.58,25.7,4.46,6222.554,182.219,2.42,0.654,0
37,72,30,615,0,5,0,0,79.17,555988,135.58,25.7,4.46,6222.554,182.219,2.42,0.654,0
37,73,42,657,1,6,0,0,79.17,555988,135.58,25.7,4.46,6222.554,182.219,2.42,0.654,0
37,74,40,697,0,6,0,0,79.17,555988,135.58,25.7,4.46,6222.554,182.219,2.42,0.654,0
37,75,29,726,0,6,0,0,79.17,555988,135.58,25.7,4.46,6222.554,182.219,2.42,0.654,0
37,76,24,750,0,6,0,0,79.17,555988,135.58,25.7,4.46,6222.554,182.219,2.42,0.654,0
37,77,10,760,1,7,0,0,79.17,555988,135.58,25.7,4.46,6222.554,182.219,2.42,0.654,0
37,78,21,781,0,7,0,0,79.17,555988,135.58,25.7,4.46,6222.554,182.219,2.42,0.654,0
37,79,11,792,0,7,0,0,79.17,555988,135.58,25.7,4.46,6222.554,182.219,2.42,0.654,0
37,80,31,823,0,7,0,0,79.17,555988,135.58,25.7,4.46,6222.554,182.219,2.42,0.654,0
37,81,25,848,1,8,0,0,79.17,555988,135.58,25.7,4.46,6222.554,182.219,2.42,0.654,0
37,82,15,863,0,8,0,0,79.17,555988,135.58,25.7,4.46,6222.554,182.219,2.42,0.654,0
37,83,27,890,0,8,0,0,79.17,555988,135.58,25.7,4.46,6222.554,182.219,2.42,0.654,0
37,84,54,944,0,8,0,0,79.17,555988,135.58,25.7,4.46,6222.554,182.219,2.42,0.654,0
37,85,38,982,0,8,0,0,79.17,555988,135.58,25.7,4.46,6222.554,182.219,2.42,0.654,0
37,86,17,999,0,8,0,0,79.17,555988,135.58,25.7,4.46,6222.554,182.219,2.42,0.654,0
37,87,4,1003,0,8,0,0,79.17,555988,135.58,25.7,4.46,6222.554,182.219,2.42,0.654,0
37,88,24,1027,2,10,0,0,79.17,555988,135.58,25.7,4.46,6222.554,182.219,2.42,0.654,0
37,89,64,1091,2,12,0,0,79.17,555988,135.58,25.7,4.46,6222.554,182.219,2.42,0.654,0
37,90,64,1155,0,12,0,0,79.17,555988,135.58,25.7,4.46,6222.554,182.219,2.42,0.654,0
37,91,10,1165,0,12,0,0,79.17,555988,135.58,25.7,4.46,6222.554,182.219,2.42,0.654,0
37,92,62,1227,3,15,0,0,79.17,555988,135.58,25.7,4.46,6222.554,182.219,2.42,0.654,0
37,93,40,1267,0,15,0,0,79.17,555988,135.58,25.7,4.46,6222.554,182.219,2.42,0.654,0
37,94,34,1301,0,15,0,0,79.17,555988,135.58,25.7,4.46,6222.554,182.219,2.42,0.654,0
37,95,81,1382,0,15,0,0,79.17,555988,135.58,25.7,4.46,6222.554,182.219,2.42,0.654,0
37,96,38,1420,1,16,0,0,79.17,555988,135.58,25.7,4.46,6222.554,182.219,2.42,0.654,0
37,97,31,1451,1,17,0,0,79.17,555988,135.58,25.7,4.46,6222.554,182.219,2.42,0.654,0
37,98,12,1463,0,17,0,0,79.17,555988,135.58,25.7,4.46,6222.554,182.219,2.42,0.654,0
37,99,36,1499,1,18,0,0,79.17,555988,135.58,25.7,4.46,6222.554,182.219,2.42,0.654,0
37,100,43,1542,0,18,0,0,79.17,555988,135.58,25.7,4.46,6222.554,182.219,2.42,0.654,0
37,101,11,1553,1,19,0,0,79.17,555988,135.58,25.7,4.46,6222.554,182.219,2.42,0.654,0
37,102,0,1553,0,19,0,0,79.17,555988,135.58,25.7,4.46,6222.554,182.219,2.42,0.654,0
37,103,38,1591,0,19,0,0,79.17,555988,135.58,25.7,4.46,6222.554,182.219,2.42,0.654,0
37,104,107,1698,0,19,0,0,79.17,555988,135.58,25.7,4.46,6222.554,182.219,2.42,0.654,0
37,105,24,1722,0,19,0,0,79.17,555988,135.58,25.7,4.46,6222.554,182.219,2.42,0.654,0
37,106,58,1780,0,19,0,0,68.06,555988,135.58,25.7,4.46,6222.554,182.219,2.42,0.654,0
37,107,57,1837,0,19,0,0,68.06,555988,135.58,25.7,4.46,6222.554,182.219,2.42,0.654,0
37,108,57,1894,0,19,0,0,68.06,555988,135.58,25.7,4.46,6222.554,182.219,2.42,0.654,0
37,109,45,1939,1,20,0,0,68.06,555988,135.58,25.7,4.46,6222.554,182.219,2.42,0.654,0
37,110,75,2014,1,21,0,0,68.06,555988,135.58,25.7,4.46,6222.554,182.219,2.42,0.654,0
37,111,29,2043,0,21,0,0,68.06,555988,135.58,25.7,4.46,6222.554,182.219,2.42,0.654,0
37,112,28,2071,0,21,0,0,68.06,555988,135.58,25.7,4.46,6222.554,182.219,2.42,0.654,0
37,113,36,2107,0,21,0,0,68.06,555988,135.58,25.7,4.46,6222.554,182.219,2.42,0.654,0
37,114,47,2154,0,21,0,0,68.06,555988,135.58,25.7,4.46,6222.554,182.219,2.42,0.654,0
37,115,36,2190,0,21,0,0,68.06,555988,135.58,25.7,4.46,6222.554,182.219,2.42,0.654,0
37,116,30,2220,1,22,0,0,68.06,555988,135.58,25.7,4.46,6222.554,182.219,2.42,0.654,0
37,117,38,2258,0,22,0,0,68.06,555988,135.58,25.7,4.46,6222.554,182.219,2.42,0.654,0
37,118,49,2307,0,22,0,0,65.28,555988,135.58,25.7,4.46,6222.554,182.219,2.42,0.654,0
37,119,21,2328,0,22,0,0,65.28,555988,135.58,25.7,4.46,6222.554,182.219,2.42,0.654,0
37,120,26,2354,0,22,0,0,65.28,555988,135.58,25.7,4.46,6222.554,182.219,2.42,0.654,0
37,121,19,2373,1,23,0,0,65.28,555988,135.58,25.7,4.46,6222.554,182.219,2.42,0.654,0
37,122,0,2373,0,23,0,0,65.28,555988,135.58,25.7,4.46,6222.554,182.219,2.42,0.654,0
37,123,78,2451,0,23,0,0,65.28,555988,135.58,25.7,4.46,6222.554,182.219,2.42,0.654,0
37,124,29,2480,1,24,0,0,65.28,555988,135.58,25.7,4.46,6222.554,182.219,2.42,0.654,0
37,125,67,2547,0,24,0,0,65.28,555988,135.58,25.7,4.46,6222.554,182.219,2.42,0.654,0
37,126,36,2583,1,25,0,0,65.28,555988,135.58,25.7,4.46,6222.554,182.219,2.42,0.654,0
37,127,48,2631,1,26,0,0,65.28,555988,135.58,25.7,4.46,6222.554,182.219,2.42,0.654,0
37,128,58,2689,1,27,0,0,65.28,555988,135.58,25.7,4.46,6222.554,182.219,2.42,0.654,0
37,129,45,2734,0,27,0,0,65.28,555988,135.58,25.7,4.46,6222.554,182.219,2.42,0.654,0
37,130,46,2780,2,29,0,0,65.28,555988,135.58,25.7,4.46,6222.554,182.219,2.42,0.654,0
37,131,55,2835,3,32,0,0,65.28,555988,135.58,25.7,4.46,6222.554,182.219,2.42,0.654,0
37,132,23,2858,0,32,0,0,65.28,555988,135.58,25.7,4.46,6222.554,182.219,2.42,0.654,0
37,133,25,2883,0,32,0,0,65.28,555988,135.58,25.7,4.46,6222.554,182.219,2.42,0.654,0
37,134,37,2920,1,33,0,0,65.28,555988,135.58,25.7,4.46,6222.554,182.219,2.42,0.654,0
37,135,80,3000,0,33,0,0,65.28,555988,135.58,25.7,4.46,6222.554,182.219,2.42,0.654,0
37,136,73,3073,0,33,0,0,65.28,555988,135.58,25.7,4.46,6222.554,182.219,2.42,0.654,0
37,137,63,3136,0,33,0,0,65.28,555988,135.58,25.7,4.46,6222.554,182.219,2.42,0.654,0
37,138,27,3163,1,34,0,0,65.28,555988,135.58,25.7,4.46,6222.554,182.219,2.42,0.654,0
37,139,16,3179,1,35,0,0,65.28,555988,135.58,25.7,4.46,6222.554,182.219,2.42,0.654,0
37,140,24,3203,1,36,0,0,65.28,555988,135.58,25.7,4.46,6222.554,182.219,2.42,0.654,0
37,141,50,3253,0,36,0,0,65.28,555988,135.58,25.7,4.46,6222.554,182.219,2.42,0.654,0
37,142,68,3321,0,36,0,0,65.28,555988,135.58,25.7,4.46,6222.554,182.219,2.42,0.654,0
37,143,47,3368,1,37,0,0,65.28,555988,135.58,25.7,4.46,6222.554,182.219,2.42,0.654,0
37,144,44,3412,0,37,0,0,65.28,555988,135.58,25.7,4.46,6222.554,182.219,2.42,0.654,0
37,145,43,3455,0,37,0,0,65.28,555988,135.58,25.7,4.46,6222.554,182.219,2.42,0.654,0
37,146,54,3509,0,37,0,0,65.28,555988,135.58,25.7,4.46,6222.554,182.219,2.42,0.654,0
37,147,23,3532,0,37,0,0,65.28,555988,135.58,25.7,4.46,6222.554,182.219,2.42,0.654,0
37,148,36,3568,0,37,0,0,65.28,555988,135.58,25.7,4.46,6222.554,182.219,2.42,0.654,0
37,149,62,3630,1,38,0,0,65.28,555988,135.58,25.7,4.46,6222.554,182.219,2.42,0.654,0
37,150,69,3699,0,38,0,0,65.28,555988,135.58,25.7,4.46,6222.554,182.219,2.42,0.654,0
37,151,46,3745,0,38,0,0,65.28,555988,135.58,25.7,4.46,6222.554,182.219,2.42,0.654,0
37,152,33,3778,1,39,0,0,65.28,555988,135.58,25.7,4.46,6222.554,182.219,2.42,0.654,0
37,153,74,3852,1,40,0,0,65.28,555988,135.58,25.7,4.46,6222.554,182.219,2.42,0.654,0
37,154,32,3884,0,40,0,0,68.98,555988,135.58,25.7,4.46,6222.554,182.219,2.42,0.654,0
37,155,86,3970,0,40,0,0,68.98,555988,135.58,25.7,4.46,6222.554,182.219,2.42,0.654,0
37,156,78,4048,1,41,0,0,68.98,555988,135.58,25.7,4.46,6222.554,182.219,2.42,0.654,0
37,157,77,4125,0,41,0,0,68.98,555988,135.58,25.7,4.46,6222.554,182.219,2.42,0.654,0
37,158,75,4200,0,41,0,0,68.98,555988,135.58,25.7,4.46,6222.554,182.219,2.42,0.654,0
37,159,75,4275,1,42,0,0,68.98,555988,135.58,25.7,4.46,6222.554,182.219,2.42,0.654,0
37,160,55,4330,0,42,0,0,68.98,555988,135.58,25.7,4.46,6222.554,182.219,2.42,0.654,0
37,161,28,4358,0,42,0,0,68.98,555988,135.58,25.7,4.46,6222.554,182.219,2.42,0.654,0
37,162,42,4400,0,42,0,0,68.98,555988,135.58,25.7,4.46,6222.554,182.219,2.42,0.654,0
37,163,73,4473,1,43,0,0,68.98,555988,135.58,25.7,4.46,6222.554,182.219,2.42,0.654,0
37,164,84,4557,0,43,0,0,68.98,555988,135.58,25.7,4.46,6222.554,182.219,2.42,0.654,0
37,165,94,4651,1,44,0,0,68.98,555988,135.58,25.7,4.46,6222.554,182.219,2.42,0.654,0
37,166,60,4711,0,44,0,0,68.98,555988,135.58,25.7,4.46,6222.554,182.219,2.42,0.654,0
37,167,102,4813,0,44,0,0,68.98,555988,135.58,25.7,4.46,6222.554,182.219,2.42,0.654,0
37,168,26,4839,1,45,0,0,68.98,555988,135.58,25.7,4.46,6222.554,182.219,2.42,0.654,0
37,169,65,4904,1,46,0,0,68.98,555988,135.58,25.7,4.46,6222.554,182.219,2.42,0.654,0
37,170,74,4978,1,47,0,0,68.98,555988,135.58,25.7,4.46,6222.554,182.219,2.42,0.654,0
37,171,85,5063,2,49,0,0,68.98,555988,135.58,25.7,4.46,6222.554,182.219,2.42,0.654,0
37,172,78,5141,1,50,0,0,68.98,555988,135.58,25.7,4.46,6222.554,182.219,2.42,0.654,0
37,173,45,5186,0,50,0,0,68.98,555988,135.58,25.7,4.46,6222.554,182.219,2.42,0.654,0
37,174,71,5257,1,51,0,0,68.98,555988,135.58,25.7,4.46,6222.554,182.219,2.42,0.654,0
37,175,0,5257,0,51,0,0,68.98,555988,135.58,25.7,4.46,6222.554,182.219,2.42,0.654,0
37,176,24,5281,1,52,0,0,68.98,555988,135.58,25.7,4.46,6222.554,182.219,2.42,0.654,0
37,177,131,5412,2,54,0,0,68.98,555988,135.58,25.7,4.46,6222.554,182.219,2.42,0.654,0
37,178,67,5479,1,55,0,0,68.98,555988,135.58,25.7,4.46,6222.554,182.219,2.42,0.654,0
37,179,149,5628,0,55,0,0,68.98,555988,135.58,25.7,4.46,6222.554,182.219,2.42,0.654,0
37,180,73,5701,1,56,0,0,68.98,555988,135.58,25.7,4.46,6222.554,182.219,2.42,0.654,0
37,181,70,5771,1,57,0,0,68.98,555988,135.58,25.7,4.46,6222.554,182.219,2.42,0.654,0
37,182,46,5817,2,59,0,0,68.98,555988,135.58,25.7,4.46,6222.554,182.219,2.42,0.654,0
37,183,83,5900,0,59,0,0,68.98,555988,135.58,25.7,4.46,6222.554,182.219,2.42,0.654,0
37,184,124,6024,1,60,0,0,68.98,555988,135.58,25.7,4.46,6222.554,182.219,2.42,0.654,0
37,185,102,6126,1,61,0,0,68.98,555988,135.58,25.7,4.46,6222.554,182.219,2.42,0.654,0
37,186,79,6205,1,62,0,0,68.98,555988,135.58,25.7,4.46,6222.554,182.219,2.42,0.654,0
37,187,91,6296,0,62,0,0,68.98,555988,135.58,25.7,4.46,6222.554,182.219,2.42,0.654,0
37,188,64,6360,3,65,0,0,68.98,555988,135.58,25.7,4.46,6222.554,182.219,2.42,0.654,0
37,189,73,6433,3,68,0,0,68.98,555988,135.58,25.7,4.46,6222.554,182.219,2.42,0.654,0
37,190,85,6518,1,69,0,0,68.98,555988,135.58,25.7,4.46,6222.554,182.219,2.42,0.654,0
37,191,106,6624,2,71,0,0,68.98,555988,135.58,25.7,4.46,6222.554,182.219,2.42,0.654,0
37,192,93,6717,0,71,0,0,68.98,555988,135.58,25.7,4.46,6222.554,182.219,2.42,0.654,0
37,193,92,6809,2,73,0,0,68.98,555988,135.58,25.7,4.46,6222.554,182.219,2.42,0.654,0
37,194,104,6913,1,74,0,0,68.98,555988,135.58,25.7,4.46,6222.554,182.219,2.42,0.654,0
37,195,159,7072,1,75,0,0,68.98,555988,135.58,25.7,4.46,6222.554,182.219,2.42,0.654,0
37,196,83,7155,0,75,0,0,68.98,555988,135.58,25.7,4.46,6222.554,182.219,2.42,0.654,0
37,197,99,7254,2,77,0,0,68.98,555988,135.58,25.7,4.46,6222.554,182.219,2.42,0.654,0
37,198,117,7371,2,79,0,0,68.98,555988,135.58,25.7,4.46,6222.554,182.219,2.42,0.654,0
37,199,73,7444,0,79,0,0,68.98,555988,135.58,25.7,4.46,6222.554,182.219,2.42,0.654,0
37,200,82,7526,3,82,0,0,68.98,555988,135.58,25.7,4.46,6222.554,182.219,2.42,0.654,0
37,201,112,7638,3,85,0,0,68.98,555988,135.58,25.7,4.46,6222.554,182.219,2.42,0.654,0
37,202,114,7752,1,86,0,0,68.98,555988,135.58,25.7,4.46,6222.554,182.219,2.42,0.654,0
37,203,48,7800,1,87,0,0,68.98,555988,135.58,25.7,4.46,6222.554,182.219,2.42,0.654,0
37,204,101,7901,0,87,0,0,68.98,555988,135.58,25.7,4.46,6222.554,182.219,2.42,0.654,0
39,1,0,6,0,0,0,0,68.52,4829764,7.479,18.3,3.655,661.24,435.727,6.1,0.367,0
39,2,2,8,0,0,0,0,68.52,4829764,7.479,18.3,3.655,661.24,435.727,6.1,0.367,0
39,3,0,8,0,0,0,0,68.52,4829764,7.479,18.3,3.655,661.24,435.727,6.1,0.367,0
39,4,0,8,0,0,0,0,68.52,4829764,7.479,18.3,3.655,661.24,435.727,6.1,0.367,0
39,5,1,9,0,0,0,0,68.52,4829764,7.479,18.3,3.655,661.24,435.727,6.1,0.367,0
39,6,0,9,0,0,0,0,68.52,4829764,7.479,18.3,3.655,661.24,435.727,6.1,0.367,0
39,7,0,9,0,0,0,0,68.52,4829764,7.479,18.3,3.655,661.24,435.727,6.1,0.367,0
39,8,0,9,0,0,0,0,68.52,4829764,7.479,18.3,3.655,661.24,435.727,6.1,0.367,0
39,9,1,10,0,0,0,0,68.52,4829764,7.479,18.3,3.655,661.24,435.727,6.1,0.367,0
39,10,1,11,0,0,0,0,68.52,4829764,7.479,18.3,3.655,661.24,435.727,6.1,0.367,0
39,11,0,11,0,0,0,0,68.52,4829764,7.479,18.3,3.655,661.24,435.727,6.1,0.367,0
39,12,0,11,0,0,0,0,68.52,4829764,7.479,18.3,3.655,661.24,435.727,6.1,0.367,0
39,13,0,11,0,0,0,0,68.52,4829764,7.479,18.3,3.655,661.24,435.727,6.1,0.367,0
39,14,0,11,0,0,0,0,68.52,4829764,7.479,18.3,3.655,661.24,435.727,6.1,0.367,0
39,15,0,11,0,0,0,0,68.52,4829764,7.479,18.3,3.655,661.24,435.727,6.1,0.367,0
39,16,0,11,0,0,0,0,68.52,4829764,7.479,18.3,3.655,661.24,435.727,6.1,0.367,0
39,17,1,12,0,0,0,0,68.52,4829764,7.479,18.3,3.655,661.24,435.727,6.1,0.367,0
39,18,0,12,0,0,0,0,68.52,4829764,7.479,18.3,3.655,661.24,435.727,6.1,0.367,0
39,19,0,12,0,0,0,0,68.52,4829764,7.479,18.3,3.655,661.24,435.727,6.1,0.367,0
39,20,0,12,0,0,0,0,68.52,4829764,7.479,18.3,3.655,661.24,435.727,6.1,0.367,0
39,21,0,12,0,0,0,0,68.52,4829764,7.479,18.3,3.655,661.24,435.727,6.1,0.367,0
39,22,2,14,0,0,0,0,68.52,4829764,7.479,18.3,3.655,661.24,435.727,6.1,0.367,0
39,23,2,16,0,0,0,0,68.52,4829764,7.479,18.3,3.655,661.24,435.727,6.1,0.367,0
39,24,1,17,0,0,0,0,68.52,4829764,7.479,18.3,3.655,661.24,435.727,6.1,0.367,0
39,25,2,19,0,0,0,0,68.52,4829764,7.479,18.3,3.655,661.24,435.727,6.1,0.367,0
39,26,0,19,0,0,0,0,68.52,4829764,7.479,18.3,3.655,661.24,435.727,6.1,0.367,0
39,27,0,19,0,0,0,0,68.52,4829764,7.479,18.3,3.655,661.24,435.727,6.1,0.367,0
39,28,31,50,0,0,0,0,68.52,4829764,7.479,18.3,3.655,661.24,435.727,6.1,0.367,0
39,29,0,50,0,0,0,0,68.52,4829764,7.479,18.3,3.655,661.24,435.727,6.1,0.367,0
39,30,0,50,0,0,0,0,68.52,4829764,7.479,18.3,3.655,661.24,435.727,6.1,0.367,0
39,31,0,50,0,0,0,0,68.52,4829764,7.479,18.3,3.655,661.24,435.727,6.1,0.367,0
39,32,22,72,0,0,0,0,68.52,4829764,7.479,18.3,3.655,661.24,435.727,6.1,0.367,0
39,33,0,72,0,0,0,0,68.52,4829764,7.479,18.3,3.655,661.24,435.727,6.1,0.367,0
39,34,0,72,0,0,0,0,68.52,4829764,7.479,18.3,3.655,661.24,435.727,6.1,0.367,0
39,35,22,94,0,0,0,0,68.52,4829764,7.479,18.3,3.655,661.24,435.727,6.1,0.367,0
39,36,0,94,0,0,0,0,68.52,4829764,7.479,18.3,3.655,661.24,435.727,6.1,0.367,0
39,37,0,94,0,0,0,0,68.52,4829764,7.479,18.3,3.655,661.24,435.727,6.1,0.367,0
39,38,0,94,0,0,0,0,75.93,4829764,7.479,18.3,3.655,661.24,435.727,6.1,0.367,0
39,39,49,143,0,0,0,0,75.93,4829764,7.479,18.3,3.655,661.24,435.727,6.1,0.367,0
39,40,0,143,0,0,0,0,75.93,4829764,7.479,18.3,3.655,661.24,435.727,6.1,0.367,0
39,41,36,179,0,0,0,0,75.93,4829764,7.479,18.3,3.655,661.24,435.727,6.1,0.367,0
39,42,0,179,0,0,0,0,75.93,4829764,7.479,18.3,3.655,661.24,435.727,6.1,0.367,0
39,43,0,179,0,0,0,0,75.93,4829764,7.479,18.3,3.655,661.24,435.727,6.1,0.367,0
39,44,18,197,0,0,0,0,75.93,4829764,7.479,18.3,3.655,661.24,435.727,6.1,0.367,0
39,45,24,221,0,0,0,0,75.93,4829764,7.479,18.3,3.655,661.24,435.727,6.1,0.367,0
39,46,80,301,0,0,0,0,75.93,4829764,7.479,18.3,3.655,661.24,435.727,6.1,0.367,0
39,47,26,327,0,0,0,0,75.93,4829764,7.479,18.3,3.655,661.24,435.727,6.1,0.367,0
39,48,0,327,0,0,0,0,75.93,4829764,7.479,18.3,3.655,661.24,435.727,6.1,0.367,0
39,49,9,336,0,0,0,0,75.93,4829764,7.479,18.3,3.655,661.24,435.727,6.1,0.367,0
39,50,75,411,0,0,0,0,75.93,4829764,7.479,18.3,3.655,661.24,435.727,6.1,0.367,0
39,51,0,411,0,0,0,0,75.93,4829764,7.479,18.3,3.655,661.24,435.727,6.1,0.367,0
39,52,25,436,0,0,0,0,75.93,4829764,7.479,18.3,3.655,661.24,435.727,6.1,0.367,0
39,53,43,479,0,0,0,0,75.93,4829764,7.479,18.3,3.655,661.24,435.727,6.1,0.367,0
39,54,73,552,1,1,0,0,75.93,4829764,7.479,18.3,3.655,661.24,435.727,6.1,0.367,0
39,55,52,604,0,1,0,0,75.93,4829764,7.479,18.3,3.655,661.24,435.727,6.1,0.367,0
39,56,48,652,0,1,0,0,75.93,4829764,7.479,18.3,3.655,661.24,435.727,6.1,0.367,0
39,57,19,671,0,1,0,0,75.93,4829764,7.479,18.3,3.655,661.24,435.727,6.1,0.367,0
39,58,31,702,0,1,0,0,75.93,4829764,7.479,18.3,3.655,661.24,435.727,6.1,0.367,0
39,59,53,755,0,1,0,0,75.93,4829764,7.479,18.3,3.655,661.24,435.727,6.1,0.367,0
39,60,119,874,0,1,0,0,75.93,4829764,7.479,18.3,3.655,661.24,435.727,6.1,0.367,0
39,61,88,962,0,1,0,0,75.93,4829764,7.479,18.3,3.655,661.24,435.727,6.1,0.367,0
39,62,49,1011,1,2,0,0,75.93,4829764,7.479,18.3,3.655,661.24,435.727,6.1,0.367,0
39,63,58,1069,2,4,0,0,75.93,4829764,7.479,18.3,3.655,661.24,435.727,6.1,0.367,0
39,64,104,1173,0,4,0,0,75.93,4829764,7.479,18.3,3.655,661.24,435.727,6.1,0.367,0
39,65,16,1189,0,4,0,0,75.93,4829764,7.479,18.3,3.655,661.24,435.727,6.1,0.367,0
39,66,99,1288,0,4,0,0,75.93,4829764,7.479,18.3,3.655,661.24,435.727,6.1,0.367,0
39,67,163,1451,0,4,0,0,75.93,4829764,7.479,18.3,3.655,661.24,435.727,6.1,0.367,0
39,68,119,1570,1,5,0,0,75.93,4829764,7.479,18.3,3.655,661.24,435.727,6.1,0.367,0
39,69,64,1634,0,5,0,0,75.93,4829764,7.479,18.3,3.655,661.24,435.727,6.1,0.367,0
39,70,216,1850,0,5,0,0,75.93,4829764,7.479,18.3,3.655,661.24,435.727,6.1,0.367,0
39,71,38,1888,0,5,0,0,75.93,4829764,7.479,18.3,3.655,661.24,435.727,6.1,0.367,0
39,72,64,1952,1,6,0,0,64.81,4829764,7.479,18.3,3.655,661.24,435.727,6.1,0.367,0
39,73,92,2044,1,7,0,0,64.81,4829764,7.479,18.3,3.655,661.24,435.727,6.1,0.367,0
39,74,13,2057,0,7,0,0,64.81,4829764,7.479,18.3,3.655,661.24,435.727,6.1,0.367,0
39,75,0,2057,0,7,0,0,64.81,4829764,7.479,18.3,3.655,661.24,435.727,6.1,0.367,0
39,76,165,2222,0,7,0,0,64.81,4829764,7.479,18.3,3.655,661.24,435.727,6.1,0.367,0
39,77,67,2289,3,10,0,0,64.81,4829764,7.479,18.3,3.655,661.24,435.727,6.1,0.367,0
39,78,121,2410,4,14,0,0,64.81,4829764,7.479,18.3,3.655,661.24,435.727,6.1,0.367,0
39,79,154,2564,4,18,0,0,64.81,4829764,7.479,18.3,3.655,661.24,435.727,6.1,0.367,0
39,80,41,2605,1,19,0,0,64.81,4829764,7.479,18.3,3.655,661.24,435.727,6.1,0.367,0
39,81,0,2605,0,19,0,0,64.81,4829764,7.479,18.3,3.655,661.24,435.727,6.1,0.367,0
39,82,203,2808,4,23,0,0,64.81,4829764,7.479,18.3,3.655,661.24,435.727,6.1,0.367,0
39,83,0,2808,0,23,0,0,64.81,4829764,7.479,18.3,3.655,661.24,435.727,6.1,0.367,0
39,84,155,2963,7,30,0,0,64.81,4829764,7.479,18.3,3.655,661.24,435.727,6.1,0.367,0
39,85,88,3051,7,37,0,0,64.81,4829764,7.479,18.3,3.655,661.24,435.727,6.1,0.367,0
39,86,48,3099,1,38,0,0,64.81,4829764,7.479,18.3,3.655,661.24,435.727,6.1,0.367,0
39,87,145,3244,2,40,0,0,64.81,4829764,7.479,18.3,3.655,661.24,435.727,6.1,0.367,0
39,88,96,3340,0,40,0,0,64.81,4829764,7.479,18.3,3.655,661.24,435.727,6.1,0.367,0
39,89,89,3429,5,45,0,0,64.81,4829764,7.479,18.3,3.655,661.24,435.727,6.1,0.367,0
39,90,0,3429,0,45,0,0,64.81,4829764,7.479,18.3,3.655,661.24,435.727,6.1,0.367,0
39,91,184,3613,2,47,0,0,64.81,4829764,7.479,18.3,3.655,661.24,435.727,6.1,0.367,0
39,92,132,3745,0,47,0,0,64.81,4829764,7.479,18.3,3.655,661.24,435.727,6.1,0.367,0
39,93,0,3745,0,47,0,0,64.81,4829764,7.479,18.3,3.655,661.24,435.727,6.1,0.367,0
39,94,78,3823,1,48,0,0,64.81,4829764,7.479,18.3,3.655,661.24,435.727,6.1,0.367,0
39,95,95,3918,0,48,0,0,64.81,4829764,7.479,18.3,3.655,661.24,435.727,6.1,0.367,0
39,96,51,3969,0,48,0,0,64.81,4829764,7.479,18.3,3.655,661.24,435.727,6.1,0.367,0
39,97,0,3969,0,48,0,0,64.81,4829764,7.479,18.3,3.655,661.24,435.727,6.1,0.367,0
39,98,64,4033,4,52,0,0,64.81,4829764,7.479,18.3,3.655,661.24,435.727,6.1,0.367,0
39,99,38,4071,0,52,0,0,64.81,4829764,7.479,18.3,3.655,661.24,435.727,6.1,0.367,0
39,100,38,4109,0,52,0,0,64.81,4829764,7.479,18.3,3.655,661.24,435.727,6.1,0.367,0
39,101,91,4200,0,52,0,0,64.81,4829764,7.479,18.3,3.655,661.24,435.727,6.1,0.367,0
39,102,59,4259,1,53,0,0,64.81,4829764,7.479,18.3,3.655,661.24,435.727,6.1,0.367,0
39,103,29,4288,0,53,0,0,64.81,4829764,7.479,18.3,3.655,661.24,435.727,6.1,0.367,0
39,104,0,4288,0,53,0,0,64.81,4829764,7.479,18.3,3.655,661.24,435.727,6.1,0.367,0
39,105,33,4321,0,53,0,0,53.7,4829764,7.479,18.3,3.655,661.24,435.727,6.1,0.367,0
39,106,35,4356,0,53,0,0,53.7,4829764,7.479,18.3,3.655,661.24,435.727,6.1,0.367,0
39,107,6,4362,0,53,0,0,53.7,4829764,7.479,18.3,3.655,661.24,435.727,6.1,0.367,0
39,108,11,4373,0,53,0,0,53.7,4829764,7.479,18.3,3.655,661.24,435.727,6.1,0.367,0
39,109,16,4389,0,53,0,0,53.7,4829764,7.479,18.3,3.655,661.24,435.727,6.1,0.367,0
39,110,96,4485,2,55,0,0,53.7,4829764,7.479,18.3,3.655,661.24,435.727,6.1,0.367,0
39,111,0,4485,0,55,0,0,53.7,4829764,7.479,18.3,3.655,661.24,435.727,6.1,0.367,0
39,112,63,4548,0,55,0,0,53.7,4829764,7.479,18.3,3.655,661.24,435.727,6.1,0.367,0
39,113,13,4561,0,55,0,0,53.7,4829764,7.479,18.3,3.655,661.24,435.727,6.1,0.367,0
39,114,13,4574,2,57,0,0,53.7,4829764,7.479,18.3,3.655,661.24,435.727,6.1,0.367,0
39,115,16,4590,1,58,0,0,54.63,4829764,7.479,18.3,3.655,661.24,435.727,6.1,0.367,0
39,116,3,4593,1,59,0,0,54.63,4829764,7.479,18.3,3.655,661.24,435.727,6.1,0.367,0
39,117,5,4598,0,59,0,0,54.63,4829764,7.479,18.3,3.655,661.24,435.727,6.1,0.367,0
39,118,1,4599,0,59,0,0,54.63,4829764,7.479,18.3,3.655,661.24,435.727,6.1,0.367,0
39,119,0,4599,0,59,0,0,54.63,4829764,7.479,18.3,3.655,661.24,435.727,6.1,0.367,0
39,120,0,4599,0,59,0,0,54.63,4829764,7.479,18.3,3.655,661.24,435.727,6.1,0.367,0
39,121,6,4605,0,59,0,0,54.63,4829764,7.479,18.3,3.655,661.24,435.727,6.1,0.367,0
39,122,0,4605,0,59,0,0,54.63,4829764,7.479,18.3,3.655,661.24,435.727,6.1,0.367,0
39,123,3,4608,0,59,0,0,54.63,4829764,7.479,18.3,3.655,661.24,435.727,6.1,0.367,0
39,124,6,4614,0,59,0,0,54.63,4829764,7.479,18.3,3.655,661.24,435.727,6.1,0.367,0
39,125,0,4614,0,59,0,0,54.63,4829764,7.479,18.3,3.655,661.24,435.727,6.1,0.367,0
39,126,0,4614,0,59,0,0,54.63,4829764,7.479,18.3,3.655,661.24,435.727,6.1,0.367,0
39,127,4,4618,0,59,0,0,54.63,4829764,7.479,18.3,3.655,661.24,435.727,6.1,0.367,0
39,128,0,4618,0,59,0,0,54.63,4829764,7.479,18.3,3.655,661.24,435.727,6.1,0.367,0
39,129,2,4620,0,59,0,0,54.63,4829764,7.479,18.3,3.655,661.24,435.727,6.1,0.367,0
39,130,21,4641,0,59,0,0,54.63,4829764,7.479,18.3,3.655,661.24,435.727,6.1,0.367,0
39,131,0,4641,1,60,0,0,54.63,4829764,7.479,18.3,3.655,661.24,435.727,6.1,0.367,0
39,132,0,4641,0,60,0,0,54.63,4829764,7.479,18.3,3.655,661.24,435.727,6.1,0.367,0
39,133,0,4641,0,60,0,0,54.63,4829764,7.479,18.3,3.655,661.24,435.727,6.1,0.367,0
39,134,6,4647,1,61,0,0,54.63,4829764,7.479,18.3,3.655,661.24,435.727,6.1,0.367,0
39,135,5,4652,0,61,0,0,54.63,4829764,7.479,18.3,3.655,661.24,435.727,6.1,0.367,0
39,136,0,4652,0,61,0,0,54.63,4829764,7.479,18.3,3.655,661.24,435.727,6.1,0.367,0
39,137,0,4652,0,61,0,0,54.63,4829764,7.479,18.3,3.655,661.24,435.727,6.1,0.367,0
39,138,0,4652,0,61,0,0,54.63,4829764,7.479,18.3,3.655,661.24,435.727,6.1,0.367,0
39,139,0,4652,0,61,0,0,54.63,4829764,7.479,18.3,3.655,661.24,435.727,6.1,0.367,0
39,140,15,4667,0,61,0,0,54.63,4829764,7.479,18.3,3.655,661.24,435.727,6.1,0.367,0
39,141,12,4679,0,61,0,0,54.63,4829764,7.479,18.3,3.655,661.24,435.727,6.1,0.367,0
39,142,0,4679,0,61,0,0,54.63,4829764,7.479,18.3,3.655,661.24,435.727,6.1,0.367,0
39,143,0,4679,0,61,0,0,54.63,4829764,7.479,18.3,3.655,661.24,435.727,6.1,0.367,0
39,144,0,4679,0,61,0,0,54.63,4829764,7.479,18.3,3.655,661.24,435.727,6.1,0.367,0
39,145,0,4679,0,61,0,0,54.63,4829764,7.479,18.3,3.655,661.24,435.727,6.1,0.367,0
39,146,0,4679,0,61,0,0,54.63,4829764,7.479,18.3,3.655,661.24,435.727,6.1,0.367,0
39,147,0,4679,0,61,0,0,54.63,4829764,7.479,18.3,3.655,661.24,435.727,6.1,0.367,0
39,148,12,4691,0,61,0,0,54.63,4829764,7.479,18.3,3.655,661.24,435.727,6.1,0.367,0
39,149,7,4698,0,61,0,0,54.63,4829764,7.479,18.3,3.655,661.24,435.727,6.1,0.367,0
39,150,0,4698,0,61,0,0,54.63,4829764,7.479,18.3,3.655,661.24,435.727,6.1,0.367,0
39,151,2,4700,0,61,0,0,54.63,4829764,7.479,18.3,3.655,661.24,435.727,6.1,0.367,0
39,152,0,4700,0,61,0,0,54.63,4829764,7.479,18.3,3.655,661.24,435.727,6.1,0.367,0
39,153,0,4700,0,61,0,0,54.63,4829764,7.479,18.3,3.655,661.24,435.727,6.1,0.367,0
39,154,11,4711,1,62,0,0,54.63,4829764,7.479,18.3,3.655,661.24,435.727,6.1,0.367,0
39,155,0,4711,0,62,0,0,54.63,4829764,7.479,18.3,3.655,661.24,435.727,6.1,0.367,0
39,156,1,4712,0,62,0,0,54.63,4829764,7.479,18.3,3.655,661.24,435.727,6.1,0.367,0
39,157,17,4729,0,62,0,0,54.63,4829764,7.479,18.3,3.655,661.24,435.727,6.1,0.367,0
39,158,0,4729,0,62,0,0,54.63,4829764,7.479,18.3,3.655,661.24,435.727,6.1,0.367,0
39,159,0,4729,0,62,0,0,54.63,4829764,7.479,18.3,3.655,661.24,435.727,6.1,0.367,0
39,160,0,4729,0,62,0,0,54.63,4829764,7.479,18.3,3.655,661.24,435.727,6.1,0.367,0
39,161,0,4729,0,62,0,0,54.63,4829764,7.479,18.3,3.655,661.24,435.727,6.1,0.367,0
39,162,7,4736,0,62,0,0,54.63,4829764,7.479,18.3,3.655,661.24,435.727,6.1,0.367,0
39,163,0,4736,0,62,0,0,54.63,4829764,7.479,18.3,3.655,661.24,435.727,6.1,0.367,0
39,164,11,4747,0,62,0,0,54.63,4829764,7.479,18.3,3.655,661.24,435.727,6.1,0.367,0
39,165,2,4749,0,62,0,0,54.63,4829764,7.479,18.3,3.655,661.24,435.727,6.1,0.367,0
39,166,0,4749,0,62,0,0,54.63,4829764,7.479,18.3,3.655,661.24,435.727,6.1,0.367,0
39,167,0,4749,0,62,0,0,54.63,4829764,7.479,18.3,3.655,661.24,435.727,6.1,0.367,0
39,168,23,4772,0,62,0,0,56.48,4829764,7.479,18.3,3.655,661.24,435.727,6.1,0.367,0
39,169,0,4772,0,62,0,0,56.48,4829764,7.479,18.3,3.655,661.24,435.727,6.1,0.367,0
39,170,10,4782,0,62,0,0,56.48,4829764,7.479,18.3,3.655,661.24,435.727,6.1,0.367,0
39,171,0,4782,0,62,0,0,56.48,4829764,7.479,18.3,3.655,661.24,435.727,6.1,0.367,0
39,172,4,4786,0,62,0,0,56.48,4829764,7.479,18.3,3.655,661.24,435.727,6.1,0.367,0
39,173,0,4786,0,62,0,0,56.48,4829764,7.479,18.3,3.655,661.24,435.727,6.1,0.367,0
39,174,7,4793,0,62,0,0,56.48,4829764,7.479,18.3,3.655,661.24,435.727,6.1,0.367,0
39,175,0,4793,0,62,0,0,56.48,4829764,7.479,18.3,3.655,661.24,435.727,6.1,0.367,0
39,176,9,4802,0,62,0,0,56.48,4829764,7.479,18.3,3.655,661.24,435.727,6.1,0.367,0
39,177,0,4802,0,62,0,0,56.48,4829764,7.479,18.3,3.655,661.24,435.727,6.1,0.367,0
39,178,2,4804,0,62,0,0,56.48,4829764,7.479,18.3,3.655,661.24,435.727,6.1,0.367,0
39,179,2,4806,0,62,0,0,56.48,4829764,7.479,18.3,3.655,661.24,435.727,6.1,0.367,0
39,180,0,4806,0,62,0,0,56.48,4829764,7.479,18.3,3.655,661.24,435.727,6.1,0.367,0
39,181,0,4806,0,62,0,0,56.48,4829764,7.479,18.3,3.655,661.24,435.727,6.1,0.367,0
39,182,0,4806,0,62,0,0,56.48,4829764,7.479,18.3,3.655,661.24,435.727,6.1,0.367,0
39,183,19,4825,0,62,0,0,56.48,4829764,7.479,18.3,3.655,661.24,435.727,6.1,0.367,0
39,184,4,4829,0,62,0,0,56.48,4829764,7.479,18.3,3.655,661.24,435.727,6.1,0.367,0
39,185,0,4829,0,62,0,0,56.48,4829764,7.479,18.3,3.655,661.24,435.727,6.1,0.367,0
39,186,0,4829,0,62,0,0,56.48,4829764,7.479,18.3,3.655,661.24,435.727,6.1,0.367,0
39,187,16,4845,0,62,0,0,56.48,4829764,7.479,18.3,3.655,661.24,435.727,6.1,0.367,0
39,188,0,4845,0,62,0,0,56.48,4829764,7.479,18.3,3.655,661.24,435.727,6.1,0.367,0
39,189,0,4845,0,62,0,0,56.48,4829764,7.479,18.3,3.655,661.24,435.727,6.1,0.367,0
39,190,7,4852,0,62,0,0,56.48,4829764,7.479,18.3,3.655,661.24,435.727,6.1,0.367,0
39,191,0,4852,0,62,0,0,56.48,4829764,7.479,18.3,3.655,661.24,435.727,6.1,0.367,0
39,192,0,4852,0,62,0,0,56.48,4829764,7.479,18.3,3.655,661.24,435.727,6.1,0.367,0
39,193,0,4852,0,62,0,0,56.48,4829764,7.479,18.3,3.655,661.24,435.727,6.1,0.367,0
39,194,2,4854,0,62,0,0,56.48,4829764,7.479,18.3,3.655,661.24,435.727,6.1,0.367,0
39,195,0,4854,0,62,0,0,56.48,4829764,7.479,18.3,3.655,661.24,435.727,6.1,0.367,0
39,196,0,4854,0,62,0,0,56.48,4829764,7.479,18.3,3.655,661.24,435.727,6.1,0.367,0
39,197,1,4855,0,62,0,0,56.48,4829764,7.479,18.3,3.655,661.24,435.727,6.1,0.367,0
39,198,0,4855,0,62,0,0,56.48,4829764,7.479,18.3,3.655,661.24,435.727,6.1,0.367,0
39,199,0,4855,0,62,0,0,56.48,4829764,7.479,18.3,3.655,661.24,435.727,6.1,0.367,0
39,200,0,4855,0,62,0,0,56.48,4829764,7.479,18.3,3.655,661.24,435.727,6.1,0.367,0
39,201,0,4855,0,62,0,0,56.48,4829764,7.479,18.3,3.655,661.24,435.727,6.1,0.367,0
39,202,0,4855,0,62,0,0,56.48,4829764,7.479,18.3,3.655,661.24,435.727,6.1,0.367,0
39,203,1,4856,0,62,0,0,56.48,4829764,7.479,18.3,3.655,661.24,435.727,6.1,0.367,0
39,204,2,4858,0,62,0,0,56.48,4829764,7.479,18.3,3.655,661.24,435.727,6.1,0.367,0
40,1,0,7,0,0,0,0,27.78,16425859,11.833,16.7,2.486,1768.153,280.995,6.1,0.404,0
40,2,0,7,0,0,0,0,33.33,16425859,11.833,16.7,2.486,1768.153,280.995,6.1,0.404,0
40,3,0,7,0,0,0,0,33.33,16425859,11.833,16.7,2.486,1768.153,280.995,6.1,0.404,0
40,4,0,7,0,0,0,0,33.33,16425859,11.833,16.7,2.486,1768.153,280.995,6.1,0.404,0
40,5,1,8,0,0,0,0,33.33,16425859,11.833,16.7,2.486,1768.153,280.995,6.1,0.404,0
40,6,1,9,0,0,0,0,33.33,16425859,11.833,16.7,2.486,1768.153,280.995,6.1,0.404,0
40,7,0,9,0,0,0,0,33.33,16425859,11.833,16.7,2.486,1768.153,280.995,6.1,0.404,0
40,8,0,9,0,0,0,0,33.33,16425859,11.833,16.7,2.486,1768.153,280.995,6.1,0.404,0
40,9,1,10,0,0,0,0,33.33,16425859,11.833,16.7,2.486,1768.153,280.995,6.1,0.404,0
40,10,1,11,0,0,0,0,33.33,16425859,11.833,16.7,2.486,1768.153,280.995,6.1,0.404,0
40,11,0,11,0,0,0,0,33.33,16425859,11.833,16.7,2.486,1768.153,280.995,6.1,0.404,0
40,12,0,11,0,0,0,0,33.33,16425859,11.833,16.7,2.486,1768.153,280.995,6.1,0.404,0
40,13,4,15,0,0,0,0,88.89,16425859,11.833,16.7,2.486,1768.153,280.995,6.1,0.404,0
40,14,8,23,0,0,0,0,88.89,16425859,11.833,16.7,2.486,1768.153,280.995,6.1,0.404,0
40,15,0,23,0,0,0,0,88.89,16425859,11.833,16.7,2.486,1768.153,280.995,6.1,0.404,0
40,16,4,27,0,0,0,0,88.89,16425859,11.833,16.7,2.486,1768.153,280.995,6.1,0.404,0
40,17,0,27,0,0,0,0,88.89,16425859,11.833,16.7,2.486,1768.153,280.995,6.1,0.404,0
40,18,6,33,0,0,0,0,88.89,16425859,11.833,16.7,2.486,1768.153,280.995,6.1,0.404,0
40,19,0,33,0,0,0,0,88.89,16425859,11.833,16.7,2.486,1768.153,280.995,6.1,0.404,0
40,20,0,33,0,0,0,0,88.89,16425859,11.833,16.7,2.486,1768.153,280.995,6.1,0.404,0
40,21,0,33,0,0,0,0,88.89,16425859,11.833,16.7,2.486,1768.153,280.995,6.1,0.404,0
40,22,1,34,0,0,0,0,88.89,16425859,11.833,16.7,2.486,1768.153,280.995,6.1,0.404,0
40,23,0,34,0,0,0,0,88.89,16425859,11.833,16.7,2.486,1768.153,280.995,6.1,0.404,0
40,24,6,40,0,0,0,0,88.89,16425859,11.833,16.7,2.486,1768.153,280.995,6.1,0.404,0
40,25,0,40,0,0,0,0,88.89,16425859,11.833,16.7,2.486,1768.153,280.995,6.1,0.404,0
40,26,0,40,0,0,0,0,88.89,16425859,11.833,16.7,2.486,1768.153,280.995,6.1,0.404,0
40,27,6,46,0,0,0,0,88.89,16425859,11.833,16.7,2.486,1768.153,280.995,6.1,0.404,0
40,28,0,46,0,0,0,0,88.89,16425859,11.833,16.7,2.486,1768.153,280.995,6.1,0.404,0
40,29,6,52,2,2,0,0,88.89,16425859,11.833,16.7,2.486,1768.153,280.995,6.1,0.404,0
40,30,0,52,0,2,0,0,88.89,16425859,11.833,16.7,2.486,1768.153,280.995,6.1,0.404,0
40,31,21,73,3,5,0,0,88.89,16425859,11.833,16.7,2.486,1768.153,280.995,6.1,0.404,0
40,32,0,73,0,5,0,0,88.89,16425859,11.833,16.7,2.486,1768.153,280.995,6.1,0.404,0
40,33,44,117,5,10,0,0,88.89,16425859,11.833,16.7,2.486,1768.153,280.995,6.1,0.404,0
40,34,0,117,0,10,0,0,88.89,16425859,11.833,16.7,2.486,1768.153,280.995,6.1,0.404,0
40,35,0,117,0,10,0,0,88.89,16425859,11.833,16.7,2.486,1768.153,280.995,6.1,0.404,0
40,36,53,170,7,17,0,0,88.89,16425859,11.833,16.7,2.486,1768.153,280.995,6.1,0.404,0
40,37,0,170,0,17,0,0,88.89,16425859,11.833,16.7,2.486,1768.153,280.995,6.1,0.404,0
40,38,83,253,10,27,0,0,88.89,16425859,11.833,16.7,2.486,1768.153,280.995,6.1,0.404,0
40,39,7,260,1,28,0,0,88.89,16425859,11.833,16.7,2.486,1768.153,280.995,6.1,0.404,0
40,40,62,322,3,31,0,0,88.89,16425859,11.833,16.7,2.486,1768.153,280.995,6.1,0.404,0
40,41,0,322,0,31,0,0,88.89,16425859,11.833,16.7,2.486,1768.153,280.995,6.1,0.404,0
40,42,0,322,0,31,0,0,87.04,16425859,11.833,16.7,2.486,1768.153,280.995,6.1,0.404,0
40,43,35,357,9,40,0,0,87.04,16425859,11.833,16.7,2.486,1768.153,280.995,6.1,0.404,0
40,44,15,372,2,42,0,0,87.04,16425859,11.833,16.7,2.486,1768.153,280.995,6.1,0.404,0
40,45,27,399,4,46,0,0,87.04,16425859,11.833,16.7,2.486,1768.153,280.995,6.1,0.404,0
40,46,29,428,2,48,0,0,87.04,16425859,11.833,16.7,2.486,1768.153,280.995,6.1,0.404,0
40,47,46,474,2,50,0,0,87.04,16425859,11.833,16.7,2.486,1768.153,280.995,6.1,0.404,0
40,48,29,503,3,53,0,0,74.07,16425859,11.833,16.7,2.486,1768.153,280.995,6.1,0.404,0
40,49,16,519,0,53,0,0,74.07,16425859,11.833,16.7,2.486,1768.153,280.995,6.1,0.404,0
40,50,26,545,3,56,0,0,74.07,16425859,11.833,16.7,2.486,1768.153,280.995,6.1,0.404,0
40,51,20,565,1,57,0,0,74.07,16425859,11.833,16.7,2.486,1768.153,280.995,6.1,0.404,0
40,52,23,588,1,58,0,0,74.07,16425859,11.833,16.7,2.486,1768.153,280.995,6.1,0.404,0
40,53,23,611,1,59,0,0,74.07,16425859,11.833,16.7,2.486,1768.153,280.995,6.1,0.404,0
40,54,37,648,1,60,0,0,74.07,16425859,11.833,16.7,2.486,1768.153,280.995,6.1,0.404,0
40,55,27,675,0,60,0,0,74.07,16425859,11.833,16.7,2.486,1768.153,280.995,6.1,0.404,0
40,56,12,687,1,61,0,0,74.07,16425859,11.833,16.7,2.486,1768.153,280.995,6.1,0.404,0
40,57,13,700,1,62,0,0,74.07,16425859,11.833,16.7,2.486,1768.153,280.995,6.1,0.404,0
40,58,15,715,2,64,0,0,74.07,16425859,11.833,16.7,2.486,1768.153,280.995,6.1,0.404,0
40,59,11,726,1,65,0,0,74.07,16425859,11.833,16.7,2.486,1768.153,280.995,6.1,0.404,0
40,60,33,759,0,65,0,0,74.07,16425859,11.833,16.7,2.486,1768.153,280.995,6.1,0.404,0
40,61,0,759,0,65,0,0,74.07,16425859,11.833,16.7,2.486,1768.153,280.995,6.1,0.404,0
40,62,19,778,0,65,0,0,74.07,16425859,11.833,16.7,2.486,1768.153,280.995,6.1,0.404,0
40,63,12,790,1,66,0,0,74.07,16425859,11.833,16.7,2.486,1768.153,280.995,6.1,0.404,0
40,64,13,803,0,66,0,0,74.07,16425859,11.833,16.7,2.486,1768.153,280.995,6.1,0.404,0
40,65,17,820,0,66,0,0,74.07,16425859,11.833,16.7,2.486,1768.153,280.995,6.1,0.404,0
40,66,8,828,0,66,0,0,74.07,16425859,11.833,16.7,2.486,1768.153,280.995,6.1,0.404,0
40,67,8,836,2,68,0,0,74.07,16425859,11.833,16.7,2.486,1768.153,280.995,6.1,0.404,0
40,68,0,836,1,69,0,0,74.07,16425859,11.833,16.7,2.486,1768.153,280.995,6.1,0.404,0
40,69,1,837,0,69,0,0,74.07,16425859,11.833,16.7,2.486,1768.153,280.995,6.1,0.404,0
40,70,2,839,1,70,0,0,74.07,16425859,11.833,16.7,2.486,1768.153,280.995,6.1,0.404,0
40,71,5,844,1,71,0,0,74.07,16425859,11.833,16.7,2.486,1768.153,280.995,6.1,0.404,0
40,72,2,846,1,72,0,0,74.07,16425859,11.833,16.7,2.486,1768.153,280.995,6.1,0.404,0
40,73,2,848,0,72,0,0,74.07,16425859,11.833,16.7,2.486,1768.153,280.995,6.1,0.404,0
40,74,0,848,0,72,0,0,74.07,16425859,11.833,16.7,2.486,1768.153,280.995,6.1,0.404,0
40,75,0,848,0,72,0,0,74.07,16425859,11.833,16.7,2.486,1768.153,280.995,6.1,0.404,0
40,76,2,850,1,73,0,0,74.07,16425859,11.833,16.7,2.486,1768.153,280.995,6.1,0.404,0
40,77,0,850,0,73,0,0,74.07,16425859,11.833,16.7,2.486,1768.153,280.995,6.1,0.404,0
40,78,3,853,1,74,0,0,74.07,16425859,11.833,16.7,2.486,1768.153,280.995,6.1,0.404,0
40,79,1,854,0,74,0,0,74.07,16425859,11.833,16.7,2.486,1768.153,280.995,6.1,0.404,0
40,80,0,854,0,74,0,0,74.07,16425859,11.833,16.7,2.486,1768.153,280.995,6.1,0.404,0
40,81,4,858,0,74,0,0,74.07,16425859,11.833,16.7,2.486,1768.153,280.995,6.1,0.404,0
40,82,0,858,0,74,0,0,74.07,16425859,11.833,16.7,2.486,1768.153,280.995,6.1,0.404,0
40,83,0,858,0,74,0,0,74.07,16425859,11.833,16.7,2.486,1768.153,280.995,6.1,0.404,0
40,84,0,858,0,74,0,0,74.07,16425859,11.833,16.7,2.486,1768.153,280.995,6.1,0.404,0
40,85,2,860,0,74,0,0,74.07,16425859,11.833,16.7,2.486,1768.153,280.995,6.1,0.404,0
40,86,0,860,0,74,0,0,67.59,16425859,11.833,16.7,2.486,1768.153,280.995,6.1,0.404,0
40,87,3,863,0,74,0,0,67.59,16425859,11.833,16.7,2.486,1768.153,280.995,6.1,0.404,0
40,88,2,865,0,74,0,0,67.59,16425859,11.833,16.7,2.486,1768.153,280.995,6.1,0.404,0
40,89,0,865,0,74,0,0,67.59,16425859,11.833,16.7,2.486,1768.153,280.995,6.1,0.404,0
40,90,1,866,0,74,0,0,67.59,16425859,11.833,16.7,2.486,1768.153,280.995,6.1,0.404,0
40,91,0,866,0,74,0,0,67.59,16425859,11.833,16.7,2.486,1768.153,280.995,6.1,0.404,0
40,92,0,866,0,74,0,0,67.59,16425859,11.833,16.7,2.486,1768.153,280.995,6.1,0.404,0
40,93,0,866,0,74,0,0,67.59,16425859,11.833,16.7,2.486,1768.153,280.995,6.1,0.404,0
40,94,2,868,0,74,0,0,67.59,16425859,11.833,16.7,2.486,1768.153,280.995,6.1,0.404,0
40,95,3,871,0,74,0,0,67.59,16425859,11.833,16.7,2.486,1768.153,280.995,6.1,0.404,0
40,96,0,871,0,74,0,0,67.59,16425859,11.833,16.7,2.486,1768.153,280.995,6.1,0.404,0
40,97,1,872,0,74,0,0,67.59,16425859,11.833,16.7,2.486,1768.153,280.995,6.1,0.404,0
40,98,0,872,0,74,0,0,67.59,16425859,11.833,16.7,2.486,1768.153,280.995,6.1,0.404,0
40,99,1,873,0,74,0,0,67.59,16425859,11.833,16.7,2.486,1768.153,280.995,6.1,0.404,0
40,100,0,873,0,74,0,0,67.59,16425859,11.833,16.7,2.486,1768.153,280.995,6.1,0.404,0
40,101,0,873,0,74,0,0,67.59,16425859,11.833,16.7,2.486,1768.153,280.995,6.1,0.404,0
40,102,1,874,0,74,0,0,67.59,16425859,11.833,16.7,2.486,1768.153,280.995,6.1,0.404,0
40,103,0,874,0,74,0,0,67.59,16425859,11.833,16.7,2.486,1768.153,280.995,6.1,0.404,0
40,104,6,880,1,75,0,0,67.59,16425859,11.833,16.7,2.486,1768.153,280.995,6.1,0.404,0
40,105,0,880,0,75,0,0,67.59,16425859,11.833,16.7,2.486,1768.153,280.995,6.1,0.404,0
40,106,4,884,0,75,0,0,67.59,16425859,11.833,16.7,2.486,1768.153,280.995,6.1,0.404,0
40,107,1,885,0,75,0,0,67.59,16425859,11.833,16.7,2.486,1768.153,280.995,6.1,0.404,0
40,108,1,886,0,75,0,0,67.59,16425859,11.833,16.7,2.486,1768.153,280.995,6.1,0.404,0
40,109,1,887,0,75,0,0,67.59,16425859,11.833,16.7,2.486,1768.153,280.995,6.1,0.404,0
40,110,2,889,0,75,0,0,67.59,16425859,11.833,16.7,2.486,1768.153,280.995,6.1,0.404,0
40,111,0,889,0,75,0,0,67.59,16425859,11.833,16.7,2.486,1768.153,280.995,6.1,0.404,0
40,112,0,889,0,75,0,0,67.59,16425859,11.833,16.7,2.486,1768.153,280.995,6.1,0.404,0
40,113,0,889,0,75,0,0,67.59,16425859,11.833,16.7,2.486,1768.153,280.995,6.1,0.404,0
40,114,0,889,0,75,0,0,67.59,16425859,11.833,16.7,2.486,1768.153,280.995,6.1,0.404,0
40,115,26,915,0,75,0,0,67.59,16425859,11.833,16.7,2.486,1768.153,280.995,6.1,0.404,0
40,116,0,915,0,75,0,0,67.59,16425859,11.833,16.7,2.486,1768.153,280.995,6.1,0.404,0
40,117,0,915,0,75,0,0,67.59,16425859,11.833,16.7,2.486,1768.153,280.995,6.1,0.404,0
40,118,0,915,0,75,0,0,67.59,16425859,11.833,16.7,2.486,1768.153,280.995,6.1,0.404,0
40,119,7,922,0,75,0,0,70.37,16425859,11.833,16.7,2.486,1768.153,280.995,6.1,0.404,0
40,120,4,926,0,75,0,0,70.37,16425859,11.833,16.7,2.486,1768.153,280.995,6.1,0.404,0
40,121,0,926,0,75,0,0,70.37,16425859,11.833,16.7,2.486,1768.153,280.995,6.1,0.404,0
40,122,9,935,0,75,0,0,70.37,16425859,11.833,16.7,2.486,1768.153,280.995,6.1,0.404,0
40,123,1,936,0,75,0,0,64.81,16425859,11.833,16.7,2.486,1768.153,280.995,6.1,0.404,0
40,124,0,936,0,75,0,0,64.81,16425859,11.833,16.7,2.486,1768.153,280.995,6.1,0.404,0
40,125,0,936,0,75,0,0,64.81,16425859,11.833,16.7,2.486,1768.153,280.995,6.1,0.404,0
40,126,0,936,0,75,0,0,64.81,16425859,11.833,16.7,2.486,1768.153,280.995,6.1,0.404,0
40,127,2,938,0,75,0,0,64.81,16425859,11.833,16.7,2.486,1768.153,280.995,6.1,0.404,0
40,128,1,939,0,75,0,0,64.81,16425859,11.833,16.7,2.486,1768.153,280.995,6.1,0.404,0
40,129,3,942,1,76,0,0,64.81,16425859,11.833,16.7,2.486,1768.153,280.995,6.1,0.404,0
40,130,0,942,0,76,0,0,64.81,16425859,11.833,16.7,2.486,1768.153,280.995,6.1,0.404,0
40,131,0,942,0,76,0,0,64.81,16425859,11.833,16.7,2.486,1768.153,280.995,6.1,0.404,0
40,132,2,944,0,76,0,0,64.81,16425859,11.833,16.7,2.486,1768.153,280.995,6.1,0.404,0
40,133,1,945,0,76,0,0,64.81,16425859,11.833,16.7,2.486,1768.153,280.995,6.1,0.404,0
40,134,1,946,0,76,0,0,64.81,16425859,11.833,16.7,2.486,1768.153,280.995,6.1,0.404,0
40,135,3,949,0,76,0,0,64.81,16425859,11.833,16.7,2.486,1768.153,280.995,6.1,0.404,0
40,136,0,949,0,76,0,0,64.81,16425859,11.833,16.7,2.486,1768.153,280.995,6.1,0.404,0
40,137,2,951,0,76,0,0,64.81,16425859,11.833,16.7,2.486,1768.153,280.995,6.1,0.404,0
40,138,1,952,0,76,0,0,64.81,16425859,11.833,16.7,2.486,1768.153,280.995,6.1,0.404,0
40,139,4,956,0,76,0,0,64.81,16425859,11.833,16.7,2.486,1768.153,280.995,6.1,0.404,0
40,140,3,959,0,76,0,0,64.81,16425859,11.833,16.7,2.486,1768.153,280.995,6.1,0.404,0
40,141,11,970,0,76,0,0,64.81,16425859,11.833,16.7,2.486,1768.153,280.995,6.1,0.404,0
40,142,1,971,0,76,0,0,64.81,16425859,11.833,16.7,2.486,1768.153,280.995,6.1,0.404,0
40,143,1,972,0,76,0,0,64.81,16425859,11.833,16.7,2.486,1768.153,280.995,6.1,0.404,0
40,144,9,981,0,76,0,0,64.81,16425859,11.833,16.7,2.486,1768.153,280.995,6.1,0.404,0
40,145,1,982,0,76,0,0,64.81,16425859,11.833,16.7,2.486,1768.153,280.995,6.1,0.404,0
40,146,4,986,0,76,0,0,64.81,16425859,11.833,16.7,2.486,1768.153,280.995,6.1,0.404,0
40,147,1,987,0,76,0,0,64.81,16425859,11.833,16.7,2.486,1768.153,280.995,6.1,0.404,0
40,148,8,995,1,77,0,0,64.81,16425859,11.833,16.7,2.486,1768.153,280.995,6.1,0.404,0
40,149,3,998,0,77,0,0,64.81,16425859,11.833,16.7,2.486,1768.153,280.995,6.1,0.404,0
40,150,6,1004,0,77,0,0,64.81,16425859,11.833,16.7,2.486,1768.153,280.995,6.1,0.404,0
40,151,4,1008,0,77,0,0,64.81,16425859,11.833,16.7,2.486,1768.153,280.995,6.1,0.404,0
40,152,0,1008,0,77,0,0,64.81,16425859,11.833,16.7,2.486,1768.153,280.995,6.1,0.404,0
40,153,4,1012,0,77,0,0,64.81,16425859,11.833,16.7,2.486,1768.153,280.995,6.1,0.404,0
40,154,1,1013,0,77,0,0,64.81,16425859,11.833,16.7,2.486,1768.153,280.995,6.1,0.404,0
40,155,4,1017,0,77,0,0,64.81,16425859,11.833,16.7,2.486,1768.153,280.995,6.1,0.404,0
40,156,0,1017,0,77,0,0,64.81,16425859,11.833,16.7,2.486,1768.153,280.995,6.1,0.404,0
40,157,1,1018,0,77,0,0,64.81,16425859,11.833,16.7,2.486,1768.153,280.995,6.1,0.404,0
40,158,5,1023,0,77,0,0,64.81,16425859,11.833,16.7,2.486,1768.153,280.995,6.1,0.404,0
40,159,11,1034,0,77,0,0,64.81,16425859,11.833,16.7,2.486,1768.153,280.995,6.1,0.404,0
40,160,5,1039,2,79,0,0,64.81,16425859,11.833,16.7,2.486,1768.153,280.995,6.1,0.404,0
40,161,1,1040,0,79,0,0,64.81,16425859,11.833,16.7,2.486,1768.153,280.995,6.1,0.404,0
40,162,5,1045,0,79,0,0,64.81,16425859,11.833,16.7,2.486,1768.153,280.995,6.1,0.404,0
40,163,3,1048,0,79,0,0,64.81,16425859,11.833,16.7,2.486,1768.153,280.995,6.1,0.404,0
40,164,3,1051,0,79,0,0,64.81,16425859,11.833,16.7,2.486,1768.153,280.995,6.1,0.404,0
40,165,30,1081,0,79,0,0,64.81,16425859,11.833,16.7,2.486,1768.153,280.995,6.1,0.404,0
40,166,2,1083,1,80,0,0,64.81,16425859,11.833,16.7,2.486,1768.153,280.995,6.1,0.404,0
40,167,1,1084,0,80,0,0,64.81,16425859,11.833,16.7,2.486,1768.153,280.995,6.1,0.404,0
40,168,1,1085,1,81,0,0,64.81,16425859,11.833,16.7,2.486,1768.153,280.995,6.1,0.404,0
40,169,2,1087,0,81,0,0,64.81,16425859,11.833,16.7,2.486,1768.153,280.995,6.1,0.404,0
40,170,3,1090,0,81,0,0,64.81,16425859,11.833,16.7,2.486,1768.153,280.995,6.1,0.404,0
40,171,25,1115,0,81,0,0,73.15,16425859,11.833,16.7,2.486,1768.153,280.995,6.1,0.404,0
40,172,32,1147,0,81,0,0,73.15,16425859,11.833,16.7,2.486,1768.153,280.995,6.1,0.404,0
40,173,2,1149,0,81,0,0,73.15,16425859,11.833,16.7,2.486,1768.153,280.995,6.1,0.404,0
40,174,2,1151,0,81,0,0,73.15,16425859,11.833,16.7,2.486,1768.153,280.995,6.1,0.404,0
40,175,2,1153,0,81,0,0,73.15,16425859,11.833,16.7,2.486,1768.153,280.995,6.1,0.404,0
40,176,2,1155,0,81,0,0,73.15,16425859,11.833,16.7,2.486,1768.153,280.995,6.1,0.404,0
40,177,9,1164,1,82,0,0,73.15,16425859,11.833,16.7,2.486,1768.153,280.995,6.1,0.404,0
40,178,7,1171,0,82,0,0,73.15,16425859,11.833,16.7,2.486,1768.153,280.995,6.1,0.404,0
40,179,4,1175,1,83,0,0,73.15,16425859,11.833,16.7,2.486,1768.153,280.995,6.1,0.404,0
40,180,2,1177,0,83,0,0,73.15,16425859,11.833,16.7,2.486,1768.153,280.995,6.1,0.404,0
40,181,1,1178,1,84,0,0,73.15,16425859,11.833,16.7,2.486,1768.153,280.995,6.1,0.404,0
40,182,7,1185,1,85,0,0,76.85,16425859,11.833,16.7,2.486,1768.153,280.995,6.1,0.404,0
40,183,8,1193,0,85,0,0,76.85,16425859,11.833,16.7,2.486,1768.153,280.995,6.1,0.404,0
40,184,7,1200,0,85,0,0,65.74,16425859,11.833,16.7,2.486,1768.153,280.995,6.1,0.404,0
40,185,3,1203,0,85,0,0,65.74,16425859,11.833,16.7,2.486,1768.153,280.995,6.1,0.404,0
40,186,8,1211,0,85,0,0,65.74,16425859,11.833,16.7,2.486,1768.153,280.995,6.1,0.404,0
40,187,3,1214,0,85,0,0,65.74,16425859,11.833,16.7,2.486,1768.153,280.995,6.1,0.404,0
40,188,3,1217,1,86,0,0,65.74,16425859,11.833,16.7,2.486,1768.153,280.995,6.1,0.404,0
40,189,6,1223,0,86,0,0,65.74,16425859,11.833,16.7,2.486,1768.153,280.995,6.1,0.404,0
40,190,15,1238,2,88,0,0,65.74,16425859,11.833,16.7,2.486,1768.153,280.995,6.1,0.404,0
40,191,13,1251,0,88,0,0,65.74,16425859,11.833,16.7,2.486,1768.153,280.995,6.1,0.404,0
40,192,11,1262,1,89,0,0,65.74,16425859,11.833,16.7,2.486,1768.153,280.995,6.1,0.404,0
40,193,12,1274,1,90,0,0,65.74,16425859,11.833,16.7,2.486,1768.153,280.995,6.1,0.404,0
40,194,17,1291,2,92,0,0,65.74,16425859,11.833,16.7,2.486,1768.153,280.995,6.1,0.404,0
40,195,13,1304,0,92,0,0,65.74,16425859,11.833,16.7,2.486,1768.153,280.995,6.1,0.404,0
40,196,4,1308,0,92,0,0,65.74,16425859,11.833,16.7,2.486,1768.153,280.995,6.1,0.404,0
40,197,13,1321,0,92,0,0,65.74,16425859,11.833,16.7,2.486,1768.153,280.995,6.1,0.404,0
40,198,8,1329,0,92,0,0,65.74,16425859,11.833,16.7,2.486,1768.153,280.995,6.1,0.404,0
40,199,21,1350,0,92,0,0,65.74,16425859,11.833,16.7,2.486,1768.153,280.995,6.1,0.404,0
40,200,11,1361,1,93,0,0,65.74,16425859,11.833,16.7,2.486,1768.153,280.995,6.1,0.404,0
40,201,4,1365,0,93,0,0,65.74,16425859,11.833,16.7,2.486,1768.153,280.995,6.1,0.404,0
40,202,14,1379,0,93,0,0,65.74,16425859,11.833,16.7,2.486,1768.153,280.995,6.1,0.404,0
40,203,11,1390,0,93,0,0,65.74,16425859,11.833,16.7,2.486,1768.153,280.995,6.1,0.404,0
40,204,9,1399,0,93,0,0,65.74,16425859,11.833,16.7,2.486,1768.153,280.995,6.1,0.404,0
41,1,289,2738,4,12,2898,30498,73.15,19116209,24.282,35.4,11.087,22767.037,127.993,8.46,0.843,0
41,2,293,3031,4,16,2685,33183,73.15,19116209,24.282,35.4,11.087,22767.037,127.993,8.46,0.843,0
41,3,373,3404,2,18,3405,36588,73.15,19116209,24.282,35.4,11.087,22767.037,127.993,8.46,0.843,0
41,4,333,3737,4,22,4483,41071,73.15,19116209,24.282,35.4,11.087,22767.037,127.993,8.46,0.843,0
41,5,424,4161,5,27,3343,44414,73.15,19116209,24.282,35.4,11.087,22767.037,127.993,8.46,0.843,0
41,6,310,4471,7,34,2908,47322,73.15,19116209,24.282,35.4,11.087,22767.037,127.993,8.46,0.843,0
41,7,344,4815,3,37,2258,49580,73.15,19116209,24.282,35.4,11.087,22767.037,127.993,8.46,0.843,0
41,8,301,5116,6,43,3269,52849,73.15,19116209,24.282,35.4,11.087,22767.037,127.993,8.46,0.843,0
41,9,430,5546,5,48,7962,60811,73.15,19116209,24.282,35.4,11.087,22767.037,127.993,8.46,0.843,0
41,10,426,5972,9,57,4444,65255,73.15,19116209,24.282,35.4,11.087,22767.037,127.993,8.46,0.843,0
41,11,529,6501,8,65,3577,68832,73.15,19116209,24.282,35.4,11.087,22767.037,127.993,8.46,0.843,0
41,12,426,6927,8,73,5897,74729,73.15,19116209,24.282,35.4,11.087,22767.037,127.993,8.46,0.843,0
41,13,286,7213,7,80,2764,77493,73.15,19116209,24.282,35.4,11.087,22767.037,127.993,8.46,0.843,0
41,14,312,7525,2,82,2759,80252,73.15,19116209,24.282,35.4,11.087,22767.037,127.993,8.46,0.843,0
41,15,392,7917,10,92,4079,84331,73.15,19116209,24.282,35.4,11.087,22767.037,127.993,8.46,0.843,0
41,16,356,8273,2,94,6551,90882,73.15,19116209,24.282,35.4,11.087,22767.037,127.993,8.46,0.843,0
41,17,534,8807,11,105,5449,96331,73.15,19116209,24.282,35.4,11.087,22767.037,127.993,8.46,0.843,0
41,18,445,9252,11,116,5018,101349,73.15,19116209,24.282,35.4,11.087,22767.037,127.993,8.46,0.843,0
41,19,478,9730,10,126,4758,106107,73.15,19116209,24.282,35.4,11.087,22767.037,127.993,8.46,0.843,0
41,20,358,10088,7,133,5178,111285,73.15,19116209,24.282,35.4,11.087,22767.037,127.993,8.46,0.843,0
41,21,419,10507,6,139,3530,114815,73.15,19116209,24.282,35.4,11.087,22767.037,127.993,8.46,0.843,0
41,22,325,10832,8,147,6365,121180,73.15,19116209,24.282,35.4,11.087,22767.037,127.993,8.46,0.843,0
41,23,464,11296,13,160,6425,127605,73.15,19116209,24.282,35.4,11.087,22767.037,127.993,8.46,0.843,0
41,24,516,11812,8,168,7120,134725,73.15,19116209,24.282,35.4,11.087,22767.037,127.993,8.46,0.843,0
41,25,494,12306,6,174,6945,141670,73.15,19116209,24.282,35.4,11.087,22767.037,127.993,8.46,0.843,0
41,26,552,12858,7,181,6763,148433,73.15,19116209,24.282,35.4,11.087,22767.037,127.993,8.46,0.843,0
41,27,473,13331,8,189,5260,153693,73.15,19116209,24.282,35.4,11.087,22767.037,127.993,8.46,0.843,0
41,28,482,13813,9,198,4930,158623,73.15,19116209,24.282,35.4,11.087,22767.037,127.993,8.46,0.843,0
41,29,552,14365,9,207,6454,165077,73.15,19116209,24.282,35.4,11.087,22767.037,127.993,8.46,0.843,0
41,30,520,14885,9,216,7898,172975,73.15,19116209,24.282,35.4,11.087,22767.037,127.993,8.46,0.843,0
41,31,1138,16023,11,227,8916,181891,73.15,19116209,24.282,35.4,11.087,22767.037,127.993,8.46,0.843,0
41,32,985,17008,7,234,9967,191858,73.15,19116209,24.282,35.4,11.087,22767.037,127.993,8.46,0.843,0
41,33,1427,18435,13,247,6818,198676,73.15,19116209,24.282,35.4,11.087,22767.037,127.993,8.46,0.843,0
41,34,1228,19663,13,260,7913,206589,73.15,19116209,24.282,35.4,11.087,22767.037,127.993,8.46,0.843,0
41,35,980,20643,10,270,7964,214553,73.15,19116209,24.282,35.4,11.087,22767.037,127.993,8.46,0.843,0
41,36,1373,22016,5,275,10013,224566,73.15,19116209,24.282,35.4,11.087,22767.037,127.993,8.46,0.843,0
41,37,1032,23048,6,281,12118,236684,73.15,19116209,24.282,35.4,11.087,22767.037,127.993,8.46,0.843,0
41,38,1533,24581,4,285,11735,248419,75.93,19116209,24.282,35.4,11.087,22767.037,127.993,8.46,0.843,0
41,39,1391,25972,9,294,11943,260362,75.93,19116209,24.282,35.4,11.087,22767.037,127.993,8.46,0.843,0
41,40,1247,27219,10,304,12780,273142,75.93,19116209,24.282,35.4,11.087,22767.037,127.993,8.46,0.843,0
41,41,1647,28866,8,312,13373,286515,75.93,19116209,24.282,35.4,11.087,22767.037,127.993,8.46,0.843,0
41,42,1197,30063,11,323,9283,295798,75.93,19116209,24.282,35.4,11.087,22767.037,127.993,8.46,0.843,0
41,43,1658,31721,12,335,10410,306208,75.93,19116209,24.282,35.4,11.087,22767.037,127.993,8.46,0.843,0
41,44,2660,34381,11,346,11502,317710,75.93,19116209,24.282,35.4,11.087,22767.037,127.993,8.46,0.843,0
41,45,2659,37040,12,358,16095,333805,78.24,19116209,24.282,35.4,11.087,22767.037,127.993,8.46,0.843,0
41,46,2502,39542,36,394,8813,342618,78.24,19116209,24.282,35.4,11.087,22767.037,127.993,8.46,0.843,0
41,47,1886,41428,27,421,13171,355789,78.24,19116209,24.282,35.4,11.087,22767.037,127.993,8.46,0.843,0
41,48,2353,43781,29,450,17515,373304,78.24,19116209,24.282,35.4,11.087,22767.037,127.993,8.46,0.843,0
41,49,2278,46059,28,478,16189,389493,78.24,19116209,24.282,35.4,11.087,22767.037,127.993,8.46,0.843,0
41,50,3520,49579,31,509,12469,401962,78.24,19116209,24.282,35.4,11.087,22767.037,127.993,8.46,0.843,0
41,51,4038,53617,35,544,16334,418296,78.24,19116209,24.282,35.4,11.087,22767.037,127.993,8.46,0.843,0
41,52,3964,57581,45,589,16090,434386,78.24,19116209,24.282,35.4,11.087,22767.037,127.993,8.46,0.843,0
41,53,4276,61857,41,630,15239,449625,78.24,19116209,24.282,35.4,11.087,22767.037,127.993,8.46,0.843,0
41,54,3536,65393,43,673,14426,464051,78.24,19116209,24.282,35.4,11.087,22767.037,127.993,8.46,0.843,0
41,55,3709,69102,45,718,16283,480334,78.24,19116209,24.282,35.4,11.087,22767.037,127.993,8.46,0.843,0
41,56,4895,73997,43,761,13084,493418,78.24,19116209,24.282,35.4,11.087,22767.037,127.993,8.46,0.843,0
41,57,3964,77961,45,806,13398,506816,78.24,19116209,24.282,35.4,11.087,22767.037,127.993,8.46,0.843,0
41,58,4328,82289,35,841,15650,522466,78.24,19116209,24.282,35.4,11.087,22767.037,127.993,8.46,0.843,0
41,59,4654,86943,49,890,16333,538799,78.24,19116209,24.282,35.4,11.087,22767.037,127.993,8.46,0.843,0
41,60,3695,90638,54,944,16814,555613,78.24,19116209,24.282,35.4,11.087,22767.037,127.993,8.46,0.843,0
41,61,4220,94858,53,997,19120,574733,78.24,19116209,24.282,35.4,11.087,22767.037,127.993,8.46,0.843,0
41,62,4830,99688,57,1054,16890,591623,78.24,19116209,24.282,35.4,11.087,22767.037,127.993,8.46,0.843,0
41,63,5471,105159,59,1113,13442,605065,78.24,19116209,24.282,35.4,11.087,22767.037,127.993,8.46,0.843,0
41,64,3527,108686,75,1188,15546,620611,78.24,19116209,24.282,35.4,11.087,22767.037,127.993,8.46,0.843,0
41,65,4942,113628,87,1275,18140,638751,78.24,19116209,24.282,35.4,11.087,22767.037,127.993,8.46,0.843,0
41,66,4664,118292,81,1356,21780,660531,78.24,19116209,24.282,35.4,11.087,22767.037,127.993,8.46,0.843,0
41,67,4207,122499,92,1448,18954,679485,78.24,19116209,24.282,35.4,11.087,22767.037,127.993,8.46,0.843,0
41,68,5246,127745,93,1541,21265,700750,78.24,19116209,24.282,35.4,11.087,22767.037,127.993,8.46,0.843,0
41,69,6405,134150,649,2190,20040,720790,78.24,19116209,24.282,35.4,11.087,22767.037,127.993,8.46,0.843,0
41,70,4696,138846,74,2264,17777,738567,78.24,19116209,24.282,35.4,11.087,22767.037,127.993,8.46,0.843,0
41,71,3913,142759,19,2283,14477,753044,78.24,19116209,24.282,35.4,11.087,22767.037,127.993,8.46,0.843,0
41,72,5737,148496,192,2475,19976,773020,78.24,19116209,24.282,35.4,11.087,22767.037,127.993,8.46,0.843,0
41,73,5596,154092,173,2648,18733,791753,78.24,19116209,24.282,35.4,11.087,22767.037,127.993,8.46,0.843,0
41,74,6754,160846,222,2870,20223,811976,78.24,19116209,24.282,35.4,11.087,22767.037,127.993,8.46,0.843,0
41,75,6509,167355,231,3101,20151,832127,78.24,19116209,24.282,35.4,11.087,22767.037,127.993,8.46,0.843,0
41,76,6938,174293,222,3323,18808,850935,78.24,19116209,24.282,35.4,11.087,22767.037,127.993,8.46,0.843,0
41,77,5143,179436,39,3362,14575,865510,78.24,19116209,24.282,35.4,11.087,22767.037,127.993,8.46,0.843,0
41,78,5013,184449,21,3383,12636,878146,78.24,19116209,24.282,35.4,11.087,22767.037,127.993,8.46,0.843,0
41,79,36179,220628,232,3615,16997,895143,78.24,19116209,24.282,35.4,11.087,22767.037,127.993,8.46,0.843,0
41,80,4475,225103,226,3841,20347,915490,78.24,19116209,24.282,35.4,11.087,22767.037,127.993,8.46,0.843,0
41,81,6290,231393,252,4093,20080,935570,78.24,19116209,24.282,35.4,11.087,22767.037,127.993,8.46,0.843,0
41,82,5355,236748,202,4295,20115,955685,78.24,19116209,24.282,35.4,11.087,22767.037,127.993,8.46,0.843,0
41,83,5607,242355,184,4479,18645,974330,78.24,19116209,24.282,35.4,11.087,22767.037,127.993,8.46,0.843,0
41,84,4608,246963,23,4502,12707,987037,78.24,19116209,24.282,35.4,11.087,22767.037,127.993,8.46,0.843,0
41,85,3804,250767,3,4505,12575,999612,78.24,19116209,24.282,35.4,11.087,22767.037,127.993,8.46,0.843,0
41,86,3649,254416,226,4731,17446,1017058,78.24,19116209,24.282,35.4,11.087,22767.037,127.993,8.46,0.843,0
41,87,4648,259064,172,4903,18249,1035307,78.24,19116209,24.282,35.4,11.087,22767.037,127.993,8.46,0.843,0
41,88,4296,263360,165,5068,17944,1053251,78.24,19116209,24.282,35.4,11.087,22767.037,127.993,8.46,0.843,0
41,89,4406,267766,279,5347,18370,1071621,78.24,19116209,24.282,35.4,11.087,22767.037,127.993,8.46,0.843,0
41,90,4216,271982,162,5509,16799,1088420,78.24,19116209,24.282,35.4,11.087,22767.037,127.993,8.46,0.843,0
41,91,4017,275999,66,5575,13349,1101769,78.24,19116209,24.282,35.4,11.087,22767.037,127.993,8.46,0.843,0
41,92,3394,279393,113,5688,10385,1112154,78.24,19116209,24.282,35.4,11.087,22767.037,127.993,8.46,0.843,0
41,93,2650,282043,65,5753,10831,1122985,78.24,19116209,24.282,35.4,11.087,22767.037,127.993,8.46,0.843,0
41,94,2498,284541,167,5920,15585,1138570,89.35,19116209,24.282,35.4,11.087,22767.037,127.993,8.46,0.843,0
41,95,3548,288089,131,6051,17287,1155857,89.35,19116209,24.282,35.4,11.087,22767.037,127.993,8.46,0.843,0
41,96,3758,291847,141,6192,18004,1173861,89.35,19116209,24.282,35.4,11.087,22767.037,127.993,8.46,0.843,0
41,97,3685,295532,116,6308,16377,1190238,89.35,19116209,24.282,35.4,11.087,22767.037,127.993,8.46,0.843,0
41,98,3025,298557,76,6384,12065,1202303,89.35,19116209,24.282,35.4,11.087,22767.037,127.993,8.46,0.843,0
41,99,2462,301019,50,6434,10464,1212767,89.35,19116209,24.282,35.4,11.087,22767.037,127.993,8.46,0.843,0
41,100,2064,303083,139,6573,16842,1229609,89.35,19116209,24.282,35.4,11.087,22767.037,127.993,8.46,0.843,0
41,101,3133,306216,109,6682,17727,1247336,89.35,19116209,24.282,35.4,11.087,22767.037,127.993,8.46,0.843,0
41,102,3058,309274,99,6781,18268,1265604,89.35,19116209,24.282,35.4,11.087,22767.037,127.993,8.46,0.843,0
41,103,2755,312029,100,6881,19171,1284775,89.35,19116209,24.282,35.4,11.087,22767.037,127.993,8.46,0.843,0
41,104,3012,315041,98,6979,17467,1302242,89.35,19116209,24.282,35.4,11.087,22767.037,127.993,8.46,0.843,0
41,105,2616,317657,45,7024,12238,1314480,89.35,19116209,24.282,35.4,11.087,22767.037,127.993,8.46,0.843,0
41,106,1836,319493,45,7069,12209,1326689,89.35,19116209,24.282,35.4,11.087,22767.037,127.993,8.46,0.843,0
41,107,1712,321205,117,7186,17192,1343881,89.35,19116209,24.282,35.4,11.087,22767.037,127.993,8.46,0.843,0
41,108,2493,323698,104,7290,18699,1362580,86.57,19116209,24.282,35.4,11.087,22767.037,127.993,8.46,0.843,0
41,109,2841,326539,1057,8347,17716,1380296,86.57,19116209,24.282,35.4,11.087,22767.037,127.993,8.46,0.843,0
41,110,2307,328846,98,8445,15728,1396024,86.57,19116209,24.282,35.4,11.087,22767.037,127.993,8.46,0.843,0
41,111,2084,330930,58,8503,16343,1412367,86.57,19116209,24.282,35.4,11.087,22767.037,127.993,8.46,0.843,0
41,112,2099,333029,130,8633,12590,1424957,86.57,19116209,24.282,35.4,11.087,22767.037,127.993,8.46,0.843,0
41,113,1654,334683,44,8677,12793,1437750,86.57,19116209,24.282,35.4,11.087,22767.037,127.993,8.46,0.843,0
41,114,1719,336402,45,8722,18867,1456617,86.57,19116209,24.282,35.4,11.087,22767.037,127.993,8.46,0.843,0
41,115,2357,338759,116,8838,21071,1477688,86.57,19116209,24.282,35.4,11.087,22767.037,127.993,8.46,0.843,0
41,116,2545,341304,76,8914,19133,1496821,86.57,19116209,24.282,35.4,11.087,22767.037,127.993,8.46,0.843,0
41,117,2288,343592,106,9020,19709,1516530,86.57,19116209,24.282,35.4,11.087,22767.037,127.993,8.46,0.843,0
41,118,2198,345790,92,9112,21544,1538074,86.57,19116209,24.282,35.4,11.087,22767.037,127.993,8.46,0.843,0
41,119,2133,347923,75,9187,17596,1555670,86.57,19116209,24.282,35.4,11.087,22767.037,127.993,8.46,0.843,0
41,120,1877,349800,53,9240,17130,1572800,86.57,19116209,24.282,35.4,11.087,22767.037,127.993,8.46,0.843,0
41,121,1775,351575,38,9278,20295,1593095,86.57,19116209,24.282,35.4,11.087,22767.037,127.993,8.46,0.843,0
41,122,1961,353536,99,9377,22874,1615969,86.57,19116209,24.282,35.4,11.087,22767.037,127.993,8.46,0.843,0
41,123,2131,355667,80,9457,24398,1640367,89.35,19116209,24.282,35.4,11.087,22767.037,127.993,8.46,0.843,0
41,124,1991,357658,76,9533,24899,1665266,89.35,19116209,24.282,35.4,11.087,22767.037,127.993,8.46,0.843,0
41,125,2073,359731,75,9608,24269,1689535,89.35,19116209,24.282,35.4,11.087,22767.037,127.993,8.46,0.843,0
41,126,1762,361493,99,9707,18857,1708392,89.35,19116209,24.282,35.4,11.087,22767.037,127.993,8.46,0.843,0
41,127,1469,362962,38,9745,21398,1729790,89.35,19116209,24.282,35.4,11.087,22767.037,127.993,8.46,0.843,0
41,128,1761,364723,47,9792,22802,1752592,89.35,19116209,24.282,35.4,11.087,22767.037,127.993,8.46,0.843,0
41,129,1948,366671,97,9889,25243,1777835,89.35,19116209,24.282,35.4,11.087,22767.037,127.993,8.46,0.843,0
41,130,2154,368825,69,9958,27037,1804872,89.35,19116209,24.282,35.4,11.087,22767.037,127.993,8.46,0.843,0
41,131,2198,371023,53,10011,28460,1833332,89.35,19116209,24.282,35.4,11.087,22767.037,127.993,8.46,0.843,0
41,132,2033,373056,66,10077,26012,1859344,83.8,19116209,24.282,35.4,11.087,22767.037,127.993,8.46,0.843,0
41,133,1988,375044,62,10139,22249,1881593,83.8,19116209,24.282,35.4,11.087,22767.037,127.993,8.46,0.843,0
41,134,1572,376616,39,10178,19348,1900941,83.8,19116209,24.282,35.4,11.087,22767.037,127.993,8.46,0.843,0
41,135,1552,378168,27,10205,23628,1924569,83.8,19116209,24.282,35.4,11.087,22767.037,127.993,8.46,0.843,0
41,136,1866,380034,94,10299,27618,1952187,83.8,19116209,24.282,35.4,11.087,22767.037,127.993,8.46,0.843,0
41,137,2077,382111,41,10340,28499,1980686,83.8,19116209,24.282,35.4,11.087,22767.037,127.993,8.46,0.843,0
41,138,1791,383902,55,10395,30882,2011568,83.8,19116209,24.282,35.4,11.087,22767.037,127.993,8.46,0.843,0
41,139,2044,385946,57,10452,25289,2036857,83.8,19116209,24.282,35.4,11.087,22767.037,127.993,8.46,0.843,0
41,140,1556,387502,61,10513,23199,2060056,83.8,19116209,24.282,35.4,11.087,22767.037,127.993,8.46,0.843,0
41,141,1353,388855,33,10546,19275,2079331,83.8,19116209,24.282,35.4,11.087,22767.037,127.993,8.46,0.843,0
41,142,1182,390037,32,10578,26278,2105609,83.8,19116209,24.282,35.4,11.087,22767.037,127.993,8.46,0.843,0
41,143,1812,391849,93,10671,28669,2134278,83.8,19116209,24.282,35.4,11.087,22767.037,127.993,8.46,0.843,0
41,144,1920,393769,52,10723,29727,2164005,83.8,19116209,24.282,35.4,11.087,22767.037,127.993,8.46,0.843,0
41,145,1939,395708,69,10792,31981,2195986,83.8,19116209,24.282,35.4,11.087,22767.037,127.993,8.46,0.843,0
41,146,1957,397665,60,10852,27454,2223440,83.8,19116209,24.282,35.4,11.087,22767.037,127.993,8.46,0.843,0
41,147,1903,399568,64,10916,24503,2247943,83.8,19116209,24.282,35.4,11.087,22767.037,127.993,8.46,0.843,0
41,148,1417,400985,42,10958,20257,2268200,83.8,19116209,24.282,35.4,11.087,22767.037,127.993,8.46,0.843,0
41,149,1380,402365,32,10990,27019,2295219,83.8,19116209,24.282,35.4,11.087,22767.037,127.993,8.46,0.843,0
41,150,1737,404102,82,11072,30274,2325493,83.8,19116209,24.282,35.4,11.087,22767.037,127.993,8.46,0.843,0
41,151,1870,405972,60,11132,32237,2357730,83.8,19116209,24.282,35.4,11.087,22767.037,127.993,8.46,0.843,0
41,152,2037,408009,49,11181,34769,2392499,83.8,19116209,24.282,35.4,11.087,22767.037,127.993,8.46,0.843,0
41,153,1965,409974,63,11244,31914,2424413,83.8,19116209,24.282,35.4,11.087,22767.037,127.993,8.46,0.843,0
41,154,1752,411726,45,11289,26326,2450739,83.8,19116209,24.282,35.4,11.087,22767.037,127.993,8.46,0.843,0
41,155,1419,413145,32,11321,22746,2473485,83.8,19116209,24.282,35.4,11.087,22767.037,127.993,8.46,0.843,0
41,156,1594,414739,23,11344,27242,2500727,83.8,19116209,24.282,35.4,11.087,22767.037,127.993,8.46,0.843,0
41,157,1762,416501,78,11422,31968,2532695,83.8,19116209,24.282,35.4,11.087,22767.037,127.993,8.46,0.843,0
41,158,1968,418469,72,11494,34595,2567290,83.8,19116209,24.282,35.4,11.087,22767.037,127.993,8.46,0.843,0
41,159,1965,420434,57,11551,35289,2602579,83.8,19116209,24.282,35.4,11.087,22767.037,127.993,8.46,0.843,0
41,160,2076,422510,41,11592,30987,2633566,83.8,19116209,24.282,35.4,11.087,22767.037,127.993,8.46,0.843,0
41,161,1764,424274,60,11652,27980,2661546,83.8,19116209,24.282,35.4,11.087,22767.037,127.993,8.46,0.843,0
41,162,1267,425541,30,11682,21805,2683351,83.8,19116209,24.282,35.4,11.087,22767.037,127.993,8.46,0.843,0
41,163,1486,427027,20,11702,28313,2711664,83.8,19116209,24.282,35.4,11.087,22767.037,127.993,8.46,0.843,0
41,164,1642,428669,79,11781,34082,2745746,83.8,19116209,24.282,35.4,11.087,22767.037,127.993,8.46,0.843,0
41,165,1866,430535,69,11850,38062,2783808,83.8,19116209,24.282,35.4,11.087,22767.037,127.993,8.46,0.843,0
41,166,2131,432666,45,11895,36298,2820106,83.8,19116209,24.282,35.4,11.087,22767.037,127.993,8.46,0.843,0
41,167,2082,434748,54,11949,32577,2852683,83.8,19116209,24.282,35.4,11.087,22767.037,127.993,8.46,0.843,0
41,168,1685,436433,64,12013,27197,2879880,83.8,19116209,24.282,35.4,11.087,22767.037,127.993,8.46,0.843,0
41,169,1550,437983,27,12040,23102,2902982,83.8,19116209,24.282,35.4,11.087,22767.037,127.993,8.46,0.843,0
41,170,1304,439287,18,12058,31646,2934628,83.8,19116209,24.282,35.4,11.087,22767.037,127.993,8.46,0.843,0
41,171,1863,441150,84,12142,33240,2967868,83.8,19116209,24.282,35.4,11.087,22767.037,127.993,8.46,0.843,0
41,172,1677,442827,57,12199,34822,3002690,83.8,19116209,24.282,35.4,11.087,22767.037,127.993,8.46,0.843,0
41,173,1847,444674,55,12254,27620,3030310,83.8,19116209,24.282,35.4,11.087,22767.037,127.993,8.46,0.843,0
41,174,1600,446274,32,12286,16822,3047132,83.8,19116209,24.282,35.4,11.087,22767.037,127.993,8.46,0.843,0
41,175,1194,447468,12,12298,13389,3060521,83.8,19116209,24.282,35.4,11.087,22767.037,127.993,8.46,0.843,0
41,176,1055,448523,23,12321,15573,3076094,83.8,19116209,24.282,35.4,11.087,22767.037,127.993,8.46,0.843,0
41,177,1380,449903,24,12345,29078,3105172,83.8,19116209,24.282,35.4,11.087,22767.037,127.993,8.46,0.843,0
41,178,1731,451634,124,12469,37653,3142825,83.8,19116209,24.282,35.4,11.087,22767.037,127.993,8.46,0.843,0
41,179,2234,453868,58,12527,38161,3180986,83.8,19116209,24.282,35.4,11.087,22767.037,127.993,8.46,0.843,0
41,180,2111,455979,64,12591,39405,3220391,83.8,19116209,24.282,35.4,11.087,22767.037,127.993,8.46,0.843,0
41,181,1922,457901,50,12641,37473,3257864,83.8,19116209,24.282,35.4,11.087,22767.037,127.993,8.46,0.843,0
41,182,1770,459671,57,12698,28919,3286783,83.8,19116209,24.282,35.4,11.087,22767.037,127.993,8.46,0.843,0
41,183,1629,461300,27,12725,27509,3314292,83.8,19116209,24.282,35.4,11.087,22767.037,127.993,8.46,0.843,0
41,184,1691,462991,16,12741,33533,3347825,83.8,19116209,24.282,35.4,11.087,22767.037,127.993,8.46,0.843,0
41,185,1759,464750,81,12822,38674,3386499,83.8,19116209,24.282,35.4,11.087,22767.037,127.993,8.46,0.843,0
41,186,1840,466590,45,12867,35698,3422197,83.8,19116209,24.282,35.4,11.087,22767.037,127.993,8.46,0.843,0
41,187,1881,468471,52,12919,36333,3458530,83.8,19116209,24.282,35.4,11.087,22767.037,127.993,8.46,0.843,0
41,188,1708,470179,60,12979,36198,3494728,83.8,19116209,24.282,35.4,11.087,22767.037,127.993,8.46,0.843,0
41,189,1567,471746,58,13037,26316,3521044,83.8,19116209,24.282,35.4,11.087,22767.037,127.993,8.46,0.843,0
41,190,1560,473306,33,13070,19706,3540750,83.8,19116209,24.282,35.4,11.087,22767.037,127.993,8.46,0.843,0
41,191,1134,474440,20,13090,32954,3573704,83.8,19116209,24.282,35.4,11.087,22767.037,127.993,8.46,0.843,0
41,192,1576,476016,77,13167,36292,3609996,83.8,19116209,24.282,35.4,11.087,22767.037,127.993,8.46,0.843,0
41,193,1753,477769,53,13220,36022,3646018,83.8,19116209,24.282,35.4,11.087,22767.037,127.993,8.46,0.843,0
41,194,1826,479595,52,13272,39211,3685229,83.8,19116209,24.282,35.4,11.087,22767.037,127.993,8.46,0.843,0
41,195,1776,481371,46,13318,35907,3721136,83.8,19116209,24.282,35.4,11.087,22767.037,127.993,8.46,0.843,0
41,196,1517,482888,61,13379,25603,3746739,83.8,19116209,24.282,35.4,11.087,22767.037,127.993,8.46,0.843,0
41,197,1392,484280,17,13396,17351,3764090,83.8,19116209,24.282,35.4,11.087,22767.037,127.993,8.46,0.843,0
41,198,1092,485372,19,13415,18005,3782095,83.8,19116209,24.282,35.4,11.087,22767.037,127.993,8.46,0.843,0
41,199,1124,486496,19,13434,31088,3813183,83.8,19116209,24.282,35.4,11.087,22767.037,127.993,8.46,0.843,0
41,200,1694,488190,95,13529,36614,3849797,83.8,19116209,24.282,35.4,11.087,22767.037,127.993,8.46,0.843,0
41,201,1813,490003,59,13588,37121,3886918,83.8,19116209,24.282,35.4,11.087,22767.037,127.993,8.46,0.843,0
41,202,1757,491760,47,13635,34671,3921589,83.8,19116209,24.282,35.4,11.087,22767.037,127.993,8.46,0.843,0
41,203,1545,493305,41,13676,0,3921589,83.8,19116209,24.282,35.4,11.087,22767.037,127.993,8.46,0.843,0
41,204,1173,494478,26,13702,0,3921589,83.8,19116209,24.282,35.4,11.087,22767.037,127.993,8.46,0.843,0
42,1,54,82295,1,3310,0,0,73.61,1439323774,147.674,38.7,10.641,15308.712,261.899,9.74,0.752,1
42,2,100,82395,6,3316,0,0,73.61,1439323774,147.674,38.7,10.641,15308.712,261.899,9.74,0.752,1
42,3,70,82465,10,3326,0,0,69.91,1439323774,147.674,38.7,10.641,15308.712,261.899,9.74,0.752,1
42,4,62,82527,4,3330,0,0,69.91,1439323774,147.674,38.7,10.641,15308.712,261.899,9.74,0.752,1
42,5,48,82575,3,3333,0,0,69.91,1439323774,147.674,38.7,10.641,15308.712,261.899,9.74,0.752,1
42,6,67,82642,2,3335,0,0,69.91,1439323774,147.674,38.7,10.641,15308.712,261.899,9.74,0.752,1
42,7,56,82698,0,3335,0,0,69.91,1439323774,147.674,38.7,10.641,15308.712,261.899,9.74,0.752,1
42,8,86,82784,2,3337,0,0,56.94,1439323774,147.674,38.7,10.641,15308.712,261.899,9.74,0.752,1
42,9,86,82870,2,3339,0,0,56.94,1439323774,147.674,38.7,10.641,15308.712,261.899,9.74,0.752,1
42,10,55,82925,1,3340,0,0,56.94,1439323774,147.674,38.7,10.641,15308.712,261.899,9.74,0.752,1
42,11,79,83004,3,3343,0,0,56.94,1439323774,147.674,38.7,10.641,15308.712,261.899,9.74,0.752,1
42,12,93,83097,0,3343,0,0,56.94,1439323774,147.674,38.7,10.641,15308.712,261.899,9.74,0.752,1
42,13,112,83209,2,3345,0,0,56.94,1439323774,147.674,38.7,10.641,15308.712,261.899,9.74,0.752,1
42,14,94,83303,0,3345,0,0,56.94,1439323774,147.674,38.7,10.641,15308.712,261.899,9.74,0.752,1
42,15,49,83352,1,3346,0,0,56.94,1439323774,147.674,38.7,10.641,15308.712,261.899,9.74,0.752,1
42,16,50,83402,0,3346,0,0,56.94,1439323774,147.674,38.7,10.641,15308.712,261.899,9.74,0.752,1
42,17,352,83754,1290,4636,0,0,56.94,1439323774,147.674,38.7,10.641,15308.712,261.899,9.74,0.752,1
42,18,31,83785,0,4636,0,0,56.94,1439323774,147.674,38.7,10.641,15308.712,261.899,9.74,0.752,1
42,19,18,83803,0,4636,0,0,56.94,1439323774,147.674,38.7,10.641,15308.712,261.899,9.74,0.752,1
42,20,14,83817,0,4636,0,0,56.94,1439323774,147.674,38.7,10.641,15308.712,261.899,9.74,0.752,1
42,21,32,83849,0,4636,0,0,56.94,1439323774,147.674,38.7,10.641,15308.712,261.899,9.74,0.752,1
42,22,15,83864,0,4636,0,0,56.94,1439323774,147.674,38.7,10.641,15308.712,261.899,9.74,0.752,1
42,23,12,83876,0,4636,0,0,56.94,1439323774,147.674,38.7,10.641,15308.712,261.899,9.74,0.752,1
42,24,8,83884,0,4636,0,0,56.94,1439323774,147.674,38.7,10.641,15308.712,261.899,9.74,0.752,1
42,25,15,83899,0,4636,0,0,56.94,1439323774,147.674,38.7,10.641,15308.712,261.899,9.74,0.752,1
42,26,10,83909,0,4636,0,0,56.94,1439323774,147.674,38.7,10.641,15308.712,261.899,9.74,0.752,1
42,27,3,83912,1,4637,0,0,56.94,1439323774,147.674,38.7,10.641,15308.712,261.899,9.74,0.752,1
42,28,26,83938,0,4637,0,0,56.94,1439323774,147.674,38.7,10.641,15308.712,261.899,9.74,0.752,1
42,29,2,83940,0,4637,0,0,56.94,1439323774,147.674,38.7,10.641,15308.712,261.899,9.74,0.752,1
42,30,4,83944,0,4637,0,0,56.94,1439323774,147.674,38.7,10.641,15308.712,261.899,9.74,0.752,1
42,31,12,83956,0,4637,0,0,56.94,1439323774,147.674,38.7,10.641,15308.712,261.899,9.74,0.752,1
42,32,3,83959,0,4637,0,0,56.94,1439323774,147.674,38.7,10.641,15308.712,261.899,9.74,0.752,1
42,33,2,83961,0,4637,0,0,56.94,1439323774,147.674,38.7,10.641,15308.712,261.899,9.74,0.752,1
42,34,3,83964,0,4637,0,0,56.94,1439323774,147.674,38.7,10.641,15308.712,261.899,9.74,0.752,1
42,35,2,83966,0,4637,0,0,56.94,1439323774,147.674,38.7,10.641,15308.712,261.899,9.74,0.752,1
42,36,2,83968,0,4637,0,0,56.94,1439323774,147.674,38.7,10.641,15308.712,261.899,9.74,0.752,1
42,37,2,83970,0,4637,0,0,56.94,1439323774,147.674,38.7,10.641,15308.712,261.899,9.74,0.752,1
42,38,6,83976,0,4637,0,0,56.94,1439323774,147.674,38.7,10.641,15308.712,261.899,9.74,0.752,1
42,39,0,83976,0,4637,0,0,56.94,1439323774,147.674,38.7,10.641,15308.712,261.899,9.74,0.752,1
42,40,15,83991,0,4637,0,0,81.94,1439323774,147.674,38.7,10.641,15308.712,261.899,9.74,0.752,1
42,41,19,84010,0,4637,0,0,81.94,1439323774,147.674,38.7,10.641,15308.712,261.899,9.74,0.752,1
42,42,1,84011,0,4637,0,0,81.94,1439323774,147.674,38.7,10.641,15308.712,261.899,9.74,0.752,1
42,43,7,84018,0,4637,0,0,81.94,1439323774,147.674,38.7,10.641,15308.712,261.899,9.74,0.752,1
42,44,6,84024,0,4637,0,0,81.94,1439323774,147.674,38.7,10.641,15308.712,261.899,9.74,0.752,1
42,45,5,84029,0,4637,0,0,81.94,1439323774,147.674,38.7,10.641,15308.712,261.899,9.74,0.752,1
42,46,9,84038,0,4637,0,0,81.94,1439323774,147.674,38.7,10.641,15308.712,261.899,9.74,0.752,1
42,47,6,84044,1,4638,0,0,81.94,1439323774,147.674,38.7,10.641,15308.712,261.899,9.74,0.752,1
42,48,10,84054,0,4638,0,0,81.94,1439323774,147.674,38.7,10.641,15308.712,261.899,9.74,0.752,1
42,49,9,84063,0,4638,0,0,81.94,1439323774,147.674,38.7,10.641,15308.712,261.899,9.74,0.752,1
42,50,2,84065,0,4638,0,0,81.94,1439323774,147.674,38.7,10.641,15308.712,261.899,9.74,0.752,1
42,51,2,84067,0,4638,0,0,81.94,1439323774,147.674,38.7,10.641,15308.712,261.899,9.74,0.752,1
42,52,12,84079,0,4638,0,0,81.94,1439323774,147.674,38.7,10.641,15308.712,261.899,9.74,0.752,1
42,53,2,84081,0,4638,0,0,81.94,1439323774,147.674,38.7,10.641,15308.712,261.899,9.74,0.752,1
42,54,3,84084,0,4638,0,0,81.94,1439323774,147.674,38.7,10.641,15308.712,261.899,9.74,0.752,1
42,55,11,84095,0,4638,0,0,81.94,1439323774,147.674,38.7,10.641,15308.712,261.899,9.74,0.752,1
42,56,7,84102,0,4638,0,0,81.94,1439323774,147.674,38.7,10.641,15308.712,261.899,9.74,0.752,1
42,57,1,84103,0,4638,0,0,81.94,1439323774,147.674,38.7,10.641,15308.712,261.899,9.74,0.752,1
42,58,3,84106,0,4638,0,0,81.94,1439323774,147.674,38.7,10.641,15308.712,261.899,9.74,0.752,1
42,59,0,84106,0,4638,0,0,81.94,1439323774,147.674,38.7,10.641,15308.712,261.899,9.74,0.752,1
42,60,17,84123,0,4638,0,0,81.94,1439323774,147.674,38.7,10.641,15308.712,261.899,9.74,0.752,1
42,61,5,84128,0,4638,0,0,81.94,1439323774,147.674,38.7,10.641,15308.712,261.899,9.74,0.752,1
42,62,19,84147,0,4638,0,0,81.94,1439323774,147.674,38.7,10.641,15308.712,261.899,9.74,0.752,1
42,63,7,84154,0,4638,0,0,81.94,1439323774,147.674,38.7,10.641,15308.712,261.899,9.74,0.752,1
42,64,5,84159,0,4638,0,0,78.24,1439323774,147.674,38.7,10.641,15308.712,261.899,9.74,0.752,1
42,65,1,84160,0,4638,0,0,78.24,1439323774,147.674,38.7,10.641,15308.712,261.899,9.74,0.752,1
42,66,11,84171,0,4638,0,0,78.24,1439323774,147.674,38.7,10.641,15308.712,261.899,9.74,0.752,1
42,67,6,84177,0,4638,0,0,78.24,1439323774,147.674,38.7,10.641,15308.712,261.899,9.74,0.752,1
42,68,9,84186,0,4638,0,0,78.24,1439323774,147.674,38.7,10.641,15308.712,261.899,9.74,0.752,1
42,69,5,84191,0,4638,0,0,78.24,1439323774,147.674,38.7,10.641,15308.712,261.899,9.74,0.752,1
42,70,3,84194,0,4638,0,0,78.24,1439323774,147.674,38.7,10.641,15308.712,261.899,9.74,0.752,1
42,71,4,84198,0,4638,0,0,78.24,1439323774,147.674,38.7,10.641,15308.712,261.899,9.74,0.752,1
42,72,11,84209,0,4638,0,0,78.24,1439323774,147.674,38.7,10.641,15308.712,261.899,9.74,0.752,1
42,73,7,84216,0,4638,0,0,78.24,1439323774,147.674,38.7,10.641,15308.712,261.899,9.74,0.752,1
42,74,12,84228,0,4638,0,0,78.24,1439323774,147.674,38.7,10.641,15308.712,261.899,9.74,0.752,1
42,75,60,84288,0,4638,0,0,78.24,1439323774,147.674,38.7,10.641,15308.712,261.899,9.74,0.752,1
42,76,47,84335,0,4638,0,0,78.24,1439323774,147.674,38.7,10.641,15308.712,261.899,9.74,0.752,1
42,77,43,84378,0,4638,0,0,81.94,1439323774,147.674,38.7,10.641,15308.712,261.899,9.74,0.752,1
42,78,44,84422,0,4638,0,0,81.94,1439323774,147.674,38.7,10.641,15308.712,261.899,9.74,0.752,1
42,79,36,84458,0,4638,0,0,81.94,1439323774,147.674,38.7,10.641,15308.712,261.899,9.74,0.752,1
42,80,36,84494,0,4638,0,0,81.94,1439323774,147.674,38.7,10.641,15308.712,261.899,9.74,0.752,1
42,81,30,84524,0,4638,0,0,81.94,1439323774,147.674,38.7,10.641,15308.712,261.899,9.74,0.752,1
42,82,29,84553,1,4639,0,0,81.94,1439323774,147.674,38.7,10.641,15308.712,261.899,9.74,0.752,1
42,83,19,84572,0,4639,0,0,81.94,1439323774,147.674,38.7,10.641,15308.712,261.899,9.74,0.752,1
42,84,52,84624,0,4639,0,0,81.94,1439323774,147.674,38.7,10.641,15308.712,261.899,9.74,0.752,1
42,85,29,84653,1,4640,0,90000000,81.94,1439323774,147.674,38.7,10.641,15308.712,261.899,9.74,0.752,1
42,86,20,84673,0,4640,0,90000000,81.94,1439323774,147.674,38.7,10.641,15308.712,261.899,9.74,0.752,1
42,87,28,84701,1,4641,0,90000000,81.94,1439323774,147.674,38.7,10.641,15308.712,261.899,9.74,0.752,1
42,88,24,84725,0,4641,0,90000000,81.94,1439323774,147.674,38.7,10.641,15308.712,261.899,9.74,0.752,1
42,89,18,84743,0,4641,0,90000000,81.94,1439323774,147.674,38.7,10.641,15308.712,261.899,9.74,0.752,1
42,90,14,84757,0,4641,0,90000000,81.94,1439323774,147.674,38.7,10.641,15308.712,261.899,9.74,0.752,1
42,91,23,84780,0,4641,0,90000000,81.94,1439323774,147.674,38.7,10.641,15308.712,261.899,9.74,0.752,1
42,92,5,84785,0,4641,0,90000000,81.94,1439323774,147.674,38.7,10.641,15308.712,261.899,9.74,0.752,1
42,93,31,84816,0,4641,0,90000000,81.94,1439323774,147.674,38.7,10.641,15308.712,261.899,9.74,0.752,1
42,94,14,84830,0,4641,0,90000000,81.94,1439323774,147.674,38.7,10.641,15308.712,261.899,9.74,0.752,1
42,95,9,84839,0,4641,0,90000000,81.94,1439323774,147.674,38.7,10.641,15308.712,261.899,9.74,0.752,1
42,96,18,84857,0,4641,0,90000000,81.94,1439323774,147.674,38.7,10.641,15308.712,261.899,9.74,0.752,1
42,97,14,84871,0,4641,0,90000000,81.94,1439323774,147.674,38.7,10.641,15308.712,261.899,9.74,0.752,1
42,98,25,84896,0,4641,0,90000000,81.94,1439323774,147.674,38.7,10.641,15308.712,261.899,9.74,0.752,1
42,99,21,84917,0,4641,0,90000000,81.94,1439323774,147.674,38.7,10.641,15308.712,261.899,9.74,0.752,1
42,100,33,84950,0,4641,0,90000000,81.94,1439323774,147.674,38.7,10.641,15308.712,261.899,9.74,0.752,1
42,101,46,84996,0,4641,0,90000000,81.94,1439323774,147.674,38.7,10.641,15308.712,261.899,9.74,0.752,1
42,102,40,85036,0,4641,0,90000000,81.94,1439323774,147.674,38.7,10.641,15308.712,261.899,9.74,0.752,1
42,103,35,85071,0,4641,0,90000000,81.94,1439323774,147.674,38.7,10.641,15308.712,261.899,9.74,0.752,1
42,104,46,85117,0,4641,0,90000000,81.94,1439323774,147.674,38.7,10.641,15308.712,261.899,9.74,0.752,1
42,105,55,85172,1,4642,0,90000000,81.94,1439323774,147.674,38.7,10.641,15308.712,261.899,9.74,0.752,1
42,106,54,85226,0,4642,0,90000000,81.94,1439323774,147.674,38.7,10.641,15308.712,261.899,9.74,0.752,1
42,107,20,85246,2,4644,0,90000000,81.94,1439323774,147.674,38.7,10.641,15308.712,261.899,9.74,0.752,1
42,108,77,85323,0,4644,0,90000000,81.94,1439323774,147.674,38.7,10.641,15308.712,261.899,9.74,0.752,1
42,109,80,85403,1,4645,0,90000000,81.94,1439323774,147.674,38.7,10.641,15308.712,261.899,9.74,0.752,1
42,110,80,85483,1,4646,0,90000000,81.94,1439323774,147.674,38.7,10.641,15308.712,261.899,9.74,0.752,1
42,111,130,85613,0,4646,0,90000000,81.94,1439323774,147.674,38.7,10.641,15308.712,261.899,9.74,0.752,1
42,112,84,85697,0,4646,0,90000000,81.94,1439323774,147.674,38.7,10.641,15308.712,261.899,9.74,0.752,1
42,113,74,85771,2,4648,0,90000000,81.94,1439323774,147.674,38.7,10.641,15308.712,261.899,9.74,0.752,1
42,114,135,85906,0,4648,0,90000000,81.94,1439323774,147.674,38.7,10.641,15308.712,261.899,9.74,0.752,1
42,115,139,86045,1,4649,0,90000000,81.94,1439323774,147.674,38.7,10.641,15308.712,261.899,9.74,0.752,1
42,116,157,86202,1,4650,0,90000000,81.94,1439323774,147.674,38.7,10.641,15308.712,261.899,9.74,0.752,1
42,117,179,86381,2,4652,0,90000000,81.94,1439323774,147.674,38.7,10.641,15308.712,261.899,9.74,0.752,1
42,118,189,86570,0,4652,0,90000000,81.94,1439323774,147.674,38.7,10.641,15308.712,261.899,9.74,0.752,1
42,119,213,86783,4,4656,0,90000000,81.94,1439323774,147.674,38.7,10.641,15308.712,261.899,9.74,0.752,1
42,120,207,86990,1,4657,0,90000000,81.94,1439323774,147.674,38.7,10.641,15308.712,261.899,9.74,0.752,1
42,121,223,87213,2,4659,0,90000000,81.94,1439323774,147.674,38.7,10.641,15308.712,261.899,9.74,0.752,1
42,122,276,87489,0,4659,0,90000000,81.94,1439323774,147.674,38.7,10.641,15308.712,261.899,9.74,0.752,1
42,123,166,87655,2,4661,0,90000000,81.94,1439323774,147.674,38.7,10.641,15308.712,261.899,9.74,0.752,1
42,124,172,87827,6,4667,0,90000000,81.94,1439323774,147.674,38.7,10.641,15308.712,261.899,9.74,0.752,1
42,125,158,87985,2,4669,0,90000000,81.94,1439323774,147.674,38.7,10.641,15308.712,261.899,9.74,0.752,1
42,126,114,88099,3,4672,0,90000000,81.94,1439323774,147.674,38.7,10.641,15308.712,261.899,9.74,0.752,1
42,127,107,88206,4,4676,0,90000000,81.94,1439323774,147.674,38.7,10.641,15308.712,261.899,9.74,0.752,1
42,128,122,88328,1,4677,0,160000000,81.94,1439323774,147.674,38.7,10.641,15308.712,261.899,9.74,0.752,1
42,129,132,88460,3,4680,0,160000000,81.94,1439323774,147.674,38.7,10.641,15308.712,261.899,9.74,0.752,1
42,130,120,88580,1,4681,0,160000000,81.94,1439323774,147.674,38.7,10.641,15308.712,261.899,9.74,0.752,1
42,131,92,88672,0,4681,0,160000000,81.94,1439323774,147.674,38.7,10.641,15308.712,261.899,9.74,0.752,1
42,132,121,88793,5,4686,0,160000000,81.94,1439323774,147.674,38.7,10.641,15308.712,261.899,9.74,0.752,1
42,133,113,88906,4,4690,0,160000000,81.94,1439323774,147.674,38.7,10.641,15308.712,261.899,9.74,0.752,1
42,134,58,88964,3,4693,0,160000000,81.94,1439323774,147.674,38.7,10.641,15308.712,261.899,9.74,0.752,1
42,135,81,89045,4,4697,0,160000000,81.94,1439323774,147.674,38.7,10.641,15308.712,261.899,9.74,0.752,1
42,136,99,89144,3,4700,0,160000000,81.94,1439323774,147.674,38.7,10.641,15308.712,261.899,9.74,0.752,1
42,137,70,89214,1,4701,0,160000000,81.94,1439323774,147.674,38.7,10.641,15308.712,261.899,9.74,0.752,1
42,138,65,89279,2,4703,0,160000000,81.94,1439323774,147.674,38.7,10.641,15308.712,261.899,9.74,0.752,1
42,139,96,89375,0,4703,0,160000000,81.94,1439323774,147.674,38.7,10.641,15308.712,261.899,9.74,0.752,1
42,140,66,89441,0,4703,0,160000000,81.94,1439323774,147.674,38.7,10.641,15308.712,261.899,9.74,0.752,1
42,141,53,89494,2,4705,0,160000000,81.94,1439323774,147.674,38.7,10.641,15308.712,261.899,9.74,0.752,1
42,142,33,89527,1,4706,0,160000000,81.94,1439323774,147.674,38.7,10.641,15308.712,261.899,9.74,0.752,1
42,143,40,89567,3,4709,0,160000000,81.94,1439323774,147.674,38.7,10.641,15308.712,261.899,9.74,0.752,1
42,144,49,89616,2,4711,0,160000000,81.94,1439323774,147.674,38.7,10.641,15308.712,261.899,9.74,0.752,1
42,145,38,89654,0,4711,0,160000000,81.94,1439323774,147.674,38.7,10.641,15308.712,261.899,9.74,0.752,1
42,146,41,89695,0,4711,0,160000000,81.94,1439323774,147.674,38.7,10.641,15308.712,261.899,9.74,0.752,1
42,147,23,89718,0,4711,0,160000000,81.94,1439323774,147.674,38.7,10.641,15308.712,261.899,9.74,0.752,1
42,148,34,89752,1,4712,0,160000000,81.94,1439323774,147.674,38.7,10.641,15308.712,261.899,9.74,0.752,1
42,149,32,89784,1,4713,0,160000000,81.94,1439323774,147.674,38.7,10.641,15308.712,261.899,9.74,0.752,1
42,150,30,89814,2,4715,0,160000000,81.94,1439323774,147.674,38.7,10.641,15308.712,261.899,9.74,0.752,1
42,151,22,89836,3,4718,0,160000000,81.94,1439323774,147.674,38.7,10.641,15308.712,261.899,9.74,0.752,1
42,152,27,89863,3,4721,0,160000000,81.94,1439323774,147.674,38.7,10.641,15308.712,261.899,9.74,0.752,1
42,153,32,89895,1,4722,0,160000000,81.94,1439323774,147.674,38.7,10.641,15308.712,261.899,9.74,0.752,1
42,154,19,89914,1,4723,0,160000000,81.94,1439323774,147.674,38.7,10.641,15308.712,261.899,9.74,0.752,1
42,155,20,89934,1,4724,0,160000000,81.94,1439323774,147.674,38.7,10.641,15308.712,261.899,9.74,0.752,1
42,156,19,89953,3,4727,0,160000000,81.94,1439323774,147.674,38.7,10.641,15308.712,261.899,9.74,0.752,1
42,157,33,89986,1,4728,0,160000000,81.94,1439323774,147.674,38.7,10.641,15308.712,261.899,9.74,0.752,1
42,158,22,90008,0,4728,0,160000000,81.94,1439323774,147.674,38.7,10.641,15308.712,261.899,9.74,0.752,1
42,159,17,90025,0,4728,0,160000000,78.24,1439323774,147.674,38.7,10.641,15308.712,261.899,9.74,0.752,1
42,160,33,90058,2,4730,0,160000000,78.24,1439323774,147.674,38.7,10.641,15308.712,261.899,9.74,0.752,1
42,161,21,90079,2,4732,0,160000000,78.24,1439323774,147.674,38.7,10.641,15308.712,261.899,9.74,0.752,1
42,162,8,90087,1,4733,0,160000000,78.24,1439323774,147.674,38.7,10.641,15308.712,261.899,9.74,0.752,1
42,163,13,90100,0,4733,0,160000000,78.24,1439323774,147.674,38.7,10.641,15308.712,261.899,9.74,0.752,1
42,164,27,90127,0,4733,0,160000000,78.24,1439323774,147.674,38.7,10.641,15308.712,261.899,9.74,0.752,1
42,165,18,90145,0,4733,0,160000000,78.24,1439323774,147.674,38.7,10.641,15308.712,261.899,9.74,0.752,1
42,166,23,90168,1,4734,0,160000000,78.24,1439323774,147.674,38.7,10.641,15308.712,261.899,9.74,0.752,1
42,167,29,90197,0,4734,0,160000000,78.24,1439323774,147.674,38.7,10.641,15308.712,261.899,9.74,0.752,1
42,168,22,90219,1,4735,0,160000000,81.94,1439323774,147.674,38.7,10.641,15308.712,261.899,9.74,0.752,1
42,169,24,90243,1,4736,0,160000000,81.94,1439323774,147.674,38.7,10.641,15308.712,261.899,9.74,0.752,1
42,170,7,90250,0,4736,0,160000000,81.94,1439323774,147.674,38.7,10.641,15308.712,261.899,9.74,0.752,1
42,171,44,90294,0,4736,0,160000000,81.94,1439323774,147.674,38.7,10.641,15308.712,261.899,9.74,0.752,1
42,172,14,90308,1,4737,0,160000000,81.94,1439323774,147.674,38.7,10.641,15308.712,261.899,9.74,0.752,1
42,173,25,90333,0,4737,0,160000000,81.94,1439323774,147.674,38.7,10.641,15308.712,261.899,9.74,0.752,1
42,174,36,90369,0,4737,0,160000000,75.46,1439323774,147.674,38.7,10.641,15308.712,261.899,9.74,0.752,1
42,175,12,90381,0,4737,0,160000000,71.76,1439323774,147.674,38.7,10.641,15308.712,261.899,9.74,0.752,1
42,176,18,90399,0,4737,0,160000000,63.43,1439323774,147.674,38.7,10.641,15308.712,261.899,9.74,0.752,1
42,177,10,90409,1,4738,0,160000000,63.43,1439323774,147.674,38.7,10.641,15308.712,261.899,9.74,0.752,1
42,178,15,90424,0,4738,0,160000000,63.43,1439323774,147.674,38.7,10.641,15308.712,261.899,9.74,0.752,1
42,179,17,90441,1,4739,0,160000000,54.17,1439323774,147.674,38.7,10.641,15308.712,261.899,9.74,0.752,1
42,180,15,90456,0,4739,0,160000000,54.17,1439323774,147.674,38.7,10.641,15308.712,261.899,9.74,0.752,1
42,181,27,90483,0,4739,0,160000000,54.17,1439323774,147.674,38.7,10.641,15308.712,261.899,9.74,0.752,1
42,182,22,90505,0,4739,0,160000000,54.17,1439323774,147.674,38.7,10.641,15308.712,261.899,9.74,0.752,1
42,183,23,90528,0,4739,0,160000000,54.17,1439323774,147.674,38.7,10.641,15308.712,261.899,9.74,0.752,1
42,184,0,90528,0,4739,0,160000000,54.17,1439323774,147.674,38.7,10.641,15308.712,261.899,9.74,0.752,1
42,185,39,90567,0,4739,0,160000000,54.17,1439323774,147.674,38.7,10.641,15308.712,261.899,9.74,0.752,1
42,186,17,90584,0,4739,0,160000000,54.17,1439323774,147.674,38.7,10.641,15308.712,261.899,9.74,0.752,1
42,187,20,90604,0,4739,0,160000000,54.17,1439323774,147.674,38.7,10.641,15308.712,261.899,9.74,0.752,1
42,188,25,90629,0,4739,0,160000000,54.17,1439323774,147.674,38.7,10.641,15308.712,261.899,9.74,0.752,1
42,189,23,90652,0,4739,0,160000000,54.17,1439323774,147.674,38.7,10.641,15308.712,261.899,9.74,0.752,1
42,190,15,90667,0,4739,0,160000000,54.17,1439323774,147.674,38.7,10.641,15308.712,261.899,9.74,0.752,1
42,191,22,90689,0,4739,0,160000000,54.17,1439323774,147.674,38.7,10.641,15308.712,261.899,9.74,0.752,1
42,192,39,90728,0,4739,0,160000000,54.17,1439323774,147.674,38.7,10.641,15308.712,261.899,9.74,0.752,1
42,193,29,90757,0,4739,0,160000000,54.17,1439323774,147.674,38.7,10.641,15308.712,261.899,9.74,0.752,1
42,194,21,90778,0,4739,0,160000000,54.17,1439323774,147.674,38.7,10.641,15308.712,261.899,9.74,0.752,1
42,195,34,90812,0,4739,0,160000000,54.17,1439323774,147.674,38.7,10.641,15308.712,261.899,9.74,0.752,1
42,196,18,90830,0,4739,0,160000000,54.17,1439323774,147.674,38.7,10.641,15308.712,261.899,9.74,0.752,1
42,197,28,90858,0,4739,0,160000000,54.17,1439323774,147.674,38.7,10.641,15308.712,261.899,9.74,0.752,1
42,198,11,90869,0,4739,0,160000000,54.17,1439323774,147.674,38.7,10.641,15308.712,261.899,9.74,0.752,1
42,199,36,90905,0,4739,0,160000000,54.17,1439323774,147.674,38.7,10.641,15308.712,261.899,9.74,0.752,1
42,200,20,90925,0,4739,0,160000000,54.17,1439323774,147.674,38.7,10.641,15308.712,261.899,9.74,0.752,1
42,201,30,90955,0,4739,0,160000000,54.17,1439323774,147.674,38.7,10.641,15308.712,261.899,9.74,0.752,1
42,202,17,90972,0,4739,0,160000000,54.17,1439323774,147.674,38.7,10.641,15308.712,261.899,9.74,0.752,1
42,203,34,91006,0,4739,0,160000000,54.17,1439323774,147.674,38.7,10.641,15308.712,261.899,9.74,0.752,1
42,204,16,91022,0,4739,0,160000000,54.17,1439323774,147.674,38.7,10.641,15308.712,261.899,9.74,0.752,1
43,1,108,906,2,16,2390,20253,87.96,50882884,44.223,32.2,7.646,13254.949,124.24,7.44,0.747,4
43,2,159,1065,1,17,1159,21412,87.96,50882884,44.223,32.2,7.646,13254.949,124.24,7.44,0.747,4
43,3,96,1161,2,19,1340,22752,87.96,50882884,44.223,32.2,7.646,13254.949,124.24,7.44,0.747,4
43,4,106,1267,6,25,1104,23856,87.96,50882884,44.223,32.2,7.646,13254.949,124.24,7.44,0.747,4
43,5,139,1406,7,32,1691,25547,87.96,50882884,44.223,32.2,7.646,13254.949,124.24,7.44,0.747,4
43,6,79,1485,3,35,2421,27968,87.96,50882884,44.223,32.2,7.646,13254.949,124.24,7.44,0.747,4
43,7,94,1579,11,46,2760,30728,87.96,50882884,44.223,32.2,7.646,13254.949,124.24,7.44,0.747,4
43,8,201,1780,4,50,3130,33858,87.96,50882884,44.223,32.2,7.646,13254.949,124.24,7.44,0.747,4
43,9,274,2054,5,55,1335,35193,87.96,50882884,44.223,32.2,7.646,13254.949,124.24,7.44,0.747,4
43,10,169,2223,14,69,2683,37876,87.96,50882884,44.223,32.2,7.646,13254.949,124.24,7.44,0.747,4
43,11,250,2473,11,80,2742,40618,87.96,50882884,44.223,32.2,7.646,13254.949,124.24,7.44,0.747,4
43,12,236,2709,20,100,1162,41780,87.96,50882884,44.223,32.2,7.646,13254.949,124.24,7.44,0.747,4
43,13,67,2776,9,109,1256,43036,87.96,50882884,44.223,32.2,7.646,13254.949,124.24,7.44,0.747,4
43,14,76,2852,3,112,2315,45351,84.26,50882884,44.223,32.2,7.646,13254.949,124.24,7.44,0.747,4
43,15,127,2979,15,127,3205,48556,84.26,50882884,44.223,32.2,7.646,13254.949,124.24,7.44,0.747,4
43,16,126,3105,4,131,3457,52013,84.26,50882884,44.223,32.2,7.646,13254.949,124.24,7.44,0.747,4
43,17,128,3233,13,144,3488,55501,84.26,50882884,44.223,32.2,7.646,13254.949,124.24,7.44,0.747,4
43,18,206,3439,9,153,3429,58930,84.26,50882884,44.223,32.2,7.646,13254.949,124.24,7.44,0.747,4
43,19,182,3621,13,166,3744,62674,84.26,50882884,44.223,32.2,7.646,13254.949,124.24,7.44,0.747,4
43,20,171,3792,13,179,2423,65097,84.26,50882884,44.223,32.2,7.646,13254.949,124.24,7.44,0.747,4
43,21,185,3977,10,189,3259,68356,84.26,50882884,44.223,32.2,7.646,13254.949,124.24,7.44,0.747,4
43,22,172,4149,7,196,3051,71407,84.26,50882884,44.223,32.2,7.646,13254.949,124.24,7.44,0.747,4
43,23,207,4356,10,206,3457,74864,84.26,50882884,44.223,32.2,7.646,13254.949,124.24,7.44,0.747,4
43,24,205,4561,9,215,3121,77985,87.04,50882884,44.223,32.2,7.646,13254.949,124.24,7.44,0.747,4
43,25,320,4881,10,225,3068,81053,87.04,50882884,44.223,32.2,7.646,13254.949,124.24,7.44,0.747,4
43,26,261,5142,8,233,6053,87106,87.04,50882884,44.223,32.2,7.646,13254.949,124.24,7.44,0.747,4
43,27,237,5379,10,243,3793,90899,90.74,50882884,44.223,32.2,7.646,13254.949,124.24,7.44,0.747,4
43,28,218,5597,10,253,4186,95085,90.74,50882884,44.223,32.2,7.646,13254.949,124.24,7.44,0.747,4
43,29,352,5949,16,269,5068,100153,90.74,50882884,44.223,32.2,7.646,13254.949,124.24,7.44,0.747,4
43,30,262,6211,9,278,4504,104657,90.74,50882884,44.223,32.2,7.646,13254.949,124.24,7.44,0.747,4
43,31,296,6507,15,293,4293,108950,90.74,50882884,44.223,32.2,7.646,13254.949,124.24,7.44,0.747,4
43,32,499,7006,21,314,5652,114602,90.74,50882884,44.223,32.2,7.646,13254.949,124.24,7.44,0.747,4
43,33,279,7285,10,324,4199,118801,90.74,50882884,44.223,32.2,7.646,13254.949,124.24,7.44,0.747,4
43,34,383,7668,16,340,4228,123029,90.74,50882884,44.223,32.2,7.646,13254.949,124.24,7.44,0.747,4
43,35,305,7973,18,358,4076,127105,90.74,50882884,44.223,32.2,7.646,13254.949,124.24,7.44,0.747,4
43,36,640,8613,20,378,4005,131110,87.04,50882884,44.223,32.2,7.646,13254.949,124.24,7.44,0.747,4
43,37,346,8959,19,397,4242,135352,87.04,50882884,44.223,32.2,7.646,13254.949,124.24,7.44,0.747,4
43,38,497,9456,10,407,4387,139739,87.04,50882884,44.223,32.2,7.646,13254.949,124.24,7.44,0.747,4
43,39,595,10051,21,428,5173,144912,87.04,50882884,44.223,32.2,7.646,13254.949,124.24,7.44,0.747,4
43,40,444,10495,17,445,6484,151396,87.04,50882884,44.223,32.2,7.646,13254.949,124.24,7.44,0.747,4
43,41,568,11063,18,463,7537,158933,87.04,50882884,44.223,32.2,7.646,13254.949,124.24,7.44,0.747,4
43,42,550,11613,16,479,6805,165738,87.04,50882884,44.223,32.2,7.646,13254.949,124.24,7.44,0.747,4
43,43,659,12272,14,493,6061,171799,87.04,50882884,44.223,32.2,7.646,13254.949,124.24,7.44,0.747,4
43,44,658,12930,16,509,5251,177050,87.04,50882884,44.223,32.2,7.646,13254.949,124.24,7.44,0.747,4
43,45,680,13610,16,525,6062,183112,87.04,50882884,44.223,32.2,7.646,13254.949,124.24,7.44,0.747,4
43,46,606,14216,21,546,7002,190114,87.04,50882884,44.223,32.2,7.646,13254.949,124.24,7.44,0.747,4
43,47,723,14939,16,562,6303,196417,87.04,50882884,44.223,32.2,7.646,13254.949,124.24,7.44,0.747,4
43,48,635,15574,12,574,5391,201808,87.04,50882884,44.223,32.2,7.646,13254.949,124.24,7.44,0.747,4
43,49,721,16295,18,592,6238,208046,87.04,50882884,44.223,32.2,7.646,13254.949,124.24,7.44,0.747,4
43,50,640,16935,21,613,6490,214536,87.04,50882884,44.223,32.2,7.646,13254.949,124.24,7.44,0.747,4
43,51,752,17687,17,630,7674,222210,87.04,50882884,44.223,32.2,7.646,13254.949,124.24,7.44,0.747,4
43,52,643,18330,22,652,13738,235948,87.04,50882884,44.223,32.2,7.646,13254.949,124.24,7.44,0.747,4
43,53,801,19131,30,682,7171,243119,87.04,50882884,44.223,32.2,7.646,13254.949,124.24,7.44,0.747,4
43,54,1046,20177,23,705,9623,252742,87.04,50882884,44.223,32.2,7.646,13254.949,124.24,7.44,0.747,4
43,55,998,21175,22,727,8070,260812,87.04,50882884,44.223,32.2,7.646,13254.949,124.24,7.44,0.747,4
43,56,806,21981,23,750,10306,271118,87.04,50882884,44.223,32.2,7.646,13254.949,124.24,7.44,0.747,4
43,57,1022,23003,26,776,12366,283484,87.04,50882884,44.223,32.2,7.646,13254.949,124.24,7.44,0.747,4
43,58,1101,24104,27,803,12130,295614,87.04,50882884,44.223,32.2,7.646,13254.949,124.24,7.44,0.747,4
43,59,1262,25366,19,822,10797,306411,87.04,50882884,44.223,32.2,7.646,13254.949,124.24,7.44,0.747,4
43,60,1322,26688,31,853,13368,319779,87.04,50882884,44.223,32.2,7.646,13254.949,124.24,7.44,0.747,4
43,61,1548,28236,37,890,12038,331817,87.04,50882884,44.223,32.2,7.646,13254.949,124.24,7.44,0.747,4
43,62,1147,29383,49,939,9325,341142,87.04,50882884,44.223,32.2,7.646,13254.949,124.24,7.44,0.747,4
43,63,1110,30493,30,969,9071,350213,87.04,50882884,44.223,32.2,7.646,13254.949,124.24,7.44,0.747,4
43,64,1340,31833,40,1009,12219,362432,87.04,50882884,44.223,32.2,7.646,13254.949,124.24,7.44,0.747,4
43,65,1521,33354,36,1045,12160,374592,87.04,50882884,44.223,32.2,7.646,13254.949,124.24,7.44,0.747,4
43,66,1766,35120,42,1087,12346,386938,87.04,50882884,44.223,32.2,7.646,13254.949,124.24,7.44,0.747,4
43,67,1515,36635,58,1145,12567,399505,87.04,50882884,44.223,32.2,7.646,13254.949,124.24,7.44,0.747,4
43,68,1392,38027,60,1205,11214,410719,87.04,50882884,44.223,32.2,7.646,13254.949,124.24,7.44,0.747,4
43,69,1209,39236,54,1259,11004,421723,87.04,50882884,44.223,32.2,7.646,13254.949,124.24,7.44,0.747,4
43,70,1483,40719,49,1308,11147,432870,87.04,50882884,44.223,32.2,7.646,13254.949,124.24,7.44,0.747,4
43,71,1359,42078,64,1372,12063,444933,87.04,50882884,44.223,32.2,7.646,13254.949,124.24,7.44,0.747,4
43,72,1604,43682,61,1433,13391,458324,87.04,50882884,44.223,32.2,7.646,13254.949,124.24,7.44,0.747,4
43,73,0,43682,0,1433,12027,470351,87.04,50882884,44.223,32.2,7.646,13254.949,124.24,7.44,0.747,4
43,74,3176,46858,112,1545,12481,482832,87.04,50882884,44.223,32.2,7.646,13254.949,124.24,7.44,0.747,4
43,75,1888,48746,47,1592,12192,495024,87.04,50882884,44.223,32.2,7.646,13254.949,124.24,7.44,0.747,4
43,76,2193,50939,75,1667,12564,507588,87.04,50882884,44.223,32.2,7.646,13254.949,124.24,7.44,0.747,4
43,77,2124,53063,59,1726,12402,519990,87.04,50882884,44.223,32.2,7.646,13254.949,124.24,7.44,0.747,4
43,78,1868,54931,75,1801,15230,535220,87.04,50882884,44.223,32.2,7.646,13254.949,124.24,7.44,0.747,4
43,79,2115,57046,63,1864,15391,550611,87.04,50882884,44.223,32.2,7.646,13254.949,124.24,7.44,0.747,4
43,80,3171,60217,86,1950,17713,568324,87.04,50882884,44.223,32.2,7.646,13254.949,124.24,7.44,0.747,4
43,81,3059,63276,95,2045,17498,585822,87.04,50882884,44.223,32.2,7.646,13254.949,124.24,7.44,0.747,4
43,82,2357,65633,81,2126,18451,604273,87.04,50882884,44.223,32.2,7.646,13254.949,124.24,7.44,0.747,4
43,83,3019,68652,111,2237,16015,620288,87.04,50882884,44.223,32.2,7.646,13254.949,124.24,7.44,0.747,4
43,84,2531,71183,73,2310,14323,634611,87.04,50882884,44.223,32.2,7.646,13254.949,124.24,7.44,0.747,4
43,85,2389,73572,94,2404,16981,651592,87.04,50882884,44.223,32.2,7.646,13254.949,124.24,7.44,0.747,4
43,86,3541,77113,87,2491,18501,670093,87.04,50882884,44.223,32.2,7.646,13254.949,124.24,7.44,0.747,4
43,87,3486,80599,163,2654,18866,688959,87.04,50882884,44.223,32.2,7.646,13254.949,124.24,7.44,0.747,4
43,88,3843,84442,157,2811,18729,707688,87.04,50882884,44.223,32.2,7.646,13254.949,124.24,7.44,0.747,4
43,89,4149,88591,128,2939,18140,725828,87.04,50882884,44.223,32.2,7.646,13254.949,124.24,7.44,0.747,4
43,90,3178,91769,167,3106,17609,743437,87.04,50882884,44.223,32.2,7.646,13254.949,124.24,7.44,0.747,4
43,91,3274,95043,117,3223,17282,760719,87.04,50882884,44.223,32.2,7.646,13254.949,124.24,7.44,0.747,4
43,92,2803,97846,111,3334,18054,778773,87.04,50882884,44.223,32.2,7.646,13254.949,124.24,7.44,0.747,4
43,93,4163,102009,136,3470,19335,798108,87.04,50882884,44.223,32.2,7.646,13254.949,124.24,7.44,0.747,4
43,94,4101,106110,171,3641,20595,818703,87.04,50882884,44.223,32.2,7.646,13254.949,124.24,7.44,0.747,4
43,95,3395,109505,136,3777,21028,839731,87.04,50882884,44.223,32.2,7.646,13254.949,124.24,7.44,0.747,4
43,96,3884,113389,165,3942,21000,860731,87.04,50882884,44.223,32.2,7.646,13254.949,124.24,7.44,0.747,4
43,97,3721,117110,122,4064,20459,881190,87.04,50882884,44.223,32.2,7.646,13254.949,124.24,7.44,0.747,4
43,98,3171,120281,146,4210,21115,902305,87.04,50882884,44.223,32.2,7.646,13254.949,124.24,7.44,0.747,4
43,99,4213,124494,149,4359,21409,923714,87.04,50882884,44.223,32.2,7.646,13254.949,124.24,7.44,0.747,4
43,100,4144,128638,168,4527,21526,945240,87.04,50882884,44.223,32.2,7.646,13254.949,124.24,7.44,0.747,4
43,101,5335,133973,187,4714,23225,968465,87.04,50882884,44.223,32.2,7.646,13254.949,124.24,7.44,0.747,4
43,102,6803,140776,211,4925,37628,1006093,87.04,50882884,44.223,32.2,7.646,13254.949,124.24,7.44,0.747,4
43,103,4586,145362,194,5119,25137,1031230,87.04,50882884,44.223,32.2,7.646,13254.949,124.24,7.44,0.747,4
43,104,5083,150445,188,5307,25584,1056814,87.04,50882884,44.223,32.2,7.646,13254.949,124.24,7.44,0.747,4
43,105,3782,154227,148,5455,25601,1082415,87.04,50882884,44.223,32.2,7.646,13254.949,124.24,7.44,0.747,4
43,106,5671,159898,170,5625,25733,1108148,87.04,50882884,44.223,32.2,7.646,13254.949,124.24,7.44,0.747,4
43,107,5271,165169,189,5814,25359,1133507,87.04,50882884,44.223,32.2,7.646,13254.949,124.24,7.44,0.747,4
43,108,8037,173206,215,6029,26055,1159562,87.04,50882884,44.223,32.2,7.646,13254.949,124.24,7.44,0.747,4
43,109,8934,182140,259,6288,26422,1185984,87.04,50882884,44.223,32.2,7.646,13254.949,124.24,7.44,0.747,4
43,110,8560,190700,228,6516,24079,1210063,87.04,50882884,44.223,32.2,7.646,13254.949,124.24,7.44,0.747,4
43,111,6578,197278,220,6736,26473,1236536,87.04,50882884,44.223,32.2,7.646,13254.949,124.24,7.44,0.747,4
43,112,6727,204005,193,6929,27164,1263700,87.04,50882884,44.223,32.2,7.646,13254.949,124.24,7.44,0.747,4
43,113,7033,211038,237,7166,28801,1292501,87.04,50882884,44.223,32.2,7.646,13254.949,124.24,7.44,0.747,4
43,114,7390,218428,207,7373,28434,1320935,87.04,50882884,44.223,32.2,7.646,13254.949,124.24,7.44,0.747,4
43,115,7945,226373,315,7688,28567,1349502,87.04,50882884,44.223,32.2,7.646,13254.949,124.24,7.44,0.747,4
43,116,7168,233541,287,7975,29541,1379043,87.04,50882884,44.223,32.2,7.646,13254.949,124.24,7.44,0.747,4
43,117,7254,240795,294,8269,30081,1409124,87.04,50882884,44.223,32.2,7.646,13254.949,124.24,7.44,0.747,4
43,118,8181,248976,256,8525,30312,1439436,87.04,50882884,44.223,32.2,7.646,13254.949,124.24,7.44,0.747,4
43,119,8125,257101,252,8777,31177,1470613,87.04,50882884,44.223,32.2,7.646,13254.949,124.24,7.44,0.747,4
43,120,10284,267385,297,9074,32196,1502809,87.04,50882884,44.223,32.2,7.646,13254.949,124.24,7.44,0.747,4
43,121,8670,276055,380,9454,34880,1537689,87.04,50882884,44.223,32.2,7.646,13254.949,124.24,7.44,0.747,4
43,122,9965,286020,356,9810,35990,1573679,87.04,50882884,44.223,32.2,7.646,13254.949,124.24,7.44,0.747,4
43,123,9488,295508,295,10105,36050,1609729,87.04,50882884,44.223,32.2,7.646,13254.949,124.24,7.44,0.747,4
43,124,10673,306181,225,10330,37666,1647395,87.04,50882884,44.223,32.2,7.646,13254.949,124.24,7.44,0.747,4
43,125,11470,317651,320,10650,38135,1685530,87.04,50882884,44.223,32.2,7.646,13254.949,124.24,7.44,0.747,4
43,126,10199,327850,367,11017,37978,1723508,87.04,50882884,44.223,32.2,7.646,13254.949,124.24,7.44,0.747,4
43,127,7129,334979,298,11315,38264,1761772,87.04,50882884,44.223,32.2,7.646,13254.949,124.24,7.44,0.747,4
43,128,10735,345714,309,11624,40063,1801835,87.04,50882884,44.223,32.2,7.646,13254.949,124.24,7.44,0.747,4
43,129,11996,357710,315,11939,40457,1842292,87.04,50882884,44.223,32.2,7.646,13254.949,124.24,7.44,0.747,4
43,130,9486,367196,311,12250,35076,1877368,87.04,50882884,44.223,32.2,7.646,13254.949,124.24,7.44,0.747,4
43,131,9674,376870,290,12540,31743,1909111,87.04,50882884,44.223,32.2,7.646,13254.949,124.24,7.44,0.747,4
43,132,10611,387481,302,12842,33619,1942730,87.04,50882884,44.223,32.2,7.646,13254.949,124.24,7.44,0.747,4
43,133,10142,397623,312,13154,40101,1982831,87.04,50882884,44.223,32.2,7.646,13254.949,124.24,7.44,0.747,4
43,134,12830,410453,321,13475,40425,2023256,87.04,50882884,44.223,32.2,7.646,13254.949,124.24,7.44,0.747,4
43,135,12066,422519,362,13837,40076,2063332,87.04,50882884,44.223,32.2,7.646,13254.949,124.24,7.44,0.747,4
43,136,11286,433805,308,14145,41434,2104766,87.04,50882884,44.223,32.2,7.646,13254.949,124.24,7.44,0.747,4
43,137,11306,445111,347,14492,38331,2143097,87.04,50882884,44.223,32.2,7.646,13254.949,124.24,7.44,0.747,4
43,138,11578,456689,318,14810,34892,2177989,87.04,50882884,44.223,32.2,7.646,13254.949,124.24,7.44,0.747,4
43,139,11643,468332,287,15097,32723,2210712,87.04,50882884,44.223,32.2,7.646,13254.949,124.24,7.44,0.747,4
43,140,8328,476660,275,15372,35883,2246595,87.04,50882884,44.223,32.2,7.646,13254.949,124.24,7.44,0.747,4
43,141,12462,489122,247,15619,30920,2277515,87.04,50882884,44.223,32.2,7.646,13254.949,124.24,7.44,0.747,4
43,142,13056,502178,360,15979,31932,2309447,87.04,50882884,44.223,32.2,7.646,13254.949,124.24,7.44,0.747,4
43,143,11541,513719,204,16183,30654,2340101,87.04,50882884,44.223,32.2,7.646,13254.949,124.24,7.44,0.747,4
43,144,8419,522138,385,16568,33967,2374068,87.04,50882884,44.223,32.2,7.646,13254.949,124.24,7.44,0.747,4
43,145,10965,533103,400,16968,22824,2396892,87.04,50882884,44.223,32.2,7.646,13254.949,124.24,7.44,0.747,4
43,146,8044,541147,348,17316,31049,2427941,87.04,50882884,44.223,32.2,7.646,13254.949,124.24,7.44,0.747,4
43,147,10549,551696,296,17612,30925,2458866,87.04,50882884,44.223,32.2,7.646,13254.949,124.24,7.44,0.747,4
43,148,10432,562128,277,17889,30564,2489430,87.04,50882884,44.223,32.2,7.646,13254.949,124.24,7.44,0.747,4
43,149,10142,572270,295,18184,30079,2519509,87.04,50882884,44.223,32.2,7.646,13254.949,124.24,7.44,0.747,4
43,150,9752,582022,284,18468,28349,2547858,87.04,50882884,44.223,32.2,7.646,13254.949,124.24,7.44,0.747,4
43,151,8498,590520,299,18767,24966,2572824,87.04,50882884,44.223,32.2,7.646,13254.949,124.24,7.44,0.747,4
43,152,9394,599914,297,19064,26879,2599703,87.04,50882884,44.223,32.2,7.646,13254.949,124.24,7.44,0.747,4
43,153,8024,607938,300,19364,25349,2625052,87.04,50882884,44.223,32.2,7.646,13254.949,124.24,7.44,0.747,4
43,154,7230,615168,299,19663,22650,2647702,71.3,50882884,44.223,32.2,7.646,13254.949,124.24,7.44,0.747,4
43,155,8901,624069,389,20052,28452,2676154,71.3,50882884,44.223,32.2,7.646,13254.949,124.24,7.44,0.747,4
43,156,9270,633339,296,20348,23735,2699889,71.3,50882884,44.223,32.2,7.646,13254.949,124.24,7.44,0.747,4
43,157,8235,641574,270,20618,28534,2728423,71.3,50882884,44.223,32.2,7.646,13254.949,124.24,7.44,0.747,4
43,158,8488,650062,270,20888,24609,2753032,71.3,50882884,44.223,32.2,7.646,13254.949,124.24,7.44,0.747,4
43,159,8394,658456,268,21156,23112,2776144,71.3,50882884,44.223,32.2,7.646,13254.949,124.24,7.44,0.747,4
43,160,8065,666521,256,21412,21856,2798000,71.3,50882884,44.223,32.2,7.646,13254.949,124.24,7.44,0.747,4
43,161,5327,671848,203,21615,21479,2819479,71.3,50882884,44.223,32.2,7.646,13254.949,124.24,7.44,0.747,4
43,162,7665,679513,202,21817,24030,2843509,71.3,50882884,44.223,32.2,7.646,13254.949,124.24,7.44,0.747,4
43,163,7343,686856,236,22053,24782,2868291,71.3,50882884,44.223,32.2,7.646,13254.949,124.24,7.44,0.747,4
43,164,7808,694664,222,22275,28683,2896974,71.3,50882884,44.223,32.2,7.646,13254.949,124.24,7.44,0.747,4
43,165,7424,702088,243,22518,24370,2921344,71.3,50882884,44.223,32.2,7.646,13254.949,124.24,7.44,0.747,4
43,166,6876,708964,216,22734,26530,2947874,71.3,50882884,44.223,32.2,7.646,13254.949,124.24,7.44,0.747,4
43,167,7355,716319,190,22924,22386,2970260,71.3,50882884,44.223,32.2,7.646,13254.949,124.24,7.44,0.747,4
43,168,5573,721892,199,23123,23949,2994209,71.3,50882884,44.223,32.2,7.646,13254.949,124.24,7.44,0.747,4
43,169,6698,728590,165,23288,24737,3018946,71.3,50882884,44.223,32.2,7.646,13254.949,124.24,7.44,0.747,4
43,170,7787,736377,190,23478,24771,3043717,71.3,50882884,44.223,32.2,7.646,13254.949,124.24,7.44,0.747,4
43,171,7568,743945,187,23665,21673,3065390,71.3,50882884,44.223,32.2,7.646,13254.949,124.24,7.44,0.747,4
43,172,6526,750471,185,23850,22386,3087776,71.3,50882884,44.223,32.2,7.646,13254.949,124.24,7.44,0.747,4
43,173,7927,758398,189,24039,24691,3112467,71.3,50882884,44.223,32.2,7.646,13254.949,124.24,7.44,0.747,4
43,174,6678,765076,169,24208,23776,3136243,71.3,50882884,44.223,32.2,7.646,13254.949,124.24,7.44,0.747,4
43,175,5359,770435,189,24397,24348,3160591,71.3,50882884,44.223,32.2,7.646,13254.949,124.24,7.44,0.747,4
43,176,7102,777537,173,24570,25023,3185614,71.3,50882884,44.223,32.2,7.646,13254.949,124.24,7.44,0.747,4
43,177,6731,784268,176,24746,22158,3207772,71.3,50882884,44.223,32.2,7.646,13254.949,124.24,7.44,0.747,4
43,178,6555,790823,178,24924,24727,3232499,71.3,50882884,44.223,32.2,7.646,13254.949,124.24,7.44,0.747,4
43,179,7494,798317,179,25103,22290,3254789,71.3,50882884,44.223,32.2,7.646,13254.949,124.24,7.44,0.747,4
43,180,7721,806038,193,25296,22820,3277609,71.3,50882884,44.223,32.2,7.646,13254.949,124.24,7.44,0.747,4
43,181,7018,813056,192,25488,24867,3302476,71.3,50882884,44.223,32.2,7.646,13254.949,124.24,7.44,0.747,4
43,182,5147,818203,153,25641,21684,3324160,71.3,50882884,44.223,32.2,7.646,13254.949,124.24,7.44,0.747,4
43,183,5839,824042,187,25828,23147,3347307,71.3,50882884,44.223,32.2,7.646,13254.949,124.24,7.44,0.747,4
43,184,5637,829679,170,25998,23504,3370811,71.3,50882884,44.223,32.2,7.646,13254.949,124.24,7.44,0.747,4
43,185,5660,835339,198,26196,28407,3399218,71.3,50882884,44.223,32.2,7.646,13254.949,124.24,7.44,0.747,4
43,186,6192,841531,201,26397,26848,3426066,71.3,50882884,44.223,32.2,7.646,13254.949,124.24,7.44,0.747,4
43,187,6616,848147,159,26556,28094,3454160,71.3,50882884,44.223,32.2,7.646,13254.949,124.24,7.44,0.747,4
43,188,6905,855052,156,26712,23561,3477721,71.3,50882884,44.223,32.2,7.646,13254.949,124.24,7.44,0.747,4
43,189,7106,862158,132,26844,23881,3501602,71.3,50882884,44.223,32.2,7.646,13254.949,124.24,7.44,0.747,4
43,190,7650,869808,173,27017,25357,3526959,71.3,50882884,44.223,32.2,7.646,13254.949,124.24,7.44,0.747,4
43,191,7875,877683,163,27180,23264,3550223,71.3,50882884,44.223,32.2,7.646,13254.949,124.24,7.44,0.747,4
43,192,8496,886179,151,27331,32860,3583083,71.3,50882884,44.223,32.2,7.646,13254.949,124.24,7.44,0.747,4
43,193,8121,894300,164,27495,29201,3612284,71.3,50882884,44.223,32.2,7.646,13254.949,124.24,7.44,0.747,4
43,194,8447,902747,165,27660,26694,3638978,71.3,50882884,44.223,32.2,7.646,13254.949,124.24,7.44,0.747,4
43,195,8569,911316,174,27834,22162,3661140,71.3,50882884,44.223,32.2,7.646,13254.949,124.24,7.44,0.747,4
43,196,7767,919083,151,27985,0,3661140,71.3,50882884,44.223,32.2,7.646,13254.949,124.24,7.44,0.747,4
43,197,5015,924098,156,28141,0,3661140,71.3,50882884,44.223,32.2,7.646,13254.949,124.24,7.44,0.747,4
43,198,6061,930159,165,28306,0,3661140,71.3,50882884,44.223,32.2,7.646,13254.949,124.24,7.44,0.747,4
43,199,6823,936982,151,28457,0,3661140,71.3,50882884,44.223,32.2,7.646,13254.949,124.24,7.44,0.747,4
43,200,8372,945354,159,28616,0,3661140,71.3,50882884,44.223,32.2,7.646,13254.949,124.24,7.44,0.747,4
43,201,7017,952371,187,28803,0,3661140,71.3,50882884,44.223,32.2,7.646,13254.949,124.24,7.44,0.747,4
43,202,7201,959572,167,28970,0,3661140,65.74,50882884,44.223,32.2,7.646,13254.949,124.24,7.44,0.747,4
43,203,6311,965883,132,29102,0,3661140,65.74,50882884,44.223,32.2,7.646,13254.949,124.24,7.44,0.747,4
43,204,8256,974139,170,29272,0,3661140,65.74,50882884,44.223,32.2,7.646,13254.949,124.24,7.44,0.747,4
45,1,3,22,2,2,0,0,97.22,5518092,15.405,19,3.402,4881.406,344.094,7.2,0.606,0
45,2,0,22,0,2,0,0,97.22,5518092,15.405,19,3.402,4881.406,344.094,7.2,0.606,0
45,3,19,41,1,3,0,0,97.22,5518092,15.405,19,3.402,4881.406,344.094,7.2,0.606,0
45,4,0,41,0,3,0,0,97.22,5518092,15.405,19,3.402,4881.406,344.094,7.2,0.606,0
45,5,4,45,2,5,0,0,97.22,5518092,15.405,19,3.402,4881.406,344.094,7.2,0.606,0
45,6,0,45,0,5,0,0,97.22,5518092,15.405,19,3.402,4881.406,344.094,7.2,0.606,0
45,7,0,45,0,5,0,0,97.22,5518092,15.405,19,3.402,4881.406,344.094,7.2,0.606,0
45,8,0,45,0,5,0,0,97.22,5518092,15.405,19,3.402,4881.406,344.094,7.2,0.606,0
45,9,15,60,0,5,0,0,97.22,5518092,15.405,19,3.402,4881.406,344.094,7.2,0.606,0
45,10,0,60,0,5,0,0,97.22,5518092,15.405,19,3.402,4881.406,344.094,7.2,0.606,0
45,11,0,60,0,5,0,0,97.22,5518092,15.405,19,3.402,4881.406,344.094,7.2,0.606,0
45,12,0,60,0,5,0,0,97.22,5518092,15.405,19,3.402,4881.406,344.094,7.2,0.606,0
45,13,10,70,0,5,0,0,97.22,5518092,15.405,19,3.402,4881.406,344.094,7.2,0.606,0
45,14,0,70,0,5,0,0,97.22,5518092,15.405,19,3.402,4881.406,344.094,7.2,0.606,0
45,15,4,74,0,5,0,0,97.22,5518092,15.405,19,3.402,4881.406,344.094,7.2,0.606,0
45,16,43,117,0,5,0,0,97.22,5518092,15.405,19,3.402,4881.406,344.094,7.2,0.606,0
45,17,0,117,0,5,0,0,97.22,5518092,15.405,19,3.402,4881.406,344.094,7.2,0.606,0
45,18,26,143,1,6,0,0,97.22,5518092,15.405,19,3.402,4881.406,344.094,7.2,0.606,0
45,19,0,143,0,6,0,0,97.22,5518092,15.405,19,3.402,4881.406,344.094,7.2,0.606,0
45,20,17,160,0,6,0,0,97.22,5518092,15.405,19,3.402,4881.406,344.094,7.2,0.606,0
45,21,0,160,0,6,0,0,97.22,5518092,15.405,19,3.402,4881.406,344.094,7.2,0.606,0
45,22,5,165,0,6,0,0,97.22,5518092,15.405,19,3.402,4881.406,344.094,7.2,0.606,0
45,23,21,186,0,6,0,0,97.22,5518092,15.405,19,3.402,4881.406,344.094,7.2,0.606,0
45,24,0,186,0,6,0,0,97.22,5518092,15.405,19,3.402,4881.406,344.094,7.2,0.606,0
45,25,14,200,0,6,0,0,97.22,5518092,15.405,19,3.402,4881.406,344.094,7.2,0.606,0
45,26,0,200,2,8,0,0,97.22,5518092,15.405,19,3.402,4881.406,344.094,7.2,0.606,0
45,27,0,200,0,8,0,0,97.22,5518092,15.405,19,3.402,4881.406,344.094,7.2,0.606,0
45,28,7,207,0,8,0,0,97.22,5518092,15.405,19,3.402,4881.406,344.094,7.2,0.606,0
45,29,0,207,0,8,0,0,97.22,5518092,15.405,19,3.402,4881.406,344.094,7.2,0.606,0
45,30,13,220,1,9,0,0,97.22,5518092,15.405,19,3.402,4881.406,344.094,7.2,0.606,0
45,31,0,220,0,9,0,0,97.22,5518092,15.405,19,3.402,4881.406,344.094,7.2,0.606,0
45,32,9,229,1,10,0,0,97.22,5518092,15.405,19,3.402,4881.406,344.094,7.2,0.606,0
45,33,0,229,0,10,0,0,97.22,5518092,15.405,19,3.402,4881.406,344.094,7.2,0.606,0
45,34,0,229,0,10,0,0,97.22,5518092,15.405,19,3.402,4881.406,344.094,7.2,0.606,0
45,35,7,236,0,10,0,0,97.22,5518092,15.405,19,3.402,4881.406,344.094,7.2,0.606,0
45,36,0,236,0,10,0,0,97.22,5518092,15.405,19,3.402,4881.406,344.094,7.2,0.606,0
45,37,28,264,0,10,0,0,97.22,5518092,15.405,19,3.402,4881.406,344.094,7.2,0.606,0
45,38,10,274,0,10,0,0,97.22,5518092,15.405,19,3.402,4881.406,344.094,7.2,0.606,0
45,39,13,287,0,10,0,0,97.22,5518092,15.405,19,3.402,4881.406,344.094,7.2,0.606,0
45,40,0,287,0,10,0,0,97.22,5518092,15.405,19,3.402,4881.406,344.094,7.2,0.606,0
45,41,0,287,0,10,0,0,97.22,5518092,15.405,19,3.402,4881.406,344.094,7.2,0.606,0
45,42,46,333,1,11,0,0,97.22,5518092,15.405,19,3.402,4881.406,344.094,7.2,0.606,0
45,43,0,333,0,11,0,0,97.22,5518092,15.405,19,3.402,4881.406,344.094,7.2,0.606,0
45,44,8,341,0,11,0,0,97.22,5518092,15.405,19,3.402,4881.406,344.094,7.2,0.606,0
45,45,50,391,4,15,0,0,97.22,5518092,15.405,19,3.402,4881.406,344.094,7.2,0.606,0
45,46,0,391,0,15,0,0,97.22,5518092,15.405,19,3.402,4881.406,344.094,7.2,0.606,0
45,47,21,412,0,15,0,0,97.22,5518092,15.405,19,3.402,4881.406,344.094,7.2,0.606,0
45,48,0,412,0,15,0,0,82.41,5518092,15.405,19,3.402,4881.406,344.094,7.2,0.606,0
45,49,0,412,0,15,0,0,82.41,5518092,15.405,19,3.402,4881.406,344.094,7.2,0.606,0
45,50,8,420,0,15,0,0,82.41,5518092,15.405,19,3.402,4881.406,344.094,7.2,0.606,0
45,51,0,420,0,15,0,0,82.41,5518092,15.405,19,3.402,4881.406,344.094,7.2,0.606,0
45,52,49,469,1,16,0,0,82.41,5518092,15.405,19,3.402,4881.406,344.094,7.2,0.606,0
45,53,0,469,0,16,0,0,82.41,5518092,15.405,19,3.402,4881.406,344.094,7.2,0.606,0
45,54,18,487,0,16,0,0,82.41,5518092,15.405,19,3.402,4881.406,344.094,7.2,0.606,0
45,55,0,487,0,16,0,0,82.41,5518092,15.405,19,3.402,4881.406,344.094,7.2,0.606,0
45,56,44,531,1,17,0,0,82.41,5518092,15.405,19,3.402,4881.406,344.094,7.2,0.606,0
45,57,38,569,2,19,0,0,82.41,5518092,15.405,19,3.402,4881.406,344.094,7.2,0.606,0
45,58,2,571,0,19,0,0,82.41,5518092,15.405,19,3.402,4881.406,344.094,7.2,0.606,0
45,59,0,571,0,19,0,0,82.41,5518092,15.405,19,3.402,4881.406,344.094,7.2,0.606,0
45,60,16,587,0,19,0,0,82.41,5518092,15.405,19,3.402,4881.406,344.094,7.2,0.606,0
45,61,0,587,0,19,0,0,82.41,5518092,15.405,19,3.402,4881.406,344.094,7.2,0.606,0
45,62,24,611,1,20,0,0,82.41,5518092,15.405,19,3.402,4881.406,344.094,7.2,0.606,0
45,63,0,611,0,20,0,0,73.15,5518092,15.405,19,3.402,4881.406,344.094,7.2,0.606,0
45,64,0,611,0,20,0,0,73.15,5518092,15.405,19,3.402,4881.406,344.094,7.2,0.606,0
45,65,7,618,0,20,0,0,73.15,5518092,15.405,19,3.402,4881.406,344.094,7.2,0.606,0
45,66,17,635,0,20,0,0,73.15,5518092,15.405,19,3.402,4881.406,344.094,7.2,0.606,0
45,67,4,639,0,20,0,0,73.15,5518092,15.405,19,3.402,4881.406,344.094,7.2,0.606,0
45,68,44,683,2,22,0,0,73.15,5518092,15.405,19,3.402,4881.406,344.094,7.2,0.606,0
45,69,0,683,0,22,0,0,73.15,5518092,15.405,19,3.402,4881.406,344.094,7.2,0.606,0
45,70,0,683,0,22,0,0,73.15,5518092,15.405,19,3.402,4881.406,344.094,7.2,0.606,0
45,71,45,728,2,24,0,0,73.15,5518092,15.405,19,3.402,4881.406,344.094,7.2,0.606,0
45,72,17,745,1,25,0,0,73.15,5518092,15.405,19,3.402,4881.406,344.094,7.2,0.606,0
45,73,0,745,0,25,0,0,73.15,5518092,15.405,19,3.402,4881.406,344.094,7.2,0.606,0
45,74,0,745,0,25,0,0,73.15,5518092,15.405,19,3.402,4881.406,344.094,7.2,0.606,0
45,75,34,779,0,25,0,0,73.15,5518092,15.405,19,3.402,4881.406,344.094,7.2,0.606,0
45,76,0,779,0,25,0,0,73.15,5518092,15.405,19,3.402,4881.406,344.094,7.2,0.606,0
45,77,104,883,2,27,0,0,73.15,5518092,15.405,19,3.402,4881.406,344.094,7.2,0.606,0
45,78,0,883,0,27,0,0,73.15,5518092,15.405,19,3.402,4881.406,344.094,7.2,0.606,0
45,79,0,883,0,27,0,0,73.15,5518092,15.405,19,3.402,4881.406,344.094,7.2,0.606,0
45,80,0,883,0,27,0,0,73.15,5518092,15.405,19,3.402,4881.406,344.094,7.2,0.606,0
45,81,0,883,0,27,0,0,73.15,5518092,15.405,19,3.402,4881.406,344.094,7.2,0.606,0
45,82,130,1013,1,28,0,0,73.15,5518092,15.405,19,3.402,4881.406,344.094,7.2,0.606,0
45,83,0,1013,0,28,0,0,73.15,5518092,15.405,19,3.402,4881.406,344.094,7.2,0.606,0
45,84,74,1087,9,37,0,0,73.15,5518092,15.405,19,3.402,4881.406,344.094,7.2,0.606,0
45,85,0,1087,0,37,0,0,73.15,5518092,15.405,19,3.402,4881.406,344.094,7.2,0.606,0
45,86,0,1087,0,37,0,0,73.15,5518092,15.405,19,3.402,4881.406,344.094,7.2,0.606,0
45,87,117,1204,1,38,0,0,73.15,5518092,15.405,19,3.402,4881.406,344.094,7.2,0.606,0
45,88,0,1204,0,38,0,0,73.15,5518092,15.405,19,3.402,4881.406,344.094,7.2,0.606,0
45,89,41,1245,2,40,0,0,73.15,5518092,15.405,19,3.402,4881.406,344.094,7.2,0.606,0
45,90,0,1245,0,40,0,0,73.15,5518092,15.405,19,3.402,4881.406,344.094,7.2,0.606,0
45,91,0,1245,0,40,0,0,73.15,5518092,15.405,19,3.402,4881.406,344.094,7.2,0.606,0
45,92,0,1245,0,40,0,0,73.15,5518092,15.405,19,3.402,4881.406,344.094,7.2,0.606,0
45,93,137,1382,1,41,0,0,73.15,5518092,15.405,19,3.402,4881.406,344.094,7.2,0.606,0
45,94,0,1382,0,41,0,0,73.15,5518092,15.405,19,3.402,4881.406,344.094,7.2,0.606,0
45,95,175,1557,3,44,0,0,73.15,5518092,15.405,19,3.402,4881.406,344.094,7.2,0.606,0
45,96,0,1557,0,44,0,0,73.15,5518092,15.405,19,3.402,4881.406,344.094,7.2,0.606,0
45,97,0,1557,0,44,0,0,73.15,5518092,15.405,19,3.402,4881.406,344.094,7.2,0.606,0
45,98,0,1557,0,44,0,0,73.15,5518092,15.405,19,3.402,4881.406,344.094,7.2,0.606,0
45,99,0,1557,0,44,0,0,73.15,5518092,15.405,19,3.402,4881.406,344.094,7.2,0.606,0
45,100,264,1821,3,47,0,0,73.15,5518092,15.405,19,3.402,4881.406,344.094,7.2,0.606,0
45,101,0,1821,0,47,0,0,73.15,5518092,15.405,19,3.402,4881.406,344.094,7.2,0.606,0
45,102,207,2028,0,47,0,0,73.15,5518092,15.405,19,3.402,4881.406,344.094,7.2,0.606,0
45,103,0,2028,0,47,0,0,73.15,5518092,15.405,19,3.402,4881.406,344.094,7.2,0.606,0
45,104,75,2103,0,47,0,0,73.15,5518092,15.405,19,3.402,4881.406,344.094,7.2,0.606,0
45,105,0,2103,0,47,0,0,73.15,5518092,15.405,19,3.402,4881.406,344.094,7.2,0.606,0
45,106,119,2222,0,47,0,0,73.15,5518092,15.405,19,3.402,4881.406,344.094,7.2,0.606,0
45,107,136,2358,1,48,0,0,73.15,5518092,15.405,19,3.402,4881.406,344.094,7.2,0.606,0
45,108,0,2358,0,48,0,0,73.15,5518092,15.405,19,3.402,4881.406,344.094,7.2,0.606,0
45,109,275,2633,1,49,0,0,73.15,5518092,15.405,19,3.402,4881.406,344.094,7.2,0.606,0
45,110,0,2633,0,49,0,0,73.15,5518092,15.405,19,3.402,4881.406,344.094,7.2,0.606,0
45,111,0,2633,0,49,0,0,73.15,5518092,15.405,19,3.402,4881.406,344.094,7.2,0.606,0
45,112,218,2851,1,50,0,0,62.04,5518092,15.405,19,3.402,4881.406,344.094,7.2,0.606,0
45,113,0,2851,0,50,0,0,62.04,5518092,15.405,19,3.402,4881.406,344.094,7.2,0.606,0
45,114,0,2851,0,50,0,0,62.04,5518092,15.405,19,3.402,4881.406,344.094,7.2,0.606,0
45,115,187,3038,1,51,0,0,62.04,5518092,15.405,19,3.402,4881.406,344.094,7.2,0.606,0
45,116,0,3038,0,51,0,0,62.04,5518092,15.405,19,3.402,4881.406,344.094,7.2,0.606,0
45,117,0,3038,0,51,0,0,62.04,5518092,15.405,19,3.402,4881.406,344.094,7.2,0.606,0
45,118,0,3038,0,51,0,0,62.04,5518092,15.405,19,3.402,4881.406,344.094,7.2,0.606,0
45,119,162,3200,3,54,0,0,62.04,5518092,15.405,19,3.402,4881.406,344.094,7.2,0.606,0
45,120,0,3200,0,54,0,0,62.04,5518092,15.405,19,3.402,4881.406,344.094,7.2,0.606,0
45,121,0,3200,0,54,0,0,62.04,5518092,15.405,19,3.402,4881.406,344.094,7.2,0.606,0
45,122,176,3376,2,56,0,0,62.04,5518092,15.405,19,3.402,4881.406,344.094,7.2,0.606,0
45,123,0,3376,0,56,0,0,62.04,5518092,15.405,19,3.402,4881.406,344.094,7.2,0.606,0
45,124,11,3387,0,56,0,0,62.04,5518092,15.405,19,3.402,4881.406,344.094,7.2,0.606,0
45,125,0,3387,0,56,0,0,62.04,5518092,15.405,19,3.402,4881.406,344.094,7.2,0.606,0
45,126,159,3546,2,58,0,0,67.59,5518092,15.405,19,3.402,4881.406,344.094,7.2,0.606,0
45,127,0,3546,0,58,0,0,67.59,5518092,15.405,19,3.402,4881.406,344.094,7.2,0.606,0
45,128,0,3546,0,58,0,0,67.59,5518092,15.405,19,3.402,4881.406,344.094,7.2,0.606,0
45,129,91,3637,0,58,0,0,67.59,5518092,15.405,19,3.402,4881.406,344.094,7.2,0.606,0
45,130,0,3637,0,58,0,0,67.59,5518092,15.405,19,3.402,4881.406,344.094,7.2,0.606,0
45,131,27,3664,0,58,0,0,67.59,5518092,15.405,19,3.402,4881.406,344.094,7.2,0.606,0
45,132,0,3664,0,58,0,0,67.59,5518092,15.405,19,3.402,4881.406,344.094,7.2,0.606,0
45,133,0,3664,0,58,0,0,67.59,5518092,15.405,19,3.402,4881.406,344.094,7.2,0.606,0
45,134,81,3745,2,60,0,0,67.59,5518092,15.405,19,3.402,4881.406,344.094,7.2,0.606,0
45,135,0,3745,0,60,0,0,67.59,5518092,15.405,19,3.402,4881.406,344.094,7.2,0.606,0
45,136,0,3745,0,60,0,0,67.59,5518092,15.405,19,3.402,4881.406,344.094,7.2,0.606,0
45,137,0,3745,0,60,0,0,67.59,5518092,15.405,19,3.402,4881.406,344.094,7.2,0.606,0
45,138,0,3745,0,60,0,0,67.59,5518092,15.405,19,3.402,4881.406,344.094,7.2,0.606,0
45,139,90,3835,16,76,0,0,67.59,5518092,15.405,19,3.402,4881.406,344.094,7.2,0.606,0
45,140,0,3835,0,76,0,0,67.59,5518092,15.405,19,3.402,4881.406,344.094,7.2,0.606,0
45,141,0,3835,0,76,0,0,67.59,5518092,15.405,19,3.402,4881.406,344.094,7.2,0.606,0
45,142,15,3850,1,77,0,0,67.59,5518092,15.405,19,3.402,4881.406,344.094,7.2,0.606,0
45,143,0,3850,0,77,0,0,67.59,5518092,15.405,19,3.402,4881.406,344.094,7.2,0.606,0
45,144,0,3850,0,77,0,0,67.59,5518092,15.405,19,3.402,4881.406,344.094,7.2,0.606,0
45,145,0,3850,0,77,0,0,67.59,5518092,15.405,19,3.402,4881.406,344.094,7.2,0.606,0
45,146,0,3850,0,77,0,0,62.04,5518092,15.405,19,3.402,4881.406,344.094,7.2,0.606,0
45,147,0,3850,0,77,0,0,50.93,5518092,15.405,19,3.402,4881.406,344.094,7.2,0.606,0
45,148,129,3979,1,78,0,0,50.93,5518092,15.405,19,3.402,4881.406,344.094,7.2,0.606,0
45,149,0,3979,0,78,0,0,50.93,5518092,15.405,19,3.402,4881.406,344.094,7.2,0.606,0
45,150,0,3979,0,78,0,0,50.93,5518092,15.405,19,3.402,4881.406,344.094,7.2,0.606,0
45,151,0,3979,0,78,0,0,50.93,5518092,15.405,19,3.402,4881.406,344.094,7.2,0.606,0
45,152,0,3979,0,78,0,0,50.93,5518092,15.405,19,3.402,4881.406,344.094,7.2,0.606,0
45,153,0,3979,0,78,0,0,50.93,5518092,15.405,19,3.402,4881.406,344.094,7.2,0.606,0
45,154,0,3979,0,78,0,0,50.93,5518092,15.405,19,3.402,4881.406,344.094,7.2,0.606,0
45,155,649,4628,4,82,0,0,50.93,5518092,15.405,19,3.402,4881.406,344.094,7.2,0.606,0
45,156,0,4628,0,82,0,0,50.93,5518092,15.405,19,3.402,4881.406,344.094,7.2,0.606,0
45,157,0,4628,0,82,0,0,50.93,5518092,15.405,19,3.402,4881.406,344.094,7.2,0.606,0
45,158,0,4628,0,82,0,0,50.93,5518092,15.405,19,3.402,4881.406,344.094,7.2,0.606,0
45,159,0,4628,0,82,0,0,50.93,5518092,15.405,19,3.402,4881.406,344.094,7.2,0.606,0
45,160,0,4628,0,82,0,0,50.93,5518092,15.405,19,3.402,4881.406,344.094,7.2,0.606,0
45,161,263,4891,1,83,0,0,50.93,5518092,15.405,19,3.402,4881.406,344.094,7.2,0.606,0
45,162,0,4891,0,83,0,0,50.93,5518092,15.405,19,3.402,4881.406,344.094,7.2,0.606,0
45,163,0,4891,0,83,0,0,50.93,5518092,15.405,19,3.402,4881.406,344.094,7.2,0.606,0
45,164,0,4891,0,83,0,0,50.93,5518092,15.405,19,3.402,4881.406,344.094,7.2,0.606,0
45,165,37,4928,5,88,0,0,50.93,5518092,15.405,19,3.402,4881.406,344.094,7.2,0.606,0
45,166,0,4928,0,88,0,0,50.93,5518092,15.405,19,3.402,4881.406,344.094,7.2,0.606,0
45,167,6,4934,0,88,0,0,50.93,5518092,15.405,19,3.402,4881.406,344.094,7.2,0.606,0
45,168,0,4934,0,88,0,0,50.93,5518092,15.405,19,3.402,4881.406,344.094,7.2,0.606,0
45,169,0,4934,0,88,0,0,50.93,5518092,15.405,19,3.402,4881.406,344.094,7.2,0.606,0
45,170,0,4934,0,88,0,0,50.93,5518092,15.405,19,3.402,4881.406,344.094,7.2,0.606,0
45,171,46,4980,1,89,0,0,50.93,5518092,15.405,19,3.402,4881.406,344.094,7.2,0.606,0
45,172,0,4980,0,89,0,0,50.93,5518092,15.405,19,3.402,4881.406,344.094,7.2,0.606,0
45,173,6,4986,0,89,0,0,50.93,5518092,15.405,19,3.402,4881.406,344.094,7.2,0.606,0
45,174,0,4986,0,89,0,0,50.93,5518092,15.405,19,3.402,4881.406,344.094,7.2,0.606,0
45,175,16,5002,0,89,0,0,62.04,5518092,15.405,19,3.402,4881.406,344.094,7.2,0.606,0
45,176,0,5002,0,89,0,0,62.04,5518092,15.405,19,3.402,4881.406,344.094,7.2,0.606,0
45,177,3,5005,0,89,0,0,62.04,5518092,15.405,19,3.402,4881.406,344.094,7.2,0.606,0
45,178,0,5005,0,89,0,0,62.04,5518092,15.405,19,3.402,4881.406,344.094,7.2,0.606,0
45,179,0,5005,0,89,0,0,62.04,5518092,15.405,19,3.402,4881.406,344.094,7.2,0.606,0
45,180,3,5008,0,89,0,0,62.04,5518092,15.405,19,3.402,4881.406,344.094,7.2,0.606,0
45,181,0,5008,0,89,0,0,56.48,5518092,15.405,19,3.402,4881.406,344.094,7.2,0.606,0
45,182,81,5089,0,89,0,0,56.48,5518092,15.405,19,3.402,4881.406,344.094,7.2,0.606,0
45,183,0,5089,0,89,0,0,56.48,5518092,15.405,19,3.402,4881.406,344.094,7.2,0.606,0
45,184,0,5089,0,89,0,0,56.48,5518092,15.405,19,3.402,4881.406,344.094,7.2,0.606,0
45,185,0,5089,0,89,0,0,56.48,5518092,15.405,19,3.402,4881.406,344.094,7.2,0.606,0
45,186,0,5089,0,89,0,0,56.48,5518092,15.405,19,3.402,4881.406,344.094,7.2,0.606,0
45,187,0,5089,0,89,0,0,56.48,5518092,15.405,19,3.402,4881.406,344.094,7.2,0.606,0
45,188,0,5089,0,89,0,0,56.48,5518092,15.405,19,3.402,4881.406,344.094,7.2,0.606,0
45,189,0,5089,0,89,0,0,56.48,5518092,15.405,19,3.402,4881.406,344.094,7.2,0.606,0
45,190,0,5089,0,89,0,0,56.48,5518092,15.405,19,3.402,4881.406,344.094,7.2,0.606,0
45,191,29,5118,1,90,0,0,56.48,5518092,15.405,19,3.402,4881.406,344.094,7.2,0.606,0
45,192,0,5118,0,90,0,0,56.48,5518092,15.405,19,3.402,4881.406,344.094,7.2,0.606,0
45,193,0,5118,0,90,0,0,56.48,5518092,15.405,19,3.402,4881.406,344.094,7.2,0.606,0
45,194,0,5118,0,90,0,0,56.48,5518092,15.405,19,3.402,4881.406,344.094,7.2,0.606,0
45,195,0,5118,0,90,0,0,56.48,5518092,15.405,19,3.402,4881.406,344.094,7.2,0.606,0
45,196,0,5118,0,90,0,0,56.48,5518092,15.405,19,3.402,4881.406,344.094,7.2,0.606,0
45,197,38,5156,2,92,0,0,56.48,5518092,15.405,19,3.402,4881.406,344.094,7.2,0.606,0
45,198,0,5156,0,92,0,0,56.48,5518092,15.405,19,3.402,4881.406,344.094,7.2,0.606,0
45,199,0,5156,0,92,0,0,56.48,5518092,15.405,19,3.402,4881.406,344.094,7.2,0.606,0
45,200,0,5156,0,92,0,0,56.48,5518092,15.405,19,3.402,4881.406,344.094,7.2,0.606,0
45,201,0,5156,0,92,0,0,56.48,5518092,15.405,19,3.402,4881.406,344.094,7.2,0.606,0
45,202,0,5156,0,92,0,0,56.48,5518092,15.405,19,3.402,4881.406,344.094,7.2,0.606,0
45,203,0,5156,0,92,0,0,56.48,5518092,15.405,19,3.402,4881.406,344.094,7.2,0.606,0
45,204,0,5156,0,92,0,0,56.48,5518092,15.405,19,3.402,4881.406,344.094,7.2,0.606,0
46,1,17,347,0,2,373,4278,75,5094114,96.079,33.6,9.468,15524.995,137.973,8.78,0.794,0
46,2,28,375,0,2,132,4410,75,5094114,96.079,33.6,9.468,15524.995,137.973,8.78,0.794,0
46,3,21,396,0,2,110,4520,75,5094114,96.079,33.6,9.468,15524.995,137.973,8.78,0.794,0
46,4,20,416,0,2,194,4714,75,5094114,96.079,33.6,9.468,15524.995,137.973,8.78,0.794,0
46,5,19,435,0,2,444,5158,75,5094114,96.079,33.6,9.468,15524.995,137.973,8.78,0.794,0
46,6,19,454,0,2,265,5423,75,5094114,96.079,33.6,9.468,15524.995,137.973,8.78,0.794,0
46,7,13,467,0,2,162,5585,75,5094114,96.079,33.6,9.468,15524.995,137.973,8.78,0.794,0
46,8,16,483,0,2,510,6095,77.78,5094114,96.079,33.6,9.468,15524.995,137.973,8.78,0.794,0
46,9,19,502,0,2,263,6358,77.78,5094114,96.079,33.6,9.468,15524.995,137.973,8.78,0.794,0
46,10,37,539,1,3,154,6512,77.78,5094114,96.079,33.6,9.468,15524.995,137.973,8.78,0.794,0
46,11,19,558,0,3,156,6668,77.78,5094114,96.079,33.6,9.468,15524.995,137.973,8.78,0.794,0
46,12,19,577,0,3,154,6822,77.78,5094114,96.079,33.6,9.468,15524.995,137.973,8.78,0.794,0
46,13,18,595,0,3,106,6928,75.93,5094114,96.079,33.6,9.468,15524.995,137.973,8.78,0.794,0
46,14,17,612,0,3,76,7004,75.93,5094114,96.079,33.6,9.468,15524.995,137.973,8.78,0.794,0
46,15,6,618,0,3,193,7197,75.93,5094114,96.079,33.6,9.468,15524.995,137.973,8.78,0.794,0
46,16,8,626,1,4,214,7411,75.93,5094114,96.079,33.6,9.468,15524.995,137.973,8.78,0.794,0
46,17,16,642,0,4,172,7583,75.93,5094114,96.079,33.6,9.468,15524.995,137.973,8.78,0.794,0
46,18,7,649,0,4,227,7810,75.93,5094114,96.079,33.6,9.468,15524.995,137.973,8.78,0.794,0
46,19,6,655,0,4,52,7862,75.93,5094114,96.079,33.6,9.468,15524.995,137.973,8.78,0.794,0
46,20,5,660,0,4,96,7958,75.93,5094114,96.079,33.6,9.468,15524.995,137.973,8.78,0.794,0
46,21,2,662,2,6,266,8224,75.93,5094114,96.079,33.6,9.468,15524.995,137.973,8.78,0.794,0
46,22,7,669,0,6,301,8525,75.93,5094114,96.079,33.6,9.468,15524.995,137.973,8.78,0.794,0
46,23,12,681,0,6,253,8778,75.93,5094114,96.079,33.6,9.468,15524.995,137.973,8.78,0.794,0
46,24,6,687,0,6,102,8880,75.93,5094114,96.079,33.6,9.468,15524.995,137.973,8.78,0.794,0
46,25,0,687,0,6,87,8967,75.93,5094114,96.079,33.6,9.468,15524.995,137.973,8.78,0.794,0
46,26,6,693,0,6,37,9004,75.93,5094114,96.079,33.6,9.468,15524.995,137.973,8.78,0.794,0
46,27,2,695,0,6,58,9062,81.48,5094114,96.079,33.6,9.468,15524.995,137.973,8.78,0.794,0
46,28,2,697,0,6,59,9121,81.48,5094114,96.079,33.6,9.468,15524.995,137.973,8.78,0.794,0
46,29,8,705,0,6,237,9358,81.48,5094114,96.079,33.6,9.468,15524.995,137.973,8.78,0.794,0
46,30,8,713,0,6,109,9467,81.48,5094114,96.079,33.6,9.468,15524.995,137.973,8.78,0.794,0
46,31,6,719,0,6,167,9634,72.22,5094114,96.079,33.6,9.468,15524.995,137.973,8.78,0.794,0
46,32,6,725,0,6,91,9725,72.22,5094114,96.079,33.6,9.468,15524.995,137.973,8.78,0.794,0
46,33,8,733,0,6,120,9845,72.22,5094114,96.079,33.6,9.468,15524.995,137.973,8.78,0.794,0
46,34,6,739,0,6,106,9951,72.22,5094114,96.079,33.6,9.468,15524.995,137.973,8.78,0.794,0
46,35,3,742,0,6,73,10024,72.22,5094114,96.079,33.6,9.468,15524.995,137.973,8.78,0.794,0
46,36,13,755,0,6,209,10233,72.22,5094114,96.079,33.6,9.468,15524.995,137.973,8.78,0.794,0
46,37,6,761,0,6,274,10507,72.22,5094114,96.079,33.6,9.468,15524.995,137.973,8.78,0.794,0
46,38,4,765,0,6,452,10959,72.22,5094114,96.079,33.6,9.468,15524.995,137.973,8.78,0.794,0
46,39,8,773,0,6,449,11408,72.22,5094114,96.079,33.6,9.468,15524.995,137.973,8.78,0.794,0
46,40,7,780,0,6,592,12000,72.22,5094114,96.079,33.6,9.468,15524.995,137.973,8.78,0.794,0
46,41,12,792,0,6,120,12120,72.22,5094114,96.079,33.6,9.468,15524.995,137.973,8.78,0.794,0
46,42,9,801,1,7,73,12193,72.22,5094114,96.079,33.6,9.468,15524.995,137.973,8.78,0.794,0
46,43,3,804,0,7,446,12639,72.22,5094114,96.079,33.6,9.468,15524.995,137.973,8.78,0.794,0
46,44,11,815,0,7,315,12954,72.22,5094114,96.079,33.6,9.468,15524.995,137.973,8.78,0.794,0
46,45,15,830,1,8,209,13163,72.22,5094114,96.079,33.6,9.468,15524.995,137.973,8.78,0.794,0
46,46,13,843,0,8,665,13828,72.22,5094114,96.079,33.6,9.468,15524.995,137.973,8.78,0.794,0
46,47,10,853,2,10,576,14404,72.22,5094114,96.079,33.6,9.468,15524.995,137.973,8.78,0.794,0
46,48,10,863,0,10,206,14610,72.22,5094114,96.079,33.6,9.468,15524.995,137.973,8.78,0.794,0
46,49,3,866,0,10,138,14748,72.22,5094114,96.079,33.6,9.468,15524.995,137.973,8.78,0.794,0
46,50,16,882,0,10,434,15182,72.22,5094114,96.079,33.6,9.468,15524.995,137.973,8.78,0.794,0
46,51,15,897,0,10,168,15350,72.22,5094114,96.079,33.6,9.468,15524.995,137.973,8.78,0.794,0
46,52,6,903,0,10,486,15836,72.22,5094114,96.079,33.6,9.468,15524.995,137.973,8.78,0.794,0
46,53,8,911,0,10,235,16071,72.22,5094114,96.079,33.6,9.468,15524.995,137.973,8.78,0.794,0
46,54,7,918,0,10,410,16481,72.22,5094114,96.079,33.6,9.468,15524.995,137.973,8.78,0.794,0
46,55,12,930,0,10,157,16638,72.22,5094114,96.079,33.6,9.468,15524.995,137.973,8.78,0.794,0
46,56,21,951,0,10,125,16763,72.22,5094114,96.079,33.6,9.468,15524.995,137.973,8.78,0.794,0
46,57,5,956,0,10,649,17412,72.22,5094114,96.079,33.6,9.468,15524.995,137.973,8.78,0.794,0
46,58,28,984,0,10,374,17786,72.22,5094114,96.079,33.6,9.468,15524.995,137.973,8.78,0.794,0
46,59,16,1000,0,10,540,18326,72.22,5094114,96.079,33.6,9.468,15524.995,137.973,8.78,0.794,0
46,60,22,1022,0,10,467,18793,72.22,5094114,96.079,33.6,9.468,15524.995,137.973,8.78,0.794,0
46,61,25,1047,0,10,515,19308,72.22,5094114,96.079,33.6,9.468,15524.995,137.973,8.78,0.794,0
46,62,9,1056,0,10,267,19575,72.22,5094114,96.079,33.6,9.468,15524.995,137.973,8.78,0.794,0
46,63,28,1084,0,10,264,19839,72.22,5094114,96.079,33.6,9.468,15524.995,137.973,8.78,0.794,0
46,64,21,1105,0,10,415,20254,72.22,5094114,96.079,33.6,9.468,15524.995,137.973,8.78,0.794,0
46,65,52,1157,0,10,376,20630,72.22,5094114,96.079,33.6,9.468,15524.995,137.973,8.78,0.794,0
46,66,37,1194,0,10,443,21073,72.22,5094114,96.079,33.6,9.468,15524.995,137.973,8.78,0.794,0
46,67,34,1228,0,10,334,21407,72.22,5094114,96.079,33.6,9.468,15524.995,137.973,8.78,0.794,0
46,68,35,1263,0,10,268,21675,72.22,5094114,96.079,33.6,9.468,15524.995,137.973,8.78,0.794,0
46,69,55,1318,0,10,161,21836,72.22,5094114,96.079,33.6,9.468,15524.995,137.973,8.78,0.794,0
46,70,24,1342,0,10,229,22065,72.22,5094114,96.079,33.6,9.468,15524.995,137.973,8.78,0.794,0
46,71,33,1375,1,11,427,22492,72.22,5094114,96.079,33.6,9.468,15524.995,137.973,8.78,0.794,0
46,72,86,1461,1,12,381,22873,72.22,5094114,96.079,33.6,9.468,15524.995,137.973,8.78,0.794,0
46,73,77,1538,0,12,483,23356,72.22,5094114,96.079,33.6,9.468,15524.995,137.973,8.78,0.794,0
46,74,74,1612,0,12,510,23866,72.22,5094114,96.079,33.6,9.468,15524.995,137.973,8.78,0.794,0
46,75,50,1662,0,12,308,24174,72.22,5094114,96.079,33.6,9.468,15524.995,137.973,8.78,0.794,0
46,76,53,1715,0,12,237,24411,72.22,5094114,96.079,33.6,9.468,15524.995,137.973,8.78,0.794,0
46,77,29,1744,0,12,278,24689,72.22,5094114,96.079,33.6,9.468,15524.995,137.973,8.78,0.794,0
46,78,25,1769,0,12,451,25140,72.22,5094114,96.079,33.6,9.468,15524.995,137.973,8.78,0.794,0
46,79,102,1871,0,12,447,25587,72.22,5094114,96.079,33.6,9.468,15524.995,137.973,8.78,0.794,0
46,80,68,1939,0,12,629,26216,72.22,5094114,96.079,33.6,9.468,15524.995,137.973,8.78,0.794,0
46,81,119,2058,0,12,457,26673,72.22,5094114,96.079,33.6,9.468,15524.995,137.973,8.78,0.794,0
46,82,69,2127,0,12,391,27064,72.22,5094114,96.079,33.6,9.468,15524.995,137.973,8.78,0.794,0
46,83,86,2213,0,12,244,27308,72.22,5094114,96.079,33.6,9.468,15524.995,137.973,8.78,0.794,0
46,84,64,2277,0,12,443,27751,72.22,5094114,96.079,33.6,9.468,15524.995,137.973,8.78,0.794,0
46,85,91,2368,0,12,621,28372,72.22,5094114,96.079,33.6,9.468,15524.995,137.973,8.78,0.794,0
46,86,147,2515,0,12,703,29075,72.22,5094114,96.079,33.6,9.468,15524.995,137.973,8.78,0.794,0
46,87,169,2684,0,12,687,29762,73.61,5094114,96.079,33.6,9.468,15524.995,137.973,8.78,0.794,0
46,88,152,2836,0,12,890,30652,73.61,5094114,96.079,33.6,9.468,15524.995,137.973,8.78,0.794,0
46,89,143,2979,0,12,743,31395,73.61,5094114,96.079,33.6,9.468,15524.995,137.973,8.78,0.794,0
46,90,151,3130,3,15,691,32086,73.61,5094114,96.079,33.6,9.468,15524.995,137.973,8.78,0.794,0
46,91,139,3269,0,15,594,32680,73.61,5094114,96.079,33.6,9.468,15524.995,137.973,8.78,0.794,0
46,92,190,3459,1,16,853,33533,73.61,5094114,96.079,33.6,9.468,15524.995,137.973,8.78,0.794,0
46,93,294,3753,1,17,1259,34792,73.61,5094114,96.079,33.6,9.468,15524.995,137.973,8.78,0.794,0
46,94,270,4023,0,17,933,35725,73.61,5094114,96.079,33.6,9.468,15524.995,137.973,8.78,0.794,0
46,95,288,4311,1,18,998,36723,73.61,5094114,96.079,33.6,9.468,15524.995,137.973,8.78,0.794,0
46,96,310,4621,0,18,1197,37920,73.61,5094114,96.079,33.6,9.468,15524.995,137.973,8.78,0.794,0
46,97,375,4996,1,19,1000,38920,73.61,5094114,96.079,33.6,9.468,15524.995,137.973,8.78,0.794,0
46,98,245,5241,4,23,1222,40142,73.61,5094114,96.079,33.6,9.468,15524.995,137.973,8.78,0.794,0
46,99,245,5486,0,23,1128,41270,73.61,5094114,96.079,33.6,9.468,15524.995,137.973,8.78,0.794,0
46,100,350,5836,1,24,1750,43020,73.61,5094114,96.079,33.6,9.468,15524.995,137.973,8.78,0.794,0
46,101,649,6485,1,25,1367,44387,73.61,5094114,96.079,33.6,9.468,15524.995,137.973,8.78,0.794,0
46,102,360,6845,1,26,1595,45982,73.61,5094114,96.079,33.6,9.468,15524.995,137.973,8.78,0.794,0
46,103,386,7231,2,28,1654,47636,73.61,5094114,96.079,33.6,9.468,15524.995,137.973,8.78,0.794,0
46,104,365,7596,2,30,1989,49625,73.61,5094114,96.079,33.6,9.468,15524.995,137.973,8.78,0.794,0
46,105,440,8036,1,31,1435,51060,73.61,5094114,96.079,33.6,9.468,15524.995,137.973,8.78,0.794,0
46,106,446,8482,5,36,1393,52453,73.61,5094114,96.079,33.6,9.468,15524.995,137.973,8.78,0.794,0
46,107,504,8986,4,40,1503,53956,73.61,5094114,96.079,33.6,9.468,15524.995,137.973,8.78,0.794,0
46,108,560,9546,2,42,1568,55524,73.61,5094114,96.079,33.6,9.468,15524.995,137.973,8.78,0.794,0
46,109,423,9969,5,47,1116,56640,73.61,5094114,96.079,33.6,9.468,15524.995,137.973,8.78,0.794,0
46,110,582,10551,7,54,1524,58164,73.61,5094114,96.079,33.6,9.468,15524.995,137.973,8.78,0.794,0
46,111,563,11114,8,62,1117,59281,73.61,5094114,96.079,33.6,9.468,15524.995,137.973,8.78,0.794,0
46,112,420,11534,4,66,1104,60385,73.61,5094114,96.079,33.6,9.468,15524.995,137.973,8.78,0.794,0
46,113,277,11811,2,68,1228,61613,73.61,5094114,96.079,33.6,9.468,15524.995,137.973,8.78,0.794,0
46,114,550,12361,3,71,1829,63442,73.61,5094114,96.079,33.6,9.468,15524.995,137.973,8.78,0.794,0
46,115,768,13129,9,80,1510,64952,73.61,5094114,96.079,33.6,9.468,15524.995,137.973,8.78,0.794,0
46,116,540,13669,7,87,1842,66794,73.61,5094114,96.079,33.6,9.468,15524.995,137.973,8.78,0.794,0
46,117,931,14600,11,98,1564,68358,73.61,5094114,96.079,33.6,9.468,15524.995,137.973,8.78,0.794,0
46,118,629,15229,6,104,1701,70059,73.61,5094114,96.079,33.6,9.468,15524.995,137.973,8.78,0.794,0
46,119,612,15841,11,115,1501,71560,73.61,5094114,96.079,33.6,9.468,15524.995,137.973,8.78,0.794,0
46,120,503,16344,10,125,1656,73216,73.61,5094114,96.079,33.6,9.468,15524.995,137.973,8.78,0.794,0
46,121,456,16800,8,133,1840,75056,73.61,5094114,96.079,33.6,9.468,15524.995,137.973,8.78,0.794,0
46,122,490,17290,7,140,1744,76800,73.61,5094114,96.079,33.6,9.468,15524.995,137.973,8.78,0.794,0
46,123,530,17820,10,150,1663,78463,62.96,5094114,96.079,33.6,9.468,15524.995,137.973,8.78,0.794,0
46,124,367,18187,4,154,2015,80478,62.96,5094114,96.079,33.6,9.468,15524.995,137.973,8.78,0.794,0
46,125,788,18975,8,162,1550,82028,62.96,5094114,96.079,33.6,9.468,15524.995,137.973,8.78,0.794,0
46,126,427,19402,9,171,1584,83612,62.96,5094114,96.079,33.6,9.468,15524.995,137.973,8.78,0.794,0
46,127,435,19837,10,181,1799,85411,62.96,5094114,96.079,33.6,9.468,15524.995,137.973,8.78,0.794,0
46,128,580,20417,10,191,1885,87296,68.52,5094114,96.079,33.6,9.468,15524.995,137.973,8.78,0.794,0
46,129,653,21070,9,200,1780,89076,68.52,5094114,96.079,33.6,9.468,15524.995,137.973,8.78,0.794,0
46,130,1011,22081,18,218,1687,90763,68.52,5094114,96.079,33.6,9.468,15524.995,137.973,8.78,0.794,0
46,131,1,22082,10,228,1405,92168,68.52,5094114,96.079,33.6,9.468,15524.995,137.973,8.78,0.794,0
46,132,1204,23286,7,235,1457,93625,72.22,5094114,96.079,33.6,9.468,15524.995,137.973,8.78,0.794,0
46,133,586,23872,9,244,1251,94876,72.22,5094114,96.079,33.6,9.468,15524.995,137.973,8.78,0.794,0
46,134,636,24508,11,255,1664,96540,72.22,5094114,96.079,33.6,9.468,15524.995,137.973,8.78,0.794,0
46,135,549,25057,8,263,1997,98537,72.22,5094114,96.079,33.6,9.468,15524.995,137.973,8.78,0.794,0
46,136,1072,26129,9,272,2172,100709,72.22,5094114,96.079,33.6,9.468,15524.995,137.973,8.78,0.794,0
46,137,802,26931,9,281,2197,102906,72.22,5094114,96.079,33.6,9.468,15524.995,137.973,8.78,0.794,0
46,138,806,27737,10,291,2244,105150,72.22,5094114,96.079,33.6,9.468,15524.995,137.973,8.78,0.794,0
46,139,728,28465,3,294,1535,106685,72.22,5094114,96.079,33.6,9.468,15524.995,137.973,8.78,0.794,0
46,140,619,29084,10,304,1059,107744,72.22,5094114,96.079,33.6,9.468,15524.995,137.973,8.78,0.794,0
46,141,559,29643,10,314,1535,109279,72.22,5094114,96.079,33.6,9.468,15524.995,137.973,8.78,0.794,0
46,142,766,30409,7,321,1195,110474,72.22,5094114,96.079,33.6,9.468,15524.995,137.973,8.78,0.794,0
46,143,666,31075,12,333,1838,112312,72.22,5094114,96.079,33.6,9.468,15524.995,137.973,8.78,0.794,0
46,144,1059,32134,7,340,2131,114443,72.22,5094114,96.079,33.6,9.468,15524.995,137.973,8.78,0.794,0
46,145,950,33084,8,348,2093,116536,72.22,5094114,96.079,33.6,9.468,15524.995,137.973,8.78,0.794,0
46,146,736,33820,7,355,1533,118069,72.22,5094114,96.079,33.6,9.468,15524.995,137.973,8.78,0.794,0
46,147,643,34463,7,362,1304,119373,72.22,5094114,96.079,33.6,9.468,15524.995,137.973,8.78,0.794,0
46,148,842,35305,14,376,2048,121421,72.22,5094114,96.079,33.6,9.468,15524.995,137.973,8.78,0.794,0
46,149,1002,36307,10,386,1859,123280,72.22,5094114,96.079,33.6,9.468,15524.995,137.973,8.78,0.794,0
46,150,985,37292,11,397,2211,125491,61.11,5094114,96.079,33.6,9.468,15524.995,137.973,8.78,0.794,0
46,151,1193,38485,10,407,2633,128124,61.11,5094114,96.079,33.6,9.468,15524.995,137.973,8.78,0.794,0
46,152,1214,39699,11,418,804,128928,61.11,5094114,96.079,33.6,9.468,15524.995,137.973,8.78,0.794,0
46,153,0,39699,0,418,2767,131695,61.11,5094114,96.079,33.6,9.468,15524.995,137.973,8.78,0.794,0
46,154,1588,41287,18,436,1488,133183,61.11,5094114,96.079,33.6,9.468,15524.995,137.973,8.78,0.794,0
46,155,897,42184,7,443,2119,135302,61.11,5094114,96.079,33.6,9.468,15524.995,137.973,8.78,0.794,0
46,156,1121,43305,10,453,2491,137793,61.11,5094114,96.079,33.6,9.468,15524.995,137.973,8.78,0.794,0
46,157,1153,44458,7,460,2750,140543,61.11,5094114,96.079,33.6,9.468,15524.995,137.973,8.78,0.794,0
46,158,1222,45680,9,469,2879,143422,61.11,5094114,96.079,33.6,9.468,15524.995,137.973,8.78,0.794,0
46,159,1240,46920,9,478,957,144379,61.11,5094114,96.079,33.6,9.468,15524.995,137.973,8.78,0.794,0
46,160,0,46920,0,478,2741,147120,61.11,5094114,96.079,33.6,9.468,15524.995,137.973,8.78,0.794,0
46,161,1860,48780,32,510,1978,149098,61.11,5094114,96.079,33.6,9.468,15524.995,137.973,8.78,0.794,0
46,162,1117,49897,21,531,2517,151615,61.11,5094114,96.079,33.6,9.468,15524.995,137.973,8.78,0.794,0
46,163,1327,51224,12,543,2615,154230,61.11,5094114,96.079,33.6,9.468,15524.995,137.973,8.78,0.794,0
46,164,1325,52549,24,567,3154,157384,61.11,5094114,96.079,33.6,9.468,15524.995,137.973,8.78,0.794,0
46,165,1420,53969,16,583,2996,160380,61.11,5094114,96.079,33.6,9.468,15524.995,137.973,8.78,0.794,0
46,166,1485,55454,7,590,911,161291,61.11,5094114,96.079,33.6,9.468,15524.995,137.973,8.78,0.794,0
46,167,0,55454,0,590,3540,164831,62.96,5094114,96.079,33.6,9.468,15524.995,137.973,8.78,0.794,0
46,168,1897,57351,31,621,1708,166539,62.96,5094114,96.079,33.6,9.468,15524.995,137.973,8.78,0.794,0
46,169,787,58138,12,633,2220,168759,62.96,5094114,96.079,33.6,9.468,15524.995,137.973,8.78,0.794,0
46,170,1378,59516,16,649,2308,171067,62.96,5094114,96.079,33.6,9.468,15524.995,137.973,8.78,0.794,0
46,171,1302,60818,17,666,3238,174305,62.96,5094114,96.079,33.6,9.468,15524.995,137.973,8.78,0.794,0
46,172,1556,62374,20,686,3110,177415,62.96,5094114,96.079,33.6,9.468,15524.995,137.973,8.78,0.794,0
46,173,1338,63712,20,706,1118,178533,62.96,5094114,96.079,33.6,9.468,15524.995,137.973,8.78,0.794,0
46,174,0,63712,0,706,3537,182070,62.96,5094114,96.079,33.6,9.468,15524.995,137.973,8.78,0.794,0
46,175,1890,65602,39,745,1902,183972,62.96,5094114,96.079,33.6,9.468,15524.995,137.973,8.78,0.794,0
46,176,1087,66689,15,760,2977,186949,62.96,5094114,96.079,33.6,9.468,15524.995,137.973,8.78,0.794,0
46,177,1370,68059,21,781,3189,190138,62.96,5094114,96.079,33.6,9.468,15524.995,137.973,8.78,0.794,0
46,178,1400,69459,14,795,2658,192796,62.96,5094114,96.079,33.6,9.468,15524.995,137.973,8.78,0.794,0
46,179,1357,70816,17,812,4620,197416,62.96,5094114,96.079,33.6,9.468,15524.995,137.973,8.78,0.794,0
46,180,1233,72049,16,828,859,198275,62.96,5094114,96.079,33.6,9.468,15524.995,137.973,8.78,0.794,0
46,181,0,72049,0,828,1722,199997,62.96,5094114,96.079,33.6,9.468,15524.995,137.973,8.78,0.794,0
46,182,1665,73714,33,861,1655,201652,62.96,5094114,96.079,33.6,9.468,15524.995,137.973,8.78,0.794,0
46,183,890,74604,19,880,3387,205039,62.96,5094114,96.079,33.6,9.468,15524.995,137.973,8.78,0.794,0
46,184,1156,75760,24,904,1852,206891,62.96,5094114,96.079,33.6,9.468,15524.995,137.973,8.78,0.794,0
46,185,1068,76828,13,917,2552,209443,62.96,5094114,96.079,33.6,9.468,15524.995,137.973,8.78,0.794,0
46,186,1001,77829,13,930,4140,213583,62.96,5094114,96.079,33.6,9.468,15524.995,137.973,8.78,0.794,0
46,187,1353,79182,20,950,1169,214752,62.96,5094114,96.079,33.6,9.468,15524.995,137.973,8.78,0.794,0
46,188,0,79182,0,950,2299,217051,61.11,5094114,96.079,33.6,9.468,15524.995,137.973,8.78,0.794,0
46,189,1947,81129,37,987,2612,219663,61.11,5094114,96.079,33.6,9.468,15524.995,137.973,8.78,0.794,0
46,190,1013,82142,17,1004,1559,221222,58.33,5094114,96.079,33.6,9.468,15524.995,137.973,8.78,0.794,0
46,191,1355,83497,20,1024,2964,224186,58.33,5094114,96.079,33.6,9.468,15524.995,137.973,8.78,0.794,0
46,192,1331,84828,16,1040,2749,226935,58.33,5094114,96.079,33.6,9.468,15524.995,137.973,8.78,0.794,0
46,193,1225,86053,15,1055,2542,229477,58.33,5094114,96.079,33.6,9.468,15524.995,137.973,8.78,0.794,0
46,194,1386,87439,21,1076,2437,231914,58.33,5094114,96.079,33.6,9.468,15524.995,137.973,8.78,0.794,0
46,195,0,87439,0,1076,2383,234297,58.33,5094114,96.079,33.6,9.468,15524.995,137.973,8.78,0.794,0
46,196,1784,89223,32,1108,1918,236215,58.33,5094114,96.079,33.6,9.468,15524.995,137.973,8.78,0.794,0
46,197,1015,90238,16,1124,2999,239214,58.33,5094114,96.079,33.6,9.468,15524.995,137.973,8.78,0.794,0
46,198,1542,91780,10,1134,3092,242306,58.33,5094114,96.079,33.6,9.468,15524.995,137.973,8.78,0.794,0
46,199,1372,93152,25,1159,0,242306,58.33,5094114,96.079,33.6,9.468,15524.995,137.973,8.78,0.794,0
46,200,1196,94348,9,1168,0,242306,58.33,5094114,96.079,33.6,9.468,15524.995,137.973,8.78,0.794,0
46,201,1166,95514,15,1183,0,242306,58.33,5094114,96.079,33.6,9.468,15524.995,137.973,8.78,0.794,0
46,202,0,95514,0,1183,0,242306,58.33,5094114,96.079,33.6,9.468,15524.995,137.973,8.78,0.794,0
46,203,1561,97075,21,1204,0,242306,58.33,5094114,96.079,33.6,9.468,15524.995,137.973,8.78,0.794,0
46,204,847,97922,18,1222,0,242306,,5094114,96.079,33.6,9.468,15524.995,137.973,8.78,0.794,0
47,1,0,168,0,1,0,0,80.56,26378275,76.399,18.7,2.933,3601.006,303.74,2.42,0.492,4
47,2,22,190,0,1,0,0,80.56,26378275,76.399,18.7,2.933,3601.006,303.74,2.42,0.492,4
47,3,4,194,0,1,0,0,80.56,26378275,76.399,18.7,2.933,3601.006,303.74,2.42,0.492,4
47,4,24,218,0,1,0,0,80.56,26378275,76.399,18.7,2.933,3601.006,303.74,2.42,0.492,4
47,5,27,245,1,2,0,0,80.56,26378275,76.399,18.7,2.933,3601.006,303.74,2.42,0.492,4
47,6,16,261,1,3,0,0,80.56,26378275,76.399,18.7,2.933,3601.006,303.74,2.42,0.492,4
47,7,62,323,0,3,0,0,80.56,26378275,76.399,18.7,2.933,3601.006,303.74,2.42,0.492,4
47,8,26,349,0,3,0,0,80.56,26378275,76.399,18.7,2.933,3601.006,303.74,2.42,0.492,4
47,9,35,384,0,3,0,0,80.56,26378275,76.399,18.7,2.933,3601.006,303.74,2.42,0.492,4
47,10,60,444,0,3,0,0,80.56,26378275,76.399,18.7,2.933,3601.006,303.74,2.42,0.492,4
47,11,36,480,0,3,0,0,80.56,26378275,76.399,18.7,2.933,3601.006,303.74,2.42,0.492,4
47,12,53,533,1,4,0,0,80.56,26378275,76.399,18.7,2.933,3601.006,303.74,2.42,0.492,4
47,13,41,574,1,5,0,3658,80.56,26378275,76.399,18.7,2.933,3601.006,303.74,2.42,0.492,4
47,14,52,626,1,6,129,3787,80.56,26378275,76.399,18.7,2.933,3601.006,303.74,2.42,0.492,4
47,15,0,626,0,6,238,4025,80.56,26378275,76.399,18.7,2.933,3601.006,303.74,2.42,0.492,4
47,16,28,654,0,6,298,4323,80.56,26378275,76.399,18.7,2.933,3601.006,303.74,2.42,0.492,4
47,17,34,688,0,6,296,4619,80.56,26378275,76.399,18.7,2.933,3601.006,303.74,2.42,0.492,4
47,18,54,742,0,6,361,4980,80.56,26378275,76.399,18.7,2.933,3601.006,303.74,2.42,0.492,4
47,19,59,801,2,8,399,5379,80.56,26378275,76.399,18.7,2.933,3601.006,303.74,2.42,0.492,4
47,20,46,847,1,9,351,5730,80.56,26378275,76.399,18.7,2.933,3601.006,303.74,2.42,0.492,4
47,21,32,879,1,10,270,6000,80.56,26378275,76.399,18.7,2.933,3601.006,303.74,2.42,0.492,4
47,22,37,916,3,13,342,6342,80.56,26378275,76.399,18.7,2.933,3601.006,303.74,2.42,0.492,4
47,23,36,952,1,14,504,6846,80.56,26378275,76.399,18.7,2.933,3601.006,303.74,2.42,0.492,4
47,24,52,1004,0,14,584,7430,80.56,26378275,76.399,18.7,2.933,3601.006,303.74,2.42,0.492,4
47,25,73,1077,0,14,302,7732,80.56,26378275,76.399,18.7,2.933,3601.006,303.74,2.42,0.492,4
47,26,34,1111,0,14,560,8292,80.56,26378275,76.399,18.7,2.933,3601.006,303.74,2.42,0.492,4
47,27,39,1150,0,14,289,8581,80.56,26378275,76.399,18.7,2.933,3601.006,303.74,2.42,0.492,4
47,28,14,1164,0,14,179,8760,80.56,26378275,76.399,18.7,2.933,3601.006,303.74,2.42,0.492,4
47,29,19,1183,0,14,512,9272,80.56,26378275,76.399,18.7,2.933,3601.006,303.74,2.42,0.492,4
47,30,55,1238,0,14,385,9657,80.56,26378275,76.399,18.7,2.933,3601.006,303.74,2.42,0.492,4
47,31,37,1275,0,14,0,9657,80.56,26378275,76.399,18.7,2.933,3601.006,303.74,2.42,0.492,4
47,32,58,1333,1,15,0,10508,80.56,26378275,76.399,18.7,2.933,3601.006,303.74,2.42,0.492,4
47,33,29,1362,0,15,288,10796,80.56,26378275,76.399,18.7,2.933,3601.006,303.74,2.42,0.492,4
47,34,36,1398,2,17,482,11278,80.56,26378275,76.399,18.7,2.933,3601.006,303.74,2.42,0.492,4
47,35,34,1432,0,17,170,11448,80.56,26378275,76.399,18.7,2.933,3601.006,303.74,2.42,0.492,4
47,36,32,1464,1,18,497,11945,80.56,26378275,76.399,18.7,2.933,3601.006,303.74,2.42,0.492,4
47,37,52,1516,0,18,367,12312,80.56,26378275,76.399,18.7,2.933,3601.006,303.74,2.42,0.492,4
47,38,55,1571,2,20,456,12768,69.91,26378275,76.399,18.7,2.933,3601.006,303.74,2.42,0.492,4
47,39,31,1602,0,20,573,13341,69.91,26378275,76.399,18.7,2.933,3601.006,303.74,2.42,0.492,4
47,40,65,1667,1,21,322,13663,69.91,26378275,76.399,18.7,2.933,3601.006,303.74,2.42,0.492,4
47,41,33,1700,0,21,499,14162,69.91,26378275,76.399,18.7,2.933,3601.006,303.74,2.42,0.492,4
47,42,30,1730,0,21,506,14668,69.91,26378275,76.399,18.7,2.933,3601.006,303.74,2.42,0.492,4
47,43,127,1857,0,21,592,15260,69.91,26378275,76.399,18.7,2.933,3601.006,303.74,2.42,0.492,4
47,44,55,1912,3,24,680,15940,69.91,26378275,76.399,18.7,2.933,3601.006,303.74,2.42,0.492,4
47,45,59,1971,0,24,728,16668,69.91,26378275,76.399,18.7,2.933,3601.006,303.74,2.42,0.492,4
47,46,46,2017,0,24,845,17513,64.81,26378275,76.399,18.7,2.933,3601.006,303.74,2.42,0.492,4
47,47,44,2061,1,25,790,18303,64.81,26378275,76.399,18.7,2.933,3601.006,303.74,2.42,0.492,4
47,48,48,2109,2,27,305,18608,64.81,26378275,76.399,18.7,2.933,3601.006,303.74,2.42,0.492,4
47,49,10,2119,1,28,566,19174,64.81,26378275,76.399,18.7,2.933,3601.006,303.74,2.42,0.492,4
47,50,34,2153,0,28,840,20014,64.81,26378275,76.399,18.7,2.933,3601.006,303.74,2.42,0.492,4
47,51,78,2231,1,29,1055,21069,64.81,26378275,76.399,18.7,2.933,3601.006,303.74,2.42,0.492,4
47,52,0,2231,0,29,1164,22233,64.81,26378275,76.399,18.7,2.933,3601.006,303.74,2.42,0.492,4
47,53,70,2301,0,29,727,22960,64.81,26378275,76.399,18.7,2.933,3601.006,303.74,2.42,0.492,4
47,54,65,2366,1,30,484,23444,64.81,26378275,76.399,18.7,2.933,3601.006,303.74,2.42,0.492,4
47,55,10,2376,0,30,873,24317,59.26,26378275,76.399,18.7,2.933,3601.006,303.74,2.42,0.492,4
47,56,47,2423,0,30,782,25099,59.26,26378275,76.399,18.7,2.933,3601.006,303.74,2.42,0.492,4
47,57,54,2477,0,30,425,25524,59.26,26378275,76.399,18.7,2.933,3601.006,303.74,2.42,0.492,4
47,58,79,2556,1,31,497,26021,59.26,26378275,76.399,18.7,2.933,3601.006,303.74,2.42,0.492,4
47,59,85,2641,1,32,527,26548,59.26,26378275,76.399,18.7,2.933,3601.006,303.74,2.42,0.492,4
47,60,109,2750,0,32,357,26905,59.26,26378275,76.399,18.7,2.933,3601.006,303.74,2.42,0.492,4
47,61,49,2799,1,33,134,27039,59.26,26378275,76.399,18.7,2.933,3601.006,303.74,2.42,0.492,4
47,62,34,2833,0,33,611,27650,59.26,26378275,76.399,18.7,2.933,3601.006,303.74,2.42,0.492,4
47,63,118,2951,0,33,470,28120,59.26,26378275,76.399,18.7,2.933,3601.006,303.74,2.42,0.492,4
47,64,73,3024,0,33,402,28522,59.26,26378275,76.399,18.7,2.933,3601.006,303.74,2.42,0.492,4
47,65,0,3024,0,33,706,29228,59.26,26378275,76.399,18.7,2.933,3601.006,303.74,2.42,0.492,4
47,66,238,3262,2,35,628,29856,59.26,26378275,76.399,18.7,2.933,3601.006,303.74,2.42,0.492,4
47,67,169,3431,1,36,756,30612,59.26,26378275,76.399,18.7,2.933,3601.006,303.74,2.42,0.492,4
47,68,126,3557,0,36,937,31549,59.26,26378275,76.399,18.7,2.933,3601.006,303.74,2.42,0.492,4
47,69,182,3739,0,36,800,32349,59.26,26378275,76.399,18.7,2.933,3601.006,303.74,2.42,0.492,4
47,70,142,3881,2,38,515,32864,59.26,26378275,76.399,18.7,2.933,3601.006,303.74,2.42,0.492,4
47,71,114,3995,0,38,612,33476,59.26,26378275,76.399,18.7,2.933,3601.006,303.74,2.42,0.492,4
47,72,186,4181,3,41,796,34272,59.26,26378275,76.399,18.7,2.933,3601.006,303.74,2.42,0.492,4
47,73,223,4404,0,41,0,34272,59.26,26378275,76.399,18.7,2.933,3601.006,303.74,2.42,0.492,4
47,74,280,4684,4,45,0,35935,57.41,26378275,76.399,18.7,2.933,3601.006,303.74,2.42,0.492,4
47,75,164,4848,0,45,848,36783,57.41,26378275,76.399,18.7,2.933,3601.006,303.74,2.42,0.492,4
47,76,236,5084,0,45,870,37653,57.41,26378275,76.399,18.7,2.933,3601.006,303.74,2.42,0.492,4
47,77,355,5439,1,46,984,38637,57.41,26378275,76.399,18.7,2.933,3601.006,303.74,2.42,0.492,4
47,78,240,5679,0,46,1214,39851,57.41,26378275,76.399,18.7,2.933,3601.006,303.74,2.42,0.492,4
47,79,384,6063,2,48,1592,41443,57.41,26378275,76.399,18.7,2.933,3601.006,303.74,2.42,0.492,4
47,80,0,6063,0,48,1632,43075,57.41,26378275,76.399,18.7,2.933,3601.006,303.74,2.42,0.492,4
47,81,381,6444,1,49,1155,44230,57.41,26378275,76.399,18.7,2.933,3601.006,303.74,2.42,0.492,4
47,82,430,6874,0,49,922,45152,57.41,26378275,76.399,18.7,2.933,3601.006,303.74,2.42,0.492,4
47,83,618,7492,2,51,844,45996,57.41,26378275,76.399,18.7,2.933,3601.006,303.74,2.42,0.492,4
47,84,0,7492,3,54,1303,47299,57.41,26378275,76.399,18.7,2.933,3601.006,303.74,2.42,0.492,4
47,85,412,7904,4,58,1041,48340,57.41,26378275,76.399,18.7,2.933,3601.006,303.74,2.42,0.492,4
47,86,0,7904,0,58,1012,49352,57.41,26378275,76.399,18.7,2.933,3601.006,303.74,2.42,0.492,4
47,87,260,8164,0,58,1562,50914,60.65,26378275,76.399,18.7,2.933,3601.006,303.74,2.42,0.492,4
47,88,170,8334,2,60,1347,52261,60.65,26378275,76.399,18.7,2.933,3601.006,303.74,2.42,0.492,4
47,89,405,8739,4,64,624,52885,60.65,26378275,76.399,18.7,2.933,3601.006,303.74,2.42,0.492,4
47,90,205,8944,2,66,1053,53938,60.65,26378275,76.399,18.7,2.933,3601.006,303.74,2.42,0.492,4
47,91,270,9214,0,66,2012,55950,60.65,26378275,76.399,18.7,2.933,3601.006,303.74,2.42,0.492,4
47,92,285,9499,2,68,1824,57774,57.87,26378275,76.399,18.7,2.933,3601.006,303.74,2.42,0.492,4
47,93,203,9702,0,68,1608,59382,57.87,26378275,76.399,18.7,2.933,3601.006,303.74,2.42,0.492,4
47,94,290,9992,0,68,1270,60652,57.87,26378275,76.399,18.7,2.933,3601.006,303.74,2.42,0.492,4
47,95,252,10244,2,70,1553,62205,57.87,26378275,76.399,18.7,2.933,3601.006,303.74,2.42,0.492,4
47,96,218,10462,2,72,2219,64424,57.87,26378275,76.399,18.7,2.933,3601.006,303.74,2.42,0.492,4
47,97,310,10772,2,74,1464,65888,57.87,26378275,76.399,18.7,2.933,3601.006,303.74,2.42,0.492,4
47,98,194,10966,1,75,1280,67168,57.87,26378275,76.399,18.7,2.933,3601.006,303.74,2.42,0.492,4
47,99,0,10966,0,75,1841,69009,57.87,26378275,76.399,18.7,2.933,3601.006,303.74,2.42,0.492,4
47,100,538,11504,3,78,1405,70414,57.87,26378275,76.399,18.7,2.933,3601.006,303.74,2.42,0.492,4
47,101,246,11750,1,79,2185,72599,57.87,26378275,76.399,18.7,2.933,3601.006,303.74,2.42,0.492,4
47,102,302,12052,2,81,2281,74880,57.87,26378275,76.399,18.7,2.933,3601.006,303.74,2.42,0.492,4
47,103,391,12443,1,82,1370,76250,57.87,26378275,76.399,18.7,2.933,3601.006,303.74,2.42,0.492,4
47,104,323,12766,2,84,1134,77384,57.87,26378275,76.399,18.7,2.933,3601.006,303.74,2.42,0.492,4
47,105,106,12872,0,84,682,78066,57.87,26378275,76.399,18.7,2.933,3601.006,303.74,2.42,0.492,4
47,106,165,13037,3,87,1829,79895,57.87,26378275,76.399,18.7,2.933,3601.006,303.74,2.42,0.492,4
47,107,366,13403,0,87,738,80633,60.65,26378275,76.399,18.7,2.933,3601.006,303.74,2.42,0.492,4
47,108,151,13554,0,87,746,81379,60.65,26378275,76.399,18.7,2.933,3601.006,303.74,2.42,0.492,4
47,109,142,13696,0,87,1237,82616,60.65,26378275,76.399,18.7,2.933,3601.006,303.74,2.42,0.492,4
47,110,216,13912,4,91,1137,83753,60.65,26378275,76.399,18.7,2.933,3601.006,303.74,2.42,0.492,4
47,111,207,14119,1,92,1656,85409,60.65,26378275,76.399,18.7,2.933,3601.006,303.74,2.42,0.492,4
47,112,193,14312,0,92,1143,86552,60.65,26378275,76.399,18.7,2.933,3601.006,303.74,2.42,0.492,4
47,113,219,14531,1,93,1131,87683,60.65,26378275,76.399,18.7,2.933,3601.006,303.74,2.42,0.492,4
47,114,0,14531,0,93,2237,89920,60.65,26378275,76.399,18.7,2.933,3601.006,303.74,2.42,0.492,4
47,115,470,15001,0,93,1735,91655,60.65,26378275,76.399,18.7,2.933,3601.006,303.74,2.42,0.492,4
47,116,252,15253,1,94,2004,93659,60.65,26378275,76.399,18.7,2.933,3601.006,303.74,2.42,0.492,4
47,117,241,15494,0,94,1446,95105,60.65,26378275,76.399,18.7,2.933,3601.006,303.74,2.42,0.492,4
47,118,102,15596,2,96,992,96097,44.91,26378275,76.399,18.7,2.933,3601.006,303.74,2.42,0.492,4
47,119,59,15655,0,96,671,96768,44.91,26378275,76.399,18.7,2.933,3601.006,303.74,2.42,0.492,4
47,120,58,15713,2,98,1246,98014,44.91,26378275,76.399,18.7,2.933,3601.006,303.74,2.42,0.492,4
47,121,100,15813,1,99,1720,99734,44.91,26378275,76.399,18.7,2.933,3601.006,303.74,2.42,0.492,4
47,122,165,15978,1,100,951,100685,31.94,26378275,76.399,18.7,2.933,3601.006,303.74,2.42,0.492,4
47,123,69,16047,2,102,898,101583,31.94,26378275,76.399,18.7,2.933,3601.006,303.74,2.42,0.492,4
47,124,62,16109,0,102,1102,102685,31.94,26378275,76.399,18.7,2.933,3601.006,303.74,2.42,0.492,4
47,125,73,16182,0,102,427,103112,31.94,26378275,76.399,18.7,2.933,3601.006,303.74,2.42,0.492,4
47,126,38,16220,0,102,512,103624,31.94,26378275,76.399,18.7,2.933,3601.006,303.74,2.42,0.492,4
47,127,73,16293,1,103,0,103624,31.94,26378275,76.399,18.7,2.933,3601.006,303.74,2.42,0.492,4
47,128,56,16349,0,103,0,104584,31.94,26378275,76.399,18.7,2.933,3601.006,303.74,2.42,0.492,4
47,129,98,16447,0,103,924,105508,31.94,26378275,76.399,18.7,2.933,3601.006,303.74,2.42,0.492,4
47,130,77,16524,1,104,1245,106753,31.94,26378275,76.399,18.7,2.933,3601.006,303.74,2.42,0.492,4
47,131,96,16620,0,104,2109,108862,31.94,26378275,76.399,18.7,2.933,3601.006,303.74,2.42,0.492,4
47,132,95,16715,1,105,815,109677,31.94,26378275,76.399,18.7,2.933,3601.006,303.74,2.42,0.492,4
47,133,83,16798,0,105,682,110359,31.94,26378275,76.399,18.7,2.933,3601.006,303.74,2.42,0.492,4
47,134,49,16847,0,105,252,110611,31.94,26378275,76.399,18.7,2.933,3601.006,303.74,2.42,0.492,4
47,135,0,16847,0,105,521,111132,31.94,26378275,76.399,18.7,2.933,3601.006,303.74,2.42,0.492,4
47,136,42,16889,0,105,929,112061,31.94,26378275,76.399,18.7,2.933,3601.006,303.74,2.42,0.492,4
47,137,46,16935,1,106,870,112931,31.94,26378275,76.399,18.7,2.933,3601.006,303.74,2.42,0.492,4
47,138,58,16993,2,108,457,113388,31.94,26378275,76.399,18.7,2.933,3601.006,303.74,2.42,0.492,4
47,139,33,17026,2,110,1032,114420,31.94,26378275,76.399,18.7,2.933,3601.006,303.74,2.42,0.492,4
47,140,0,17026,0,110,918,115338,31.94,26378275,76.399,18.7,2.933,3601.006,303.74,2.42,0.492,4
47,141,124,17150,0,110,1447,116785,31.94,26378275,76.399,18.7,2.933,3601.006,303.74,2.42,0.492,4
47,142,82,17232,1,111,330,117115,31.94,26378275,76.399,18.7,2.933,3601.006,303.74,2.42,0.492,4
47,143,17,17249,1,112,950,118065,38.43,26378275,76.399,18.7,2.933,3601.006,303.74,2.42,0.492,4
47,144,61,17310,0,112,1101,119166,38.43,26378275,76.399,18.7,2.933,3601.006,303.74,2.42,0.492,4
47,145,64,17374,1,113,1133,120299,38.43,26378275,76.399,18.7,2.933,3601.006,303.74,2.42,0.492,4
47,146,97,17471,0,113,987,121286,38.43,26378275,76.399,18.7,2.933,3601.006,303.74,2.42,0.492,4
47,147,35,17506,1,114,793,122079,38.43,26378275,76.399,18.7,2.933,3601.006,303.74,2.42,0.492,4
47,148,56,17562,0,114,896,122975,38.43,26378275,76.399,18.7,2.933,3601.006,303.74,2.42,0.492,4
47,149,41,17603,0,114,1082,124057,38.43,26378275,76.399,18.7,2.933,3601.006,303.74,2.42,0.492,4
47,150,99,17702,1,115,1028,125085,38.43,26378275,76.399,18.7,2.933,3601.006,303.74,2.42,0.492,4
47,151,95,17797,0,115,887,125972,38.43,26378275,76.399,18.7,2.933,3601.006,303.74,2.42,0.492,4
47,152,96,17893,0,115,580,126552,38.43,26378275,76.399,18.7,2.933,3601.006,303.74,2.42,0.492,4
47,153,55,17948,0,115,1252,127804,38.43,26378275,76.399,18.7,2.933,3601.006,303.74,2.42,0.492,4
47,154,119,18067,2,117,383,128187,38.43,26378275,76.399,18.7,2.933,3601.006,303.74,2.42,0.492,4
47,155,36,18103,0,117,938,129125,38.43,26378275,76.399,18.7,2.933,3601.006,303.74,2.42,0.492,4
47,156,58,18161,0,117,921,130046,38.43,26378275,76.399,18.7,2.933,3601.006,303.74,2.42,0.492,4
47,157,47,18208,2,119,1104,131150,38.43,26378275,76.399,18.7,2.933,3601.006,303.74,2.42,0.492,4
47,158,61,18269,0,119,1713,132863,38.43,26378275,76.399,18.7,2.933,3601.006,303.74,2.42,0.492,4
47,159,203,18472,0,119,1163,134026,38.43,26378275,76.399,18.7,2.933,3601.006,303.74,2.42,0.492,4
47,160,116,18588,0,119,759,134785,38.43,26378275,76.399,18.7,2.933,3601.006,303.74,2.42,0.492,4
47,161,113,18701,0,119,492,135277,38.43,26378275,76.399,18.7,2.933,3601.006,303.74,2.42,0.492,4
47,162,77,18778,0,119,1164,136441,38.43,26378275,76.399,18.7,2.933,3601.006,303.74,2.42,0.492,4
47,163,37,18815,0,119,1480,137921,39.81,26378275,76.399,18.7,2.933,3601.006,303.74,2.42,0.492,4
47,164,54,18869,0,119,1785,139706,39.81,26378275,76.399,18.7,2.933,3601.006,303.74,2.42,0.492,4
47,165,47,18916,0,119,1756,141462,39.81,26378275,76.399,18.7,2.933,3601.006,303.74,2.42,0.492,4
47,166,71,18987,1,120,786,142248,39.81,26378275,76.399,18.7,2.933,3601.006,303.74,2.42,0.492,4
47,167,26,19013,0,120,1413,143661,34.26,26378275,76.399,18.7,2.933,3601.006,303.74,2.42,0.492,4
47,168,53,19066,0,120,1098,144759,34.26,26378275,76.399,18.7,2.933,3601.006,303.74,2.42,0.492,4
47,169,34,19100,0,120,1553,146312,34.26,26378275,76.399,18.7,2.933,3601.006,303.74,2.42,0.492,4
47,170,32,19132,0,120,1253,147565,34.26,26378275,76.399,18.7,2.933,3601.006,303.74,2.42,0.492,4
47,171,26,19158,0,120,1392,148957,34.26,26378275,76.399,18.7,2.933,3601.006,303.74,2.42,0.492,4
47,172,42,19200,0,120,1689,150646,34.26,26378275,76.399,18.7,2.933,3601.006,303.74,2.42,0.492,4
47,173,69,19269,0,120,1881,152527,34.26,26378275,76.399,18.7,2.933,3601.006,303.74,2.42,0.492,4
47,174,51,19320,0,120,155,152682,34.26,26378275,76.399,18.7,2.933,3601.006,303.74,2.42,0.492,4
47,175,7,19327,0,120,546,153228,32.41,26378275,76.399,18.7,2.933,3601.006,303.74,2.42,0.492,4
47,176,16,19343,0,120,1742,154970,32.41,26378275,76.399,18.7,2.933,3601.006,303.74,2.42,0.492,4
47,177,87,19430,0,120,1420,156390,32.41,26378275,76.399,18.7,2.933,3601.006,303.74,2.42,0.492,4
47,178,71,19501,0,120,1632,158022,32.41,26378275,76.399,18.7,2.933,3601.006,303.74,2.42,0.492,4
47,179,55,19556,0,120,1263,159285,32.41,26378275,76.399,18.7,2.933,3601.006,303.74,2.42,0.492,4
47,180,44,19600,0,120,907,160192,32.41,26378275,76.399,18.7,2.933,3601.006,303.74,2.42,0.492,4
47,181,29,19629,0,120,236,160428,32.41,26378275,76.399,18.7,2.933,3601.006,303.74,2.42,0.492,4
47,182,12,19641,0,120,693,161121,32.41,26378275,76.399,18.7,2.933,3601.006,303.74,2.42,0.492,4
47,183,28,19669,0,120,1660,162781,32.41,26378275,76.399,18.7,2.933,3601.006,303.74,2.42,0.492,4
47,184,55,19724,0,120,934,163715,32.41,26378275,76.399,18.7,2.933,3601.006,303.74,2.42,0.492,4
47,185,31,19755,0,120,1124,164839,32.41,26378275,76.399,18.7,2.933,3601.006,303.74,2.42,0.492,4
47,186,38,19793,0,120,896,165735,32.41,26378275,76.399,18.7,2.933,3601.006,303.74,2.42,0.492,4
47,187,56,19849,0,120,794,166529,32.41,26378275,76.399,18.7,2.933,3601.006,303.74,2.42,0.492,4
47,188,33,19882,0,120,170,166699,32.41,26378275,76.399,18.7,2.933,3601.006,303.74,2.42,0.492,4
47,189,3,19885,0,120,384,167083,32.41,26378275,76.399,18.7,2.933,3601.006,303.74,2.42,0.492,4
47,190,18,19903,0,120,1226,168309,32.41,26378275,76.399,18.7,2.933,3601.006,303.74,2.42,0.492,4
47,191,32,19935,0,120,1095,169404,32.41,26378275,76.399,18.7,2.933,3601.006,303.74,2.42,0.492,4
47,192,47,19982,0,120,1099,170503,32.41,26378275,76.399,18.7,2.933,3601.006,303.74,2.42,0.492,4
47,193,54,20036,0,120,1805,172308,32.41,26378275,76.399,18.7,2.933,3601.006,303.74,2.42,0.492,4
47,194,92,20128,0,120,906,173214,32.41,26378275,76.399,18.7,2.933,3601.006,303.74,2.42,0.492,4
47,195,26,20154,0,120,68,173282,32.41,26378275,76.399,18.7,2.933,3601.006,303.74,2.42,0.492,4
47,196,1,20155,0,120,941,174223,32.41,26378275,76.399,18.7,2.933,3601.006,303.74,2.42,0.492,4
47,197,28,20183,0,120,1443,175666,32.41,26378275,76.399,18.7,2.933,3601.006,303.74,2.42,0.492,4
47,198,34,20217,1,121,1178,176844,32.41,26378275,76.399,18.7,2.933,3601.006,303.74,2.42,0.492,4
47,199,40,20257,0,121,973,177817,32.41,26378275,76.399,18.7,2.933,3601.006,303.74,2.42,0.492,4
47,200,18,20275,0,121,984,178801,32.41,26378275,76.399,18.7,2.933,3601.006,303.74,2.42,0.492,4
47,201,26,20301,0,121,1239,180040,32.41,26378275,76.399,18.7,2.933,3601.006,303.74,2.42,0.492,4
47,202,22,20323,0,121,0,180040,32.41,26378275,76.399,18.7,2.933,3601.006,303.74,2.42,0.492,4
47,203,1,20324,0,121,0,180040,32.41,26378275,76.399,18.7,2.933,3601.006,303.74,2.42,0.492,4
47,204,18,20342,0,121,0,180040,32.41,26378275,76.399,18.7,2.933,3601.006,303.74,2.42,0.492,4
48,1,77,867,0,6,665,7680,96.3,4105268,73.726,44,19.724,22669.797,253.782,5.59,0.831,0
48,2,96,963,0,6,672,8352,96.3,4105268,73.726,44,19.724,22669.797,253.782,5.59,0.831,0
48,3,48,1011,1,7,898,9250,96.3,4105268,73.726,44,19.724,22669.797,253.782,5.59,0.831,0
48,4,68,1079,1,8,583,9833,96.3,4105268,73.726,44,19.724,22669.797,253.782,5.59,0.831,0
48,5,47,1126,4,12,1014,10847,96.3,4105268,73.726,44,19.724,22669.797,253.782,5.59,0.831,0
48,6,56,1182,3,15,617,11464,96.3,4105268,73.726,44,19.724,22669.797,253.782,5.59,0.831,0
48,7,40,1222,1,16,858,12322,96.3,4105268,73.726,44,19.724,22669.797,253.782,5.59,0.831,0
48,8,60,1282,2,18,803,13125,96.3,4105268,73.726,44,19.724,22669.797,253.782,5.59,0.831,0
48,9,61,1343,1,19,555,13680,96.3,4105268,73.726,44,19.724,22669.797,253.782,5.59,0.831,0
48,10,64,1407,1,20,932,14612,96.3,4105268,73.726,44,19.724,22669.797,253.782,5.59,0.831,0
48,11,88,1495,1,21,1079,15691,96.3,4105268,73.726,44,19.724,22669.797,253.782,5.59,0.831,0
48,12,39,1534,0,21,690,16381,96.3,4105268,73.726,44,19.724,22669.797,253.782,5.59,0.831,0
48,13,66,1600,2,23,1409,17790,96.3,4105268,73.726,44,19.724,22669.797,253.782,5.59,0.831,0
48,14,50,1650,2,25,569,18359,96.3,4105268,73.726,44,19.724,22669.797,253.782,5.59,0.831,0
48,15,54,1704,6,31,897,19256,96.3,4105268,73.726,44,19.724,22669.797,253.782,5.59,0.831,0
48,16,37,1741,3,34,902,20158,96.3,4105268,73.726,44,19.724,22669.797,253.782,5.59,0.831,0
48,17,50,1791,1,35,795,20953,96.3,4105268,73.726,44,19.724,22669.797,253.782,5.59,0.831,0
48,18,23,1814,1,36,694,21647,96.3,4105268,73.726,44,19.724,22669.797,253.782,5.59,0.831,0
48,19,18,1832,3,39,2539,24186,96.3,4105268,73.726,44,19.724,22669.797,253.782,5.59,0.831,0
48,20,39,1871,8,47,2424,26610,96.3,4105268,73.726,44,19.724,22669.797,253.782,5.59,0.831,0
48,21,10,1881,0,47,0,26610,96.3,4105268,73.726,44,19.724,22669.797,253.782,5.59,0.831,0
48,22,27,1908,1,48,0,27614,96.3,4105268,73.726,44,19.724,22669.797,253.782,5.59,0.831,0
48,23,42,1950,0,48,1239,28853,96.3,4105268,73.726,44,19.724,22669.797,253.782,5.59,0.831,0
48,24,31,1981,2,50,1360,30213,96.3,4105268,73.726,44,19.724,22669.797,253.782,5.59,0.831,0
48,25,28,2009,1,51,700,30913,96.3,4105268,73.726,44,19.724,22669.797,253.782,5.59,0.831,0
48,26,7,2016,3,54,709,31622,96.3,4105268,73.726,44,19.724,22669.797,253.782,5.59,0.831,0
48,27,14,2030,1,55,1195,32817,89.81,4105268,73.726,44,19.724,22669.797,253.782,5.59,0.831,0
48,28,9,2039,4,59,760,33577,89.81,4105268,73.726,44,19.724,22669.797,253.782,5.59,0.831,0
48,29,8,2047,4,63,899,34476,89.81,4105268,73.726,44,19.724,22669.797,253.782,5.59,0.831,0
48,30,15,2062,4,67,2441,36917,89.81,4105268,73.726,44,19.724,22669.797,253.782,5.59,0.831,0
48,31,14,2076,2,69,0,36917,89.81,4105268,73.726,44,19.724,22669.797,253.782,5.59,0.831,0
48,32,9,2085,6,75,0,37557,89.81,4105268,73.726,44,19.724,22669.797,253.782,5.59,0.831,0
48,33,3,2088,2,77,527,38084,89.81,4105268,73.726,44,19.724,22669.797,253.782,5.59,0.831,0
48,34,8,2096,2,79,956,39040,89.81,4105268,73.726,44,19.724,22669.797,253.782,5.59,0.831,0
48,35,5,2101,1,80,933,39973,89.81,4105268,73.726,44,19.724,22669.797,253.782,5.59,0.831,0
48,36,11,2112,3,83,1080,41053,89.81,4105268,73.726,44,19.724,22669.797,253.782,5.59,0.831,0
48,37,7,2119,2,85,885,41938,89.81,4105268,73.726,44,19.724,22669.797,253.782,5.59,0.831,0
48,38,6,2125,1,86,1440,43378,89.81,4105268,73.726,44,19.724,22669.797,253.782,5.59,0.831,0
48,39,36,2161,0,86,840,44218,89.81,4105268,73.726,44,19.724,22669.797,253.782,5.59,0.831,0
48,40,15,2176,1,87,668,44886,89.81,4105268,73.726,44,19.724,22669.797,253.782,5.59,0.831,0
48,41,11,2187,3,90,1185,46071,70.37,4105268,73.726,44,19.724,22669.797,253.782,5.59,0.831,0
48,42,9,2196,1,91,1409,47480,70.37,4105268,73.726,44,19.724,22669.797,253.782,5.59,0.831,0
48,43,11,2207,0,91,1257,48737,70.37,4105268,73.726,44,19.724,22669.797,253.782,5.59,0.831,0
48,44,6,2213,3,94,1603,50340,70.37,4105268,73.726,44,19.724,22669.797,253.782,5.59,0.831,0
48,45,8,2221,0,94,1228,51568,70.37,4105268,73.726,44,19.724,22669.797,253.782,5.59,0.831,0
48,46,1,2222,1,95,857,52425,70.37,4105268,73.726,44,19.724,22669.797,253.782,5.59,0.831,0
48,47,2,2224,0,95,1452,53877,70.37,4105268,73.726,44,19.724,22669.797,253.782,5.59,0.831,0
48,48,2,2226,0,95,943,54820,70.37,4105268,73.726,44,19.724,22669.797,253.782,5.59,0.831,0
48,49,2,2228,0,95,980,55800,70.37,4105268,73.726,44,19.724,22669.797,253.782,5.59,0.831,0
48,50,4,2232,1,96,1221,57021,70.37,4105268,73.726,44,19.724,22669.797,253.782,5.59,0.831,0
48,51,2,2234,0,96,0,57021,70.37,4105268,73.726,44,19.724,22669.797,253.782,5.59,0.831,0
48,52,3,2237,1,97,0,59911,70.37,4105268,73.726,44,19.724,22669.797,253.782,5.59,0.831,0
48,53,6,2243,2,99,953,60864,70.37,4105268,73.726,44,19.724,22669.797,253.782,5.59,0.831,0
48,54,0,2243,0,99,618,61482,70.37,4105268,73.726,44,19.724,22669.797,253.782,5.59,0.831,0
48,55,1,2244,0,99,940,62422,62.04,4105268,73.726,44,19.724,22669.797,253.782,5.59,0.831,0
48,56,0,2244,1,100,1260,63682,53.7,4105268,73.726,44,19.724,22669.797,253.782,5.59,0.831,0
48,57,0,2244,1,101,584,64266,53.7,4105268,73.726,44,19.724,22669.797,253.782,5.59,0.831,0
48,58,0,2244,0,101,828,65094,50.93,4105268,73.726,44,19.724,22669.797,253.782,5.59,0.831,0
48,59,1,2245,1,102,415,65509,50.93,4105268,73.726,44,19.724,22669.797,253.782,5.59,0.831,0
48,60,0,2245,1,103,635,66144,50.93,4105268,73.726,44,19.724,22669.797,253.782,5.59,0.831,0
48,61,1,2246,0,103,261,66405,50.93,4105268,73.726,44,19.724,22669.797,253.782,5.59,0.831,0
48,62,0,2246,0,103,290,66695,50.93,4105268,73.726,44,19.724,22669.797,253.782,5.59,0.831,0
48,63,0,2246,0,103,602,67297,50.93,4105268,73.726,44,19.724,22669.797,253.782,5.59,0.831,0
48,64,0,2246,0,103,517,67814,50.93,4105268,73.726,44,19.724,22669.797,253.782,5.59,0.831,0
48,65,0,2246,0,103,183,67997,50.93,4105268,73.726,44,19.724,22669.797,253.782,5.59,0.831,0
48,66,1,2247,0,103,270,68267,36.11,4105268,73.726,44,19.724,22669.797,253.782,5.59,0.831,0
48,67,0,2247,0,103,247,68514,36.11,4105268,73.726,44,19.724,22669.797,253.782,5.59,0.831,0
48,68,0,2247,1,104,226,68740,36.11,4105268,73.726,44,19.724,22669.797,253.782,5.59,0.831,0
48,69,0,2247,0,104,126,68866,36.11,4105268,73.726,44,19.724,22669.797,253.782,5.59,0.831,0
48,70,0,2247,0,104,249,69115,36.11,4105268,73.726,44,19.724,22669.797,253.782,5.59,0.831,0
48,71,0,2247,2,106,234,69349,36.11,4105268,73.726,44,19.724,22669.797,253.782,5.59,0.831,0
48,72,2,2249,0,106,257,69606,36.11,4105268,73.726,44,19.724,22669.797,253.782,5.59,0.831,0
48,73,0,2249,0,106,115,69721,32.41,4105268,73.726,44,19.724,22669.797,253.782,5.59,0.831,0
48,74,0,2249,1,107,246,69967,32.41,4105268,73.726,44,19.724,22669.797,253.782,5.59,0.831,0
48,75,2,2251,0,107,143,70110,32.41,4105268,73.726,44,19.724,22669.797,253.782,5.59,0.831,0
48,76,1,2252,0,107,144,70254,32.41,4105268,73.726,44,19.724,22669.797,253.782,5.59,0.831,0
48,77,2,2254,0,107,272,70526,32.41,4105268,73.726,44,19.724,22669.797,253.782,5.59,0.831,0
48,78,1,2255,0,107,186,70712,32.41,4105268,73.726,44,19.724,22669.797,253.782,5.59,0.831,0
48,79,3,2258,0,107,283,70995,32.41,4105268,73.726,44,19.724,22669.797,253.782,5.59,0.831,0
48,80,11,2269,0,107,819,71814,32.41,4105268,73.726,44,19.724,22669.797,253.782,5.59,0.831,0
48,81,11,2280,0,107,388,72202,32.41,4105268,73.726,44,19.724,22669.797,253.782,5.59,0.831,0
48,82,19,2299,0,107,276,72478,32.41,4105268,73.726,44,19.724,22669.797,253.782,5.59,0.831,0
48,83,18,2317,0,107,268,72746,32.41,4105268,73.726,44,19.724,22669.797,253.782,5.59,0.831,0
48,84,19,2336,0,107,347,73093,32.41,4105268,73.726,44,19.724,22669.797,253.782,5.59,0.831,0
48,85,30,2366,0,107,645,73738,32.41,4105268,73.726,44,19.724,22669.797,253.782,5.59,0.831,0
48,86,22,2388,0,107,919,74657,32.41,4105268,73.726,44,19.724,22669.797,253.782,5.59,0.831,0
48,87,95,2483,0,107,0,74657,32.41,4105268,73.726,44,19.724,22669.797,253.782,5.59,0.831,0
48,88,56,2539,0,107,0,76624,32.41,4105268,73.726,44,19.724,22669.797,253.782,5.59,0.831,0
48,89,85,2624,0,107,829,77453,32.41,4105268,73.726,44,19.724,22669.797,253.782,5.59,0.831,0
48,90,67,2691,0,107,730,78183,32.41,4105268,73.726,44,19.724,22669.797,253.782,5.59,0.831,0
48,91,34,2725,0,107,921,79104,32.41,4105268,73.726,44,19.724,22669.797,253.782,5.59,0.831,0
48,92,52,2777,0,107,1352,80456,32.41,4105268,73.726,44,19.724,22669.797,253.782,5.59,0.831,0
48,93,54,2831,1,108,981,81437,32.41,4105268,73.726,44,19.724,22669.797,253.782,5.59,0.831,0
48,94,81,2912,2,110,1465,82902,32.41,4105268,73.726,44,19.724,22669.797,253.782,5.59,0.831,0
48,95,96,3008,2,112,1264,84166,32.41,4105268,73.726,44,19.724,22669.797,253.782,5.59,0.831,0
48,96,86,3094,1,113,1244,85410,32.41,4105268,73.726,44,19.724,22669.797,253.782,5.59,0.831,0
48,97,57,3151,0,113,587,85997,32.41,4105268,73.726,44,19.724,22669.797,253.782,5.59,0.831,0
48,98,69,3220,0,113,863,86860,32.41,4105268,73.726,44,19.724,22669.797,253.782,5.59,0.831,0
48,99,52,3272,0,113,1375,88235,32.41,4105268,73.726,44,19.724,22669.797,253.782,5.59,0.831,0
48,100,53,3325,1,114,1529,89764,32.41,4105268,73.726,44,19.724,22669.797,253.782,5.59,0.831,0
48,101,91,3416,1,115,1722,91486,32.41,4105268,73.726,44,19.724,22669.797,253.782,5.59,0.831,0
48,102,116,3532,2,117,1322,92808,29.63,4105268,73.726,44,19.724,22669.797,253.782,5.59,0.831,0
48,103,140,3672,1,118,763,93571,29.63,4105268,73.726,44,19.724,22669.797,253.782,5.59,0.831,0
48,104,50,3722,1,119,604,94175,29.63,4105268,73.726,44,19.724,22669.797,253.782,5.59,0.831,0
48,105,53,3775,0,119,1745,95920,29.63,4105268,73.726,44,19.724,22669.797,253.782,5.59,0.831,0
48,106,52,3827,0,119,1804,97724,26.85,4105268,73.726,44,19.724,22669.797,253.782,5.59,0.831,0
48,107,126,3953,0,119,1690,99414,26.85,4105268,73.726,44,19.724,22669.797,253.782,5.59,0.831,0
48,108,86,4039,0,119,1437,100851,26.85,4105268,73.726,44,19.724,22669.797,253.782,5.59,0.831,0
48,109,98,4137,1,120,1338,102189,26.85,4105268,73.726,44,19.724,22669.797,253.782,5.59,0.831,0
48,110,98,4235,0,120,915,103104,26.85,4105268,73.726,44,19.724,22669.797,253.782,5.59,0.831,0
48,111,119,4354,0,120,1028,104132,26.85,4105268,73.726,44,19.724,22669.797,253.782,5.59,0.831,0
48,112,16,4370,2,122,1394,105526,24.07,4105268,73.726,44,19.724,22669.797,253.782,5.59,0.831,0
48,113,52,4422,0,122,1279,106805,24.07,4105268,73.726,44,19.724,22669.797,253.782,5.59,0.831,0
48,114,108,4530,3,125,1417,108222,24.07,4105268,73.726,44,19.724,22669.797,253.782,5.59,0.831,0
48,115,104,4634,3,128,1136,109358,24.07,4105268,73.726,44,19.724,22669.797,253.782,5.59,0.831,0
48,116,81,4715,0,128,1156,110514,24.07,4105268,73.726,44,19.724,22669.797,253.782,5.59,0.831,0
48,117,77,4792,5,133,1489,112003,24.07,4105268,73.726,44,19.724,22669.797,253.782,5.59,0.831,0
48,118,65,4857,3,136,831,112834,24.07,4105268,73.726,44,19.724,22669.797,253.782,5.59,0.831,0
48,119,24,4881,3,139,1256,114090,24.07,4105268,73.726,44,19.724,22669.797,253.782,5.59,0.831,0
48,120,42,4923,1,140,1632,115722,24.07,4105268,73.726,44,19.724,22669.797,253.782,5.59,0.831,0
48,121,70,4993,1,141,1448,117170,24.07,4105268,73.726,44,19.724,22669.797,253.782,5.59,0.831,0
48,122,78,5071,3,144,1785,118955,24.07,4105268,73.726,44,19.724,22669.797,253.782,5.59,0.831,0
48,123,67,5138,1,145,1381,120336,24.07,4105268,73.726,44,19.724,22669.797,253.782,5.59,0.831,0
48,124,86,5224,0,145,984,121320,24.07,4105268,73.726,44,19.724,22669.797,253.782,5.59,0.831,0
48,125,36,5260,4,149,763,122083,24.07,4105268,73.726,44,19.724,22669.797,253.782,5.59,0.831,0
48,126,36,5296,4,153,1116,123199,24.07,4105268,73.726,44,19.724,22669.797,253.782,5.59,0.831,0
48,127,22,5318,1,154,1184,124383,31.48,4105268,73.726,44,19.724,22669.797,253.782,5.59,0.831,0
48,128,58,5376,0,154,934,125317,31.48,4105268,73.726,44,19.724,22669.797,253.782,5.59,0.831,0
48,129,28,5404,1,155,1093,126410,31.48,4105268,73.726,44,19.724,22669.797,253.782,5.59,0.831,0
48,130,62,5466,0,155,995,127405,31.48,4105268,73.726,44,19.724,22669.797,253.782,5.59,0.831,0
48,131,77,5543,2,157,727,128132,31.48,4105268,73.726,44,19.724,22669.797,253.782,5.59,0.831,0
48,132,61,5604,0,157,1247,129379,31.48,4105268,73.726,44,19.724,22669.797,253.782,5.59,0.831,0
48,133,45,5649,1,158,1309,130688,31.48,4105268,73.726,44,19.724,22669.797,253.782,5.59,0.831,0
48,134,91,5740,2,160,1604,132292,31.48,4105268,73.726,44,19.724,22669.797,253.782,5.59,0.831,0
48,135,130,5870,0,160,1201,133493,31.48,4105268,73.726,44,19.724,22669.797,253.782,5.59,0.831,0
48,136,180,6050,1,161,1249,134742,31.48,4105268,73.726,44,19.724,22669.797,253.782,5.59,0.831,0
48,137,208,6258,2,163,1538,136280,31.48,4105268,73.726,44,19.724,22669.797,253.782,5.59,0.831,0
48,138,162,6420,2,165,1377,137657,31.48,4105268,73.726,44,19.724,22669.797,253.782,5.59,0.831,0
48,139,151,6571,1,166,990,138647,31.48,4105268,73.726,44,19.724,22669.797,253.782,5.59,0.831,0
48,140,85,6656,0,166,1824,140471,31.48,4105268,73.726,44,19.724,22669.797,253.782,5.59,0.831,0
48,141,199,6855,0,166,1653,142124,31.48,4105268,73.726,44,19.724,22669.797,253.782,5.59,0.831,0
48,142,219,7074,2,168,2397,144521,31.48,4105268,73.726,44,19.724,22669.797,253.782,5.59,0.831,0
48,143,255,7329,0,168,1647,146168,31.48,4105268,73.726,44,19.724,22669.797,253.782,5.59,0.831,0
48,144,265,7594,1,169,2574,148742,31.48,4105268,73.726,44,19.724,22669.797,253.782,5.59,0.831,0
48,145,306,7900,1,170,1718,150460,31.48,4105268,73.726,44,19.724,22669.797,253.782,5.59,0.831,0
48,146,275,8175,1,171,2364,152824,31.48,4105268,73.726,44,19.724,22669.797,253.782,5.59,0.831,0
48,147,136,8311,2,173,1335,154159,31.48,4105268,73.726,44,19.724,22669.797,253.782,5.59,0.831,0
48,148,219,8530,2,175,3228,157387,31.48,4105268,73.726,44,19.724,22669.797,253.782,5.59,0.831,0
48,149,358,8888,0,175,2849,160236,31.48,4105268,73.726,44,19.724,22669.797,253.782,5.59,0.831,0
48,150,304,9192,2,177,2065,162301,31.48,4105268,73.726,44,19.724,22669.797,253.782,5.59,0.831,0
48,151,357,9549,3,180,3415,165716,31.48,4105268,73.726,44,19.724,22669.797,253.782,5.59,0.831,0
48,152,312,9861,3,183,922,166638,31.48,4105268,73.726,44,19.724,22669.797,253.782,5.59,0.831,0
48,153,262,10123,1,184,1591,168229,31.48,4105268,73.726,44,19.724,22669.797,253.782,5.59,0.831,0
48,154,146,10269,2,186,2995,171224,31.48,4105268,73.726,44,19.724,22669.797,253.782,5.59,0.831,0
48,155,145,10414,1,187,4122,175346,31.48,4105268,73.726,44,19.724,22669.797,253.782,5.59,0.831,0
48,156,311,10725,4,191,4492,179838,31.48,4105268,73.726,44,19.724,22669.797,253.782,5.59,0.831,0
48,157,369,11094,3,194,4074,183912,31.48,4105268,73.726,44,19.724,22669.797,253.782,5.59,0.831,0
48,158,334,11428,1,195,3939,187851,31.48,4105268,73.726,44,19.724,22669.797,253.782,5.59,0.831,0
48,159,311,11739,2,197,3509,191360,31.48,4105268,73.726,44,19.724,22669.797,253.782,5.59,0.831,0
48,160,225,11964,1,198,1793,193153,28.7,4105268,73.726,44,19.724,22669.797,253.782,5.59,0.831,0
48,161,117,12081,3,201,3813,196966,28.7,4105268,73.726,44,19.724,22669.797,253.782,5.59,0.831,0
48,162,204,12285,2,203,4172,201138,28.7,4105268,73.726,44,19.724,22669.797,253.782,5.59,0.831,0
48,163,341,12626,3,206,4118,205256,28.7,4105268,73.726,44,19.724,22669.797,253.782,5.59,0.831,0
48,164,291,12917,2,208,5549,210805,28.7,4105268,73.726,44,19.724,22669.797,253.782,5.59,0.831,0
48,165,190,13107,3,211,5690,216495,28.7,4105268,73.726,44,19.724,22669.797,253.782,5.59,0.831,0
48,166,261,13368,7,218,5339,221834,28.7,4105268,73.726,44,19.724,22669.797,253.782,5.59,0.831,0
48,167,165,13533,6,224,3180,225014,28.7,4105268,73.726,44,19.724,22669.797,253.782,5.59,0.831,0
48,168,65,13598,3,227,5571,230585,28.7,4105268,73.726,44,19.724,22669.797,253.782,5.59,0.831,0
48,169,151,13749,3,230,6353,236938,28.7,4105268,73.726,44,19.724,22669.797,253.782,5.59,0.831,0
48,170,280,14029,6,236,5948,242886,28.7,4105268,73.726,44,19.724,22669.797,253.782,5.59,0.831,0
48,171,250,14279,2,238,6137,249023,28.7,4105268,73.726,44,19.724,22669.797,253.782,5.59,0.831,0
48,172,234,14513,6,244,5457,254480,28.7,4105268,73.726,44,19.724,22669.797,253.782,5.59,0.831,0
48,173,212,14725,0,244,4384,258864,28.7,4105268,73.726,44,19.724,22669.797,253.782,5.59,0.831,0
48,174,197,14922,4,248,3268,262132,28.7,4105268,73.726,44,19.724,22669.797,253.782,5.59,0.831,0
48,175,70,14992,5,253,5165,267297,28.7,4105268,73.726,44,19.724,22669.797,253.782,5.59,0.831,0
48,176,144,15136,2,255,6387,273684,28.7,4105268,73.726,44,19.724,22669.797,253.782,5.59,0.831,0
48,177,204,15340,2,257,5351,279035,28.7,4105268,73.726,44,19.724,22669.797,253.782,5.59,0.831,0
48,178,232,15572,4,261,5414,284449,28.7,4105268,73.726,44,19.724,22669.797,253.782,5.59,0.831,0
48,179,223,15795,5,266,4575,289024,28.7,4105268,73.726,44,19.724,22669.797,253.782,5.59,0.831,0
48,180,212,16007,3,269,3945,292969,28.7,4105268,73.726,44,19.724,22669.797,253.782,5.59,0.831,0
48,181,190,16197,3,272,3029,295998,28.7,4105268,73.726,44,19.724,22669.797,253.782,5.59,0.831,0
48,182,48,16245,0,272,4494,300492,28.7,4105268,73.726,44,19.724,22669.797,253.782,5.59,0.831,0
48,183,135,16380,3,275,6592,307084,28.7,4105268,73.726,44,19.724,22669.797,253.782,5.59,0.831,0
48,184,213,16593,5,280,5322,312406,28.7,4105268,73.726,44,19.724,22669.797,253.782,5.59,0.831,0
48,185,234,16827,4,284,4793,317199,28.7,4105268,73.726,44,19.724,22669.797,253.782,5.59,0.831,0
48,186,333,17160,7,291,0,317199,28.7,4105268,73.726,44,19.724,22669.797,253.782,5.59,0.831,0
48,187,241,17401,2,293,0,326159,28.7,4105268,73.726,44,19.724,22669.797,253.782,5.59,0.831,0
48,188,258,17659,5,298,2233,328392,28.7,4105268,73.726,44,19.724,22669.797,253.782,5.59,0.831,0
48,189,138,17797,2,300,4849,333241,28.7,4105268,73.726,44,19.724,22669.797,253.782,5.59,0.831,0
48,190,287,18084,4,304,5353,338594,28.7,4105268,73.726,44,19.724,22669.797,253.782,5.59,0.831,0
48,191,363,18447,5,309,5939,344533,28.7,4105268,73.726,44,19.724,22669.797,253.782,5.59,0.831,0
48,192,542,18989,1,310,4417,348950,28.7,4105268,73.726,44,19.724,22669.797,253.782,5.59,0.831,0
48,193,457,19446,3,313,4576,353526,28.7,4105268,73.726,44,19.724,22669.797,253.782,5.59,0.831,0
48,194,486,19932,4,317,4989,358515,28.7,4105268,73.726,44,19.724,22669.797,253.782,5.59,0.831,0
48,195,508,20440,7,324,2461,360976,28.7,4105268,73.726,44,19.724,22669.797,253.782,5.59,0.831,0
48,196,181,20621,3,327,5259,366235,28.7,4105268,73.726,44,19.724,22669.797,253.782,5.59,0.831,0
48,197,372,20993,3,330,6448,372683,28.7,4105268,73.726,44,19.724,22669.797,253.782,5.59,0.831,0
48,198,748,21741,4,334,6696,379379,28.7,4105268,73.726,44,19.724,22669.797,253.782,5.59,0.831,0
48,199,793,22534,10,344,5693,385072,28.7,4105268,73.726,44,19.724,22669.797,253.782,5.59,0.831,0
48,200,1131,23665,1,345,6980,392052,28.7,4105268,73.726,44,19.724,22669.797,253.782,5.59,0.831,0
48,201,1096,24761,10,355,4948,397000,28.7,4105268,73.726,44,19.724,22669.797,253.782,5.59,0.831,0
48,202,819,25580,8,363,3636,400636,28.7,4105268,73.726,44,19.724,22669.797,253.782,5.59,0.831,0
48,203,393,25973,11,374,5883,406519,28.7,4105268,73.726,44,19.724,22669.797,253.782,5.59,0.831,0
48,204,890,26863,8,382,0,406519,28.7,4105268,73.726,44,19.724,22669.797,253.782,5.59,0.831,0
51,1,32,262,1,8,779,8176,92.59,875899,127.657,37.3,13.416,32415.132,141.171,9.24,0.869,0
51,2,58,320,1,9,603,8779,92.59,875899,127.657,37.3,13.416,32415.132,141.171,9.24,0.869,0
51,3,36,356,0,9,668,9447,92.59,875899,127.657,37.3,13.416,32415.132,141.171,9.24,0.869,0
51,4,40,396,0,9,698,10145,92.59,875899,127.657,37.3,13.416,32415.132,141.171,9.24,0.869,0
51,5,30,426,0,9,792,10937,92.59,875899,127.657,37.3,13.416,32415.132,141.171,9.24,0.869,0
51,6,20,446,0,9,718,11655,92.59,875899,127.657,37.3,13.416,32415.132,141.171,9.24,0.869,0
51,7,19,465,0,9,1353,13008,92.59,875899,127.657,37.3,13.416,32415.132,141.171,9.24,0.869,0
51,8,29,494,0,9,1256,14264,92.59,875899,127.657,37.3,13.416,32415.132,141.171,9.24,0.869,0
51,9,32,526,0,9,1216,15480,92.59,875899,127.657,37.3,13.416,32415.132,141.171,9.24,0.869,0
51,10,38,564,1,10,819,16299,92.59,875899,127.657,37.3,13.416,32415.132,141.171,9.24,0.869,0
51,11,31,595,0,10,811,17110,92.59,875899,127.657,37.3,13.416,32415.132,141.171,9.24,0.869,0
51,12,21,616,0,10,804,17914,92.59,875899,127.657,37.3,13.416,32415.132,141.171,9.24,0.869,0
51,13,17,633,1,11,891,18805,92.59,875899,127.657,37.3,13.416,32415.132,141.171,9.24,0.869,0
51,14,29,662,1,12,1703,20508,92.59,875899,127.657,37.3,13.416,32415.132,141.171,9.24,0.869,0
51,15,33,695,0,12,2312,22820,92.59,875899,127.657,37.3,13.416,32415.132,141.171,9.24,0.869,0
51,16,20,715,0,12,2905,25725,94.44,875899,127.657,37.3,13.416,32415.132,141.171,9.24,0.869,0
51,17,20,735,0,12,3241,28966,94.44,875899,127.657,37.3,13.416,32415.132,141.171,9.24,0.869,0
51,18,0,735,0,12,3209,32175,94.44,875899,127.657,37.3,13.416,32415.132,141.171,9.24,0.869,0
51,19,26,761,0,12,1803,33978,94.44,875899,127.657,37.3,13.416,32415.132,141.171,9.24,0.869,0
51,20,6,767,0,12,1669,35647,94.44,875899,127.657,37.3,13.416,32415.132,141.171,9.24,0.869,0
51,21,5,772,0,12,1325,36972,94.44,875899,127.657,37.3,13.416,32415.132,141.171,9.24,0.869,0
51,22,12,784,0,12,1441,38413,94.44,875899,127.657,37.3,13.416,32415.132,141.171,9.24,0.869,0
51,23,6,790,2,14,2322,40735,94.44,875899,127.657,37.3,13.416,32415.132,141.171,9.24,0.869,0
51,24,5,795,0,14,2698,43433,94.44,875899,127.657,37.3,13.416,32415.132,141.171,9.24,0.869,0
51,25,9,804,0,14,2467,45900,94.44,875899,127.657,37.3,13.416,32415.132,141.171,9.24,0.869,0
51,26,6,810,0,14,2415,48315,94.44,875899,127.657,37.3,13.416,32415.132,141.171,9.24,0.869,0
51,27,7,817,0,14,1796,50111,94.44,875899,127.657,37.3,13.416,32415.132,141.171,9.24,0.869,0
51,28,5,822,1,15,2999,53110,94.44,875899,127.657,37.3,13.416,32415.132,141.171,9.24,0.869,0
51,29,15,837,0,15,2436,55546,94.44,875899,127.657,37.3,13.416,32415.132,141.171,9.24,0.869,0
51,30,6,843,0,15,2454,58000,94.44,875899,127.657,37.3,13.416,32415.132,141.171,9.24,0.869,0
51,31,7,850,0,15,2427,60427,94.44,875899,127.657,37.3,13.416,32415.132,141.171,9.24,0.869,0
51,32,7,857,0,15,1731,62158,94.44,875899,127.657,37.3,13.416,32415.132,141.171,9.24,0.869,0
51,33,7,864,0,15,1968,64126,94.44,875899,127.657,37.3,13.416,32415.132,141.171,9.24,0.869,0
51,34,8,872,0,15,1490,65616,92.59,875899,127.657,37.3,13.416,32415.132,141.171,9.24,0.869,0
51,35,2,874,0,15,1250,66866,92.59,875899,127.657,37.3,13.416,32415.132,141.171,9.24,0.869,0
51,36,4,878,0,15,2062,68928,92.59,875899,127.657,37.3,13.416,32415.132,141.171,9.24,0.869,0
51,37,5,883,0,15,1774,70702,92.59,875899,127.657,37.3,13.416,32415.132,141.171,9.24,0.869,0
51,38,6,889,0,15,1957,72659,92.59,875899,127.657,37.3,13.416,32415.132,141.171,9.24,0.869,0
51,39,2,891,0,15,1978,74637,92.59,875899,127.657,37.3,13.416,32415.132,141.171,9.24,0.869,0
51,40,1,892,0,15,1393,76030,92.59,875899,127.657,37.3,13.416,32415.132,141.171,9.24,0.869,0
51,41,6,898,1,16,1046,77076,92.59,875899,127.657,37.3,13.416,32415.132,141.171,9.24,0.869,0
51,42,3,901,0,16,1153,78229,92.59,875899,127.657,37.3,13.416,32415.132,141.171,9.24,0.869,0
51,43,2,903,0,16,1946,80175,92.59,875899,127.657,37.3,13.416,32415.132,141.171,9.24,0.869,0
51,44,2,905,1,17,1659,81834,92.59,875899,127.657,37.3,13.416,32415.132,141.171,9.24,0.869,0
51,45,2,907,0,17,1794,83628,92.59,875899,127.657,37.3,13.416,32415.132,141.171,9.24,0.869,0
51,46,3,910,0,17,1564,85192,92.59,875899,127.657,37.3,13.416,32415.132,141.171,9.24,0.869,0
51,47,4,914,0,17,2248,87440,92.59,875899,127.657,37.3,13.416,32415.132,141.171,9.24,0.869,0
51,48,2,916,0,17,1287,88727,92.59,875899,127.657,37.3,13.416,32415.132,141.171,9.24,0.869,0
51,49,1,917,0,17,1882,90609,92.59,875899,127.657,37.3,13.416,32415.132,141.171,9.24,0.869,0
51,50,1,918,0,17,1984,92593,92.59,875899,127.657,37.3,13.416,32415.132,141.171,9.24,0.869,0
51,51,4,922,0,17,2647,95240,76.85,875899,127.657,37.3,13.416,32415.132,141.171,9.24,0.869,0
51,52,1,923,0,17,1970,97210,76.85,875899,127.657,37.3,13.416,32415.132,141.171,9.24,0.869,0
51,53,4,927,0,17,2414,99624,76.85,875899,127.657,37.3,13.416,32415.132,141.171,9.24,0.869,0
51,54,0,927,0,17,1953,101577,76.85,875899,127.657,37.3,13.416,32415.132,141.171,9.24,0.869,0
51,55,8,935,0,17,2128,103705,76.85,875899,127.657,37.3,13.416,32415.132,141.171,9.24,0.869,0
51,56,2,937,0,17,2214,105919,76.85,875899,127.657,37.3,13.416,32415.132,141.171,9.24,0.869,0
51,57,2,939,0,17,2640,108559,76.85,875899,127.657,37.3,13.416,32415.132,141.171,9.24,0.869,0
51,58,0,939,0,17,2602,111161,76.85,875899,127.657,37.3,13.416,32415.132,141.171,9.24,0.869,0
51,59,2,941,0,17,2363,113524,76.85,875899,127.657,37.3,13.416,32415.132,141.171,9.24,0.869,0
51,60,0,941,0,17,2061,115585,76.85,875899,127.657,37.3,13.416,32415.132,141.171,9.24,0.869,0
51,61,2,943,0,17,1717,117302,76.85,875899,127.657,37.3,13.416,32415.132,141.171,9.24,0.869,0
51,62,1,944,0,17,1504,118806,76.85,875899,127.657,37.3,13.416,32415.132,141.171,9.24,0.869,0
51,63,5,949,0,17,1473,120279,76.85,875899,127.657,37.3,13.416,32415.132,141.171,9.24,0.869,0
51,64,3,952,0,17,2928,123207,76.85,875899,127.657,37.3,13.416,32415.132,141.171,9.24,0.869,0
51,65,6,958,0,17,1996,125203,76.85,875899,127.657,37.3,13.416,32415.132,141.171,9.24,0.869,0
51,66,0,958,0,17,1836,127039,76.85,875899,127.657,37.3,13.416,32415.132,141.171,9.24,0.869,0
51,67,2,960,0,17,2054,129093,76.85,875899,127.657,37.3,13.416,32415.132,141.171,9.24,0.869,0
51,68,0,960,1,18,2364,131457,76.85,875899,127.657,37.3,13.416,32415.132,141.171,9.24,0.869,0
51,69,4,964,0,18,799,132256,71.3,875899,127.657,37.3,13.416,32415.132,141.171,9.24,0.869,0
51,70,6,970,0,18,484,132740,62.96,875899,127.657,37.3,13.416,32415.132,141.171,9.24,0.869,0
51,71,2,972,0,18,1369,134109,62.96,875899,127.657,37.3,13.416,32415.132,141.171,9.24,0.869,0
51,72,2,974,0,18,2518,136627,62.96,875899,127.657,37.3,13.416,32415.132,141.171,9.24,0.869,0
51,73,1,975,0,18,1289,137916,62.96,875899,127.657,37.3,13.416,32415.132,141.171,9.24,0.869,0
51,74,5,980,0,18,1613,139529,62.96,875899,127.657,37.3,13.416,32415.132,141.171,9.24,0.869,0
51,75,0,980,0,18,1252,140781,62.96,875899,127.657,37.3,13.416,32415.132,141.171,9.24,0.869,0
51,76,3,983,0,18,622,141403,62.96,875899,127.657,37.3,13.416,32415.132,141.171,9.24,0.869,0
51,77,2,985,0,18,912,142315,62.96,875899,127.657,37.3,13.416,32415.132,141.171,9.24,0.869,0
51,78,0,985,0,18,1210,143525,62.96,875899,127.657,37.3,13.416,32415.132,141.171,9.24,0.869,0
51,79,0,985,0,18,1047,144572,62.96,875899,127.657,37.3,13.416,32415.132,141.171,9.24,0.869,0
51,80,0,985,1,19,763,145335,62.96,875899,127.657,37.3,13.416,32415.132,141.171,9.24,0.869,0
51,81,0,985,0,19,808,146143,62.96,875899,127.657,37.3,13.416,32415.132,141.171,9.24,0.869,0
51,82,0,985,0,19,620,146763,62.96,875899,127.657,37.3,13.416,32415.132,141.171,9.24,0.869,0
51,83,1,986,0,19,1039,147802,62.96,875899,127.657,37.3,13.416,32415.132,141.171,9.24,0.869,0
51,84,2,988,0,19,1067,148869,62.96,875899,127.657,37.3,13.416,32415.132,141.171,9.24,0.869,0
51,85,2,990,0,19,1405,150274,50,875899,127.657,37.3,13.416,32415.132,141.171,9.24,0.869,0
51,86,1,991,0,19,1104,151378,50,875899,127.657,37.3,13.416,32415.132,141.171,9.24,0.869,0
51,87,1,992,0,19,1059,152437,50,875899,127.657,37.3,13.416,32415.132,141.171,9.24,0.869,0
51,88,0,992,0,19,1336,153773,50,875899,127.657,37.3,13.416,32415.132,141.171,9.24,0.869,0
51,89,2,994,0,19,1059,154832,50,875899,127.657,37.3,13.416,32415.132,141.171,9.24,0.869,0
51,90,0,994,0,19,1290,156122,50,875899,127.657,37.3,13.416,32415.132,141.171,9.24,0.869,0
51,91,2,996,0,19,1320,157442,50,875899,127.657,37.3,13.416,32415.132,141.171,9.24,0.869,0
51,92,2,998,0,19,1204,158646,50,875899,127.657,37.3,13.416,32415.132,141.171,9.24,0.869,0
51,93,1,999,0,19,1019,159665,50,875899,127.657,37.3,13.416,32415.132,141.171,9.24,0.869,0
51,94,0,999,0,19,1538,161203,50,875899,127.657,37.3,13.416,32415.132,141.171,9.24,0.869,0
51,95,0,999,0,19,1699,162902,50,875899,127.657,37.3,13.416,32415.132,141.171,9.24,0.869,0
51,96,3,1002,0,19,1445,164347,50,875899,127.657,37.3,13.416,32415.132,141.171,9.24,0.869,0
51,97,1,1003,0,19,1259,165606,50,875899,127.657,37.3,13.416,32415.132,141.171,9.24,0.869,0
51,98,1,1004,0,19,1191,166797,50,875899,127.657,37.3,13.416,32415.132,141.171,9.24,0.869,0
51,99,1,1005,0,19,1691,168488,50,875899,127.657,37.3,13.416,32415.132,141.171,9.24,0.869,0
51,100,3,1008,0,19,1159,169647,50,875899,127.657,37.3,13.416,32415.132,141.171,9.24,0.869,0
51,101,2,1010,0,19,1247,170894,50,875899,127.657,37.3,13.416,32415.132,141.171,9.24,0.869,0
51,102,3,1013,0,19,1748,172642,50,875899,127.657,37.3,13.416,32415.132,141.171,9.24,0.869,0
51,103,1,1014,0,19,1179,173821,47.22,875899,127.657,37.3,13.416,32415.132,141.171,9.24,0.869,0
51,104,7,1021,0,19,942,174763,47.22,875899,127.657,37.3,13.416,32415.132,141.171,9.24,0.869,0
51,105,1,1022,0,19,1754,176517,47.22,875899,127.657,37.3,13.416,32415.132,141.171,9.24,0.869,0
51,106,0,1022,0,19,1658,178175,47.22,875899,127.657,37.3,13.416,32415.132,141.171,9.24,0.869,0
51,107,1,1023,0,19,1504,179679,47.22,875899,127.657,37.3,13.416,32415.132,141.171,9.24,0.869,0
51,108,8,1031,0,19,1329,181008,47.22,875899,127.657,37.3,13.416,32415.132,141.171,9.24,0.869,0
51,109,0,1031,0,19,1831,182839,47.22,875899,127.657,37.3,13.416,32415.132,141.171,9.24,0.869,0
51,110,6,1037,0,19,1085,183924,47.22,875899,127.657,37.3,13.416,32415.132,141.171,9.24,0.869,0
51,111,1,1038,0,19,1565,185489,47.22,875899,127.657,37.3,13.416,32415.132,141.171,9.24,0.869,0
51,112,0,1038,0,19,1395,186884,47.22,875899,127.657,37.3,13.416,32415.132,141.171,9.24,0.869,0
51,113,2,1040,0,19,2465,189349,47.22,875899,127.657,37.3,13.416,32415.132,141.171,9.24,0.869,0
51,114,0,1040,0,19,1575,190924,47.22,875899,127.657,37.3,13.416,32415.132,141.171,9.24,0.869,0
51,115,5,1045,0,19,1109,192033,47.22,875899,127.657,37.3,13.416,32415.132,141.171,9.24,0.869,0
51,116,2,1047,0,19,1682,193715,47.22,875899,127.657,37.3,13.416,32415.132,141.171,9.24,0.869,0
51,117,6,1053,0,19,902,194617,47.22,875899,127.657,37.3,13.416,32415.132,141.171,9.24,0.869,0
51,118,4,1057,0,19,1855,196472,47.22,875899,127.657,37.3,13.416,32415.132,141.171,9.24,0.869,0
51,119,3,1060,0,19,1974,198446,47.22,875899,127.657,37.3,13.416,32415.132,141.171,9.24,0.869,0
51,120,7,1067,0,19,1725,200171,47.22,875899,127.657,37.3,13.416,32415.132,141.171,9.24,0.869,0
51,121,13,1080,0,19,2069,202240,47.22,875899,127.657,37.3,13.416,32415.132,141.171,9.24,0.869,0
51,122,4,1084,0,19,1850,204090,47.22,875899,127.657,37.3,13.416,32415.132,141.171,9.24,0.869,0
51,123,30,1114,0,19,2987,207077,47.22,875899,127.657,37.3,13.416,32415.132,141.171,9.24,0.869,0
51,124,10,1124,0,19,2924,210001,47.22,875899,127.657,37.3,13.416,32415.132,141.171,9.24,0.869,0
51,125,26,1150,0,19,2581,212582,47.22,875899,127.657,37.3,13.416,32415.132,141.171,9.24,0.869,0
51,126,5,1155,0,19,3988,216570,47.22,875899,127.657,37.3,13.416,32415.132,141.171,9.24,0.869,0
51,127,25,1180,0,19,3132,219702,47.22,875899,127.657,37.3,13.416,32415.132,141.171,9.24,0.869,0
51,128,15,1195,0,19,3486,223188,47.22,875899,127.657,37.3,13.416,32415.132,141.171,9.24,0.869,0
51,129,13,1208,0,19,3539,226727,47.22,875899,127.657,37.3,13.416,32415.132,141.171,9.24,0.869,0
51,130,14,1222,0,19,3314,230041,47.22,875899,127.657,37.3,13.416,32415.132,141.171,9.24,0.869,0
51,131,11,1233,0,19,2919,232960,47.22,875899,127.657,37.3,13.416,32415.132,141.171,9.24,0.869,0
51,132,9,1242,0,19,2619,235579,47.22,875899,127.657,37.3,13.416,32415.132,141.171,9.24,0.869,0
51,133,10,1252,0,19,4024,239603,47.22,875899,127.657,37.3,13.416,32415.132,141.171,9.24,0.869,0
51,134,25,1277,1,20,3775,243378,47.22,875899,127.657,37.3,13.416,32415.132,141.171,9.24,0.869,0
51,135,14,1291,0,20,3387,246765,47.22,875899,127.657,37.3,13.416,32415.132,141.171,9.24,0.869,0
51,136,14,1305,0,20,2960,249725,47.22,875899,127.657,37.3,13.416,32415.132,141.171,9.24,0.869,0
51,137,13,1318,0,20,3813,253538,47.22,875899,127.657,37.3,13.416,32415.132,141.171,9.24,0.869,0
51,138,14,1332,0,20,2475,256013,47.22,875899,127.657,37.3,13.416,32415.132,141.171,9.24,0.869,0
51,139,0,1332,0,20,3588,259601,47.22,875899,127.657,37.3,13.416,32415.132,141.171,9.24,0.869,0
51,140,19,1351,0,20,4315,263916,47.22,875899,127.657,37.3,13.416,32415.132,141.171,9.24,0.869,0
51,141,8,1359,0,20,3372,267288,47.22,875899,127.657,37.3,13.416,32415.132,141.171,9.24,0.869,0
51,142,26,1385,1,21,3202,270490,47.22,875899,127.657,37.3,13.416,32415.132,141.171,9.24,0.869,0
51,143,10,1395,0,21,3201,273691,47.22,875899,127.657,37.3,13.416,32415.132,141.171,9.24,0.869,0
51,144,11,1406,0,21,3446,277137,50,875899,127.657,37.3,13.416,32415.132,141.171,9.24,0.869,0
51,145,11,1417,0,21,3281,280418,50,875899,127.657,37.3,13.416,32415.132,141.171,9.24,0.869,0
51,146,4,1421,0,21,3522,283940,50,875899,127.657,37.3,13.416,32415.132,141.171,9.24,0.869,0
51,147,30,1451,0,21,2769,286709,50,875899,127.657,37.3,13.416,32415.132,141.171,9.24,0.869,0
51,148,23,1474,0,21,3207,289916,50,875899,127.657,37.3,13.416,32415.132,141.171,9.24,0.869,0
51,149,7,1481,0,21,2755,292671,50,875899,127.657,37.3,13.416,32415.132,141.171,9.24,0.869,0
51,150,0,1481,0,21,2917,295588,50,875899,127.657,37.3,13.416,32415.132,141.171,9.24,0.869,0
51,151,0,1481,0,21,2843,298431,50,875899,127.657,37.3,13.416,32415.132,141.171,9.24,0.869,0
51,152,2,1483,0,21,2845,301276,50,875899,127.657,37.3,13.416,32415.132,141.171,9.24,0.869,0
51,153,4,1487,0,21,1916,303192,50,875899,127.657,37.3,13.416,32415.132,141.171,9.24,0.869,0
51,154,1,1488,0,21,2646,305838,50,875899,127.657,37.3,13.416,32415.132,141.171,9.24,0.869,0
51,155,2,1490,0,21,2643,308481,50,875899,127.657,37.3,13.416,32415.132,141.171,9.24,0.869,0
51,156,5,1495,0,21,2149,310630,50,875899,127.657,37.3,13.416,32415.132,141.171,9.24,0.869,0
51,157,3,1498,0,21,1810,312440,50,875899,127.657,37.3,13.416,32415.132,141.171,9.24,0.869,0
51,158,0,1498,0,21,3033,315473,50,875899,127.657,37.3,13.416,32415.132,141.171,9.24,0.869,0
51,159,9,1507,0,21,2150,317623,50,875899,127.657,37.3,13.416,32415.132,141.171,9.24,0.869,0
51,160,2,1509,0,21,2049,319672,50,875899,127.657,37.3,13.416,32415.132,141.171,9.24,0.869,0
51,161,1,1510,0,21,2797,322469,55.56,875899,127.657,37.3,13.416,32415.132,141.171,9.24,0.869,0
51,162,1,1511,0,21,2251,324720,55.56,875899,127.657,37.3,13.416,32415.132,141.171,9.24,0.869,0
51,163,3,1514,0,21,2452,327172,55.56,875899,127.657,37.3,13.416,32415.132,141.171,9.24,0.869,0
51,164,3,1517,0,21,3108,330280,55.56,875899,127.657,37.3,13.416,32415.132,141.171,9.24,0.869,0
51,165,3,1520,0,21,2320,332600,55.56,875899,127.657,37.3,13.416,32415.132,141.171,9.24,0.869,0
51,166,3,1523,0,21,2810,335410,55.56,875899,127.657,37.3,13.416,32415.132,141.171,9.24,0.869,0
51,167,3,1526,0,21,1960,337370,53.7,875899,127.657,37.3,13.416,32415.132,141.171,9.24,0.869,0
51,168,8,1534,1,22,3157,340527,53.7,875899,127.657,37.3,13.416,32415.132,141.171,9.24,0.869,0
51,169,6,1540,0,22,2449,342976,53.7,875899,127.657,37.3,13.416,32415.132,141.171,9.24,0.869,0
51,170,8,1548,0,22,1951,344927,53.7,875899,127.657,37.3,13.416,32415.132,141.171,9.24,0.869,0
51,171,10,1558,0,22,3039,347966,53.7,875899,127.657,37.3,13.416,32415.132,141.171,9.24,0.869,0
51,172,7,1565,0,22,2950,350916,53.7,875899,127.657,37.3,13.416,32415.132,141.171,9.24,0.869,0
51,173,15,1580,0,22,2164,353080,53.7,875899,127.657,37.3,13.416,32415.132,141.171,9.24,0.869,0
51,174,20,1600,0,22,3036,356116,53.7,875899,127.657,37.3,13.416,32415.132,141.171,9.24,0.869,0
51,175,3,1603,0,22,2709,358825,53.7,875899,127.657,37.3,13.416,32415.132,141.171,9.24,0.869,0
51,176,15,1618,0,22,3317,362142,53.7,875899,127.657,37.3,13.416,32415.132,141.171,9.24,0.869,0
51,177,36,1654,0,22,2893,365035,53.7,875899,127.657,37.3,13.416,32415.132,141.171,9.24,0.869,0
51,178,9,1663,0,22,2615,367650,53.7,875899,127.657,37.3,13.416,32415.132,141.171,9.24,0.869,0
51,179,8,1671,0,22,3220,370870,53.7,875899,127.657,37.3,13.416,32415.132,141.171,9.24,0.869,0
51,180,13,1684,0,22,3338,374208,53.7,875899,127.657,37.3,13.416,32415.132,141.171,9.24,0.869,0
51,181,12,1696,0,22,2465,376673,53.7,875899,127.657,37.3,13.416,32415.132,141.171,9.24,0.869,0
51,182,17,1713,0,22,2685,379358,53.7,875899,127.657,37.3,13.416,32415.132,141.171,9.24,0.869,0
51,183,30,1743,0,22,3147,382505,53.7,875899,127.657,37.3,13.416,32415.132,141.171,9.24,0.869,0
51,184,12,1755,0,22,2454,384959,53.7,875899,127.657,37.3,13.416,32415.132,141.171,9.24,0.869,0
51,185,17,1772,0,22,2412,387371,53.7,875899,127.657,37.3,13.416,32415.132,141.171,9.24,0.869,0
51,186,17,1789,0,22,3477,390848,53.7,875899,127.657,37.3,13.416,32415.132,141.171,9.24,0.869,0
51,187,22,1811,0,22,3177,394025,53.7,875899,127.657,37.3,13.416,32415.132,141.171,9.24,0.869,0
51,188,13,1824,0,22,2736,396761,53.7,875899,127.657,37.3,13.416,32415.132,141.171,9.24,0.869,0
51,189,23,1847,0,22,3532,400293,53.7,875899,127.657,37.3,13.416,32415.132,141.171,9.24,0.869,0
51,190,29,1876,1,23,3533,403826,53.7,875899,127.657,37.3,13.416,32415.132,141.171,9.24,0.869,0
51,191,21,1897,1,24,3133,406959,53.7,875899,127.657,37.3,13.416,32415.132,141.171,9.24,0.869,0
51,192,21,1918,0,24,2891,409850,50,875899,127.657,37.3,13.416,32415.132,141.171,9.24,0.869,0
51,193,33,1951,1,25,3414,413264,50,875899,127.657,37.3,13.416,32415.132,141.171,9.24,0.869,0
51,194,35,1986,0,25,3365,416629,50,875899,127.657,37.3,13.416,32415.132,141.171,9.24,0.869,0
51,195,0,1986,0,25,2610,419239,50,875899,127.657,37.3,13.416,32415.132,141.171,9.24,0.869,0
51,196,61,2047,0,25,3645,422884,50,875899,127.657,37.3,13.416,32415.132,141.171,9.24,0.869,0
51,197,0,2047,0,25,2291,425175,50,875899,127.657,37.3,13.416,32415.132,141.171,9.24,0.869,0
51,198,83,2130,0,25,3877,429052,50,875899,127.657,37.3,13.416,32415.132,141.171,9.24,0.869,0
51,199,51,2181,0,25,3084,432136,50,875899,127.657,37.3,13.416,32415.132,141.171,9.24,0.869,0
51,200,198,2379,0,25,4966,437102,50,875899,127.657,37.3,13.416,32415.132,141.171,9.24,0.869,0
51,201,0,2379,0,25,3688,440790,46.3,875899,127.657,37.3,13.416,32415.132,141.171,9.24,0.869,0
51,202,265,2644,0,25,2558,443348,46.3,875899,127.657,37.3,13.416,32415.132,141.171,9.24,0.869,0
51,203,43,2687,0,25,0,443348,46.3,875899,127.657,37.3,13.416,32415.132,141.171,9.24,0.869,0
51,204,152,2839,0,25,0,443348,46.3,875899,127.657,37.3,13.416,32415.132,141.171,9.24,0.869,0
52,1,306,3308,7,31,6102,62090,82.41,10708982,137.176,43.3,19.027,32605.906,227.485,6.82,0.888,0
52,2,281,3589,8,39,6673,68763,74.07,10708982,137.176,43.3,19.027,32605.906,227.485,6.82,0.888,0
52,3,269,3858,5,44,7398,76161,74.07,10708982,137.176,43.3,19.027,32605.906,227.485,6.82,0.888,0
52,4,332,4190,9,53,5837,81998,74.07,10708982,137.176,43.3,19.027,32605.906,227.485,6.82,0.888,0
52,5,282,4472,6,59,4812,86810,74.07,10708982,137.176,43.3,19.027,32605.906,227.485,6.82,0.888,0
52,6,115,4587,8,67,6435,93245,74.07,10708982,137.176,43.3,19.027,32605.906,227.485,6.82,0.888,0
52,7,235,4822,11,78,8173,101418,74.07,10708982,137.176,43.3,19.027,32605.906,227.485,6.82,0.888,0
52,8,195,5017,10,88,8469,109887,74.07,10708982,137.176,43.3,19.027,32605.906,227.485,6.82,0.888,0
52,9,295,5312,11,99,8180,118067,74.07,10708982,137.176,43.3,19.027,32605.906,227.485,6.82,0.888,0
52,10,257,5569,13,112,5702,123769,74.07,10708982,137.176,43.3,19.027,32605.906,227.485,6.82,0.888,0
52,11,163,5732,7,119,4891,128660,74.07,10708982,137.176,43.3,19.027,32605.906,227.485,6.82,0.888,0
52,12,170,5902,10,129,3250,131910,74.07,10708982,137.176,43.3,19.027,32605.906,227.485,6.82,0.888,0
52,13,89,5991,9,138,3215,135125,74.07,10708982,137.176,43.3,19.027,32605.906,227.485,6.82,0.888,0
52,14,68,6059,5,143,6173,141298,71.3,10708982,137.176,43.3,19.027,32605.906,227.485,6.82,0.888,0
52,15,82,6141,18,161,8476,149774,71.3,10708982,137.176,43.3,19.027,32605.906,227.485,6.82,0.888,0
52,16,162,6303,5,166,8381,158155,71.3,10708982,137.176,43.3,19.027,32605.906,227.485,6.82,0.888,0
52,17,130,6433,3,169,8288,166443,71.3,10708982,137.176,43.3,19.027,32605.906,227.485,6.82,0.888,0
52,18,116,6549,4,173,5605,172048,71.3,10708982,137.176,43.3,19.027,32605.906,227.485,6.82,0.888,0
52,19,105,6654,8,181,4027,176075,71.3,10708982,137.176,43.3,19.027,32605.906,227.485,6.82,0.888,0
52,20,133,6787,7,188,6567,182642,63.89,10708982,137.176,43.3,19.027,32605.906,227.485,6.82,0.888,0
52,21,127,6914,8,196,8341,190983,60.19,10708982,137.176,43.3,19.027,32605.906,227.485,6.82,0.888,0
52,22,127,7041,5,201,8818,199801,60.19,10708982,137.176,43.3,19.027,32605.906,227.485,6.82,0.888,0
52,23,95,7136,9,210,7901,207702,60.19,10708982,137.176,43.3,19.027,32605.906,227.485,6.82,0.888,0
52,24,52,7188,3,213,7129,214831,60.19,10708982,137.176,43.3,19.027,32605.906,227.485,6.82,0.888,0
52,25,85,7273,2,215,4446,219277,60.19,10708982,137.176,43.3,19.027,32605.906,227.485,6.82,0.888,0
52,26,79,7352,3,218,3381,222658,60.19,10708982,137.176,43.3,19.027,32605.906,227.485,6.82,0.888,0
52,27,52,7404,3,221,7754,230412,57.41,10708982,137.176,43.3,19.027,32605.906,227.485,6.82,0.888,0
52,28,45,7449,2,223,8741,239153,57.41,10708982,137.176,43.3,19.027,32605.906,227.485,6.82,0.888,0
52,29,55,7504,4,227,7322,246475,57.41,10708982,137.176,43.3,19.027,32605.906,227.485,6.82,0.888,0
52,30,75,7579,0,227,7396,253871,57.41,10708982,137.176,43.3,19.027,32605.906,227.485,6.82,0.888,0
52,31,103,7682,9,236,4497,258368,57.41,10708982,137.176,43.3,19.027,32605.906,227.485,6.82,0.888,0
52,32,55,7737,4,240,3885,262253,57.41,10708982,137.176,43.3,19.027,32605.906,227.485,6.82,0.888,0
52,33,18,7755,5,245,3881,266134,57.41,10708982,137.176,43.3,19.027,32605.906,227.485,6.82,0.888,0
52,34,26,7781,3,248,7756,273890,57.41,10708982,137.176,43.3,19.027,32605.906,227.485,6.82,0.888,0
52,35,38,7819,4,252,9383,283273,57.41,10708982,137.176,43.3,19.027,32605.906,227.485,6.82,0.888,0
52,36,77,7896,5,257,8052,291325,57.41,10708982,137.176,43.3,19.027,32605.906,227.485,6.82,0.888,0
52,37,78,7974,5,262,7599,298924,57.41,10708982,137.176,43.3,19.027,32605.906,227.485,6.82,0.888,0
52,38,57,8031,8,270,4510,303434,57.41,10708982,137.176,43.3,19.027,32605.906,227.485,6.82,0.888,0
52,39,46,8077,3,273,3788,307222,57.41,10708982,137.176,43.3,19.027,32605.906,227.485,6.82,0.888,0
52,40,18,8095,3,276,4052,311274,57.41,10708982,137.176,43.3,19.027,32605.906,227.485,6.82,0.888,0
52,41,28,8123,4,280,7809,319083,57.41,10708982,137.176,43.3,19.027,32605.906,227.485,6.82,0.888,0
52,42,53,8176,2,282,8755,327838,57.41,10708982,137.176,43.3,19.027,32605.906,227.485,6.82,0.888,0
52,43,45,8221,1,283,7687,335525,57.41,10708982,137.176,43.3,19.027,32605.906,227.485,6.82,0.888,0
52,44,48,8269,7,290,6902,342427,57.41,10708982,137.176,43.3,19.027,32605.906,227.485,6.82,0.888,0
52,45,82,8351,3,293,6790,349217,57.41,10708982,137.176,43.3,19.027,32605.906,227.485,6.82,0.888,0
52,46,55,8406,2,295,4197,353414,57.41,10708982,137.176,43.3,19.027,32605.906,227.485,6.82,0.888,0
52,47,49,8455,1,296,3553,356967,57.41,10708982,137.176,43.3,19.027,32605.906,227.485,6.82,0.888,0
52,48,20,8475,1,297,7458,364425,57.41,10708982,137.176,43.3,19.027,32605.906,227.485,6.82,0.888,0
52,49,111,8586,0,297,8336,372761,57.41,10708982,137.176,43.3,19.027,32605.906,227.485,6.82,0.888,0
52,50,61,8647,5,302,7518,380279,57.41,10708982,137.176,43.3,19.027,32605.906,227.485,6.82,0.888,0
52,51,74,8721,2,304,7290,387569,57.41,10708982,137.176,43.3,19.027,32605.906,227.485,6.82,0.888,0
52,52,33,8754,2,306,7748,395317,57.41,10708982,137.176,43.3,19.027,32605.906,227.485,6.82,0.888,0
52,53,59,8813,6,312,5059,400376,57.41,10708982,137.176,43.3,19.027,32605.906,227.485,6.82,0.888,0
52,54,77,8890,2,314,3849,404225,57.41,10708982,137.176,43.3,19.027,32605.906,227.485,6.82,0.888,0
52,55,67,8957,1,315,7508,411733,45.37,10708982,137.176,43.3,19.027,32605.906,227.485,6.82,0.888,0
52,56,47,9004,2,317,7241,418974,45.37,10708982,137.176,43.3,19.027,32605.906,227.485,6.82,0.888,0
52,57,46,9050,0,317,6846,425820,45.37,10708982,137.176,43.3,19.027,32605.906,227.485,6.82,0.888,0
52,58,36,9086,0,317,6013,431833,45.37,10708982,137.176,43.3,19.027,32605.906,227.485,6.82,0.888,0
52,59,54,9140,2,319,6113,437946,45.37,10708982,137.176,43.3,19.027,32605.906,227.485,6.82,0.888,0
52,60,56,9196,0,319,3548,441494,45.37,10708982,137.176,43.3,19.027,32605.906,227.485,6.82,0.888,0
52,61,34,9230,0,319,2141,443635,45.37,10708982,137.176,43.3,19.027,32605.906,227.485,6.82,0.888,0
52,62,43,9273,1,320,5721,449356,41.67,10708982,137.176,43.3,19.027,32605.906,227.485,6.82,0.888,0
52,63,29,9302,1,321,6478,455834,41.67,10708982,137.176,43.3,19.027,32605.906,227.485,6.82,0.888,0
52,64,62,9364,2,323,5313,461147,41.67,10708982,137.176,43.3,19.027,32605.906,227.485,6.82,0.888,0
52,65,74,9438,1,324,5011,466158,41.67,10708982,137.176,43.3,19.027,32605.906,227.485,6.82,0.888,0
52,66,56,9494,2,326,4173,470331,41.67,10708982,137.176,43.3,19.027,32605.906,227.485,6.82,0.888,0
52,67,35,9529,1,327,2150,472481,41.67,10708982,137.176,43.3,19.027,32605.906,227.485,6.82,0.888,0
52,68,38,9567,0,327,2127,474608,41.67,10708982,137.176,43.3,19.027,32605.906,227.485,6.82,0.888,0
52,69,61,9628,0,327,4684,479292,41.67,10708982,137.176,43.3,19.027,32605.906,227.485,6.82,0.888,0
52,70,69,9697,1,328,4552,483844,41.67,10708982,137.176,43.3,19.027,32605.906,227.485,6.82,0.888,0
52,71,54,9751,0,328,4068,487912,41.67,10708982,137.176,43.3,19.027,32605.906,227.485,6.82,0.888,0
52,72,73,9824,0,328,3739,491651,41.67,10708982,137.176,43.3,19.027,32605.906,227.485,6.82,0.888,0
52,73,62,9886,1,329,3726,495377,41.67,10708982,137.176,43.3,19.027,32605.906,227.485,6.82,0.888,0
52,74,52,9938,0,329,1652,497029,41.67,10708982,137.176,43.3,19.027,32605.906,227.485,6.82,0.888,0
52,75,53,9991,0,329,1121,498150,41.67,10708982,137.176,43.3,19.027,32605.906,227.485,6.82,0.888,0
52,76,33,10024,0,329,3673,501823,41.67,10708982,137.176,43.3,19.027,32605.906,227.485,6.82,0.888,0
52,77,40,10064,1,330,4023,505846,41.67,10708982,137.176,43.3,19.027,32605.906,227.485,6.82,0.888,0
52,78,47,10111,1,331,4036,509882,41.67,10708982,137.176,43.3,19.027,32605.906,227.485,6.82,0.888,0
52,79,51,10162,2,333,4403,514285,41.67,10708982,137.176,43.3,19.027,32605.906,227.485,6.82,0.888,0
52,80,68,10230,1,334,3574,517859,41.67,10708982,137.176,43.3,19.027,32605.906,227.485,6.82,0.888,0
52,81,176,10406,1,335,1699,519558,41.67,10708982,137.176,43.3,19.027,32605.906,227.485,6.82,0.888,0
52,82,42,10448,1,336,1313,520871,35.19,10708982,137.176,43.3,19.027,32605.906,227.485,6.82,0.888,0
52,83,50,10498,0,336,3910,524781,35.19,10708982,137.176,43.3,19.027,32605.906,227.485,6.82,0.888,0
52,84,63,10561,0,336,4567,529348,35.19,10708982,137.176,43.3,19.027,32605.906,227.485,6.82,0.888,0
52,85,89,10650,3,339,4287,533635,35.19,10708982,137.176,43.3,19.027,32605.906,227.485,6.82,0.888,0
52,86,127,10777,4,343,4047,537682,35.19,10708982,137.176,43.3,19.027,32605.906,227.485,6.82,0.888,0
52,87,93,10870,2,345,4533,542215,35.19,10708982,137.176,43.3,19.027,32605.906,227.485,6.82,0.888,0
52,88,168,11038,0,345,2554,544769,35.19,10708982,137.176,43.3,19.027,32605.906,227.485,6.82,0.888,0
52,89,260,11298,2,347,2423,547192,35.19,10708982,137.176,43.3,19.027,32605.906,227.485,6.82,0.888,0
52,90,305,11603,1,348,4485,551677,35.19,10708982,137.176,43.3,19.027,32605.906,227.485,6.82,0.888,0
52,91,202,11805,0,348,4412,556089,37.5,10708982,137.176,43.3,19.027,32605.906,227.485,6.82,0.888,0
52,92,149,11954,1,349,4593,560682,37.5,10708982,137.176,43.3,19.027,32605.906,227.485,6.82,0.888,0
52,93,92,12046,0,349,4665,565347,37.5,10708982,137.176,43.3,19.027,32605.906,227.485,6.82,0.888,0
52,94,132,12178,2,351,5109,570456,37.5,10708982,137.176,43.3,19.027,32605.906,227.485,6.82,0.888,0
52,95,141,12319,1,352,1687,572143,34.72,10708982,137.176,43.3,19.027,32605.906,227.485,6.82,0.888,0
52,96,121,12440,-1,351,1524,573667,34.72,10708982,137.176,43.3,19.027,32605.906,227.485,6.82,0.888,0
52,97,75,12515,-3,348,1714,575381,34.72,10708982,137.176,43.3,19.027,32605.906,227.485,6.82,0.888,0
52,98,51,12566,2,350,4159,579540,34.72,10708982,137.176,43.3,19.027,32605.906,227.485,6.82,0.888,0
52,99,119,12685,1,351,5406,584946,34.72,10708982,137.176,43.3,19.027,32605.906,227.485,6.82,0.888,0
52,100,129,12814,0,351,4682,589628,34.72,10708982,137.176,43.3,19.027,32605.906,227.485,6.82,0.888,0
52,101,105,12919,1,352,5333,594961,34.72,10708982,137.176,43.3,19.027,32605.906,227.485,6.82,0.888,0
52,102,143,13062,0,352,2321,597282,34.72,10708982,137.176,43.3,19.027,32605.906,227.485,6.82,0.888,0
52,103,53,13115,0,352,1787,599069,34.72,10708982,137.176,43.3,19.027,32605.906,227.485,6.82,0.888,0
52,104,59,13174,0,352,4424,603493,34.72,10708982,137.176,43.3,19.027,32605.906,227.485,6.82,0.888,0
52,105,64,13238,1,353,4802,608295,34.72,10708982,137.176,43.3,19.027,32605.906,227.485,6.82,0.888,0
52,106,103,13341,2,355,4694,612989,34.72,10708982,137.176,43.3,19.027,32605.906,227.485,6.82,0.888,0
52,107,134,13475,0,355,4730,617719,34.72,10708982,137.176,43.3,19.027,32605.906,227.485,6.82,0.888,0
52,108,137,13612,0,355,4727,622446,34.72,10708982,137.176,43.3,19.027,32605.906,227.485,6.82,0.888,0
52,109,130,13742,3,358,2334,624780,37.5,10708982,137.176,43.3,19.027,32605.906,227.485,6.82,0.888,0
52,110,113,13855,0,358,1830,626610,37.5,10708982,137.176,43.3,19.027,32605.906,227.485,6.82,0.888,0
52,111,90,13945,1,359,5785,632395,37.5,10708982,137.176,43.3,19.027,32605.906,227.485,6.82,0.888,0
52,112,153,14098,0,359,6089,638484,37.5,10708982,137.176,43.3,19.027,32605.906,227.485,6.82,0.888,0
52,113,226,14324,1,360,6609,645093,37.5,10708982,137.176,43.3,19.027,32605.906,227.485,6.82,0.888,0
52,114,246,14570,4,364,5557,650650,37.5,10708982,137.176,43.3,19.027,32605.906,227.485,6.82,0.888,0
52,115,230,14800,1,365,6238,656888,37.5,10708982,137.176,43.3,19.027,32605.906,227.485,6.82,0.888,0
52,116,281,15081,3,368,3337,660225,37.5,10708982,137.176,43.3,19.027,32605.906,227.485,6.82,0.888,0
52,117,131,15212,0,368,1781,662006,37.5,10708982,137.176,43.3,19.027,32605.906,227.485,6.82,0.888,0
52,118,112,15324,3,371,6527,668533,36.11,10708982,137.176,43.3,19.027,32605.906,227.485,6.82,0.888,0
52,119,192,15516,2,373,7877,676410,36.11,10708982,137.176,43.3,19.027,32605.906,227.485,6.82,0.888,0
52,120,283,15799,0,373,7492,683902,36.11,10708982,137.176,43.3,19.027,32605.906,227.485,6.82,0.888,0
52,121,294,16093,1,374,7610,691512,36.11,10708982,137.176,43.3,19.027,32605.906,227.485,6.82,0.888,0
52,122,249,16342,5,379,8178,699690,36.11,10708982,137.176,43.3,19.027,32605.906,227.485,6.82,0.888,0
52,123,232,16574,3,382,4703,704393,36.11,10708982,137.176,43.3,19.027,32605.906,227.485,6.82,0.888,0
52,124,125,16699,1,383,2647,707040,36.11,10708982,137.176,43.3,19.027,32605.906,227.485,6.82,0.888,0
52,125,101,16800,0,383,7719,714759,36.11,10708982,137.176,43.3,19.027,32605.906,227.485,6.82,0.888,0
52,126,208,17008,0,383,8393,723152,36.11,10708982,137.176,43.3,19.027,32605.906,227.485,6.82,0.888,0
52,127,278,17286,0,383,6926,730078,36.11,10708982,137.176,43.3,19.027,32605.906,227.485,6.82,0.888,0
52,128,243,17529,5,388,7349,737427,36.11,10708982,137.176,43.3,19.027,32605.906,227.485,6.82,0.888,0
52,129,211,17740,1,389,9186,746613,36.11,10708982,137.176,43.3,19.027,32605.906,227.485,6.82,0.888,0
52,130,320,18060,0,389,5488,752101,36.11,10708982,137.176,43.3,19.027,32605.906,227.485,6.82,0.888,0
52,131,175,18235,0,389,2915,755016,36.11,10708982,137.176,43.3,19.027,32605.906,227.485,6.82,0.888,0
52,132,120,18355,0,389,6450,761466,36.11,10708982,137.176,43.3,19.027,32605.906,227.485,6.82,0.888,0
52,133,139,18494,0,389,8454,769920,36.11,10708982,137.176,43.3,19.027,32605.906,227.485,6.82,0.888,0
52,134,289,18783,2,391,7758,777678,36.11,10708982,137.176,43.3,19.027,32605.906,227.485,6.82,0.888,0
52,135,292,19075,0,391,7193,784871,36.11,10708982,137.176,43.3,19.027,32605.906,227.485,6.82,0.888,0
52,136,326,19401,0,391,7793,792664,36.11,10708982,137.176,43.3,19.027,32605.906,227.485,6.82,0.888,0
52,137,292,19693,3,394,4942,797606,36.11,10708982,137.176,43.3,19.027,32605.906,227.485,6.82,0.888,0
52,138,198,19891,1,395,2872,800478,36.11,10708982,137.176,43.3,19.027,32605.906,227.485,6.82,0.888,0
52,139,121,20012,2,397,7192,807670,36.11,10708982,137.176,43.3,19.027,32605.906,227.485,6.82,0.888,0
52,140,190,20202,2,399,7599,815269,36.11,10708982,137.176,43.3,19.027,32605.906,227.485,6.82,0.888,0
52,141,281,20483,2,401,7546,822815,36.11,10708982,137.176,43.3,19.027,32605.906,227.485,6.82,0.888,0
52,142,315,20798,3,404,8218,831033,36.11,10708982,137.176,43.3,19.027,32605.906,227.485,6.82,0.888,0
52,143,247,21045,2,406,9682,840715,36.11,10708982,137.176,43.3,19.027,32605.906,227.485,6.82,0.888,0
52,144,506,21551,5,411,5113,845828,36.11,10708982,137.176,43.3,19.027,32605.906,227.485,6.82,0.888,0
52,145,239,21790,0,411,2397,848225,36.11,10708982,137.176,43.3,19.027,32605.906,227.485,6.82,0.888,0
52,146,133,21923,1,412,7396,855621,36.11,10708982,137.176,43.3,19.027,32605.906,227.485,6.82,0.888,0
52,147,258,22181,3,415,8757,864378,36.11,10708982,137.176,43.3,19.027,32605.906,227.485,6.82,0.888,0
52,148,367,22548,1,416,8854,873232,36.11,10708982,137.176,43.3,19.027,32605.906,227.485,6.82,0.888,0
52,149,403,22951,2,418,9193,882425,36.11,10708982,137.176,43.3,19.027,32605.906,227.485,6.82,0.888,0
52,150,349,23300,0,418,10790,893215,36.11,10708982,137.176,43.3,19.027,32605.906,227.485,6.82,0.888,0
52,151,477,23777,1,419,6568,899783,36.11,10708982,137.176,43.3,19.027,32605.906,227.485,6.82,0.888,0
52,152,317,24094,2,421,3944,903727,36.11,10708982,137.176,43.3,19.027,32605.906,227.485,6.82,0.888,0
52,153,273,24367,2,423,9353,913080,36.11,10708982,137.176,43.3,19.027,32605.906,227.485,6.82,0.888,0
52,154,251,24618,1,424,11125,924205,36.11,10708982,137.176,43.3,19.027,32605.906,227.485,6.82,0.888,0
52,155,499,25117,1,425,11798,936003,36.11,10708982,137.176,43.3,19.027,32605.906,227.485,6.82,0.888,0
52,156,656,25773,0,425,11537,947540,36.11,10708982,137.176,43.3,19.027,32605.906,227.485,6.82,0.888,0
52,157,679,26452,1,426,13610,961150,36.11,10708982,137.176,43.3,19.027,32605.906,227.485,6.82,0.888,0
52,158,797,27249,3,429,7466,968616,36.11,10708982,137.176,43.3,19.027,32605.906,227.485,6.82,0.888,0
52,159,503,27752,2,431,4535,973151,36.11,10708982,137.176,43.3,19.027,32605.906,227.485,6.82,0.888,0
52,160,404,28156,5,436,11577,984728,36.11,10708982,137.176,43.3,19.027,32605.906,227.485,6.82,0.888,0
52,161,560,28716,1,437,16095,1000823,38.89,10708982,137.176,43.3,19.027,32605.906,227.485,6.82,0.888,0
52,162,1161,29877,4,441,15474,1016297,38.89,10708982,137.176,43.3,19.027,32605.906,227.485,6.82,0.888,0
52,163,1159,31036,3,444,16298,1032595,38.89,10708982,137.176,43.3,19.027,32605.906,227.485,6.82,0.888,0
52,164,1377,32413,4,448,19192,1051787,38.89,10708982,137.176,43.3,19.027,32605.906,227.485,6.82,0.888,0
52,165,1447,33860,2,450,13057,1064844,38.89,10708982,137.176,43.3,19.027,32605.906,227.485,6.82,0.888,0
52,166,1541,35401,3,453,7090,1071934,38.89,10708982,137.176,43.3,19.027,32605.906,227.485,6.82,0.888,0
52,167,787,36188,3,456,17493,1089427,38.89,10708982,137.176,43.3,19.027,32605.906,227.485,6.82,0.888,0
52,168,1034,37222,9,465,20303,1109730,38.89,10708982,137.176,43.3,19.027,32605.906,227.485,6.82,0.888,0
52,169,1674,38896,11,476,20460,1130190,38.89,10708982,137.176,43.3,19.027,32605.906,227.485,6.82,0.888,0
52,170,2136,41032,6,482,23428,1153618,38.89,10708982,137.176,43.3,19.027,32605.906,227.485,6.82,0.888,0
52,171,3123,44155,7,489,21570,1175188,38.89,10708982,137.176,43.3,19.027,32605.906,227.485,6.82,0.888,0
52,172,2107,46262,6,495,15050,1190238,38.89,10708982,137.176,43.3,19.027,32605.906,227.485,6.82,0.888,0
52,173,2044,48306,4,499,10179,1200417,38.89,10708982,137.176,43.3,19.027,32605.906,227.485,6.82,0.888,0
52,174,934,49240,4,503,19405,1219822,38.89,10708982,137.176,43.3,19.027,32605.906,227.485,6.82,0.888,0
52,175,1524,50764,19,522,22381,1242203,38.89,10708982,137.176,43.3,19.027,32605.906,227.485,6.82,0.888,0
52,176,2394,53158,9,531,22373,1264576,38.89,10708982,137.176,43.3,19.027,32605.906,227.485,6.82,0.888,0
52,177,2306,55464,24,555,23147,1287723,38.89,10708982,137.176,43.3,19.027,32605.906,227.485,6.82,0.888,0
52,178,2910,58374,12,567,23124,1310847,38.89,10708982,137.176,43.3,19.027,32605.906,227.485,6.82,0.888,0
52,179,2944,61318,14,581,15385,1326232,38.89,10708982,137.176,43.3,19.027,32605.906,227.485,6.82,0.888,0
52,180,1976,63294,10,591,10460,1336692,38.89,10708982,137.176,43.3,19.027,32605.906,227.485,6.82,0.888,0
52,181,1303,64597,15,606,12218,1348910,38.89,10708982,137.176,43.3,19.027,32605.906,227.485,6.82,0.888,0
52,182,1286,65883,12,618,18303,1367213,38.89,10708982,137.176,43.3,19.027,32605.906,227.485,6.82,0.888,0
52,183,1960,67843,18,636,21080,1388293,38.89,10708982,137.176,43.3,19.027,32605.906,227.485,6.82,0.888,0
52,184,1076,68919,19,655,23906,1412199,38.89,10708982,137.176,43.3,19.027,32605.906,227.485,6.82,0.888,0
52,185,5336,74255,23,678,23630,1435829,38.89,10708982,137.176,43.3,19.027,32605.906,227.485,6.82,0.888,0
52,186,3796,78051,21,699,15201,1451030,38.89,10708982,137.176,43.3,19.027,32605.906,227.485,6.82,0.888,0
52,187,2554,80605,12,711,7766,1458796,38.89,10708982,137.176,43.3,19.027,32605.906,227.485,6.82,0.888,0
52,188,1841,82446,16,727,17716,1476512,48.15,10708982,137.176,43.3,19.027,32605.906,227.485,6.82,0.888,0
52,189,3120,85566,31,758,22988,1499500,48.15,10708982,137.176,43.3,19.027,32605.906,227.485,6.82,0.888,0
52,190,4456,90022,36,794,23964,1523464,48.15,10708982,137.176,43.3,19.027,32605.906,227.485,6.82,0.888,0
52,191,5338,95360,35,829,25051,1548515,48.15,10708982,137.176,43.3,19.027,32605.906,227.485,6.82,0.888,0
52,192,5397,100757,40,869,27724,1576239,48.15,10708982,137.176,43.3,19.027,32605.906,227.485,6.82,0.888,0
52,193,8617,109374,36,905,18069,1594308,48.15,10708982,137.176,43.3,19.027,32605.906,227.485,6.82,0.888,0
52,194,4633,114007,90,995,11502,1605810,48.15,10708982,137.176,43.3,19.027,32605.906,227.485,6.82,0.888,0
52,195,3103,117110,39,1034,22029,1627839,48.15,10708982,137.176,43.3,19.027,32605.906,227.485,6.82,0.888,0
52,196,4311,121421,17,1051,31563,1659402,48.15,10708982,137.176,43.3,19.027,32605.906,227.485,6.82,0.888,0
52,197,8326,129747,55,1106,34781,1694183,48.15,10708982,137.176,43.3,19.027,32605.906,227.485,6.82,0.888,0
52,198,9543,139290,66,1172,34774,1728957,48.15,10708982,137.176,43.3,19.027,32605.906,227.485,6.82,0.888,0
52,199,9720,149010,58,1230,38677,1767634,48.15,10708982,137.176,43.3,19.027,32605.906,227.485,6.82,0.888,0
52,200,11102,160112,53,1283,29255,1796889,48.15,10708982,137.176,43.3,19.027,32605.906,227.485,6.82,0.888,0
52,201,8715,168827,69,1352,17113,1814002,48.15,10708982,137.176,43.3,19.027,32605.906,227.485,6.82,0.888,0
52,202,5058,173885,70,1422,0,1814002,48.15,10708982,137.176,43.3,19.027,32605.906,227.485,6.82,0.888,0
52,203,8077,181962,91,1513,0,1814002,48.15,10708982,137.176,43.3,19.027,32605.906,227.485,6.82,0.888,0
52,204,11984,193946,106,1619,0,1814002,48.15,10708982,137.176,43.3,19.027,32605.906,227.485,6.82,0.888,0
53,1,0,98,0,8,0,0,77.78,89561404,35.879,17,3.02,808.133,318.949,6.1,0.457,3
53,2,25,123,3,11,0,0,77.78,89561404,35.879,17,3.02,808.133,318.949,6.1,0.457,3
53,3,0,123,0,11,0,0,77.78,89561404,35.879,17,3.02,808.133,318.949,6.1,0.457,3
53,4,11,134,2,13,0,0,77.78,89561404,35.879,17,3.02,808.133,318.949,6.1,0.457,3
53,5,20,154,5,18,0,0,77.78,89561404,35.879,17,3.02,808.133,318.949,6.1,0.457,3
53,6,0,154,0,18,0,0,80.56,89561404,35.879,17,3.02,808.133,318.949,6.1,0.457,3
53,7,7,161,0,18,0,0,80.56,89561404,35.879,17,3.02,808.133,318.949,6.1,0.457,3
53,8,19,180,0,18,64,0,80.56,89561404,35.879,17,3.02,808.133,318.949,6.1,0.457,3
53,9,3,183,2,20,98,0,80.56,89561404,35.879,17,3.02,808.133,318.949,6.1,0.457,3
53,10,32,215,0,20,127,0,80.56,89561404,35.879,17,3.02,808.133,318.949,6.1,0.457,3
53,11,8,223,0,20,122,0,80.56,89561404,35.879,17,3.02,808.133,318.949,6.1,0.457,3
53,12,11,234,0,20,0,0,80.56,89561404,35.879,17,3.02,808.133,318.949,6.1,0.457,3
53,13,0,234,0,20,68,0,80.56,89561404,35.879,17,3.02,808.133,318.949,6.1,0.457,3
53,14,1,235,0,20,197,0,80.56,89561404,35.879,17,3.02,808.133,318.949,6.1,0.457,3
53,15,19,254,1,21,206,0,80.56,89561404,35.879,17,3.02,808.133,318.949,6.1,0.457,3
53,16,13,267,1,22,141,0,80.56,89561404,35.879,17,3.02,808.133,318.949,6.1,0.457,3
53,17,20,287,1,23,300,0,80.56,89561404,35.879,17,3.02,808.133,318.949,6.1,0.457,3
53,18,20,307,2,25,297,0,80.56,89561404,35.879,17,3.02,808.133,318.949,6.1,0.457,3
53,19,20,327,0,25,127,0,80.56,89561404,35.879,17,3.02,808.133,318.949,6.1,0.457,3
53,20,5,332,0,25,86,0,80.56,89561404,35.879,17,3.02,808.133,318.949,6.1,0.457,3
53,21,18,350,0,25,123,0,80.56,89561404,35.879,17,3.02,808.133,318.949,6.1,0.457,3
53,22,9,359,0,25,119,0,80.56,89561404,35.879,17,3.02,808.133,318.949,6.1,0.457,3
53,23,18,377,0,25,74,0,80.56,89561404,35.879,17,3.02,808.133,318.949,6.1,0.457,3
53,24,17,394,0,25,136,0,80.56,89561404,35.879,17,3.02,808.133,318.949,6.1,0.457,3
53,25,22,416,3,28,190,0,80.56,89561404,35.879,17,3.02,808.133,318.949,6.1,0.457,3
53,26,26,442,0,28,0,0,80.56,89561404,35.879,17,3.02,808.133,318.949,6.1,0.457,3
53,27,17,459,0,28,70,0,80.56,89561404,35.879,17,3.02,808.133,318.949,6.1,0.457,3
53,28,12,471,2,30,187,0,80.56,89561404,35.879,17,3.02,808.133,318.949,6.1,0.457,3
53,29,20,491,0,30,126,0,80.56,89561404,35.879,17,3.02,808.133,318.949,6.1,0.457,3
53,30,9,500,1,31,0,0,80.56,89561404,35.879,17,3.02,808.133,318.949,6.1,0.457,3
53,31,72,572,0,31,238,0,80.56,89561404,35.879,17,3.02,808.133,318.949,6.1,0.457,3
53,32,32,604,1,32,164,0,80.56,89561404,35.879,17,3.02,808.133,318.949,6.1,0.457,3
53,33,70,674,1,33,0,0,80.56,89561404,35.879,17,3.02,808.133,318.949,6.1,0.457,3
53,34,10,684,1,34,121,0,80.56,89561404,35.879,17,3.02,808.133,318.949,6.1,0.457,3
53,35,0,684,0,34,0,0,80.56,89561404,35.879,17,3.02,808.133,318.949,6.1,0.457,3
53,36,21,705,0,34,374,0,80.56,89561404,35.879,17,3.02,808.133,318.949,6.1,0.457,3
53,37,158,863,2,36,270,0,80.56,89561404,35.879,17,3.02,808.133,318.949,6.1,0.457,3
53,38,34,897,0,36,131,0,80.56,89561404,35.879,17,3.02,808.133,318.949,6.1,0.457,3
53,39,40,937,3,39,0,0,80.56,89561404,35.879,17,3.02,808.133,318.949,6.1,0.457,3
53,40,54,991,2,41,0,0,80.56,89561404,35.879,17,3.02,808.133,318.949,6.1,0.457,3
53,41,33,1024,0,41,289,0,80.56,89561404,35.879,17,3.02,808.133,318.949,6.1,0.457,3
53,42,78,1102,3,44,192,0,80.56,89561404,35.879,17,3.02,808.133,318.949,6.1,0.457,3
53,43,67,1169,6,50,310,0,80.56,89561404,35.879,17,3.02,808.133,318.949,6.1,0.457,3
53,44,73,1242,0,50,209,0,80.56,89561404,35.879,17,3.02,808.133,318.949,6.1,0.457,3
53,45,56,1298,0,50,0,0,80.56,89561404,35.879,17,3.02,808.133,318.949,6.1,0.457,3
53,46,71,1369,10,60,242,0,80.56,89561404,35.879,17,3.02,808.133,318.949,6.1,0.457,3
53,47,85,1454,0,60,0,0,80.56,89561404,35.879,17,3.02,808.133,318.949,6.1,0.457,3
53,48,0,1454,0,60,0,0,80.56,89561404,35.879,17,3.02,808.133,318.949,6.1,0.457,3
53,49,175,1629,1,61,0,0,80.56,89561404,35.879,17,3.02,808.133,318.949,6.1,0.457,3
53,50,102,1731,0,61,0,0,80.56,89561404,35.879,17,3.02,808.133,318.949,6.1,0.457,3
53,51,104,1835,0,61,225,0,80.56,89561404,35.879,17,3.02,808.133,318.949,6.1,0.457,3
53,52,110,1945,2,63,0,0,80.56,89561404,35.879,17,3.02,808.133,318.949,6.1,0.457,3
53,53,80,2025,0,63,287,0,80.56,89561404,35.879,17,3.02,808.133,318.949,6.1,0.457,3
53,54,116,2141,0,63,402,0,80.56,89561404,35.879,17,3.02,808.133,318.949,6.1,0.457,3
53,55,156,2297,4,67,0,0,80.56,89561404,35.879,17,3.02,808.133,318.949,6.1,0.457,3
53,56,0,2297,0,67,410,0,80.56,89561404,35.879,17,3.02,808.133,318.949,6.1,0.457,3
53,57,248,2545,0,67,367,0,80.56,89561404,35.879,17,3.02,808.133,318.949,6.1,0.457,3
53,58,114,2659,1,68,327,0,80.56,89561404,35.879,17,3.02,808.133,318.949,6.1,0.457,3
53,59,173,2832,1,69,398,0,80.56,89561404,35.879,17,3.02,808.133,318.949,6.1,0.457,3
53,60,1,2833,0,69,357,0,80.56,89561404,35.879,17,3.02,808.133,318.949,6.1,0.457,3
53,61,133,2966,0,69,0,0,80.56,89561404,35.879,17,3.02,808.133,318.949,6.1,0.457,3
53,62,83,3049,2,71,0,0,80.56,89561404,35.879,17,3.02,808.133,318.949,6.1,0.457,3
53,63,145,3194,1,72,610,0,80.56,89561404,35.879,17,3.02,808.133,318.949,6.1,0.457,3
53,64,131,3325,0,72,650,0,80.56,89561404,35.879,17,3.02,808.133,318.949,6.1,0.457,3
53,65,169,3494,3,75,415,0,80.56,89561404,35.879,17,3.02,808.133,318.949,6.1,0.457,3
53,66,149,3643,3,78,440,0,80.56,89561404,35.879,17,3.02,808.133,318.949,6.1,0.457,3
53,67,121,3764,3,81,492,0,80.56,89561404,35.879,17,3.02,808.133,318.949,6.1,0.457,3
53,68,114,3878,0,81,0,0,80.56,89561404,35.879,17,3.02,808.133,318.949,6.1,0.457,3
53,69,138,4016,4,85,0,0,80.56,89561404,35.879,17,3.02,808.133,318.949,6.1,0.457,3
53,70,89,4105,2,87,392,0,80.56,89561404,35.879,17,3.02,808.133,318.949,6.1,0.457,3
53,71,153,4258,2,89,655,0,80.56,89561404,35.879,17,3.02,808.133,318.949,6.1,0.457,3
53,72,131,4389,6,95,579,0,80.56,89561404,35.879,17,3.02,808.133,318.949,6.1,0.457,3
53,73,125,4514,2,97,366,0,80.56,89561404,35.879,17,3.02,808.133,318.949,6.1,0.457,3
53,74,122,4636,3,100,362,0,80.56,89561404,35.879,17,3.02,808.133,318.949,6.1,0.457,3
53,75,87,4723,5,105,0,0,80.56,89561404,35.879,17,3.02,808.133,318.949,6.1,0.457,3
53,76,54,4777,1,106,0,0,80.56,89561404,35.879,17,3.02,808.133,318.949,6.1,0.457,3
53,77,60,4837,6,112,549,0,80.56,89561404,35.879,17,3.02,808.133,318.949,6.1,0.457,3
53,78,137,4974,0,112,569,0,80.56,89561404,35.879,17,3.02,808.133,318.949,6.1,0.457,3
53,79,125,5099,3,115,624,0,80.56,89561404,35.879,17,3.02,808.133,318.949,6.1,0.457,3
53,80,183,5282,2,117,839,0,80.56,89561404,35.879,17,3.02,808.133,318.949,6.1,0.457,3
53,81,194,5476,4,121,0,0,80.56,89561404,35.879,17,3.02,808.133,318.949,6.1,0.457,3
53,82,195,5671,3,124,336,0,80.56,89561404,35.879,17,3.02,808.133,318.949,6.1,0.457,3
53,83,155,5826,6,130,0,0,80.56,89561404,35.879,17,3.02,808.133,318.949,6.1,0.457,3
53,84,99,5925,5,135,962,0,80.56,89561404,35.879,17,3.02,808.133,318.949,6.1,0.457,3
53,85,102,6027,0,135,974,0,80.56,89561404,35.879,17,3.02,808.133,318.949,6.1,0.457,3
53,86,0,6027,0,135,824,0,80.56,89561404,35.879,17,3.02,808.133,318.949,6.1,0.457,3
53,87,384,6411,7,142,951,0,80.56,89561404,35.879,17,3.02,808.133,318.949,6.1,0.457,3
53,88,141,6552,7,149,975,0,80.56,89561404,35.879,17,3.02,808.133,318.949,6.1,0.457,3
53,89,0,6552,0,149,475,0,80.56,89561404,35.879,17,3.02,808.133,318.949,6.1,0.457,3
53,90,274,6826,8,157,923,0,80.56,89561404,35.879,17,3.02,808.133,318.949,6.1,0.457,3
53,91,113,6939,10,167,686,0,80.56,89561404,35.879,17,3.02,808.133,318.949,6.1,0.457,3
53,92,99,7038,2,169,662,0,80.56,89561404,35.879,17,3.02,808.133,318.949,6.1,0.457,3
53,93,83,7121,5,174,748,0,80.56,89561404,35.879,17,3.02,808.133,318.949,6.1,0.457,3
53,94,67,7188,1,175,758,0,80.56,89561404,35.879,17,3.02,808.133,318.949,6.1,0.457,3
53,95,0,7188,0,175,243,0,80.56,89561404,35.879,17,3.02,808.133,318.949,6.1,0.457,3
53,96,190,7378,6,181,335,0,80.56,89561404,35.879,17,3.02,808.133,318.949,6.1,0.457,3
53,97,32,7410,0,181,846,0,80.56,89561404,35.879,17,3.02,808.133,318.949,6.1,0.457,3
53,98,22,7432,1,182,919,0,80.56,89561404,35.879,17,3.02,808.133,318.949,6.1,0.457,3
53,99,228,7660,0,182,1217,0,80.56,89561404,35.879,17,3.02,808.133,318.949,6.1,0.457,3
53,100,77,7737,2,184,566,0,80.56,89561404,35.879,17,3.02,808.133,318.949,6.1,0.457,3
53,101,108,7845,4,188,893,0,80.56,89561404,35.879,17,3.02,808.133,318.949,6.1,0.457,3
53,102,59,7904,0,188,466,0,80.56,89561404,35.879,17,3.02,808.133,318.949,6.1,0.457,3
53,103,66,7970,0,188,349,0,80.56,89561404,35.879,17,3.02,808.133,318.949,6.1,0.457,3
53,104,62,8032,0,188,741,0,80.56,89561404,35.879,17,3.02,808.133,318.949,6.1,0.457,3
53,105,42,8074,1,189,456,0,80.56,89561404,35.879,17,3.02,808.133,318.949,6.1,0.457,3
53,106,61,8135,0,189,563,0,80.56,89561404,35.879,17,3.02,808.133,318.949,6.1,0.457,3
53,107,27,8162,2,191,464,0,80.56,89561404,35.879,17,3.02,808.133,318.949,6.1,0.457,3
53,108,36,8198,1,192,800,0,80.56,89561404,35.879,17,3.02,808.133,318.949,6.1,0.457,3
53,109,50,8248,0,192,435,0,80.56,89561404,35.879,17,3.02,808.133,318.949,6.1,0.457,3
53,110,75,8323,0,192,423,0,80.56,89561404,35.879,17,3.02,808.133,318.949,6.1,0.457,3
53,111,79,8402,1,193,649,0,80.56,89561404,35.879,17,3.02,808.133,318.949,6.1,0.457,3
53,112,40,8442,1,194,741,0,80.56,89561404,35.879,17,3.02,808.133,318.949,6.1,0.457,3
53,113,91,8533,1,195,737,0,55.56,89561404,35.879,17,3.02,808.133,318.949,6.1,0.457,3
53,114,92,8625,2,197,645,0,55.56,89561404,35.879,17,3.02,808.133,318.949,6.1,0.457,3
53,115,94,8719,3,200,464,0,55.56,89561404,35.879,17,3.02,808.133,318.949,6.1,0.457,3
53,116,47,8766,0,200,669,0,55.56,89561404,35.879,17,3.02,808.133,318.949,6.1,0.457,3
53,117,34,8800,3,203,137,0,55.56,89561404,35.879,17,3.02,808.133,318.949,6.1,0.457,3
53,118,31,8831,1,204,242,0,55.56,89561404,35.879,17,3.02,808.133,318.949,6.1,0.457,3
53,119,13,8844,4,208,242,0,55.56,89561404,35.879,17,3.02,808.133,318.949,6.1,0.457,3
53,120,29,8873,0,208,637,0,55.56,89561404,35.879,17,3.02,808.133,318.949,6.1,0.457,3
53,121,58,8931,5,213,364,0,55.56,89561404,35.879,17,3.02,808.133,318.949,6.1,0.457,3
53,122,79,9010,1,214,417,0,55.56,89561404,35.879,17,3.02,808.133,318.949,6.1,0.457,3
53,123,60,9070,0,214,289,0,55.56,89561404,35.879,17,3.02,808.133,318.949,6.1,0.457,3
53,124,13,9083,0,214,237,0,55.56,89561404,35.879,17,3.02,808.133,318.949,6.1,0.457,3
53,125,31,9114,0,214,431,0,59.26,89561404,35.879,17,3.02,808.133,318.949,6.1,0.457,3
53,126,18,9132,0,214,344,0,59.26,89561404,35.879,17,3.02,808.133,318.949,6.1,0.457,3
53,127,45,9177,0,214,489,0,59.26,89561404,35.879,17,3.02,808.133,318.949,6.1,0.457,3
53,128,75,9252,0,214,342,0,59.26,89561404,35.879,17,3.02,808.133,318.949,6.1,0.457,3
53,129,56,9308,0,214,431,0,59.26,89561404,35.879,17,3.02,808.133,318.949,6.1,0.457,3
53,130,46,9354,3,217,342,0,59.26,89561404,35.879,17,3.02,808.133,318.949,6.1,0.457,3
53,131,99,9453,6,223,267,0,59.26,89561404,35.879,17,3.02,808.133,318.949,6.1,0.457,3
53,132,0,9453,0,223,299,0,48.15,89561404,35.879,17,3.02,808.133,318.949,6.1,0.457,3
53,133,35,9488,0,223,462,0,48.15,89561404,35.879,17,3.02,808.133,318.949,6.1,0.457,3
53,134,10,9498,1,224,413,0,48.15,89561404,35.879,17,3.02,808.133,318.949,6.1,0.457,3
53,135,39,9537,1,225,326,0,48.15,89561404,35.879,17,3.02,808.133,318.949,6.1,0.457,3
53,136,51,9588,9,234,480,0,48.15,89561404,35.879,17,3.02,808.133,318.949,6.1,0.457,3
53,137,16,9604,4,238,437,0,37.04,89561404,35.879,17,3.02,808.133,318.949,6.1,0.457,3
53,138,33,9637,1,239,208,0,37.04,89561404,35.879,17,3.02,808.133,318.949,6.1,0.457,3
53,139,38,9675,0,239,333,0,37.04,89561404,35.879,17,3.02,808.133,318.949,6.1,0.457,3
53,140,30,9705,3,242,293,0,37.04,89561404,35.879,17,3.02,808.133,318.949,6.1,0.457,3
53,141,15,9720,0,242,398,0,37.04,89561404,35.879,17,3.02,808.133,318.949,6.1,0.457,3
53,142,20,9740,3,245,309,0,37.04,89561404,35.879,17,3.02,808.133,318.949,6.1,0.457,3
53,143,16,9756,1,246,254,0,37.04,89561404,35.879,17,3.02,808.133,318.949,6.1,0.457,3
53,144,45,9801,1,247,422,0,37.04,89561404,35.879,17,3.02,808.133,318.949,6.1,0.457,3
53,145,9,9810,3,250,154,0,37.04,89561404,35.879,17,3.02,808.133,318.949,6.1,0.457,3
53,146,19,9829,0,250,184,0,37.04,89561404,35.879,17,3.02,808.133,318.949,6.1,0.457,3
53,147,12,9841,0,250,217,0,37.04,89561404,35.879,17,3.02,808.133,318.949,6.1,0.457,3
53,148,49,9890,0,250,148,0,42.59,89561404,35.879,17,3.02,808.133,318.949,6.1,0.457,3
53,149,21,9911,3,253,296,0,42.59,89561404,35.879,17,3.02,808.133,318.949,6.1,0.457,3
53,150,3,9914,1,254,151,0,42.59,89561404,35.879,17,3.02,808.133,318.949,6.1,0.457,3
53,151,79,9993,0,254,339,0,42.59,89561404,35.879,17,3.02,808.133,318.949,6.1,0.457,3
53,152,14,10007,3,257,327,0,42.59,89561404,35.879,17,3.02,808.133,318.949,6.1,0.457,3
53,153,37,10044,0,257,135,0,42.59,89561404,35.879,17,3.02,808.133,318.949,6.1,0.457,3
53,154,52,10096,0,257,0,0,42.59,89561404,35.879,17,3.02,808.133,318.949,6.1,0.457,3
53,155,7,10103,1,258,266,0,42.59,89561404,35.879,17,3.02,808.133,318.949,6.1,0.457,3
53,156,10,10113,0,258,187,0,42.59,89561404,35.879,17,3.02,808.133,318.949,6.1,0.457,3
53,157,12,10125,0,258,434,0,42.59,89561404,35.879,17,3.02,808.133,318.949,6.1,0.457,3
53,158,23,10148,0,258,339,0,42.59,89561404,35.879,17,3.02,808.133,318.949,6.1,0.457,3
53,159,30,10178,0,258,128,0,42.59,89561404,35.879,17,3.02,808.133,318.949,6.1,0.457,3
53,160,31,10209,1,259,272,0,42.59,89561404,35.879,17,3.02,808.133,318.949,6.1,0.457,3
53,161,23,10232,0,259,250,0,42.59,89561404,35.879,17,3.02,808.133,318.949,6.1,0.457,3
53,162,59,10291,0,259,195,0,42.59,89561404,35.879,17,3.02,808.133,318.949,6.1,0.457,3
53,163,32,10323,0,259,396,0,42.59,89561404,35.879,17,3.02,808.133,318.949,6.1,0.457,3
53,164,19,10342,2,261,273,0,42.59,89561404,35.879,17,3.02,808.133,318.949,6.1,0.457,3
53,165,18,10360,0,261,230,0,42.59,89561404,35.879,17,3.02,808.133,318.949,6.1,0.457,3
53,166,24,10384,0,261,36,0,42.59,89561404,35.879,17,3.02,808.133,318.949,6.1,0.457,3
53,167,5,10389,3,264,189,0,42.59,89561404,35.879,17,3.02,808.133,318.949,6.1,0.457,3
53,168,0,10389,0,264,272,0,42.59,89561404,35.879,17,3.02,808.133,318.949,6.1,0.457,3
53,169,12,10401,3,267,313,0,42.59,89561404,35.879,17,3.02,808.133,318.949,6.1,0.457,3
53,170,0,10401,0,267,392,0,42.59,89561404,35.879,17,3.02,808.133,318.949,6.1,0.457,3
53,171,41,10442,0,267,251,0,42.59,89561404,35.879,17,3.02,808.133,318.949,6.1,0.457,3
53,172,14,10456,1,268,188,0,42.59,89561404,35.879,17,3.02,808.133,318.949,6.1,0.457,3
53,173,32,10488,0,268,99,0,42.59,89561404,35.879,17,3.02,808.133,318.949,6.1,0.457,3
53,174,26,10514,2,270,128,0,42.59,89561404,35.879,17,3.02,808.133,318.949,6.1,0.457,3
53,175,4,10518,0,270,238,0,42.59,89561404,35.879,17,3.02,808.133,318.949,6.1,0.457,3
53,176,4,10522,0,270,251,0,42.59,89561404,35.879,17,3.02,808.133,318.949,6.1,0.457,3
53,177,14,10536,0,270,275,0,39.81,89561404,35.879,17,3.02,808.133,318.949,6.1,0.457,3
53,178,18,10554,0,270,210,0,39.81,89561404,35.879,17,3.02,808.133,318.949,6.1,0.457,3
53,179,23,10577,0,270,121,0,39.81,89561404,35.879,17,3.02,808.133,318.949,6.1,0.457,3
53,180,15,10592,0,270,92,0,39.81,89561404,35.879,17,3.02,808.133,318.949,6.1,0.457,3
53,181,19,10611,0,270,187,0,39.81,89561404,35.879,17,3.02,808.133,318.949,6.1,0.457,3
53,182,13,10624,1,271,212,0,39.81,89561404,35.879,17,3.02,808.133,318.949,6.1,0.457,3
53,183,6,10630,0,271,316,0,39.81,89561404,35.879,17,3.02,808.133,318.949,6.1,0.457,3
53,184,29,10659,1,272,253,0,39.81,89561404,35.879,17,3.02,808.133,318.949,6.1,0.457,3
53,185,25,10684,0,272,223,0,39.81,89561404,35.879,17,3.02,808.133,318.949,6.1,0.457,3
53,186,0,10684,0,272,141,0,39.81,89561404,35.879,17,3.02,808.133,318.949,6.1,0.457,3
53,187,68,10752,1,273,126,0,39.81,89561404,35.879,17,3.02,808.133,318.949,6.1,0.457,3
53,188,7,10759,0,273,147,0,39.81,89561404,35.879,17,3.02,808.133,318.949,6.1,0.457,3
53,189,19,10778,1,274,220,0,39.81,89561404,35.879,17,3.02,808.133,318.949,6.1,0.457,3
53,190,0,10778,0,274,210,0,39.81,89561404,35.879,17,3.02,808.133,318.949,6.1,0.457,3
53,191,26,10804,1,275,154,0,39.81,89561404,35.879,17,3.02,808.133,318.949,6.1,0.457,3
53,192,17,10821,0,275,0,0,48.15,89561404,35.879,17,3.02,808.133,318.949,6.1,0.457,3
53,193,13,10834,0,275,0,0,48.15,89561404,35.879,17,3.02,808.133,318.949,6.1,0.457,3
53,194,6,10840,0,275,0,0,48.15,89561404,35.879,17,3.02,808.133,318.949,6.1,0.457,3
53,195,10,10850,0,275,0,0,48.15,89561404,35.879,17,3.02,808.133,318.949,6.1,0.457,3
53,196,18,10868,0,275,0,0,48.15,89561404,35.879,17,3.02,808.133,318.949,6.1,0.457,3
53,197,3,10871,0,275,0,0,48.15,89561404,35.879,17,3.02,808.133,318.949,6.1,0.457,3
53,198,63,10934,5,280,0,0,48.15,89561404,35.879,17,3.02,808.133,318.949,6.1,0.457,3
53,199,35,10969,0,280,0,0,48.15,89561404,35.879,17,3.02,808.133,318.949,6.1,0.457,3
53,200,30,10999,21,301,0,0,48.15,89561404,35.879,17,3.02,808.133,318.949,6.1,0.457,3
53,201,6,11005,0,301,0,0,48.15,89561404,35.879,17,3.02,808.133,318.949,6.1,0.457,3
53,202,46,11051,1,302,0,0,48.15,89561404,35.879,17,3.02,808.133,318.949,6.1,0.457,3
53,203,0,11051,0,302,0,0,48.15,89561404,35.879,17,3.02,808.133,318.949,6.1,0.457,3
53,204,14,11065,0,302,0,0,48.15,89561404,35.879,17,3.02,808.133,318.949,6.1,0.457,3
54,1,283,2860,13,90,3557,33483,72.22,5792203,136.52,42.3,19.677,46682.515,114.767,6.41,0.929,0
54,2,247,3107,14,104,5752,39235,72.22,5792203,136.52,42.3,19.677,46682.515,114.767,6.41,0.929,0
54,3,279,3386,19,123,6617,45852,72.22,5792203,136.52,42.3,19.677,46682.515,114.767,6.41,0.929,0
54,4,371,3757,16,139,3697,49549,72.22,5792203,136.52,42.3,19.677,46682.515,114.767,6.41,0.929,0
54,5,320,4077,22,161,2213,51762,72.22,5792203,136.52,42.3,19.677,46682.515,114.767,6.41,0.929,0
54,6,292,4369,18,179,6569,58331,72.22,5792203,136.52,42.3,19.677,46682.515,114.767,6.41,0.929,0
54,7,312,4681,8,187,6384,64715,72.22,5792203,136.52,42.3,19.677,46682.515,114.767,6.41,0.929,0
54,8,390,5071,16,203,5632,70347,72.22,5792203,136.52,42.3,19.677,46682.515,114.767,6.41,0.929,0
54,9,331,5402,15,218,2558,72905,72.22,5792203,136.52,42.3,19.677,46682.515,114.767,6.41,0.929,0
54,10,233,5635,19,237,2326,75231,72.22,5792203,136.52,42.3,19.677,46682.515,114.767,6.41,0.929,0
54,11,184,5819,10,247,2229,77460,72.22,5792203,136.52,42.3,19.677,46682.515,114.767,6.41,0.929,0
54,12,177,5996,13,260,2143,79603,72.22,5792203,136.52,42.3,19.677,46682.515,114.767,6.41,0.929,0
54,13,178,6174,13,273,2149,81752,72.22,5792203,136.52,42.3,19.677,46682.515,114.767,6.41,0.929,0
54,14,144,6318,12,285,6219,87971,72.22,5792203,136.52,42.3,19.677,46682.515,114.767,6.41,0.929,0
54,15,193,6511,14,299,5634,93605,68.52,5792203,136.52,42.3,19.677,46682.515,114.767,6.41,0.929,0
54,16,170,6681,10,309,5332,98937,68.52,5792203,136.52,42.3,19.677,46682.515,114.767,6.41,0.929,0
54,17,198,6879,12,321,4803,103740,68.52,5792203,136.52,42.3,19.677,46682.515,114.767,6.41,0.929,0
54,18,194,7073,15,336,2302,106042,68.52,5792203,136.52,42.3,19.677,46682.515,114.767,6.41,0.929,0
54,19,169,7242,10,346,1886,107928,68.52,5792203,136.52,42.3,19.677,46682.515,114.767,6.41,0.929,0
54,20,142,7384,9,355,6670,114598,68.52,5792203,136.52,42.3,19.677,46682.515,114.767,6.41,0.929,0
54,21,131,7515,9,364,9775,124373,68.52,5792203,136.52,42.3,19.677,46682.515,114.767,6.41,0.929,0
54,22,180,7695,6,370,11605,135978,68.52,5792203,136.52,42.3,19.677,46682.515,114.767,6.41,0.929,0
54,23,217,7912,14,384,12486,148464,68.52,5792203,136.52,42.3,19.677,46682.515,114.767,6.41,0.929,0
54,24,161,8073,10,394,14819,163283,68.52,5792203,136.52,42.3,19.677,46682.515,114.767,6.41,0.929,0
54,25,137,8210,9,403,12432,175715,68.52,5792203,136.52,42.3,19.677,46682.515,114.767,6.41,0.929,0
54,26,235,8445,15,418,10327,186042,68.52,5792203,136.52,42.3,19.677,46682.515,114.767,6.41,0.929,0
54,27,130,8575,4,422,17351,203393,68.52,5792203,136.52,42.3,19.677,46682.515,114.767,6.41,0.929,0
54,28,123,8698,5,427,16267,219660,68.52,5792203,136.52,42.3,19.677,46682.515,114.767,6.41,0.929,0
54,29,153,8851,7,434,16077,235737,68.52,5792203,136.52,42.3,19.677,46682.515,114.767,6.41,0.929,0
54,30,157,9008,9,443,15951,251688,68.52,5792203,136.52,42.3,19.677,46682.515,114.767,6.41,0.929,0
54,31,150,9158,9,452,14445,266133,68.52,5792203,136.52,42.3,19.677,46682.515,114.767,6.41,0.929,0
54,32,153,9311,10,462,11146,277279,68.52,5792203,136.52,42.3,19.677,46682.515,114.767,6.41,0.929,0
54,33,96,9407,11,473,8999,286278,68.52,5792203,136.52,42.3,19.677,46682.515,114.767,6.41,0.929,0
54,34,116,9523,8,481,17780,304058,68.52,5792203,136.52,42.3,19.677,46682.515,114.767,6.41,0.929,0
54,35,147,9670,9,490,15795,319853,68.52,5792203,136.52,42.3,19.677,46682.515,114.767,6.41,0.929,0
54,36,151,9821,7,497,14329,334182,68.52,5792203,136.52,42.3,19.677,46682.515,114.767,6.41,0.929,0
54,37,162,9983,3,500,14371,348553,68.52,5792203,136.52,42.3,19.677,46682.515,114.767,6.41,0.929,0
54,38,100,10083,6,506,8373,356926,65.74,5792203,136.52,42.3,19.677,46682.515,114.767,6.41,0.929,0
54,39,135,10218,6,512,8246,365172,65.74,5792203,136.52,42.3,19.677,46682.515,114.767,6.41,0.929,0
54,40,101,10319,4,516,6687,371859,65.74,5792203,136.52,42.3,19.677,46682.515,114.767,6.41,0.929,0
54,41,110,10429,3,519,16448,388307,65.74,5792203,136.52,42.3,19.677,46682.515,114.767,6.41,0.929,0
54,42,84,10513,5,524,14783,403090,65.74,5792203,136.52,42.3,19.677,46682.515,114.767,6.41,0.929,0
54,43,78,10591,4,528,14759,417849,65.74,5792203,136.52,42.3,19.677,46682.515,114.767,6.41,0.929,0
54,44,76,10667,6,534,12995,430844,65.74,5792203,136.52,42.3,19.677,46682.515,114.767,6.41,0.929,0
54,45,46,10713,4,538,12670,443514,65.74,5792203,136.52,42.3,19.677,46682.515,114.767,6.41,0.929,0
54,46,78,10791,0,538,7698,451212,65.74,5792203,136.52,42.3,19.677,46682.515,114.767,6.41,0.929,0
54,47,67,10858,5,543,7070,458282,65.74,5792203,136.52,42.3,19.677,46682.515,114.767,6.41,0.929,0
54,48,69,10927,4,547,15281,473563,65.74,5792203,136.52,42.3,19.677,46682.515,114.767,6.41,0.929,0
54,49,41,10968,1,548,14983,488546,65.74,5792203,136.52,42.3,19.677,46682.515,114.767,6.41,0.929,0
54,50,76,11044,3,551,14461,503007,65.74,5792203,136.52,42.3,19.677,46682.515,114.767,6.41,0.929,0
54,51,73,11117,3,554,8472,511479,65.74,5792203,136.52,42.3,19.677,46682.515,114.767,6.41,0.929,0
54,52,65,11182,7,561,12305,523784,60.19,5792203,136.52,42.3,19.677,46682.515,114.767,6.41,0.929,0
54,53,48,11230,0,561,8782,532566,60.19,5792203,136.52,42.3,19.677,46682.515,114.767,6.41,0.929,0
54,54,59,11289,0,561,8666,541232,60.19,5792203,136.52,42.3,19.677,46682.515,114.767,6.41,0.929,0
54,55,71,11360,1,562,18296,559528,57.41,5792203,136.52,42.3,19.677,46682.515,114.767,6.41,0.929,0
54,56,27,11387,1,563,15978,575506,57.41,5792203,136.52,42.3,19.677,46682.515,114.767,6.41,0.929,0
54,57,41,11428,0,563,14787,590293,57.41,5792203,136.52,42.3,19.677,46682.515,114.767,6.41,0.929,0
54,58,52,11480,2,565,13164,603457,57.41,5792203,136.52,42.3,19.677,46682.515,114.767,6.41,0.929,0
54,59,32,11512,3,568,11781,615238,57.41,5792203,136.52,42.3,19.677,46682.515,114.767,6.41,0.929,0
54,60,81,11593,0,568,7178,622416,57.41,5792203,136.52,42.3,19.677,46682.515,114.767,6.41,0.929,0
54,61,40,11633,3,571,7636,630052,57.41,5792203,136.52,42.3,19.677,46682.515,114.767,6.41,0.929,0
54,62,36,11669,3,574,8723,638775,57.41,5792203,136.52,42.3,19.677,46682.515,114.767,6.41,0.929,0
54,63,30,11699,2,576,15535,654310,57.41,5792203,136.52,42.3,19.677,46682.515,114.767,6.41,0.929,0
54,64,35,11734,4,580,13459,667769,57.41,5792203,136.52,42.3,19.677,46682.515,114.767,6.41,0.929,0
54,65,37,11771,0,580,11866,679635,57.41,5792203,136.52,42.3,19.677,46682.515,114.767,6.41,0.929,0
54,66,40,11811,2,582,9656,689291,57.41,5792203,136.52,42.3,19.677,46682.515,114.767,6.41,0.929,0
54,67,64,11875,4,586,7971,697262,57.41,5792203,136.52,42.3,19.677,46682.515,114.767,6.41,0.929,0
54,68,49,11924,1,587,7745,705007,57.41,5792203,136.52,42.3,19.677,46682.515,114.767,6.41,0.929,0
54,69,24,11948,2,589,16859,721866,57.41,5792203,136.52,42.3,19.677,46682.515,114.767,6.41,0.929,0
54,70,14,11962,4,593,15649,737515,57.41,5792203,136.52,42.3,19.677,46682.515,114.767,6.41,0.929,0
54,71,39,12001,0,593,14960,752475,57.41,5792203,136.52,42.3,19.677,46682.515,114.767,6.41,0.929,0
54,72,15,12016,0,593,14548,767023,57.41,5792203,136.52,42.3,19.677,46682.515,114.767,6.41,0.929,0
54,73,19,12035,0,593,14870,781893,57.41,5792203,136.52,42.3,19.677,46682.515,114.767,6.41,0.929,0
54,74,64,12099,1,594,10009,791902,57.41,5792203,136.52,42.3,19.677,46682.515,114.767,6.41,0.929,0
54,75,40,12139,3,597,9060,800962,57.41,5792203,136.52,42.3,19.677,46682.515,114.767,6.41,0.929,0
54,76,54,12193,0,597,17714,818676,57.41,5792203,136.52,42.3,19.677,46682.515,114.767,6.41,0.929,0
54,77,24,12217,1,598,18201,836877,57.41,5792203,136.52,42.3,19.677,46682.515,114.767,6.41,0.929,0
54,78,33,12250,0,598,19225,856102,57.41,5792203,136.52,42.3,19.677,46682.515,114.767,6.41,0.929,0
54,79,44,12294,0,598,17516,873618,57.41,5792203,136.52,42.3,19.677,46682.515,114.767,6.41,0.929,0
54,80,50,12344,2,600,16991,890609,57.41,5792203,136.52,42.3,19.677,46682.515,114.767,6.41,0.929,0
54,81,47,12391,0,600,12098,902707,57.41,5792203,136.52,42.3,19.677,46682.515,114.767,6.41,0.929,0
54,82,0,12391,0,600,11415,914122,57.41,5792203,136.52,42.3,19.677,46682.515,114.767,6.41,0.929,0
54,83,0,12391,0,600,21457,935579,57.41,5792203,136.52,42.3,19.677,46682.515,114.767,6.41,0.929,0
54,84,136,12527,2,602,20913,956492,57.41,5792203,136.52,42.3,19.677,46682.515,114.767,6.41,0.929,0
54,85,34,12561,1,603,20079,976571,57.41,5792203,136.52,42.3,19.677,46682.515,114.767,6.41,0.929,0
54,86,54,12615,0,603,16830,993401,57.41,5792203,136.52,42.3,19.677,46682.515,114.767,6.41,0.929,0
54,87,21,12636,0,603,15838,1009239,57.41,5792203,136.52,42.3,19.677,46682.515,114.767,6.41,0.929,0
54,88,39,12675,1,604,9483,1018722,57.41,5792203,136.52,42.3,19.677,46682.515,114.767,6.41,0.929,0
54,89,0,12675,0,604,9461,1028183,57.41,5792203,136.52,42.3,19.677,46682.515,114.767,6.41,0.929,0
54,90,0,12675,0,604,18718,1046901,57.41,5792203,136.52,42.3,19.677,46682.515,114.767,6.41,0.929,0
54,91,76,12751,1,605,17884,1064785,57.41,5792203,136.52,42.3,19.677,46682.515,114.767,6.41,0.929,0
54,92,17,12768,0,605,17615,1082400,57.41,5792203,136.52,42.3,19.677,46682.515,114.767,6.41,0.929,0
54,93,26,12794,1,606,15361,1097761,57.41,5792203,136.52,42.3,19.677,46682.515,114.767,6.41,0.929,0
54,94,21,12815,0,606,14321,1112082,57.41,5792203,136.52,42.3,19.677,46682.515,114.767,6.41,0.929,0
54,95,17,12832,0,606,9624,1121706,57.41,5792203,136.52,42.3,19.677,46682.515,114.767,6.41,0.929,0
54,96,0,12832,0,606,9737,1131443,57.41,5792203,136.52,42.3,19.677,46682.515,114.767,6.41,0.929,0
54,97,0,12832,0,606,17841,1149284,57.41,5792203,136.52,42.3,19.677,46682.515,114.767,6.41,0.929,0
54,98,46,12878,1,607,16513,1165797,57.41,5792203,136.52,42.3,19.677,46682.515,114.767,6.41,0.929,0
54,99,10,12888,2,609,15903,1181700,54.63,5792203,136.52,42.3,19.677,46682.515,114.767,6.41,0.929,0
54,100,12,12900,0,609,14303,1196003,54.63,5792203,136.52,42.3,19.677,46682.515,114.767,6.41,0.929,0
54,101,16,12916,0,609,14186,1210189,54.63,5792203,136.52,42.3,19.677,46682.515,114.767,6.41,0.929,0
54,102,30,12946,0,609,9650,1219839,54.63,5792203,136.52,42.3,19.677,46682.515,114.767,6.41,0.929,0
54,103,0,12946,0,609,9133,1228972,54.63,5792203,136.52,42.3,19.677,46682.515,114.767,6.41,0.929,0
54,104,0,12946,0,609,18280,1247252,54.63,5792203,136.52,42.3,19.677,46682.515,114.767,6.41,0.929,0
54,105,91,13037,1,610,16717,1263969,54.63,5792203,136.52,42.3,19.677,46682.515,114.767,6.41,0.929,0
54,106,24,13061,0,610,16345,1280314,54.63,5792203,136.52,42.3,19.677,46682.515,114.767,6.41,0.929,0
54,107,31,13092,0,610,15182,1295496,54.63,5792203,136.52,42.3,19.677,46682.515,114.767,6.41,0.929,0
54,108,32,13124,0,610,14271,1309767,54.63,5792203,136.52,42.3,19.677,46682.515,114.767,6.41,0.929,0
54,109,49,13173,1,611,10669,1320436,54.63,5792203,136.52,42.3,19.677,46682.515,114.767,6.41,0.929,0
54,110,0,13173,0,611,10936,1331372,54.63,5792203,136.52,42.3,19.677,46682.515,114.767,6.41,0.929,0
54,111,0,13173,0,611,18211,1349583,54.63,5792203,136.52,42.3,19.677,46682.515,114.767,6.41,0.929,0
54,112,89,13262,0,611,16692,1366275,54.63,5792203,136.52,42.3,19.677,46682.515,114.767,6.41,0.929,0
54,113,40,13302,0,611,16637,1382912,54.63,5792203,136.52,42.3,19.677,46682.515,114.767,6.41,0.929,0
54,114,48,13350,0,611,15793,1398705,54.63,5792203,136.52,42.3,19.677,46682.515,114.767,6.41,0.929,0
54,115,40,13390,1,612,16108,1414813,54.63,5792203,136.52,42.3,19.677,46682.515,114.767,6.41,0.929,0
54,116,48,13438,1,613,11731,1426544,54.63,5792203,136.52,42.3,19.677,46682.515,114.767,6.41,0.929,0
54,117,0,13438,0,613,12813,1439357,54.63,5792203,136.52,42.3,19.677,46682.515,114.767,6.41,0.929,0
54,118,0,13438,0,613,20720,1460077,54.63,5792203,136.52,42.3,19.677,46682.515,114.767,6.41,0.929,0
54,119,109,13547,0,613,20376,1480453,54.63,5792203,136.52,42.3,19.677,46682.515,114.767,6.41,0.929,0
54,120,30,13577,0,613,20218,1500671,54.63,5792203,136.52,42.3,19.677,46682.515,114.767,6.41,0.929,0
54,121,57,13634,1,614,20547,1521218,54.63,5792203,136.52,42.3,19.677,46682.515,114.767,6.41,0.929,0
54,122,91,13725,1,615,19917,1541135,54.63,5792203,136.52,42.3,19.677,46682.515,114.767,6.41,0.929,0
54,123,64,13789,0,615,14305,1555440,50.93,5792203,136.52,42.3,19.677,46682.515,114.767,6.41,0.929,0
54,124,0,13789,0,615,15714,1571154,50.93,5792203,136.52,42.3,19.677,46682.515,114.767,6.41,0.929,0
54,125,0,13789,0,615,23844,1594998,50.93,5792203,136.52,42.3,19.677,46682.515,114.767,6.41,0.929,0
54,126,207,13996,1,616,24940,1619938,50.93,5792203,136.52,42.3,19.677,46682.515,114.767,6.41,0.929,0
54,127,77,14073,0,616,24878,1644816,50.93,5792203,136.52,42.3,19.677,46682.515,114.767,6.41,0.929,0
54,128,112,14185,0,616,26855,1671671,50.93,5792203,136.52,42.3,19.677,46682.515,114.767,6.41,0.929,0
54,129,121,14306,1,617,27074,1698745,50.93,5792203,136.52,42.3,19.677,46682.515,114.767,6.41,0.929,0
54,130,136,14442,0,617,20789,1719534,50.93,5792203,136.52,42.3,19.677,46682.515,114.767,6.41,0.929,0
54,131,0,14442,0,617,20934,1740468,50.93,5792203,136.52,42.3,19.677,46682.515,114.767,6.41,0.929,0
54,132,0,14442,0,617,30947,1771415,50.93,5792203,136.52,42.3,19.677,46682.515,114.767,6.41,0.929,0
54,133,373,14815,3,620,33524,1804939,50.93,5792203,136.52,42.3,19.677,46682.515,114.767,6.41,0.929,0
54,134,144,14959,1,621,34727,1839666,50.93,5792203,136.52,42.3,19.677,46682.515,114.767,6.41,0.929,0
54,135,111,15070,0,621,33775,1873441,50.93,5792203,136.52,42.3,19.677,46682.515,114.767,6.41,0.929,0
54,136,144,15214,0,621,32564,1906005,50.93,5792203,136.52,42.3,19.677,46682.515,114.767,6.41,0.929,0
54,137,165,15379,0,621,25240,1931245,50.93,5792203,136.52,42.3,19.677,46682.515,114.767,6.41,0.929,0
54,138,104,15483,0,621,25604,1956849,50.93,5792203,136.52,42.3,19.677,46682.515,114.767,6.41,0.929,0
54,139,134,15617,0,621,35591,1992440,50.93,5792203,136.52,42.3,19.677,46682.515,114.767,6.41,0.929,0
54,140,123,15740,0,621,37885,2030325,50.93,5792203,136.52,42.3,19.677,46682.515,114.767,6.41,0.929,0
54,141,115,15855,0,621,39063,2069388,50.93,5792203,136.52,42.3,19.677,46682.515,114.767,6.41,0.929,0
54,142,85,15940,0,621,38012,2107400,50.93,5792203,136.52,42.3,19.677,46682.515,114.767,6.41,0.929,0
54,143,116,16056,0,621,35704,2143104,50.93,5792203,136.52,42.3,19.677,46682.515,114.767,6.41,0.929,0
54,144,71,16127,0,621,28635,2171739,50.93,5792203,136.52,42.3,19.677,46682.515,114.767,6.41,0.929,0
54,145,0,16127,0,621,27561,2199300,50.93,5792203,136.52,42.3,19.677,46682.515,114.767,6.41,0.929,0
54,146,0,16127,0,621,39359,2238659,50.93,5792203,136.52,42.3,19.677,46682.515,114.767,6.41,0.929,0
54,147,270,16397,2,623,39750,2278409,50.93,5792203,136.52,42.3,19.677,46682.515,114.767,6.41,0.929,0
54,148,83,16480,0,623,40064,2318473,50.93,5792203,136.52,42.3,19.677,46682.515,114.767,6.41,0.929,0
54,149,57,16537,0,623,38678,2357151,50.93,5792203,136.52,42.3,19.677,46682.515,114.767,6.41,0.929,0
54,150,90,16627,1,624,35441,2392592,50.93,5792203,136.52,42.3,19.677,46682.515,114.767,6.41,0.929,0
54,151,73,16700,0,624,25187,2417779,50.93,5792203,136.52,42.3,19.677,46682.515,114.767,6.41,0.929,0
54,152,0,16700,0,624,25245,2443024,50.93,5792203,136.52,42.3,19.677,46682.515,114.767,6.41,0.929,0
54,153,0,16700,0,624,39627,2482651,50.93,5792203,136.52,42.3,19.677,46682.515,114.767,6.41,0.929,0
54,154,285,16985,0,624,39213,2521864,50.93,5792203,136.52,42.3,19.677,46682.515,114.767,6.41,0.929,0
54,155,99,17084,1,625,40021,2561885,50.93,5792203,136.52,42.3,19.677,46682.515,114.767,6.41,0.929,0
54,156,111,17195,1,626,38809,2600694,50.93,5792203,136.52,42.3,19.677,46682.515,114.767,6.41,0.929,0
54,157,179,17374,0,626,40138,2640832,50.93,5792203,136.52,42.3,19.677,46682.515,114.767,6.41,0.929,0
54,158,173,17547,1,627,28560,2669392,50.93,5792203,136.52,42.3,19.677,46682.515,114.767,6.41,0.929,0
54,159,0,17547,0,627,29783,2699175,50.93,5792203,136.52,42.3,19.677,46682.515,114.767,6.41,0.929,0
54,160,0,17547,0,627,47810,2746985,50.93,5792203,136.52,42.3,19.677,46682.515,114.767,6.41,0.929,0
54,161,566,18113,1,628,48327,2795312,50.93,5792203,136.52,42.3,19.677,46682.515,114.767,6.41,0.929,0
54,162,243,18356,0,628,48823,2844135,47.69,5792203,136.52,42.3,19.677,46682.515,114.767,6.41,0.929,0
54,163,251,18607,0,628,52153,2896288,47.69,5792203,136.52,42.3,19.677,46682.515,114.767,6.41,0.929,0
54,164,317,18924,1,629,50573,2946861,47.69,5792203,136.52,42.3,19.677,46682.515,114.767,6.41,0.929,0
54,165,292,19216,0,629,41342,2988203,47.69,5792203,136.52,42.3,19.677,46682.515,114.767,6.41,0.929,0
54,166,0,19216,0,629,41895,3030098,47.69,5792203,136.52,42.3,19.677,46682.515,114.767,6.41,0.929,0
54,167,0,19216,0,629,55732,3085830,47.69,5792203,136.52,42.3,19.677,46682.515,114.767,6.41,0.929,0
54,168,584,19800,4,633,56153,3141983,47.69,5792203,136.52,42.3,19.677,46682.515,114.767,6.41,0.929,0
54,169,329,20129,0,633,56677,3198660,47.69,5792203,136.52,42.3,19.677,46682.515,114.767,6.41,0.929,0
54,170,442,20571,0,633,52006,3250666,47.69,5792203,136.52,42.3,19.677,46682.515,114.767,6.41,0.929,0
54,171,822,21393,2,635,51491,3302157,47.69,5792203,136.52,42.3,19.677,46682.515,114.767,6.41,0.929,0
54,172,454,21847,0,635,40046,3342203,50.93,5792203,136.52,42.3,19.677,46682.515,114.767,6.41,0.929,0
54,173,0,21847,0,635,40965,3383168,50.93,5792203,136.52,42.3,19.677,46682.515,114.767,6.41,0.929,0
54,174,0,21847,0,635,54132,3437300,50.93,5792203,136.52,42.3,19.677,46682.515,114.767,6.41,0.929,0
54,175,1476,23323,5,640,56613,3493913,50.93,5792203,136.52,42.3,19.677,46682.515,114.767,6.41,0.929,0
54,176,476,23799,1,641,55506,3549419,50.93,5792203,136.52,42.3,19.677,46682.515,114.767,6.41,0.929,0
54,177,558,24357,2,643,53890,3603309,50.93,5792203,136.52,42.3,19.677,46682.515,114.767,6.41,0.929,0
54,178,559,24916,2,645,51536,3654845,50.93,5792203,136.52,42.3,19.677,46682.515,114.767,6.41,0.929,0
54,179,678,25594,2,647,39584,3694429,50.93,5792203,136.52,42.3,19.677,46682.515,114.767,6.41,0.929,0
54,180,619,26213,1,648,39590,3734019,50.93,5792203,136.52,42.3,19.677,46682.515,114.767,6.41,0.929,0
54,181,424,26637,1,649,53931,3787950,50.93,5792203,136.52,42.3,19.677,46682.515,114.767,6.41,0.929,0
54,182,435,27072,0,649,50696,3838646,50.93,5792203,136.52,42.3,19.677,46682.515,114.767,6.41,0.929,0
54,183,392,27464,1,650,47685,3886331,50.93,5792203,136.52,42.3,19.677,46682.515,114.767,6.41,0.929,0
54,184,534,27998,0,650,44466,3930797,50.93,5792203,136.52,42.3,19.677,46682.515,114.767,6.41,0.929,0
54,185,398,28396,1,651,43105,3973902,50.93,5792203,136.52,42.3,19.677,46682.515,114.767,6.41,0.929,0
54,186,536,28932,1,652,33596,4007498,50.93,5792203,136.52,42.3,19.677,46682.515,114.767,6.41,0.929,0
54,187,370,29302,2,654,33948,4041446,50.93,5792203,136.52,42.3,19.677,46682.515,114.767,6.41,0.929,0
54,188,378,29680,4,658,52384,4093830,50.93,5792203,136.52,42.3,19.677,46682.515,114.767,6.41,0.929,0
54,189,377,30057,1,659,53562,4147392,50.93,5792203,136.52,42.3,19.677,46682.515,114.767,6.41,0.929,0
54,190,322,30379,4,663,50044,4197436,50.93,5792203,136.52,42.3,19.677,46682.515,114.767,6.41,0.929,0
54,191,331,30710,0,663,47767,4245203,50.93,5792203,136.52,42.3,19.677,46682.515,114.767,6.41,0.929,0
54,192,446,31156,2,665,39621,4284824,50.93,5792203,136.52,42.3,19.677,46682.515,114.767,6.41,0.929,0
54,193,482,31638,0,665,27187,4312011,37.96,5792203,136.52,42.3,19.677,46682.515,114.767,6.41,0.929,0
54,194,444,32082,2,667,26763,4338774,37.96,5792203,136.52,42.3,19.677,46682.515,114.767,6.41,0.929,0
54,195,340,32422,2,669,40440,4379214,37.96,5792203,136.52,42.3,19.677,46682.515,114.767,6.41,0.929,0
54,196,389,32811,2,671,36242,4415456,37.96,5792203,136.52,42.3,19.677,46682.515,114.767,6.41,0.929,0
54,197,290,33101,3,674,35850,4451306,37.96,5792203,136.52,42.3,19.677,46682.515,114.767,6.41,0.929,0
54,198,492,33593,1,675,35223,4486529,37.96,5792203,136.52,42.3,19.677,46682.515,114.767,6.41,0.929,0
54,199,430,34023,2,677,34361,4520890,37.96,5792203,136.52,42.3,19.677,46682.515,114.767,6.41,0.929,0
54,200,418,34441,0,677,26450,4547340,37.96,5792203,136.52,42.3,19.677,46682.515,114.767,6.41,0.929,0
54,201,500,34941,2,679,9817,4557157,37.96,5792203,136.52,42.3,19.677,46682.515,114.767,6.41,0.929,0
54,202,451,35392,1,680,0,4557157,37.96,5792203,136.52,42.3,19.677,46682.515,114.767,6.41,0.929,0
54,203,452,35844,6,686,0,4557157,37.96,5792203,136.52,42.3,19.677,46682.515,114.767,6.41,0.929,0
54,204,529,36373,2,688,0,4557157,37.96,5792203,136.52,42.3,19.677,46682.515,114.767,6.41,0.929,0
55,1,5,31,0,0,0,0,100,988002,41.285,25.4,4.213,2705.406,258.037,6.05,0.476,0
55,2,3,34,0,0,0,0,100,988002,41.285,25.4,4.213,2705.406,258.037,6.05,0.476,0
55,3,7,41,0,0,0,0,100,988002,41.285,25.4,4.213,2705.406,258.037,6.05,0.476,0
55,4,0,41,0,0,0,0,100,988002,41.285,25.4,4.213,2705.406,258.037,6.05,0.476,0
55,5,10,51,0,0,0,0,100,988002,41.285,25.4,4.213,2705.406,258.037,6.05,0.476,0
55,6,8,59,0,0,0,0,100,988002,41.285,25.4,4.213,2705.406,258.037,6.05,0.476,0
55,7,31,90,0,0,0,0,100,988002,41.285,25.4,4.213,2705.406,258.037,6.05,0.476,0
55,8,31,121,0,0,0,0,100,988002,41.285,25.4,4.213,2705.406,258.037,6.05,0.476,0
55,9,14,135,0,0,0,0,100,988002,41.285,25.4,4.213,2705.406,258.037,6.05,0.476,0
55,10,5,140,1,1,0,0,100,988002,41.285,25.4,4.213,2705.406,258.037,6.05,0.476,0
55,11,10,150,0,1,0,0,100,988002,41.285,25.4,4.213,2705.406,258.037,6.05,0.476,0
55,12,37,187,1,2,0,0,100,988002,41.285,25.4,4.213,2705.406,258.037,6.05,0.476,0
55,13,27,214,0,2,0,0,100,988002,41.285,25.4,4.213,2705.406,258.037,6.05,0.476,0
55,14,84,298,0,2,0,0,100,988002,41.285,25.4,4.213,2705.406,258.037,6.05,0.476,0
55,15,65,363,0,2,0,0,100,988002,41.285,25.4,4.213,2705.406,258.037,6.05,0.476,0
55,16,72,435,0,2,0,0,100,988002,41.285,25.4,4.213,2705.406,258.037,6.05,0.476,0
55,17,156,591,0,2,0,0,100,988002,41.285,25.4,4.213,2705.406,258.037,6.05,0.476,0
55,18,141,732,0,2,0,0,100,988002,41.285,25.4,4.213,2705.406,258.037,6.05,0.476,0
55,19,0,732,0,2,0,0,100,988002,41.285,25.4,4.213,2705.406,258.037,6.05,0.476,0
55,20,114,846,0,2,0,0,100,988002,41.285,25.4,4.213,2705.406,258.037,6.05,0.476,0
55,21,0,846,0,2,0,0,100,988002,41.285,25.4,4.213,2705.406,258.037,6.05,0.476,0
55,22,99,945,0,2,0,0,100,988002,41.285,25.4,4.213,2705.406,258.037,6.05,0.476,0
55,23,29,974,0,2,0,0,100,988002,41.285,25.4,4.213,2705.406,258.037,6.05,0.476,0
55,24,12,986,0,2,0,0,100,988002,41.285,25.4,4.213,2705.406,258.037,6.05,0.476,0
55,25,13,999,0,2,0,0,100,988002,41.285,25.4,4.213,2705.406,258.037,6.05,0.476,0
55,26,9,1008,0,2,0,0,100,988002,41.285,25.4,4.213,2705.406,258.037,6.05,0.476,0
55,27,15,1023,0,2,0,0,100,988002,41.285,25.4,4.213,2705.406,258.037,6.05,0.476,0
55,28,12,1035,0,2,0,0,100,988002,41.285,25.4,4.213,2705.406,258.037,6.05,0.476,0
55,29,37,1072,0,2,0,0,100,988002,41.285,25.4,4.213,2705.406,258.037,6.05,0.476,0
55,30,5,1077,0,2,0,0,100,988002,41.285,25.4,4.213,2705.406,258.037,6.05,0.476,0
55,31,12,1089,0,2,0,0,100,988002,41.285,25.4,4.213,2705.406,258.037,6.05,0.476,0
55,32,8,1097,0,2,0,0,100,988002,41.285,25.4,4.213,2705.406,258.037,6.05,0.476,0
55,33,15,1112,0,2,0,0,100,988002,41.285,25.4,4.213,2705.406,258.037,6.05,0.476,0
55,34,0,1112,0,2,0,0,100,988002,41.285,25.4,4.213,2705.406,258.037,6.05,0.476,0
55,35,4,1116,0,2,0,0,100,988002,41.285,25.4,4.213,2705.406,258.037,6.05,0.476,0
55,36,4,1120,0,2,0,0,100,988002,41.285,25.4,4.213,2705.406,258.037,6.05,0.476,0
55,37,0,1120,1,3,0,0,100,988002,41.285,25.4,4.213,2705.406,258.037,6.05,0.476,0
55,38,13,1133,0,3,0,0,100,988002,41.285,25.4,4.213,2705.406,258.037,6.05,0.476,0
55,39,2,1135,0,3,0,0,100,988002,41.285,25.4,4.213,2705.406,258.037,6.05,0.476,0
55,40,54,1189,0,3,0,0,100,988002,41.285,25.4,4.213,2705.406,258.037,6.05,0.476,0
55,41,21,1210,0,3,0,0,100,988002,41.285,25.4,4.213,2705.406,258.037,6.05,0.476,0
55,42,17,1227,0,3,0,0,100,988002,41.285,25.4,4.213,2705.406,258.037,6.05,0.476,0
55,43,29,1256,0,3,0,0,100,988002,41.285,25.4,4.213,2705.406,258.037,6.05,0.476,0
55,44,12,1268,0,3,0,0,100,988002,41.285,25.4,4.213,2705.406,258.037,6.05,0.476,0
55,45,16,1284,0,3,0,0,100,988002,41.285,25.4,4.213,2705.406,258.037,6.05,0.476,0
55,46,25,1309,1,4,0,0,100,988002,41.285,25.4,4.213,2705.406,258.037,6.05,0.476,0
55,47,22,1331,0,4,0,0,59.26,988002,41.285,25.4,4.213,2705.406,258.037,6.05,0.476,0
55,48,70,1401,0,4,0,0,59.26,988002,41.285,25.4,4.213,2705.406,258.037,6.05,0.476,0
55,49,117,1518,3,7,0,0,59.26,988002,41.285,25.4,4.213,2705.406,258.037,6.05,0.476,0
55,50,0,1518,0,7,0,0,59.26,988002,41.285,25.4,4.213,2705.406,258.037,6.05,0.476,0
55,51,310,1828,2,9,0,0,59.26,988002,41.285,25.4,4.213,2705.406,258.037,6.05,0.476,0
55,52,219,2047,1,10,0,0,59.26,988002,41.285,25.4,4.213,2705.406,258.037,6.05,0.476,0
55,53,223,2270,0,10,0,0,53.7,988002,41.285,25.4,4.213,2705.406,258.037,6.05,0.476,0
55,54,0,2270,0,10,0,0,53.7,988002,41.285,25.4,4.213,2705.406,258.037,6.05,0.476,0
55,55,0,2270,0,10,0,0,53.7,988002,41.285,25.4,4.213,2705.406,258.037,6.05,0.476,0
55,56,198,2468,4,14,0,0,53.7,988002,41.285,25.4,4.213,2705.406,258.037,6.05,0.476,0
55,57,0,2468,0,14,0,0,53.7,988002,41.285,25.4,4.213,2705.406,258.037,6.05,0.476,0
55,58,229,2697,4,18,0,0,53.7,988002,41.285,25.4,4.213,2705.406,258.037,6.05,0.476,0
55,59,217,2914,2,20,0,0,53.7,988002,41.285,25.4,4.213,2705.406,258.037,6.05,0.476,0
55,60,0,2914,0,20,0,0,53.7,988002,41.285,25.4,4.213,2705.406,258.037,6.05,0.476,0
55,61,280,3194,2,22,0,0,53.7,988002,41.285,25.4,4.213,2705.406,258.037,6.05,0.476,0
55,62,160,3354,2,24,0,0,53.7,988002,41.285,25.4,4.213,2705.406,258.037,6.05,0.476,0
55,63,215,3569,0,24,0,0,53.7,988002,41.285,25.4,4.213,2705.406,258.037,6.05,0.476,0
55,64,210,3779,1,25,0,0,53.7,988002,41.285,25.4,4.213,2705.406,258.037,6.05,0.476,0
55,65,156,3935,1,26,0,0,53.7,988002,41.285,25.4,4.213,2705.406,258.037,6.05,0.476,0
55,66,119,4054,0,26,0,0,53.7,988002,41.285,25.4,4.213,2705.406,258.037,6.05,0.476,0
55,67,69,4123,0,26,0,0,53.7,988002,41.285,25.4,4.213,2705.406,258.037,6.05,0.476,0
55,68,46,4169,0,26,0,0,53.7,988002,41.285,25.4,4.213,2705.406,258.037,6.05,0.476,0
55,69,38,4207,2,28,0,0,53.7,988002,41.285,25.4,4.213,2705.406,258.037,6.05,0.476,0
55,70,71,4278,3,31,0,0,53.7,988002,41.285,25.4,4.213,2705.406,258.037,6.05,0.476,0
55,71,53,4331,3,34,0,0,53.7,988002,41.285,25.4,4.213,2705.406,258.037,6.05,0.476,0
55,72,42,4373,0,34,0,0,53.7,988002,41.285,25.4,4.213,2705.406,258.037,6.05,0.476,0
55,73,25,4398,3,37,0,0,53.7,988002,41.285,25.4,4.213,2705.406,258.037,6.05,0.476,0
55,74,43,4441,1,38,0,0,53.7,988002,41.285,25.4,4.213,2705.406,258.037,6.05,0.476,0
55,75,8,4449,3,41,0,0,53.7,988002,41.285,25.4,4.213,2705.406,258.037,6.05,0.476,0
55,76,16,4465,2,43,0,0,53.7,988002,41.285,25.4,4.213,2705.406,258.037,6.05,0.476,0
55,77,36,4501,0,43,0,0,53.7,988002,41.285,25.4,4.213,2705.406,258.037,6.05,0.476,0
55,78,38,4539,0,43,0,0,53.7,988002,41.285,25.4,4.213,2705.406,258.037,6.05,0.476,0
55,79,6,4545,0,43,0,0,53.7,988002,41.285,25.4,4.213,2705.406,258.037,6.05,0.476,0
55,80,12,4557,0,43,0,0,53.7,988002,41.285,25.4,4.213,2705.406,258.037,6.05,0.476,0
55,81,8,4565,2,45,0,0,53.7,988002,41.285,25.4,4.213,2705.406,258.037,6.05,0.476,0
55,82,0,4565,0,45,0,0,53.7,988002,41.285,25.4,4.213,2705.406,258.037,6.05,0.476,0
55,83,17,4582,0,45,0,0,53.7,988002,41.285,25.4,4.213,2705.406,258.037,6.05,0.476,0
55,84,17,4599,3,48,0,0,53.7,988002,41.285,25.4,4.213,2705.406,258.037,6.05,0.476,0
55,85,18,4617,1,49,0,0,53.7,988002,41.285,25.4,4.213,2705.406,258.037,6.05,0.476,0
55,86,13,4630,3,52,0,0,53.7,988002,41.285,25.4,4.213,2705.406,258.037,6.05,0.476,0
55,87,5,4635,0,52,0,0,53.7,988002,41.285,25.4,4.213,2705.406,258.037,6.05,0.476,0
55,88,8,4643,0,52,0,0,53.7,988002,41.285,25.4,4.213,2705.406,258.037,6.05,0.476,0
55,89,0,4643,0,52,0,0,53.7,988002,41.285,25.4,4.213,2705.406,258.037,6.05,0.476,0
55,90,0,4643,0,52,0,0,53.7,988002,41.285,25.4,4.213,2705.406,258.037,6.05,0.476,0
55,91,13,4656,1,53,0,0,53.7,988002,41.285,25.4,4.213,2705.406,258.037,6.05,0.476,0
55,92,26,4682,1,54,0,0,53.7,988002,41.285,25.4,4.213,2705.406,258.037,6.05,0.476,0
55,93,22,4704,1,55,0,0,53.7,988002,41.285,25.4,4.213,2705.406,258.037,6.05,0.476,0
55,94,11,4715,0,55,0,0,53.7,988002,41.285,25.4,4.213,2705.406,258.037,6.05,0.476,0
55,95,21,4736,0,55,0,0,53.7,988002,41.285,25.4,4.213,2705.406,258.037,6.05,0.476,0
55,96,0,4736,0,55,0,0,53.7,988002,41.285,25.4,4.213,2705.406,258.037,6.05,0.476,0
55,97,56,4792,0,55,0,0,53.7,988002,41.285,25.4,4.213,2705.406,258.037,6.05,0.476,0
55,98,30,4822,0,55,0,0,53.7,988002,41.285,25.4,4.213,2705.406,258.037,6.05,0.476,0
55,99,56,4878,0,55,0,0,53.7,988002,41.285,25.4,4.213,2705.406,258.037,6.05,0.476,0
55,100,11,4889,0,55,0,0,53.7,988002,41.285,25.4,4.213,2705.406,258.037,6.05,0.476,0
55,101,66,4955,1,56,0,0,53.7,988002,41.285,25.4,4.213,2705.406,258.037,6.05,0.476,0
55,102,0,4955,0,56,0,0,53.7,988002,41.285,25.4,4.213,2705.406,258.037,6.05,0.476,0
55,103,0,4955,0,56,0,0,53.7,988002,41.285,25.4,4.213,2705.406,258.037,6.05,0.476,0
55,104,17,4972,0,56,0,0,53.7,988002,41.285,25.4,4.213,2705.406,258.037,6.05,0.476,0
55,105,5,4977,0,56,0,0,53.7,988002,41.285,25.4,4.213,2705.406,258.037,6.05,0.476,0
55,106,2,4979,0,56,0,0,53.7,988002,41.285,25.4,4.213,2705.406,258.037,6.05,0.476,0
55,107,6,4985,0,56,0,0,53.7,988002,41.285,25.4,4.213,2705.406,258.037,6.05,0.476,0
55,108,8,4993,0,56,0,0,45.37,988002,41.285,25.4,4.213,2705.406,258.037,6.05,0.476,0
55,109,10,5003,0,56,0,0,45.37,988002,41.285,25.4,4.213,2705.406,258.037,6.05,0.476,0
55,110,0,5003,0,56,0,0,45.37,988002,41.285,25.4,4.213,2705.406,258.037,6.05,0.476,0
55,111,8,5011,0,56,0,0,45.37,988002,41.285,25.4,4.213,2705.406,258.037,6.05,0.476,0
55,112,9,5020,0,56,0,0,45.37,988002,41.285,25.4,4.213,2705.406,258.037,6.05,0.476,0
55,113,7,5027,0,56,0,0,45.37,988002,41.285,25.4,4.213,2705.406,258.037,6.05,0.476,0
55,114,3,5030,2,58,0,0,45.37,988002,41.285,25.4,4.213,2705.406,258.037,6.05,0.476,0
55,115,1,5031,0,58,0,0,45.37,988002,41.285,25.4,4.213,2705.406,258.037,6.05,0.476,0
55,116,8,5039,0,58,0,0,45.37,988002,41.285,25.4,4.213,2705.406,258.037,6.05,0.476,0
55,117,0,5039,0,58,0,0,45.37,988002,41.285,25.4,4.213,2705.406,258.037,6.05,0.476,0
55,118,11,5050,0,58,0,0,45.37,988002,41.285,25.4,4.213,2705.406,258.037,6.05,0.476,0
55,119,9,5059,0,58,0,0,45.37,988002,41.285,25.4,4.213,2705.406,258.037,6.05,0.476,0
55,120,9,5068,0,58,0,0,45.37,988002,41.285,25.4,4.213,2705.406,258.037,6.05,0.476,0
55,121,13,5081,0,58,0,0,45.37,988002,41.285,25.4,4.213,2705.406,258.037,6.05,0.476,0
55,122,0,5081,0,58,0,0,45.37,988002,41.285,25.4,4.213,2705.406,258.037,6.05,0.476,0
55,123,0,5081,0,58,0,0,45.37,988002,41.285,25.4,4.213,2705.406,258.037,6.05,0.476,0
55,124,0,5081,0,58,0,0,45.37,988002,41.285,25.4,4.213,2705.406,258.037,6.05,0.476,0
55,125,80,5161,1,59,0,0,45.37,988002,41.285,25.4,4.213,2705.406,258.037,6.05,0.476,0
55,126,79,5240,0,59,0,0,45.37,988002,41.285,25.4,4.213,2705.406,258.037,6.05,0.476,0
55,127,8,5248,0,59,0,0,45.37,988002,41.285,25.4,4.213,2705.406,258.037,6.05,0.476,0
55,128,82,5330,0,59,0,0,45.37,988002,41.285,25.4,4.213,2705.406,258.037,6.05,0.476,0
55,129,4,5334,0,59,0,0,45.37,988002,41.285,25.4,4.213,2705.406,258.037,6.05,0.476,0
55,130,4,5338,0,59,0,0,45.37,988002,41.285,25.4,4.213,2705.406,258.037,6.05,0.476,0
55,131,0,5338,0,59,0,0,45.37,988002,41.285,25.4,4.213,2705.406,258.037,6.05,0.476,0
55,132,6,5344,0,59,0,0,45.37,988002,41.285,25.4,4.213,2705.406,258.037,6.05,0.476,0
55,133,3,5347,0,59,0,0,45.37,988002,41.285,25.4,4.213,2705.406,258.037,6.05,0.476,0
55,134,1,5348,0,59,0,0,45.37,988002,41.285,25.4,4.213,2705.406,258.037,6.05,0.476,0
55,135,10,5358,0,59,0,0,45.37,988002,41.285,25.4,4.213,2705.406,258.037,6.05,0.476,0
55,136,0,5358,0,59,0,0,45.37,988002,41.285,25.4,4.213,2705.406,258.037,6.05,0.476,0
55,137,9,5367,0,59,0,0,45.37,988002,41.285,25.4,4.213,2705.406,258.037,6.05,0.476,0
55,138,0,5367,0,59,0,0,45.37,988002,41.285,25.4,4.213,2705.406,258.037,6.05,0.476,0
55,139,2,5369,0,59,0,0,45.37,988002,41.285,25.4,4.213,2705.406,258.037,6.05,0.476,0
55,140,3,5372,0,59,0,0,45.37,988002,41.285,25.4,4.213,2705.406,258.037,6.05,0.476,0
55,141,2,5374,0,59,0,0,45.37,988002,41.285,25.4,4.213,2705.406,258.037,6.05,0.476,0
55,142,0,5374,0,59,0,0,45.37,988002,41.285,25.4,4.213,2705.406,258.037,6.05,0.476,0
55,143,0,5374,0,59,0,0,45.37,988002,41.285,25.4,4.213,2705.406,258.037,6.05,0.476,0
55,144,8,5382,1,60,0,0,45.37,988002,41.285,25.4,4.213,2705.406,258.037,6.05,0.476,0
55,145,0,5382,0,60,0,0,45.37,988002,41.285,25.4,4.213,2705.406,258.037,6.05,0.476,0
55,146,0,5382,0,60,0,0,45.37,988002,41.285,25.4,4.213,2705.406,258.037,6.05,0.476,0
55,147,1,5383,0,60,0,0,45.37,988002,41.285,25.4,4.213,2705.406,258.037,6.05,0.476,0
55,148,0,5383,0,60,0,0,45.37,988002,41.285,25.4,4.213,2705.406,258.037,6.05,0.476,0
55,149,0,5383,0,60,0,0,45.37,988002,41.285,25.4,4.213,2705.406,258.037,6.05,0.476,0
55,150,0,5383,0,60,0,0,45.37,988002,41.285,25.4,4.213,2705.406,258.037,6.05,0.476,0
55,151,0,5383,0,60,0,0,45.37,988002,41.285,25.4,4.213,2705.406,258.037,6.05,0.476,0
55,152,2,5385,0,60,0,0,45.37,988002,41.285,25.4,4.213,2705.406,258.037,6.05,0.476,0
55,153,0,5385,0,60,0,0,45.37,988002,41.285,25.4,4.213,2705.406,258.037,6.05,0.476,0
55,154,2,5387,0,60,0,0,45.37,988002,41.285,25.4,4.213,2705.406,258.037,6.05,0.476,0
55,155,0,5387,0,60,0,0,45.37,988002,41.285,25.4,4.213,2705.406,258.037,6.05,0.476,0
55,156,0,5387,0,60,0,0,45.37,988002,41.285,25.4,4.213,2705.406,258.037,6.05,0.476,0
55,157,0,5387,0,60,0,0,45.37,988002,41.285,25.4,4.213,2705.406,258.037,6.05,0.476,0
55,158,0,5387,0,60,0,0,45.37,988002,41.285,25.4,4.213,2705.406,258.037,6.05,0.476,0
55,159,0,5387,0,60,0,0,45.37,988002,41.285,25.4,4.213,2705.406,258.037,6.05,0.476,0
55,160,1,5388,1,61,0,0,37.96,988002,41.285,25.4,4.213,2705.406,258.037,6.05,0.476,0
55,161,0,5388,0,61,0,0,37.96,988002,41.285,25.4,4.213,2705.406,258.037,6.05,0.476,0
55,162,0,5388,0,61,0,0,37.96,988002,41.285,25.4,4.213,2705.406,258.037,6.05,0.476,0
55,163,3,5391,0,61,0,0,37.96,988002,41.285,25.4,4.213,2705.406,258.037,6.05,0.476,0
55,164,3,5394,0,61,0,0,37.96,988002,41.285,25.4,4.213,2705.406,258.037,6.05,0.476,0
55,165,0,5394,0,61,0,0,37.96,988002,41.285,25.4,4.213,2705.406,258.037,6.05,0.476,0
55,166,0,5394,0,61,0,0,37.96,988002,41.285,25.4,4.213,2705.406,258.037,6.05,0.476,0
55,167,1,5395,0,61,0,0,37.96,988002,41.285,25.4,4.213,2705.406,258.037,6.05,0.476,0
55,168,1,5396,0,61,0,0,37.96,988002,41.285,25.4,4.213,2705.406,258.037,6.05,0.476,0
55,169,0,5396,0,61,0,0,37.96,988002,41.285,25.4,4.213,2705.406,258.037,6.05,0.476,0
55,170,3,5399,0,61,0,0,37.96,988002,41.285,25.4,4.213,2705.406,258.037,6.05,0.476,0
55,171,2,5401,0,61,0,0,37.96,988002,41.285,25.4,4.213,2705.406,258.037,6.05,0.476,0
55,172,2,5403,0,61,0,0,37.96,988002,41.285,25.4,4.213,2705.406,258.037,6.05,0.476,0
55,173,0,5403,0,61,0,0,37.96,988002,41.285,25.4,4.213,2705.406,258.037,6.05,0.476,0
55,174,0,5403,0,61,0,0,37.96,988002,41.285,25.4,4.213,2705.406,258.037,6.05,0.476,0
55,175,1,5404,0,61,0,0,37.96,988002,41.285,25.4,4.213,2705.406,258.037,6.05,0.476,0
55,176,3,5407,0,61,0,0,37.96,988002,41.285,25.4,4.213,2705.406,258.037,6.05,0.476,0
55,177,0,5407,0,61,0,0,37.96,988002,41.285,25.4,4.213,2705.406,258.037,6.05,0.476,0
55,178,0,5407,0,61,0,0,37.96,988002,41.285,25.4,4.213,2705.406,258.037,6.05,0.476,0
55,179,2,5409,0,61,0,0,37.96,988002,41.285,25.4,4.213,2705.406,258.037,6.05,0.476,0
55,180,0,5409,0,61,0,0,37.96,988002,41.285,25.4,4.213,2705.406,258.037,6.05,0.476,0
55,181,0,5409,0,61,0,0,37.96,988002,41.285,25.4,4.213,2705.406,258.037,6.05,0.476,0
55,182,1,5410,0,61,0,0,37.96,988002,41.285,25.4,4.213,2705.406,258.037,6.05,0.476,0
55,183,6,5416,0,61,0,0,37.96,988002,41.285,25.4,4.213,2705.406,258.037,6.05,0.476,0
55,184,0,5416,0,61,0,0,37.96,988002,41.285,25.4,4.213,2705.406,258.037,6.05,0.476,0
55,185,1,5417,0,61,0,0,37.96,988002,41.285,25.4,4.213,2705.406,258.037,6.05,0.476,0
55,186,0,5417,0,61,0,0,37.96,988002,41.285,25.4,4.213,2705.406,258.037,6.05,0.476,0
55,187,1,5418,0,61,0,0,37.96,988002,41.285,25.4,4.213,2705.406,258.037,6.05,0.476,0
55,188,1,5419,0,61,0,0,37.96,988002,41.285,25.4,4.213,2705.406,258.037,6.05,0.476,0
55,189,2,5421,0,61,0,0,37.96,988002,41.285,25.4,4.213,2705.406,258.037,6.05,0.476,0
55,190,2,5423,0,61,0,0,37.96,988002,41.285,25.4,4.213,2705.406,258.037,6.05,0.476,0
55,191,0,5423,0,61,0,0,37.96,988002,41.285,25.4,4.213,2705.406,258.037,6.05,0.476,0
55,192,0,5423,0,61,0,0,45.37,988002,41.285,25.4,4.213,2705.406,258.037,6.05,0.476,0
55,193,0,5423,0,61,0,0,45.37,988002,41.285,25.4,4.213,2705.406,258.037,6.05,0.476,0
55,194,0,5423,0,61,0,0,45.37,988002,41.285,25.4,4.213,2705.406,258.037,6.05,0.476,0
55,195,0,5423,0,61,0,0,45.37,988002,41.285,25.4,4.213,2705.406,258.037,6.05,0.476,0
55,196,3,5426,0,61,0,0,45.37,988002,41.285,25.4,4.213,2705.406,258.037,6.05,0.476,0
55,197,2,5428,0,61,0,0,45.37,988002,41.285,25.4,4.213,2705.406,258.037,6.05,0.476,0
55,198,12,5440,0,61,0,0,45.37,988002,41.285,25.4,4.213,2705.406,258.037,6.05,0.476,0
55,199,3,5443,0,61,0,0,45.37,988002,41.285,25.4,4.213,2705.406,258.037,6.05,0.476,0
55,200,6,5449,0,61,0,0,45.37,988002,41.285,25.4,4.213,2705.406,258.037,6.05,0.476,0
55,201,3,5452,0,61,0,0,45.37,988002,41.285,25.4,4.213,2705.406,258.037,6.05,0.476,0
55,202,7,5459,0,61,0,0,45.37,988002,41.285,25.4,4.213,2705.406,258.037,6.05,0.476,0
55,203,10,5469,0,61,0,0,45.37,988002,41.285,25.4,4.213,2705.406,258.037,6.05,0.476,0
55,204,30,5499,0,61,0,0,45.37,988002,41.285,25.4,4.213,2705.406,258.037,6.05,0.476,0
57,1,208,1109,9,51,316,4018,89.81,10847904,222.873,27.6,6.981,14600.861,266.653,8.2,0.736,0
57,2,175,1284,6,57,182,4200,89.81,10847904,222.873,27.6,6.981,14600.861,266.653,8.2,0.736,0
57,3,96,1380,3,60,342,4542,89.81,10847904,222.873,27.6,6.981,14600.861,266.653,8.2,0.736,0
57,4,108,1488,8,68,641,5183,89.81,10847904,222.873,27.6,6.981,14600.861,266.653,8.2,0.736,0
57,5,90,1578,9,77,306,5489,89.81,10847904,222.873,27.6,6.981,14600.861,266.653,8.2,0.736,0
57,6,167,1745,5,82,331,5820,89.81,10847904,222.873,27.6,6.981,14600.861,266.653,8.2,0.736,0
57,7,83,1828,4,86,538,6358,89.81,10847904,222.873,27.6,6.981,14600.861,266.653,8.2,0.736,0
57,8,128,1956,12,98,793,7151,89.81,10847904,222.873,27.6,6.981,14600.861,266.653,8.2,0.736,0
57,9,155,2111,10,108,785,7936,89.81,10847904,222.873,27.6,6.981,14600.861,266.653,8.2,0.736,0
57,10,238,2349,10,118,533,8469,89.81,10847904,222.873,27.6,6.981,14600.861,266.653,8.2,0.736,0
57,11,271,2620,8,126,806,9275,89.81,10847904,222.873,27.6,6.981,14600.861,266.653,8.2,0.736,0
57,12,139,2759,9,135,800,10075,89.81,10847904,222.873,27.6,6.981,14600.861,266.653,8.2,0.736,0
57,13,208,2967,38,173,373,10448,89.81,10847904,222.873,27.6,6.981,14600.861,266.653,8.2,0.736,0
57,14,200,3167,4,177,1293,11741,89.81,10847904,222.873,27.6,6.981,14600.861,266.653,8.2,0.736,0
57,15,119,3286,6,183,488,12229,89.81,10847904,222.873,27.6,6.981,14600.861,266.653,8.2,0.736,0
57,16,328,3614,6,189,1053,13282,89.81,10847904,222.873,27.6,6.981,14600.861,266.653,8.2,0.736,0
57,17,141,3755,7,196,1091,14373,89.81,10847904,222.873,27.6,6.981,14600.861,266.653,8.2,0.736,0
57,18,371,4126,4,200,1210,15583,93.52,10847904,222.873,27.6,6.981,14600.861,266.653,8.2,0.736,0
57,19,209,4335,17,217,1099,16682,93.52,10847904,222.873,27.6,6.981,14600.861,266.653,8.2,0.736,0
57,20,345,4680,9,226,291,16973,93.52,10847904,222.873,27.6,6.981,14600.861,266.653,8.2,0.736,0
57,21,284,4964,9,235,1288,18261,93.52,10847904,222.873,27.6,6.981,14600.861,266.653,8.2,0.736,0
57,22,80,5044,10,245,1019,19280,93.52,10847904,222.873,27.6,6.981,14600.861,266.653,8.2,0.736,0
57,23,256,5300,15,260,990,20270,93.52,10847904,222.873,27.6,6.981,14600.861,266.653,8.2,0.736,0
57,24,243,5543,5,265,1014,21284,93.52,10847904,222.873,27.6,6.981,14600.861,266.653,8.2,0.736,0
57,25,206,5749,2,267,1214,22498,93.52,10847904,222.873,27.6,6.981,14600.861,266.653,8.2,0.736,0
57,26,177,5926,6,273,987,23485,93.52,10847904,222.873,27.6,6.981,14600.861,266.653,8.2,0.736,0
57,27,209,6135,5,278,494,23979,93.52,10847904,222.873,27.6,6.981,14600.861,266.653,8.2,0.736,0
57,28,0,6135,0,278,1389,25368,97.22,10847904,222.873,27.6,6.981,14600.861,266.653,8.2,0.736,0
57,29,281,6416,8,286,1613,26981,97.22,10847904,222.873,27.6,6.981,14600.861,266.653,8.2,0.736,0
57,30,236,6652,7,293,1465,28446,97.22,10847904,222.873,27.6,6.981,14600.861,266.653,8.2,0.736,0
57,31,320,6972,8,301,1656,30102,97.22,10847904,222.873,27.6,6.981,14600.861,266.653,8.2,0.736,0
57,32,316,7288,12,313,1923,32025,97.22,10847904,222.873,27.6,6.981,14600.861,266.653,8.2,0.736,0
57,33,290,7578,13,326,1352,33377,97.22,10847904,222.873,27.6,6.981,14600.861,266.653,8.2,0.736,0
57,34,376,7954,7,333,959,34336,97.22,10847904,222.873,27.6,6.981,14600.861,266.653,8.2,0.736,0
57,35,281,8235,13,346,1004,35340,97.22,10847904,222.873,27.6,6.981,14600.861,266.653,8.2,0.736,0
57,36,245,8480,8,354,1619,36959,97.22,10847904,222.873,27.6,6.981,14600.861,266.653,8.2,0.736,0
57,37,327,8807,8,362,1584,38543,97.22,10847904,222.873,27.6,6.981,14600.861,266.653,8.2,0.736,0
57,38,288,9095,11,373,2048,40591,97.22,10847904,222.873,27.6,6.981,14600.861,266.653,8.2,0.736,0
57,39,281,9376,7,380,2024,42615,97.22,10847904,222.873,27.6,6.981,14600.861,266.653,8.2,0.736,0
57,40,506,9882,5,385,1672,44287,97.22,10847904,222.873,27.6,6.981,14600.861,266.653,8.2,0.736,0
57,41,465,10347,3,388,1038,45325,97.22,10847904,222.873,27.6,6.981,14600.861,266.653,8.2,0.736,0
57,42,287,10634,5,393,1792,47117,97.22,10847904,222.873,27.6,6.981,14600.861,266.653,8.2,0.736,0
57,43,266,10900,9,402,746,47863,97.22,10847904,222.873,27.6,6.981,14600.861,266.653,8.2,0.736,0
57,44,296,11196,7,409,2245,50108,97.22,10847904,222.873,27.6,6.981,14600.861,266.653,8.2,0.736,0
57,45,124,11320,13,422,2251,52359,97.22,10847904,222.873,27.6,6.981,14600.861,266.653,8.2,0.736,0
57,46,419,11739,2,424,921,53280,97.22,10847904,222.873,27.6,6.981,14600.861,266.653,8.2,0.736,0
57,47,154,11893,0,424,2189,55469,97.22,10847904,222.873,27.6,6.981,14600.861,266.653,8.2,0.736,0
57,48,421,12314,4,428,0,55469,93.52,10847904,222.873,27.6,6.981,14600.861,266.653,8.2,0.736,0
57,49,411,12725,6,434,0,59976,93.52,10847904,222.873,27.6,6.981,14600.861,266.653,8.2,0.736,0
57,50,498,13223,7,441,1354,61330,84.26,10847904,222.873,27.6,6.981,14600.861,266.653,8.2,0.736,0
57,51,254,13477,5,446,2189,63519,84.26,10847904,222.873,27.6,6.981,14600.861,266.653,8.2,0.736,0
57,52,180,13657,2,448,1836,65355,84.26,10847904,222.873,27.6,6.981,14600.861,266.653,8.2,0.736,0
57,53,332,13989,8,456,2585,67940,84.26,10847904,222.873,27.6,6.981,14600.861,266.653,8.2,0.736,0
57,54,433,14422,2,458,1668,69608,84.26,10847904,222.873,27.6,6.981,14600.861,266.653,8.2,0.736,0
57,55,0,14422,0,458,1364,70972,84.26,10847904,222.873,27.6,6.981,14600.861,266.653,8.2,0.736,0
57,56,651,15073,2,460,2149,73121,84.26,10847904,222.873,27.6,6.981,14600.861,266.653,8.2,0.736,0
57,57,191,15264,8,468,1491,74612,84.26,10847904,222.873,27.6,6.981,14600.861,266.653,8.2,0.736,0
57,58,459,15723,6,474,2318,76930,84.26,10847904,222.873,27.6,6.981,14600.861,266.653,8.2,0.736,0
57,59,345,16068,11,485,2242,79172,84.26,10847904,222.873,27.6,6.981,14600.861,266.653,8.2,0.736,0
57,60,463,16531,3,488,2475,81647,84.26,10847904,222.873,27.6,6.981,14600.861,266.653,8.2,0.736,0
57,61,377,16908,10,498,1797,83444,84.26,10847904,222.873,27.6,6.981,14600.861,266.653,8.2,0.736,0
57,62,377,17285,4,502,1194,84638,78.7,10847904,222.873,27.6,6.981,14600.861,266.653,8.2,0.736,0
57,63,287,17572,0,502,1647,86285,78.7,10847904,222.873,27.6,6.981,14600.861,266.653,8.2,0.736,0
57,64,180,17752,13,515,1771,88056,78.7,10847904,222.873,27.6,6.981,14600.861,266.653,8.2,0.736,0
57,65,288,18040,1,516,2085,90141,78.7,10847904,222.873,27.6,6.981,14600.861,266.653,8.2,0.736,0
57,66,279,18319,4,520,2079,92220,78.7,10847904,222.873,27.6,6.981,14600.861,266.653,8.2,0.736,0
57,67,389,18708,5,525,2291,94511,78.7,10847904,222.873,27.6,6.981,14600.861,266.653,8.2,0.736,0
57,68,487,19195,11,536,2529,97040,78.7,10847904,222.873,27.6,6.981,14600.861,266.653,8.2,0.736,0
57,69,405,19600,2,538,1060,98100,78.7,10847904,222.873,27.6,6.981,14600.861,266.653,8.2,0.736,0
57,70,526,20126,1,539,1935,100035,78.7,10847904,222.873,27.6,6.981,14600.861,266.653,8.2,0.736,0
57,71,289,20415,5,544,2465,102500,78.7,10847904,222.873,27.6,6.981,14600.861,266.653,8.2,0.736,0
57,72,393,20808,6,550,2516,105016,78.7,10847904,222.873,27.6,6.981,14600.861,266.653,8.2,0.736,0
57,73,629,21437,11,561,2159,107175,78.7,10847904,222.873,27.6,6.981,14600.861,266.653,8.2,0.736,0
57,74,571,22008,7,568,1847,109022,78.7,10847904,222.873,27.6,6.981,14600.861,266.653,8.2,0.736,0
57,75,564,22572,9,577,1759,110781,78.7,10847904,222.873,27.6,6.981,14600.861,266.653,8.2,0.736,0
57,76,390,22962,15,592,1822,112603,78.7,10847904,222.873,27.6,6.981,14600.861,266.653,8.2,0.736,0
57,77,309,23271,13,605,1932,114535,78.7,10847904,222.873,27.6,6.981,14600.861,266.653,8.2,0.736,0
57,78,415,23686,10,615,2584,117119,78.7,10847904,222.873,27.6,6.981,14600.861,266.653,8.2,0.736,0
57,79,419,24105,18,633,2200,119319,78.7,10847904,222.873,27.6,6.981,14600.861,266.653,8.2,0.736,0
57,80,540,24645,2,635,3327,122646,78.7,10847904,222.873,27.6,6.981,14600.861,266.653,8.2,0.736,0
57,81,423,25068,12,647,3222,125868,78.7,10847904,222.873,27.6,6.981,14600.861,266.653,8.2,0.736,0
57,82,710,25778,8,655,2907,128775,78.7,10847904,222.873,27.6,6.981,14600.861,266.653,8.2,0.736,0
57,83,899,26677,7,662,1970,130745,78.7,10847904,222.873,27.6,6.981,14600.861,266.653,8.2,0.736,0
57,84,693,27370,7,669,2973,133718,78.7,10847904,222.873,27.6,6.981,14600.861,266.653,8.2,0.736,0
57,85,566,27936,6,675,2251,135969,78.7,10847904,222.873,27.6,6.981,14600.861,266.653,8.2,0.736,0
57,86,695,28631,16,691,2729,138698,78.7,10847904,222.873,27.6,6.981,14600.861,266.653,8.2,0.736,0
57,87,510,29141,7,698,3642,142340,78.7,10847904,222.873,27.6,6.981,14600.861,266.653,8.2,0.736,0
57,88,623,29764,14,712,3720,146060,78.7,10847904,222.873,27.6,6.981,14600.861,266.653,8.2,0.736,0
57,89,855,30619,6,718,2148,148208,75,10847904,222.873,27.6,6.981,14600.861,266.653,8.2,0.736,0
57,90,754,31373,8,726,2711,150919,75,10847904,222.873,27.6,6.981,14600.861,266.653,8.2,0.736,0
57,91,443,31816,7,733,3210,154129,80.56,10847904,222.873,27.6,6.981,14600.861,266.653,8.2,0.736,0
57,92,752,32568,14,747,2916,157045,75,10847904,222.873,27.6,6.981,14600.861,266.653,8.2,0.736,0
57,93,819,33387,7,754,3496,160541,75,10847904,222.873,27.6,6.981,14600.861,266.653,8.2,0.736,0
57,94,810,34197,11,765,3186,163727,75,10847904,222.873,27.6,6.981,14600.861,266.653,8.2,0.736,0
57,95,951,35148,10,775,3645,167372,75,10847904,222.873,27.6,6.981,14600.861,266.653,8.2,0.736,0
57,96,1036,36184,11,786,2627,169999,75,10847904,222.873,27.6,6.981,14600.861,266.653,8.2,0.736,0
57,97,1241,37425,8,794,1098,171097,75,10847904,222.873,27.6,6.981,14600.861,266.653,8.2,0.736,0
57,98,703,38128,10,804,3654,174751,75,10847904,222.873,27.6,6.981,14600.861,266.653,8.2,0.736,0
57,99,302,38430,17,821,4087,178838,75,10847904,222.873,27.6,6.981,14600.861,266.653,8.2,0.736,0
57,100,1158,39588,8,829,3425,182263,75,10847904,222.873,27.6,6.981,14600.861,266.653,8.2,0.736,0
57,101,1202,40790,13,842,3590,185853,75,10847904,222.873,27.6,6.981,14600.861,266.653,8.2,0.736,0
57,102,1125,41915,22,864,3538,189391,75,10847904,222.873,27.6,6.981,14600.861,266.653,8.2,0.736,0
57,103,1199,43114,16,880,2969,192360,75,10847904,222.873,27.6,6.981,14600.861,266.653,8.2,0.736,0
57,104,1418,44532,17,897,2101,194461,75,10847904,222.873,27.6,6.981,14600.861,266.653,8.2,0.736,0
57,105,974,45506,6,903,4035,198496,75,10847904,222.873,27.6,6.981,14600.861,266.653,8.2,0.736,0
57,106,799,46305,7,910,3173,201669,75,10847904,222.873,27.6,6.981,14600.861,266.653,8.2,0.736,0
57,107,1366,47671,19,929,3769,205438,75,10847904,222.873,27.6,6.981,14600.861,266.653,8.2,0.736,0
57,108,1072,48743,12,941,3814,209252,75,10847904,222.873,27.6,6.981,14600.861,266.653,8.2,0.736,0
57,109,1370,50113,1,942,3833,213085,75,10847904,222.873,27.6,6.981,14600.861,266.653,8.2,0.736,0
57,110,1406,51519,29,971,3396,216481,75,10847904,222.873,27.6,6.981,14600.861,266.653,8.2,0.736,0
57,111,1336,52855,10,981,2345,218826,78.7,10847904,222.873,27.6,6.981,14600.861,266.653,8.2,0.736,0
57,112,1101,53956,12,993,3760,222586,78.7,10847904,222.873,27.6,6.981,14600.861,266.653,8.2,0.736,0
57,113,841,54797,6,999,4107,226693,78.7,10847904,222.873,27.6,6.981,14600.861,266.653,8.2,0.736,0
57,114,1246,56043,6,1005,3961,230654,78.7,10847904,222.873,27.6,6.981,14600.861,266.653,8.2,0.736,0
57,115,1572,57615,1,1006,4635,235289,78.7,10847904,222.873,27.6,6.981,14600.861,266.653,8.2,0.736,0
57,116,1462,59077,30,1036,5487,240776,78.7,10847904,222.873,27.6,6.981,14600.861,266.653,8.2,0.736,0
57,117,1819,60896,19,1055,3867,244643,78.7,10847904,222.873,27.6,6.981,14600.861,266.653,8.2,0.736,0
57,118,2012,62908,8,1063,2310,246953,78.7,10847904,222.873,27.6,6.981,14600.861,266.653,8.2,0.736,0
57,119,1248,64156,20,1083,3471,250424,78.7,10847904,222.873,27.6,6.981,14600.861,266.653,8.2,0.736,0
57,120,534,64690,18,1101,0,250424,78.7,10847904,222.873,27.6,6.981,14600.861,266.653,8.2,0.736,0
57,121,1492,66182,22,1123,0,250424,78.7,10847904,222.873,27.6,6.981,14600.861,266.653,8.2,0.736,0
57,122,1733,67915,23,1146,0,250424,78.7,10847904,222.873,27.6,6.981,14600.861,266.653,8.2,0.736,0
57,123,1734,69649,14,1160,0,266844,78.7,10847904,222.873,27.6,6.981,14600.861,266.653,8.2,0.736,0
57,124,1766,71415,10,1170,1685,268529,78.7,10847904,222.873,27.6,6.981,14600.861,266.653,8.2,0.736,0
57,125,828,72243,8,1178,5172,273701,78.7,10847904,222.873,27.6,6.981,14600.861,266.653,8.2,0.736,0
57,126,874,73117,5,1183,4734,278435,78.7,10847904,222.873,27.6,6.981,14600.861,266.653,8.2,0.736,0
57,127,1178,74295,30,1213,3491,281926,78.7,10847904,222.873,27.6,6.981,14600.861,266.653,8.2,0.736,0
57,128,1365,75660,9,1222,4202,286128,78.7,10847904,222.873,27.6,6.981,14600.861,266.653,8.2,0.736,0
57,129,876,76536,24,1246,4139,290267,78.7,10847904,222.873,27.6,6.981,14600.861,266.653,8.2,0.736,0
57,130,1173,77709,13,1259,3772,294039,78.7,10847904,222.873,27.6,6.981,14600.861,266.653,8.2,0.736,0
57,131,1069,78778,30,1289,3453,297492,78.7,10847904,222.873,27.6,6.981,14600.861,266.653,8.2,0.736,0
57,132,954,79732,20,1309,2642,300134,78.7,10847904,222.873,27.6,6.981,14600.861,266.653,8.2,0.736,0
57,133,767,80499,19,1328,4367,304501,78.7,10847904,222.873,27.6,6.981,14600.861,266.653,8.2,0.736,0
57,134,595,81094,18,1346,3686,308187,78.7,10847904,222.873,27.6,6.981,14600.861,266.653,8.2,0.736,0
57,135,1130,82224,25,1371,5104,313291,78.7,10847904,222.873,27.6,6.981,14600.861,266.653,8.2,0.736,0
57,136,910,83134,22,1393,4352,317643,78.7,10847904,222.873,27.6,6.981,14600.861,266.653,8.2,0.736,0
57,137,1354,84488,16,1409,4413,322056,78.7,10847904,222.873,27.6,6.981,14600.861,266.653,8.2,0.736,0
57,138,1057,85545,29,1438,2407,324463,78.7,10847904,222.873,27.6,6.981,14600.861,266.653,8.2,0.736,0
57,139,764,86309,15,1453,2181,326644,78.7,10847904,222.873,27.6,6.981,14600.861,266.653,8.2,0.736,0
57,140,428,86737,28,1481,4516,331160,78.7,10847904,222.873,27.6,6.981,14600.861,266.653,8.2,0.736,0
57,141,386,87123,8,1489,4318,335478,78.7,10847904,222.873,27.6,6.981,14600.861,266.653,8.2,0.736,0
57,142,1004,88127,12,1501,4382,339860,78.7,10847904,222.873,27.6,6.981,14600.861,266.653,8.2,0.736,0
57,143,883,89010,4,1505,3936,343796,78.7,10847904,222.873,27.6,6.981,14600.861,266.653,8.2,0.736,0
57,144,857,89867,28,1533,3467,347263,75.93,10847904,222.873,27.6,6.981,14600.861,266.653,8.2,0.736,0
57,145,694,90561,21,1554,2770,350033,75.93,10847904,222.873,27.6,6.981,14600.861,266.653,8.2,0.736,0
57,146,600,91161,13,1567,3221,353254,75.93,10847904,222.873,27.6,6.981,14600.861,266.653,8.2,0.736,0
57,147,447,91608,6,1573,2585,355839,75.93,10847904,222.873,27.6,6.981,14600.861,266.653,8.2,0.736,0
57,148,609,92217,12,1585,2694,358533,75.93,10847904,222.873,27.6,6.981,14600.861,266.653,8.2,0.736,0
57,149,340,92557,28,1613,2466,360999,75.93,10847904,222.873,27.6,6.981,14600.861,266.653,8.2,0.736,0
57,150,407,92964,17,1630,2808,363807,75.93,10847904,222.873,27.6,6.981,14600.861,266.653,8.2,0.736,0
57,151,426,93390,18,1648,3339,367146,75.93,10847904,222.873,27.6,6.981,14600.861,266.653,8.2,0.736,0
57,152,342,93732,25,1673,3729,370875,75.93,10847904,222.873,27.6,6.981,14600.861,266.653,8.2,0.736,0
57,153,509,94241,8,1681,2126,373001,75.93,10847904,222.873,27.6,6.981,14600.861,266.653,8.2,0.736,0
57,154,474,94715,29,1710,3120,376121,75.93,10847904,222.873,27.6,6.981,14600.861,266.653,8.2,0.736,0
57,155,264,94979,28,1738,3808,379929,75.93,10847904,222.873,27.6,6.981,14600.861,266.653,8.2,0.736,0
57,156,648,95627,27,1765,6192,386121,75.93,10847904,222.873,27.6,6.981,14600.861,266.653,8.2,0.736,0
57,157,1002,96629,36,1801,5069,391190,75.93,10847904,222.873,27.6,6.981,14600.861,266.653,8.2,0.736,0
57,158,0,96629,0,1801,3601,394791,75.93,10847904,222.873,27.6,6.981,14600.861,266.653,8.2,0.736,0
57,159,2147,98776,39,1840,2854,397645,75.93,10847904,222.873,27.6,6.981,14600.861,266.653,8.2,0.736,0
57,160,557,99333,5,1845,2493,400138,75.93,10847904,222.873,27.6,6.981,14600.861,266.653,8.2,0.736,0
57,161,565,99898,19,1864,3617,403755,75.93,10847904,222.873,27.6,6.981,14600.861,266.653,8.2,0.736,0
57,162,233,100131,25,1889,4259,408014,75.93,10847904,222.873,27.6,6.981,14600.861,266.653,8.2,0.736,0
57,163,806,100937,25,1914,3650,411664,75.93,10847904,222.873,27.6,6.981,14600.861,266.653,8.2,0.736,0
57,164,779,101716,12,1926,0,411664,75.93,10847904,222.873,27.6,6.981,14600.861,266.653,8.2,0.736,0
57,165,516,102232,15,1941,0,419327,75.93,10847904,222.873,27.6,6.981,14600.861,266.653,8.2,0.736,0
57,166,860,103092,12,1953,2743,422070,75.93,10847904,222.873,27.6,6.981,14600.861,266.653,8.2,0.736,0
57,167,568,103660,15,1968,3432,425502,75.93,10847904,222.873,27.6,6.981,14600.861,266.653,8.2,0.736,0
57,168,450,104110,16,1984,3921,429423,75.93,10847904,222.873,27.6,6.981,14600.861,266.653,8.2,0.736,0
57,169,693,104803,14,1998,4425,433848,75.93,10847904,222.873,27.6,6.981,14600.861,266.653,8.2,0.736,0
57,170,718,105521,11,2009,3469,437317,75.93,10847904,222.873,27.6,6.981,14600.861,266.653,8.2,0.736,0
57,171,615,106136,13,2022,5037,442354,75.93,10847904,222.873,27.6,6.981,14600.861,266.653,8.2,0.736,0
57,172,596,106732,12,2034,3885,446239,75.93,10847904,222.873,27.6,6.981,14600.861,266.653,8.2,0.736,0
57,173,968,107700,10,2044,3350,449589,75.93,10847904,222.873,27.6,6.981,14600.861,266.653,8.2,0.736,0
57,174,589,108289,3,2047,2599,452188,75.93,10847904,222.873,27.6,6.981,14600.861,266.653,8.2,0.736,0
57,175,494,108783,7,2054,0,452188,75.93,10847904,222.873,27.6,6.981,14600.861,266.653,8.2,0.736,0
57,176,486,109269,10,2064,0,458581,75.93,10847904,222.873,27.6,6.981,14600.861,266.653,8.2,0.736,0
57,177,468,109737,10,2074,0,458581,75.93,10847904,222.873,27.6,6.981,14600.861,266.653,8.2,0.736,0
57,178,385,110122,2,2076,0,465821,75.93,10847904,222.873,27.6,6.981,14600.861,266.653,8.2,0.736,0
57,179,475,110597,11,2087,4440,470261,75.93,10847904,222.873,27.6,6.981,14600.861,266.653,8.2,0.736,0
57,180,360,110957,6,2093,2160,472421,75.93,10847904,222.873,27.6,6.981,14600.861,266.653,8.2,0.736,0
57,181,429,111386,2,2095,0,472421,75.93,10847904,222.873,27.6,6.981,14600.861,266.653,8.2,0.736,0
57,182,280,111666,3,2098,0,477407,75.93,10847904,222.873,27.6,6.981,14600.861,266.653,8.2,0.736,0
57,183,234,111900,3,2101,3595,481002,75.93,10847904,222.873,27.6,6.981,14600.861,266.653,8.2,0.736,0
57,184,309,112209,4,2105,0,481002,75.93,10847904,222.873,27.6,6.981,14600.861,266.653,8.2,0.736,0
57,185,519,112728,3,2108,0,488732,75.93,10847904,222.873,27.6,6.981,14600.861,266.653,8.2,0.736,0
57,186,622,113350,9,2117,4359,493091,75.93,10847904,222.873,27.6,6.981,14600.861,266.653,8.2,0.736,0
57,187,576,113926,11,2128,0,493091,75.93,10847904,222.873,27.6,6.981,14600.861,266.653,8.2,0.736,0
57,188,554,114480,6,2134,0,498081,75.93,10847904,222.873,27.6,6.981,14600.861,266.653,8.2,0.736,0
57,189,574,115054,10,2144,4599,502680,75.93,10847904,222.873,27.6,6.981,14600.861,266.653,8.2,0.736,0
57,190,317,115371,5,2149,3738,506418,64.81,10847904,222.873,27.6,6.981,14600.861,266.653,8.2,0.736,0
57,191,777,116148,10,2159,0,506418,64.81,10847904,222.873,27.6,6.981,14600.861,266.653,8.2,0.736,0
57,192,724,116872,4,2163,0,506418,64.81,10847904,222.873,27.6,6.981,14600.861,266.653,8.2,0.736,0
57,193,585,117457,2,2165,0,519366,64.81,10847904,222.873,27.6,6.981,14600.861,266.653,8.2,0.736,0
57,194,557,118014,2,2167,0,519366,64.81,10847904,222.873,27.6,6.981,14600.861,266.653,8.2,0.736,0
57,195,463,118477,6,2173,0,523637,64.81,10847904,222.873,27.6,6.981,14600.861,266.653,8.2,0.736,0
57,196,366,118843,6,2179,5350,528987,64.81,10847904,222.873,27.6,6.981,14600.861,266.653,8.2,0.736,0
57,197,165,119008,4,2183,2679,531666,64.81,10847904,222.873,27.6,6.981,14600.861,266.653,8.2,0.736,0
57,198,654,119662,3,2186,0,531666,64.81,10847904,222.873,27.6,6.981,14600.861,266.653,8.2,0.736,0
57,199,404,120066,3,2189,0,539053,64.81,10847904,222.873,27.6,6.981,14600.861,266.653,8.2,0.736,0
57,200,384,120450,3,2192,3174,542227,64.81,10847904,222.873,27.6,6.981,14600.861,266.653,8.2,0.736,0
57,201,475,120925,3,2195,0,542227,64.81,10847904,222.873,27.6,6.981,14600.861,266.653,8.2,0.736,0
57,202,422,121347,4,2199,0,542227,64.81,10847904,222.873,27.6,6.981,14600.861,266.653,8.2,0.736,0
57,203,320,121667,4,2203,0,542227,64.81,10847904,222.873,27.6,6.981,14600.861,266.653,8.2,0.736,0
57,204,306,121973,1,2204,0,542227,64.81,10847904,222.873,27.6,6.981,14600.861,266.653,8.2,0.736,0
58,1,336,2302,17,79,763,5591,93.52,17643060,66.939,28.1,7.104,10581.936,140.448,5.55,0.752,0
58,2,456,2758,41,120,711,6302,93.52,17643060,66.939,28.1,7.104,10581.936,140.448,5.55,0.752,0
58,3,405,3163,0,120,354,6656,93.52,17643060,66.939,28.1,7.104,10581.936,140.448,5.55,0.752,0
58,4,205,3368,25,145,178,6834,93.52,17643060,66.939,28.1,7.104,10581.936,140.448,5.55,0.752,0
58,5,97,3465,27,172,415,7249,93.52,17643060,66.939,28.1,7.104,10581.936,140.448,5.55,0.752,0
58,6,181,3646,8,180,341,7590,93.52,17643060,66.939,28.1,7.104,10581.936,140.448,5.55,0.752,0
58,7,101,3747,11,191,361,7951,93.52,17643060,66.939,28.1,7.104,10581.936,140.448,5.55,0.752,0
58,8,248,3995,29,220,707,8658,93.52,17643060,66.939,28.1,7.104,10581.936,140.448,5.55,0.752,0
58,9,455,4450,22,242,981,9639,93.52,17643060,66.939,28.1,7.104,10581.936,140.448,5.55,0.752,0
58,10,515,4965,30,272,4018,13657,93.52,17643060,66.939,28.1,7.104,10581.936,140.448,5.55,0.752,0
58,11,2196,7161,25,297,544,14201,93.52,17643060,66.939,28.1,7.104,10581.936,140.448,5.55,0.752,0
58,12,96,7257,18,315,383,14584,93.52,17643060,66.939,28.1,7.104,10581.936,140.448,5.55,0.752,0
58,13,209,7466,18,333,242,14826,93.52,17643060,66.939,28.1,7.104,10581.936,140.448,5.55,0.752,0
58,14,63,7529,22,355,272,15098,93.52,17643060,66.939,28.1,7.104,10581.936,140.448,5.55,0.752,0
58,15,74,7603,0,355,516,15614,93.52,17643060,66.939,28.1,7.104,10581.936,140.448,5.55,0.752,0
58,16,255,7858,33,388,523,16137,93.52,17643060,66.939,28.1,7.104,10581.936,140.448,5.55,0.752,0
58,17,367,8225,15,403,388,16525,93.52,17643060,66.939,28.1,7.104,10581.936,140.448,5.55,0.752,0
58,18,225,8450,18,421,988,17513,93.52,17643060,66.939,28.1,7.104,10581.936,140.448,5.55,0.752,0
58,19,572,9022,35,456,920,18433,93.52,17643060,66.939,28.1,7.104,10581.936,140.448,5.55,0.752,0
58,20,446,9468,18,474,1427,19860,93.52,17643060,66.939,28.1,7.104,10581.936,140.448,5.55,0.752,0
58,21,660,10128,33,507,620,20480,93.52,17643060,66.939,28.1,7.104,10581.936,140.448,5.55,0.752,0
58,22,270,10398,13,520,1127,21607,93.52,17643060,66.939,28.1,7.104,10581.936,140.448,5.55,0.752,0
58,23,452,10850,17,537,1776,23383,93.52,17643060,66.939,28.1,7.104,10581.936,140.448,5.55,0.752,0
58,24,333,11183,23,560,0,23383,93.52,17643060,66.939,28.1,7.104,10581.936,140.448,5.55,0.752,0
58,25,0,11183,16,576,0,23383,93.52,17643060,66.939,28.1,7.104,10581.936,140.448,5.55,0.752,0
58,26,0,11183,0,576,0,23383,93.52,17643060,66.939,28.1,7.104,10581.936,140.448,5.55,0.752,0
58,27,11536,22719,0,576,0,31134,93.52,17643060,66.939,28.1,7.104,10581.936,140.448,5.55,0.752,0
58,28,521,23240,87,663,1326,32460,93.52,17643060,66.939,28.1,7.104,10581.936,140.448,5.55,0.752,0
58,29,1018,24258,208,871,1224,33684,93.52,17643060,66.939,28.1,7.104,10581.936,140.448,5.55,0.752,0
58,30,417,24675,12,883,663,34347,93.52,17643060,66.939,28.1,7.104,10581.936,140.448,5.55,0.752,0
58,31,259,24934,17,900,2714,37061,93.52,17643060,66.939,28.1,7.104,10581.936,140.448,5.55,0.752,0
58,32,1402,26336,163,1063,1863,38924,93.52,17643060,66.939,28.1,7.104,10581.936,140.448,5.55,0.752,0
58,33,1128,27464,308,1371,4803,43727,93.52,17643060,66.939,28.1,7.104,10581.936,140.448,5.55,0.752,0
58,34,2074,29538,193,1564,2533,46260,86.11,17643060,66.939,28.1,7.104,10581.936,140.448,5.55,0.752,0
58,35,2343,31881,5,1569,0,46260,86.11,17643060,66.939,28.1,7.104,10581.936,140.448,5.55,0.752,0
58,36,0,31881,0,1569,0,42870,86.11,17643060,66.939,28.1,7.104,10581.936,140.448,5.55,0.752,0
58,37,-2461,29420,49,1618,1503,44373,86.11,17643060,66.939,28.1,7.104,10581.936,140.448,5.55,0.752,0
58,38,878,30298,36,1654,-3743,40630,86.11,17643060,66.939,28.1,7.104,10581.936,140.448,5.55,0.752,0
58,39,-1480,28818,50,1704,871,41501,86.11,17643060,66.939,28.1,7.104,10581.936,140.448,5.55,0.752,0
58,40,253,29071,13,1717,1814,43315,86.11,17643060,66.939,28.1,7.104,10581.936,140.448,5.55,0.752,0
58,41,488,29559,410,2127,-1377,41938,86.11,17643060,66.939,28.1,7.104,10581.936,140.448,5.55,0.752,0
58,42,-50,29509,18,2145,2250,44188,86.11,17643060,66.939,28.1,7.104,10581.936,140.448,5.55,0.752,0
58,43,910,30419,182,2327,97,44285,86.11,17643060,66.939,28.1,7.104,10581.936,140.448,5.55,0.752,0
58,44,67,30486,7,2334,64,44349,86.11,17643060,66.939,28.1,7.104,10581.936,140.448,5.55,0.752,0
58,45,16,30502,4,2338,3532,47881,86.11,17643060,66.939,28.1,7.104,10581.936,140.448,5.55,0.752,0
58,46,965,31467,256,2594,2139,50020,86.11,17643060,66.939,28.1,7.104,10581.936,140.448,5.55,0.752,0
58,47,1296,32763,94,2688,1375,51395,86.11,17643060,66.939,28.1,7.104,10581.936,140.448,5.55,0.752,0
58,48,419,33182,48,2736,1317,52712,86.11,17643060,66.939,28.1,7.104,10581.936,140.448,5.55,0.752,0
58,49,400,33582,63,2799,1101,53813,86.11,17643060,66.939,28.1,7.104,10581.936,140.448,5.55,0.752,0
58,50,569,34151,40,2839,1571,55384,86.11,17643060,66.939,28.1,7.104,10581.936,140.448,5.55,0.752,0
58,51,703,34854,49,2888,1742,57126,86.11,17643060,66.939,28.1,7.104,10581.936,140.448,5.55,0.752,0
58,52,452,35306,51,2939,2409,59535,86.11,17643060,66.939,28.1,7.104,10581.936,140.448,5.55,0.752,0
58,53,522,35828,117,3056,1161,60696,86.11,17643060,66.939,28.1,7.104,10581.936,140.448,5.55,0.752,0
58,54,430,36258,40,3096,1231,61927,86.11,17643060,66.939,28.1,7.104,10581.936,140.448,5.55,0.752,0
58,55,498,36756,12,3108,2268,64195,86.11,17643060,66.939,28.1,7.104,10581.936,140.448,5.55,0.752,0
58,56,599,37355,95,3203,582,64777,86.11,17643060,66.939,28.1,7.104,10581.936,140.448,5.55,0.752,0
58,57,0,37355,0,3203,1583,66360,86.11,17643060,66.939,28.1,7.104,10581.936,140.448,5.55,0.752,0
58,58,748,38103,72,3275,779,67139,86.11,17643060,66.939,28.1,7.104,10581.936,140.448,5.55,0.752,0
58,59,368,38471,38,3313,579,67718,86.11,17643060,66.939,28.1,7.104,10581.936,140.448,5.55,0.752,0
58,60,100,38571,21,3334,513,68231,86.11,17643060,66.939,28.1,7.104,10581.936,140.448,5.55,0.752,0
58,61,0,38571,0,3334,757,68988,86.11,17643060,66.939,28.1,7.104,10581.936,140.448,5.55,0.752,0
58,62,527,39098,24,3358,2434,71422,77.78,17643060,66.939,28.1,7.104,10581.936,140.448,5.55,0.752,0
58,63,896,39994,36,3394,1347,72769,77.78,17643060,66.939,28.1,7.104,10581.936,140.448,5.55,0.752,0
58,64,420,40414,44,3438,1959,74728,77.78,17643060,66.939,28.1,7.104,10581.936,140.448,5.55,0.752,0
58,65,552,40966,48,3486,1415,76143,77.78,17643060,66.939,28.1,7.104,10581.936,140.448,5.55,0.752,0
58,66,0,40966,0,3486,2136,78279,77.78,17643060,66.939,28.1,7.104,10581.936,140.448,5.55,0.752,0
58,67,609,41575,48,3534,844,79123,77.78,17643060,66.939,28.1,7.104,10581.936,140.448,5.55,0.752,0
58,68,1153,42728,74,3608,1253,80376,77.78,17643060,66.939,28.1,7.104,10581.936,140.448,5.55,0.752,0
58,69,392,43120,13,3621,420,80796,77.78,17643060,66.939,28.1,7.104,10581.936,140.448,5.55,0.752,0
58,70,258,43378,21,3642,1483,82279,77.78,17643060,66.939,28.1,7.104,10581.936,140.448,5.55,0.752,0
58,71,539,43917,48,3690,1121,83400,77.78,17643060,66.939,28.1,7.104,10581.936,140.448,5.55,0.752,0
58,72,523,44440,30,3720,2192,85592,77.78,17643060,66.939,28.1,7.104,10581.936,140.448,5.55,0.752,0
58,73,0,44440,0,3720,1969,87561,77.78,17643060,66.939,28.1,7.104,10581.936,140.448,5.55,0.752,0
58,74,1338,45778,108,3828,1385,88946,77.78,17643060,66.939,28.1,7.104,10581.936,140.448,5.55,0.752,0
58,75,578,46356,46,3874,896,89842,77.78,17643060,66.939,28.1,7.104,10581.936,140.448,5.55,0.752,0
58,76,395,46751,22,3896,1259,91101,77.78,17643060,66.939,28.1,7.104,10581.936,140.448,5.55,0.752,0
58,77,571,47322,33,3929,1863,92964,77.78,17643060,66.939,28.1,7.104,10581.936,140.448,5.55,0.752,0
58,78,621,47943,41,3970,1262,94226,77.78,17643060,66.939,28.1,7.104,10581.936,140.448,5.55,0.752,0
58,79,547,48490,37,4007,1470,95696,77.78,17643060,66.939,28.1,7.104,10581.936,140.448,5.55,0.752,0
58,80,607,49097,80,4087,1879,97575,74.07,17643060,66.939,28.1,7.104,10581.936,140.448,5.55,0.752,0
58,81,634,49731,69,4156,1466,99041,74.07,17643060,66.939,28.1,7.104,10581.936,140.448,5.55,0.752,0
58,82,452,50183,43,4199,1227,100268,74.07,17643060,66.939,28.1,7.104,10581.936,140.448,5.55,0.752,0
58,83,457,50640,24,4223,488,100756,74.07,17643060,66.939,28.1,7.104,10581.936,140.448,5.55,0.752,0
58,84,0,50640,0,4223,2099,102855,74.07,17643060,66.939,28.1,7.104,10581.936,140.448,5.55,0.752,0
58,85,1003,51643,51,4274,1717,104572,74.07,17643060,66.939,28.1,7.104,10581.936,140.448,5.55,0.752,0
58,86,691,52334,35,4309,1904,106476,74.07,17643060,66.939,28.1,7.104,10581.936,140.448,5.55,0.752,0
58,87,822,53156,34,4343,1995,108471,74.07,17643060,66.939,28.1,7.104,10581.936,140.448,5.55,0.752,0
58,88,700,53856,63,4406,1468,109939,74.07,17643060,66.939,28.1,7.104,10581.936,140.448,5.55,0.752,0
58,89,718,54574,18,4424,1584,111523,74.07,17643060,66.939,28.1,7.104,10581.936,140.448,5.55,0.752,0
58,90,681,55255,5,4429,1322,112845,74.07,17643060,66.939,28.1,7.104,10581.936,140.448,5.55,0.752,0
58,91,410,55665,73,4502,2065,114910,74.07,17643060,66.939,28.1,7.104,10581.936,140.448,5.55,0.752,0
58,92,767,56432,25,4527,2693,117603,74.07,17643060,66.939,28.1,7.104,10581.936,140.448,5.55,0.752,0
58,93,1825,58257,49,4576,2743,120346,74.07,17643060,66.939,28.1,7.104,10581.936,140.448,5.55,0.752,0
58,94,1211,59468,63,4639,2285,122631,74.07,17643060,66.939,28.1,7.104,10581.936,140.448,5.55,0.752,0
58,95,1189,60657,61,4700,2104,124735,74.07,17643060,66.939,28.1,7.104,10581.936,140.448,5.55,0.752,0
58,96,878,61535,69,4769,999,125734,74.07,17643060,66.939,28.1,7.104,10581.936,140.448,5.55,0.752,0
58,97,423,61958,12,4781,965,126699,74.07,17643060,66.939,28.1,7.104,10581.936,140.448,5.55,0.752,0
58,98,422,62380,40,4821,2126,128825,74.07,17643060,66.939,28.1,7.104,10581.936,140.448,5.55,0.752,0
58,99,865,63245,52,4873,2397,131222,74.07,17643060,66.939,28.1,7.104,10581.936,140.448,5.55,0.752,0
58,100,976,64221,27,4900,1985,133207,74.07,17643060,66.939,28.1,7.104,10581.936,140.448,5.55,0.752,0
58,101,797,65018,39,4939,1604,134811,74.07,17643060,66.939,28.1,7.104,10581.936,140.448,5.55,0.752,0
58,102,783,65801,44,4983,2608,137419,74.07,17643060,66.939,28.1,7.104,10581.936,140.448,5.55,0.752,0
58,103,1408,67209,48,5031,1852,139271,74.07,17643060,66.939,28.1,7.104,10581.936,140.448,5.55,0.752,0
58,104,661,67870,16,5047,1331,140602,74.07,17643060,66.939,28.1,7.104,10581.936,140.448,5.55,0.752,0
58,105,589,68459,16,5063,2388,142990,74.07,17643060,66.939,28.1,7.104,10581.936,140.448,5.55,0.752,0
58,106,1111,69570,67,5130,2217,145207,74.07,17643060,66.939,28.1,7.104,10581.936,140.448,5.55,0.752,0
58,107,759,70329,28,5158,2786,147993,74.07,17643060,66.939,28.1,7.104,10581.936,140.448,5.55,0.752,0
58,108,1036,71365,49,5207,2368,150361,74.07,17643060,66.939,28.1,7.104,10581.936,140.448,5.55,0.752,0
58,109,1079,72444,43,5250,2087,152448,74.07,17643060,66.939,28.1,7.104,10581.936,140.448,5.55,0.752,0
58,110,938,73382,32,5282,1702,154150,74.07,17643060,66.939,28.1,7.104,10581.936,140.448,5.55,0.752,0
58,111,631,74013,31,5313,1618,155768,74.07,17643060,66.939,28.1,7.104,10581.936,140.448,5.55,0.752,0
58,112,607,74620,5,5318,3384,159152,74.07,17643060,66.939,28.1,7.104,10581.936,140.448,5.55,0.752,0
58,113,1597,76217,48,5366,2291,161443,74.07,17643060,66.939,28.1,7.104,10581.936,140.448,5.55,0.752,0
58,114,1040,77257,52,5418,2155,163598,75.46,17643060,66.939,28.1,7.104,10581.936,140.448,5.55,0.752,0
58,115,891,78148,21,5439,2114,165712,72.69,17643060,66.939,28.1,7.104,10581.936,140.448,5.55,0.752,0
58,116,901,79049,29,5468,2070,167782,72.69,17643060,66.939,28.1,7.104,10581.936,140.448,5.55,0.752,0
58,117,987,80036,39,5507,1823,169605,72.69,17643060,66.939,28.1,7.104,10581.936,140.448,5.55,0.752,0
58,118,658,80694,8,5515,1126,170731,72.69,17643060,66.939,28.1,7.104,10581.936,140.448,5.55,0.752,0
58,119,467,81161,17,5532,3364,174095,72.69,17643060,66.939,28.1,7.104,10581.936,140.448,5.55,0.752,0
58,120,1118,82279,52,5584,2113,176208,72.69,17643060,66.939,28.1,7.104,10581.936,140.448,5.55,0.752,0
58,121,914,83193,39,5623,2885,179093,72.69,17643060,66.939,28.1,7.104,10581.936,140.448,5.55,0.752,0
58,122,1177,84370,34,5657,2501,181594,72.69,17643060,66.939,28.1,7.104,10581.936,140.448,5.55,0.752,0
58,123,985,85355,45,5702,2451,184045,70.83,17643060,66.939,28.1,7.104,10581.936,140.448,5.55,0.752,0
58,124,877,86232,34,5736,878,184923,70.83,17643060,66.939,28.1,7.104,10581.936,140.448,5.55,0.752,0
58,125,292,86524,14,5750,1413,186336,70.83,17643060,66.939,28.1,7.104,10581.936,140.448,5.55,0.752,0
58,126,517,87041,17,5767,2095,188431,70.83,17643060,66.939,28.1,7.104,10581.936,140.448,5.55,0.752,0
58,127,922,87963,41,5808,2156,190587,70.83,17643060,66.939,28.1,7.104,10581.936,140.448,5.55,0.752,0
58,128,903,88866,39,5847,3762,194349,70.83,17643060,66.939,28.1,7.104,10581.936,140.448,5.55,0.752,0
58,129,1671,90537,40,5887,3508,197857,70.83,17643060,66.939,28.1,7.104,10581.936,140.448,5.55,0.752,0
58,130,1432,91969,10,5897,4537,202394,70.83,17643060,66.939,28.1,7.104,10581.936,140.448,5.55,0.752,0
58,131,1603,93572,19,5916,2335,204729,70.83,17643060,66.939,28.1,7.104,10581.936,140.448,5.55,0.752,0
58,132,887,94459,6,5922,635,205364,70.83,17643060,66.939,28.1,7.104,10581.936,140.448,5.55,0.752,0
58,133,242,94701,10,5932,2172,207536,70.83,17643060,66.939,28.1,7.104,10581.936,140.448,5.55,0.752,0
58,134,862,95563,19,5951,3656,211192,70.83,17643060,66.939,28.1,7.104,10581.936,140.448,5.55,0.752,0
58,135,1547,97110,33,5984,3285,214477,70.83,17643060,66.939,28.1,7.104,10581.936,140.448,5.55,0.752,0
58,136,1233,98343,26,6010,2997,217474,70.83,17643060,66.939,28.1,7.104,10581.936,140.448,5.55,0.752,0
58,137,1066,99409,20,6030,3689,221163,70.83,17643060,66.939,28.1,7.104,10581.936,140.448,5.55,0.752,0
58,138,1279,100688,35,6065,2679,223842,70.83,17643060,66.939,28.1,7.104,10581.936,140.448,5.55,0.752,0
58,139,854,101542,5,6070,993,224835,70.83,17643060,66.939,28.1,7.104,10581.936,140.448,5.55,0.752,0
58,140,209,101751,13,6083,3203,228038,70.83,17643060,66.939,28.1,7.104,10581.936,140.448,5.55,0.752,0
58,141,1190,102941,22,6105,3845,231883,70.83,17643060,66.939,28.1,7.104,10581.936,140.448,5.55,0.752,0
58,142,1534,104475,41,6146,3518,235401,70.83,17643060,66.939,28.1,7.104,10581.936,140.448,5.55,0.752,0
58,143,1033,105508,54,6200,2757,238158,70.83,17643060,66.939,28.1,7.104,10581.936,140.448,5.55,0.752,0
58,144,973,106481,48,6248,1608,239766,70.83,17643060,66.939,28.1,7.104,10581.936,140.448,5.55,0.752,0
58,145,608,107089,29,6277,2348,242114,70.83,17643060,66.939,28.1,7.104,10581.936,140.448,5.55,0.752,0
58,146,680,107769,33,6310,1323,243437,70.83,17643060,66.939,28.1,7.104,10581.936,140.448,5.55,0.752,0
58,147,520,108289,12,6322,2546,245983,70.83,17643060,66.939,28.1,7.104,10581.936,140.448,5.55,0.752,0
58,148,741,109030,46,6368,3469,249452,70.83,17643060,66.939,28.1,7.104,10581.936,140.448,5.55,0.752,0
58,149,1519,110549,42,6410,2080,251532,70.83,17643060,66.939,28.1,7.104,10581.936,140.448,5.55,0.752,0
58,150,670,111219,61,6471,2444,253976,70.83,17643060,66.939,28.1,7.104,10581.936,140.448,5.55,0.752,0
58,151,922,112141,33,6504,2236,256212,70.83,17643060,66.939,28.1,7.104,10581.936,140.448,5.55,0.752,0
58,152,765,112906,33,6537,2054,258266,70.83,17643060,66.939,28.1,7.104,10581.936,140.448,5.55,0.752,0
58,153,742,113648,18,6555,627,258893,70.83,17643060,66.939,28.1,7.104,10581.936,140.448,5.55,0.752,0
58,154,119,113767,1,6556,1520,260413,70.83,17643060,66.939,28.1,7.104,10581.936,140.448,5.55,0.752,0
58,155,542,114309,15,6571,2828,263241,70.83,17643060,66.939,28.1,7.104,10581.936,140.448,5.55,0.752,0
58,156,1148,115457,48,6619,2399,265640,70.83,17643060,66.939,28.1,7.104,10581.936,140.448,5.55,0.752,0
58,157,903,116360,29,6648,2352,267992,70.83,17643060,66.939,28.1,7.104,10581.936,140.448,5.55,0.752,0
58,158,815,117175,26,6674,2626,270618,70.83,17643060,66.939,28.1,7.104,10581.936,140.448,5.55,0.752,0
58,159,870,118045,50,6724,2363,272981,70.83,17643060,66.939,28.1,7.104,10581.936,140.448,5.55,0.752,0
58,160,-8261,109784,3800,10524,749,273730,70.83,17643060,66.939,28.1,7.104,10581.936,140.448,5.55,0.752,0
58,161,308,110092,52,10576,1511,275241,70.83,17643060,66.939,28.1,7.104,10581.936,140.448,5.55,0.752,0
58,162,665,110757,51,10627,3698,278939,70.83,17643060,66.939,28.1,7.104,10581.936,140.448,5.55,0.752,0
58,163,1409,112166,74,10701,2981,281920,70.83,17643060,66.939,28.1,7.104,10581.936,140.448,5.55,0.752,0
58,164,1040,113206,48,10749,4836,286756,70.83,17643060,66.939,28.1,7.104,10581.936,140.448,5.55,0.752,0
58,165,1526,114732,87,10836,4140,290896,70.83,17643060,66.939,28.1,7.104,10581.936,140.448,5.55,0.752,0
58,166,1719,116451,28,10864,3432,294328,70.83,17643060,66.939,28.1,7.104,10581.936,140.448,5.55,0.752,0
58,167,2143,118594,39,10903,1046,295374,48.61,17643060,66.939,28.1,7.104,10581.936,140.448,5.55,0.752,0
58,168,317,118911,19,10922,2013,297387,48.61,17643060,66.939,28.1,7.104,10581.936,140.448,5.55,0.752,0
58,169,642,119553,41,10963,5210,302597,48.61,17643060,66.939,28.1,7.104,10581.936,140.448,5.55,0.752,0
58,170,1972,121525,33,10996,6330,308927,48.61,17643060,66.939,28.1,7.104,10581.936,140.448,5.55,0.752,0
58,171,732,122257,33,11029,4648,313575,48.61,17643060,66.939,28.1,7.104,10581.936,140.448,5.55,0.752,0
58,172,1872,124129,15,11044,6664,320239,48.61,17643060,66.939,28.1,7.104,10581.936,140.448,5.55,0.752,0
58,173,1491,125620,40,11084,3440,323679,48.61,17643060,66.939,28.1,7.104,10581.936,140.448,5.55,0.752,0
58,174,799,126419,6,11090,729,324408,48.61,17643060,66.939,28.1,7.104,10581.936,140.448,5.55,0.752,0
58,175,292,126711,5,11095,2535,326943,48.61,17643060,66.939,28.1,7.104,10581.936,140.448,5.55,0.752,0
58,176,932,127643,31,11126,6145,333088,48.61,17643060,66.939,28.1,7.104,10581.936,140.448,5.55,0.752,0
58,177,2249,129892,45,11171,4339,337427,48.61,17643060,66.939,28.1,7.104,10581.936,140.448,5.55,0.752,0
58,178,1254,131146,42,11213,4397,341824,48.61,17643060,66.939,28.1,7.104,10581.936,140.448,5.55,0.752,0
58,179,1329,132475,23,11236,5958,347782,48.61,17643060,66.939,28.1,7.104,10581.936,140.448,5.55,0.752,0
58,180,1506,133981,37,11273,2716,350498,48.61,17643060,66.939,28.1,7.104,10581.936,140.448,5.55,0.752,0
58,181,766,134747,6,11279,723,351221,48.61,17643060,66.939,28.1,7.104,10581.936,140.448,5.55,0.752,0
58,182,218,134965,1,11280,3380,354601,48.61,17643060,66.939,28.1,7.104,10581.936,140.448,5.55,0.752,0
58,183,784,135749,32,11312,5317,359918,48.61,17643060,66.939,28.1,7.104,10581.936,140.448,5.55,0.752,0
58,184,1298,137047,43,11355,5085,365003,48.61,17643060,66.939,28.1,7.104,10581.936,140.448,5.55,0.752,0
58,185,1537,138584,78,11433,4543,369546,48.61,17643060,66.939,28.1,7.104,10581.936,140.448,5.55,0.752,0
58,186,950,139534,62,11495,3268,372814,48.61,17643060,66.939,28.1,7.104,10581.936,140.448,5.55,0.752,0
58,187,817,140351,102,11597,2461,375275,48.61,17643060,66.939,28.1,7.104,10581.936,140.448,5.55,0.752,0
58,188,683,141034,50,11647,1020,376295,48.61,17643060,66.939,28.1,7.104,10581.936,140.448,5.55,0.752,0
58,189,305,141339,34,11681,2576,378871,48.61,17643060,66.939,28.1,7.104,10581.936,140.448,5.55,0.752,0
58,190,717,142056,21,11702,5215,384086,48.61,17643060,66.939,28.1,7.104,10581.936,140.448,5.55,0.752,0
58,191,1475,143531,41,11743,4780,388866,48.61,17643060,66.939,28.1,7.104,10581.936,140.448,5.55,0.752,0
58,192,1514,145045,398,12141,3768,392634,48.61,17643060,66.939,28.1,7.104,10581.936,140.448,5.55,0.752,0
58,193,803,145848,34,12175,5946,398580,48.61,17643060,66.939,28.1,7.104,10581.936,140.448,5.55,0.752,0
58,194,980,146828,13,12188,1041,399621,48.61,17643060,66.939,28.1,7.104,10581.936,140.448,5.55,0.752,0
58,195,205,147033,3,12191,1001,400622,48.61,17643060,66.939,28.1,7.104,10581.936,140.448,5.55,0.752,0
58,196,282,147315,27,12218,2780,403402,48.61,17643060,66.939,28.1,7.104,10581.936,140.448,5.55,0.752,0
58,197,856,148171,17,12235,4493,407895,48.61,17643060,66.939,28.1,7.104,10581.936,140.448,5.55,0.752,0
58,198,912,149083,29,12264,5167,413062,48.61,17643060,66.939,28.1,7.104,10581.936,140.448,5.55,0.752,0
58,199,1277,150360,42,12306,4556,417618,48.61,17643060,66.939,28.1,7.104,10581.936,140.448,5.55,0.752,0
58,200,1299,151659,51,12357,2900,420518,48.61,17643060,66.939,28.1,7.104,10581.936,140.448,5.55,0.752,0
58,201,763,152422,18,12375,4357,424875,48.61,17643060,66.939,28.1,7.104,10581.936,140.448,5.55,0.752,0
58,202,867,153289,12,12387,0,424875,48.61,17643060,66.939,28.1,7.104,10581.936,140.448,5.55,0.752,0
58,203,134,153423,8,12395,0,424875,48.61,17643060,66.939,28.1,7.104,10581.936,140.448,5.55,0.752,0
58,204,692,154115,9,12404,0,424875,48.61,17643060,66.939,28.1,7.104,10581.936,140.448,5.55,0.752,0
59,1,47,656,1,41,0,0,84.26,102334403,97.999,25.3,5.159,10550.206,525.432,17.31,0.696,3
59,2,54,710,5,46,0,0,84.26,102334403,97.999,25.3,5.159,10550.206,525.432,17.31,0.696,3
59,3,69,779,6,52,0,0,84.26,102334403,97.999,25.3,5.159,10550.206,525.432,17.31,0.696,3
59,4,0,779,0,52,0,0,84.26,102334403,97.999,25.3,5.159,10550.206,525.432,17.31,0.696,3
59,5,206,985,14,66,0,0,84.26,102334403,97.999,25.3,5.159,10550.206,525.432,17.31,0.696,3
59,6,85,1070,5,71,0,0,84.26,102334403,97.999,25.3,5.159,10550.206,525.432,17.31,0.696,3
59,7,3,1073,7,78,0,0,84.26,102334403,97.999,25.3,5.159,10550.206,525.432,17.31,0.696,3
59,8,249,1322,7,85,0,0,84.26,102334403,97.999,25.3,5.159,10550.206,525.432,17.31,0.696,3
59,9,238,1560,18,103,0,0,84.26,102334403,97.999,25.3,5.159,10550.206,525.432,17.31,0.696,3
59,10,139,1699,15,118,0,0,84.26,102334403,97.999,25.3,5.159,10550.206,525.432,17.31,0.696,3
59,11,95,1794,17,135,0,0,84.26,102334403,97.999,25.3,5.159,10550.206,525.432,17.31,0.696,3
59,12,145,1939,11,146,0,0,84.26,102334403,97.999,25.3,5.159,10550.206,525.432,17.31,0.696,3
59,13,126,2065,13,159,0,0,84.26,102334403,97.999,25.3,5.159,10550.206,525.432,17.31,0.696,3
59,14,125,2190,5,164,0,0,84.26,102334403,97.999,25.3,5.159,10550.206,525.432,17.31,0.696,3
59,15,160,2350,14,178,0,0,84.26,102334403,97.999,25.3,5.159,10550.206,525.432,17.31,0.696,3
59,16,155,2505,5,183,0,0,84.26,102334403,97.999,25.3,5.159,10550.206,525.432,17.31,0.696,3
59,17,168,2673,13,196,0,0,84.26,102334403,97.999,25.3,5.159,10550.206,525.432,17.31,0.696,3
59,18,171,2844,9,205,0,0,84.26,102334403,97.999,25.3,5.159,10550.206,525.432,17.31,0.696,3
59,19,188,3032,19,224,0,0,84.26,102334403,97.999,25.3,5.159,10550.206,525.432,17.31,0.696,3
59,20,112,3144,15,239,0,0,84.26,102334403,97.999,25.3,5.159,10550.206,525.432,17.31,0.696,3
59,21,189,3333,11,250,0,0,84.26,102334403,97.999,25.3,5.159,10550.206,525.432,17.31,0.696,3
59,22,157,3490,14,264,0,0,84.26,102334403,97.999,25.3,5.159,10550.206,525.432,17.31,0.696,3
59,23,0,3490,0,264,0,0,84.26,102334403,97.999,25.3,5.159,10550.206,525.432,17.31,0.696,3
59,24,169,3659,12,276,0,0,84.26,102334403,97.999,25.3,5.159,10550.206,525.432,17.31,0.696,3
59,25,433,4092,18,294,0,0,84.26,102334403,97.999,25.3,5.159,10550.206,525.432,17.31,0.696,3
59,26,227,4319,13,307,0,0,84.26,102334403,97.999,25.3,5.159,10550.206,525.432,17.31,0.696,3
59,27,0,4319,0,307,0,0,84.26,102334403,97.999,25.3,5.159,10550.206,525.432,17.31,0.696,3
59,28,463,4782,30,337,0,0,84.26,102334403,97.999,25.3,5.159,10550.206,525.432,17.31,0.696,3
59,29,260,5042,22,359,0,0,84.26,102334403,97.999,25.3,5.159,10550.206,525.432,17.31,0.696,3
59,30,226,5268,21,380,0,0,84.26,102334403,97.999,25.3,5.159,10550.206,525.432,17.31,0.696,3
59,31,269,5537,12,392,0,0,84.26,102334403,97.999,25.3,5.159,10550.206,525.432,17.31,0.696,3
59,32,358,5895,14,406,0,0,84.26,102334403,97.999,25.3,5.159,10550.206,525.432,17.31,0.696,3
59,33,298,6193,9,415,0,0,84.26,102334403,97.999,25.3,5.159,10550.206,525.432,17.31,0.696,3
59,34,272,6465,14,429,0,0,84.26,102334403,97.999,25.3,5.159,10550.206,525.432,17.31,0.696,3
59,35,348,6813,7,436,0,0,84.26,102334403,97.999,25.3,5.159,10550.206,525.432,17.31,0.696,3
59,36,388,7201,16,452,0,0,84.26,102334403,97.999,25.3,5.159,10550.206,525.432,17.31,0.696,3
59,37,387,7588,17,469,0,0,84.26,102334403,97.999,25.3,5.159,10550.206,525.432,17.31,0.696,3
59,38,393,7981,13,482,0,0,84.26,102334403,97.999,25.3,5.159,10550.206,525.432,17.31,0.696,3
59,39,495,8476,21,503,0,0,84.26,102334403,97.999,25.3,5.159,10550.206,525.432,17.31,0.696,3
59,40,488,8964,11,514,0,0,84.26,102334403,97.999,25.3,5.159,10550.206,525.432,17.31,0.696,3
59,41,436,9400,11,525,0,0,84.26,102334403,97.999,25.3,5.159,10550.206,525.432,17.31,0.696,3
59,42,346,9746,8,533,0,0,84.26,102334403,97.999,25.3,5.159,10550.206,525.432,17.31,0.696,3
59,43,347,10093,11,544,0,0,84.26,102334403,97.999,25.3,5.159,10550.206,525.432,17.31,0.696,3
59,44,338,10431,12,556,0,0,84.26,102334403,97.999,25.3,5.159,10550.206,525.432,17.31,0.696,3
59,45,398,10829,15,571,0,0,84.26,102334403,97.999,25.3,5.159,10550.206,525.432,17.31,0.696,3
59,46,399,11228,21,592,0,0,84.26,102334403,97.999,25.3,5.159,10550.206,525.432,17.31,0.696,3
59,47,491,11719,20,612,0,0,84.26,102334403,97.999,25.3,5.159,10550.206,525.432,17.31,0.696,3
59,48,510,12229,18,630,0,0,84.26,102334403,97.999,25.3,5.159,10550.206,525.432,17.31,0.696,3
59,49,535,12764,15,645,0,0,84.26,102334403,97.999,25.3,5.159,10550.206,525.432,17.31,0.696,3
59,50,720,13484,14,659,0,0,84.26,102334403,97.999,25.3,5.159,10550.206,525.432,17.31,0.696,3
59,51,745,14229,21,680,0,0,84.26,102334403,97.999,25.3,5.159,10550.206,525.432,17.31,0.696,3
59,52,774,15003,16,696,0,0,84.26,102334403,97.999,25.3,5.159,10550.206,525.432,17.31,0.696,3
59,53,783,15786,11,707,0,0,84.26,102334403,97.999,25.3,5.159,10550.206,525.432,17.31,0.696,3
59,54,827,16613,28,735,0,0,84.26,102334403,97.999,25.3,5.159,10550.206,525.432,17.31,0.696,3
59,55,652,17265,29,764,0,0,84.26,102334403,97.999,25.3,5.159,10550.206,525.432,17.31,0.696,3
59,56,702,17967,19,783,0,0,84.26,102334403,97.999,25.3,5.159,10550.206,525.432,17.31,0.696,3
59,57,789,18756,14,797,0,0,84.26,102334403,97.999,25.3,5.159,10550.206,525.432,17.31,0.696,3
59,58,910,19666,19,816,0,0,84.26,102334403,97.999,25.3,5.159,10550.206,525.432,17.31,0.696,3
59,59,1127,20793,29,845,0,0,84.26,102334403,97.999,25.3,5.159,10550.206,525.432,17.31,0.696,3
59,60,1289,22082,34,879,0,0,84.26,102334403,97.999,25.3,5.159,10550.206,525.432,17.31,0.696,3
59,61,1367,23449,34,913,0,0,84.26,102334403,97.999,25.3,5.159,10550.206,525.432,17.31,0.696,3
59,62,1536,24985,46,959,0,0,84.26,102334403,97.999,25.3,5.159,10550.206,525.432,17.31,0.696,3
59,63,1399,26384,46,1005,0,0,84.26,102334403,97.999,25.3,5.159,10550.206,525.432,17.31,0.696,3
59,64,1152,27536,47,1052,0,0,84.26,102334403,97.999,25.3,5.159,10550.206,525.432,17.31,0.696,3
59,65,1079,28615,36,1088,0,0,84.26,102334403,97.999,25.3,5.159,10550.206,525.432,17.31,0.696,3
59,66,1152,29767,38,1126,0,0,84.26,102334403,97.999,25.3,5.159,10550.206,525.432,17.31,0.696,3
59,67,1348,31115,40,1166,0,0,84.26,102334403,97.999,25.3,5.159,10550.206,525.432,17.31,0.696,3
59,68,1497,32612,32,1198,0,0,71.3,102334403,97.999,25.3,5.159,10550.206,525.432,17.31,0.696,3
59,69,1467,34079,39,1237,0,0,71.3,102334403,97.999,25.3,5.159,10550.206,525.432,17.31,0.696,3
59,70,1365,35444,34,1271,0,0,71.3,102334403,97.999,25.3,5.159,10550.206,525.432,17.31,0.696,3
59,71,1385,36829,35,1306,0,0,71.3,102334403,97.999,25.3,5.159,10550.206,525.432,17.31,0.696,3
59,72,1455,38284,36,1342,0,0,71.3,102334403,97.999,25.3,5.159,10550.206,525.432,17.31,0.696,3
59,73,1442,39726,35,1377,0,0,71.3,102334403,97.999,25.3,5.159,10550.206,525.432,17.31,0.696,3
59,74,1578,41304,45,1422,0,0,71.3,102334403,97.999,25.3,5.159,10550.206,525.432,17.31,0.696,3
59,75,1676,42980,62,1484,0,0,71.3,102334403,97.999,25.3,5.159,10550.206,525.432,17.31,0.696,3
59,76,1618,44598,91,1575,0,0,71.3,102334403,97.999,25.3,5.159,10550.206,525.432,17.31,0.696,3
59,77,1691,46289,97,1672,0,0,71.3,102334403,97.999,25.3,5.159,10550.206,525.432,17.31,0.696,3
59,78,1567,47856,94,1766,0,0,71.3,102334403,97.999,25.3,5.159,10550.206,525.432,17.31,0.696,3
59,79,1363,49219,84,1850,0,0,71.3,102334403,97.999,25.3,5.159,10550.206,525.432,17.31,0.696,3
59,80,1218,50437,88,1938,0,0,71.3,102334403,97.999,25.3,5.159,10550.206,525.432,17.31,0.696,3
59,81,1774,52211,79,2017,0,0,71.3,102334403,97.999,25.3,5.159,10550.206,525.432,17.31,0.696,3
59,82,1547,53758,89,2106,0,0,71.3,102334403,97.999,25.3,5.159,10550.206,525.432,17.31,0.696,3
59,83,1475,55233,87,2193,0,0,71.3,102334403,97.999,25.3,5.159,10550.206,525.432,17.31,0.696,3
59,84,1576,56809,85,2278,0,0,71.3,102334403,97.999,25.3,5.159,10550.206,525.432,17.31,0.696,3
59,85,1332,58141,87,2365,0,0,71.3,102334403,97.999,25.3,5.159,10550.206,525.432,17.31,0.696,3
59,86,1420,59561,85,2450,0,0,71.3,102334403,97.999,25.3,5.159,10550.206,525.432,17.31,0.696,3
59,87,1569,61130,83,2533,0,0,71.3,102334403,97.999,25.3,5.159,10550.206,525.432,17.31,0.696,3
59,88,1625,62755,87,2620,0,0,71.3,102334403,97.999,25.3,5.159,10550.206,525.432,17.31,0.696,3
59,89,1168,63923,88,2708,0,0,71.3,102334403,97.999,25.3,5.159,10550.206,525.432,17.31,0.696,3
59,90,1265,65188,81,2789,0,0,71.3,102334403,97.999,25.3,5.159,10550.206,525.432,17.31,0.696,3
59,91,1566,66754,83,2872,0,0,71.3,102334403,97.999,25.3,5.159,10550.206,525.432,17.31,0.696,3
59,92,1557,68311,81,2953,0,0,60.19,102334403,97.999,25.3,5.159,10550.206,525.432,17.31,0.696,3
59,93,1503,69814,81,3034,0,0,60.19,102334403,97.999,25.3,5.159,10550.206,525.432,17.31,0.696,3
59,94,1485,71299,86,3120,0,0,60.19,102334403,97.999,25.3,5.159,10550.206,525.432,17.31,0.696,3
59,95,1412,72711,81,3201,0,0,60.19,102334403,97.999,25.3,5.159,10550.206,525.432,17.31,0.696,3
59,96,1324,74035,79,3280,0,0,60.19,102334403,97.999,25.3,5.159,10550.206,525.432,17.31,0.696,3
59,97,1218,75253,63,3343,0,0,60.19,102334403,97.999,25.3,5.159,10550.206,525.432,17.31,0.696,3
59,98,969,76222,79,3422,0,0,60.19,102334403,97.999,25.3,5.159,10550.206,525.432,17.31,0.696,3
59,99,1057,77279,67,3489,0,0,60.19,102334403,97.999,25.3,5.159,10550.206,525.432,17.31,0.696,3
59,100,1025,78304,75,3564,0,0,60.19,102334403,97.999,25.3,5.159,10550.206,525.432,17.31,0.696,3
59,101,950,79254,53,3617,0,0,60.19,102334403,97.999,25.3,5.159,10550.206,525.432,17.31,0.696,3
59,102,981,80235,85,3702,0,0,60.19,102334403,97.999,25.3,5.159,10550.206,525.432,17.31,0.696,3
59,103,923,81158,67,3769,0,0,60.19,102334403,97.999,25.3,5.159,10550.206,525.432,17.31,0.696,3
59,104,912,82070,89,3858,0,0,60.19,102334403,97.999,25.3,5.159,10550.206,525.432,17.31,0.696,3
59,105,931,83001,77,3935,0,0,60.19,102334403,97.999,25.3,5.159,10550.206,525.432,17.31,0.696,3
59,106,929,83930,73,4008,0,0,60.19,102334403,97.999,25.3,5.159,10550.206,525.432,17.31,0.696,3
59,107,913,84843,59,4067,0,0,60.19,102334403,97.999,25.3,5.159,10550.206,525.432,17.31,0.696,3
59,108,928,85771,53,4120,0,0,60.19,102334403,97.999,25.3,5.159,10550.206,525.432,17.31,0.696,3
59,109,703,86474,68,4188,0,0,60.19,102334403,97.999,25.3,5.159,10550.206,525.432,17.31,0.696,3
59,110,698,87172,63,4251,0,0,60.19,102334403,97.999,25.3,5.159,10550.206,525.432,17.31,0.696,3
59,111,603,87775,51,4302,0,0,60.19,102334403,97.999,25.3,5.159,10550.206,525.432,17.31,0.696,3
59,112,627,88402,50,4352,0,0,60.19,102334403,97.999,25.3,5.159,10550.206,525.432,17.31,0.696,3
59,113,676,89078,47,4399,0,0,60.19,102334403,97.999,25.3,5.159,10550.206,525.432,17.31,0.696,3
59,114,667,89745,41,4440,0,0,60.19,102334403,97.999,25.3,5.159,10550.206,525.432,17.31,0.696,3
59,115,668,90413,40,4480,0,0,60.19,102334403,97.999,25.3,5.159,10550.206,525.432,17.31,0.696,3
59,116,659,91072,38,4518,0,0,60.19,102334403,97.999,25.3,5.159,10550.206,525.432,17.31,0.696,3
59,117,511,91583,40,4558,0,0,60.19,102334403,97.999,25.3,5.159,10550.206,525.432,17.31,0.696,3
59,118,479,92062,48,4606,0,0,60.19,102334403,97.999,25.3,5.159,10550.206,525.432,17.31,0.696,3
59,119,420,92482,46,4652,0,0,60.19,102334403,97.999,25.3,5.159,10550.206,525.432,17.31,0.696,3
59,120,465,92947,39,4691,0,0,60.19,102334403,97.999,25.3,5.159,10550.206,525.432,17.31,0.696,3
59,121,409,93356,37,4728,0,0,60.19,102334403,97.999,25.3,5.159,10550.206,525.432,17.31,0.696,3
59,122,401,93757,46,4774,0,0,60.19,102334403,97.999,25.3,5.159,10550.206,525.432,17.31,0.696,3
59,123,321,94078,31,4805,0,0,60.19,102334403,97.999,25.3,5.159,10550.206,525.432,17.31,0.696,3
59,124,238,94316,29,4834,0,0,60.19,102334403,97.999,25.3,5.159,10550.206,525.432,17.31,0.696,3
59,125,167,94483,31,4865,0,0,62.96,102334403,97.999,25.3,5.159,10550.206,525.432,17.31,0.696,3
59,126,157,94640,23,4888,0,0,62.96,102334403,97.999,25.3,5.159,10550.206,525.432,17.31,0.696,3
59,127,112,94752,24,4912,0,0,62.96,102334403,97.999,25.3,5.159,10550.206,525.432,17.31,0.696,3
59,128,123,94875,18,4930,0,0,62.96,102334403,97.999,25.3,5.159,10550.206,525.432,17.31,0.696,3
59,129,131,95006,21,4951,0,0,62.96,102334403,97.999,25.3,5.159,10550.206,525.432,17.31,0.696,3
59,130,141,95147,20,4971,0,0,62.96,102334403,97.999,25.3,5.159,10550.206,525.432,17.31,0.696,3
59,131,167,95314,21,4992,0,0,62.96,102334403,97.999,25.3,5.159,10550.206,525.432,17.31,0.696,3
59,132,178,95492,17,5009,0,0,62.96,102334403,97.999,25.3,5.159,10550.206,525.432,17.31,0.696,3
59,133,174,95666,26,5035,0,0,62.96,102334403,97.999,25.3,5.159,10550.206,525.432,17.31,0.696,3
59,134,168,95834,24,5059,0,0,62.96,102334403,97.999,25.3,5.159,10550.206,525.432,17.31,0.696,3
59,135,129,95963,26,5085,0,0,62.96,102334403,97.999,25.3,5.159,10550.206,525.432,17.31,0.696,3
59,136,145,96108,22,5107,0,0,62.96,102334403,97.999,25.3,5.159,10550.206,525.432,17.31,0.696,3
59,137,112,96220,17,5124,0,0,62.96,102334403,97.999,25.3,5.159,10550.206,525.432,17.31,0.696,3
59,138,116,96336,17,5141,0,0,62.96,102334403,97.999,25.3,5.159,10550.206,525.432,17.31,0.696,3
59,139,139,96475,19,5160,0,0,62.96,102334403,97.999,25.3,5.159,10550.206,525.432,17.31,0.696,3
59,140,115,96590,13,5173,0,0,62.96,102334403,97.999,25.3,5.159,10550.206,525.432,17.31,0.696,3
59,141,0,96590,0,5173,0,0,62.96,102334403,97.999,25.3,5.159,10550.206,525.432,17.31,0.696,3
59,142,324,96914,24,5197,0,0,62.96,102334403,97.999,25.3,5.159,10550.206,525.432,17.31,0.696,3
59,143,111,97025,15,5212,0,0,62.96,102334403,97.999,25.3,5.159,10550.206,525.432,17.31,0.696,3
59,144,123,97148,19,5231,0,0,62.96,102334403,97.999,25.3,5.159,10550.206,525.432,17.31,0.696,3
59,145,89,97237,12,5243,0,0,62.96,102334403,97.999,25.3,5.159,10550.206,525.432,17.31,0.696,3
59,146,0,97237,0,5243,0,0,62.96,102334403,97.999,25.3,5.159,10550.206,525.432,17.31,0.696,3
59,147,241,97478,37,5280,0,0,62.96,102334403,97.999,25.3,5.159,10550.206,525.432,17.31,0.696,3
59,148,141,97619,18,5298,0,0,62.96,102334403,97.999,25.3,5.159,10550.206,525.432,17.31,0.696,3
59,149,206,97825,19,5317,0,0,62.96,102334403,97.999,25.3,5.159,10550.206,525.432,17.31,0.696,3
59,150,237,98062,25,5342,0,0,62.96,102334403,97.999,25.3,5.159,10550.206,525.432,17.31,0.696,3
59,151,223,98285,20,5362,0,0,62.96,102334403,97.999,25.3,5.159,10550.206,525.432,17.31,0.696,3
59,152,212,98497,14,5376,0,0,62.96,102334403,97.999,25.3,5.159,10550.206,525.432,17.31,0.696,3
59,153,230,98727,23,5399,0,0,62.96,102334403,97.999,25.3,5.159,10550.206,525.432,17.31,0.696,3
59,154,212,98939,22,5421,0,0,62.96,102334403,97.999,25.3,5.159,10550.206,525.432,17.31,0.696,3
59,155,176,99115,19,5440,0,0,62.96,102334403,97.999,25.3,5.159,10550.206,525.432,17.31,0.696,3
59,156,165,99280,21,5461,0,0,62.96,102334403,97.999,25.3,5.159,10550.206,525.432,17.31,0.696,3
59,157,145,99425,18,5479,0,0,62.96,102334403,97.999,25.3,5.159,10550.206,525.432,17.31,0.696,3
59,158,157,99582,16,5495,0,0,62.96,102334403,97.999,25.3,5.159,10550.206,525.432,17.31,0.696,3
59,159,130,99712,16,5511,0,0,62.96,102334403,97.999,25.3,5.159,10550.206,525.432,17.31,0.696,3
59,160,151,99863,19,5530,0,0,62.96,102334403,97.999,25.3,5.159,10550.206,525.432,17.31,0.696,3
59,161,178,100041,11,5541,0,0,62.96,102334403,97.999,25.3,5.159,10550.206,525.432,17.31,0.696,3
59,162,187,100228,19,5560,0,0,62.96,102334403,97.999,25.3,5.159,10550.206,525.432,17.31,0.696,3
59,163,175,100403,17,5577,0,0,62.96,102334403,97.999,25.3,5.159,10550.206,525.432,17.31,0.696,3
59,164,154,100557,13,5590,0,0,62.96,102334403,97.999,25.3,5.159,10550.206,525.432,17.31,0.696,3
59,165,151,100708,17,5607,0,0,62.96,102334403,97.999,25.3,5.159,10550.206,525.432,17.31,0.696,3
59,166,148,100856,20,5627,0,0,62.96,102334403,97.999,25.3,5.159,10550.206,525.432,17.31,0.696,3
59,167,153,101009,21,5648,0,0,62.96,102334403,97.999,25.3,5.159,10550.206,525.432,17.31,0.696,3
59,168,168,101177,13,5661,0,0,62.96,102334403,97.999,25.3,5.159,10550.206,525.432,17.31,0.696,3
59,169,163,101340,18,5679,0,0,62.96,102334403,97.999,25.3,5.159,10550.206,525.432,17.31,0.696,3
59,170,160,101500,17,5696,0,0,62.96,102334403,97.999,25.3,5.159,10550.206,525.432,17.31,0.696,3
59,171,141,101641,19,5715,0,0,62.96,102334403,97.999,25.3,5.159,10550.206,525.432,17.31,0.696,3
59,172,131,101772,18,5733,0,0,62.96,102334403,97.999,25.3,5.159,10550.206,525.432,17.31,0.696,3
59,173,128,101900,17,5750,0,0,62.96,102334403,97.999,25.3,5.159,10550.206,525.432,17.31,0.696,3
59,174,115,102015,20,5770,0,0,62.96,102334403,97.999,25.3,5.159,10550.206,525.432,17.31,0.696,3
59,175,126,102141,17,5787,0,0,62.96,102334403,97.999,25.3,5.159,10550.206,525.432,17.31,0.696,3
59,176,113,102254,19,5806,0,0,62.96,102334403,97.999,25.3,5.159,10550.206,525.432,17.31,0.696,3
59,177,121,102375,16,5822,0,0,62.96,102334403,97.999,25.3,5.159,10550.206,525.432,17.31,0.696,3
59,178,138,102513,13,5835,0,0,62.96,102334403,97.999,25.3,5.159,10550.206,525.432,17.31,0.696,3
59,179,112,102625,18,5853,0,0,62.96,102334403,97.999,25.3,5.159,10550.206,525.432,17.31,0.696,3
59,180,111,102736,16,5869,0,0,62.96,102334403,97.999,25.3,5.159,10550.206,525.432,17.31,0.696,3
59,181,104,102840,14,5883,0,0,62.96,102334403,97.999,25.3,5.159,10550.206,525.432,17.31,0.696,3
59,182,115,102955,18,5901,0,0,62.96,102334403,97.999,25.3,5.159,10550.206,525.432,17.31,0.696,3
59,183,124,103079,13,5914,0,0,62.96,102334403,97.999,25.3,5.159,10550.206,525.432,17.31,0.696,3
59,184,119,103198,16,5930,0,0,62.96,102334403,97.999,25.3,5.159,10550.206,525.432,17.31,0.696,3
59,185,119,103317,16,5946,0,0,62.96,102334403,97.999,25.3,5.159,10550.206,525.432,17.31,0.696,3
59,186,149,103466,10,5956,0,0,62.96,102334403,97.999,25.3,5.159,10550.206,525.432,17.31,0.696,3
59,187,109,103575,14,5970,0,0,62.96,102334403,97.999,25.3,5.159,10550.206,525.432,17.31,0.696,3
59,188,108,103683,11,5981,0,0,62.96,102334403,97.999,25.3,5.159,10550.206,525.432,17.31,0.696,3
59,189,98,103781,9,5990,0,0,62.96,102334403,97.999,25.3,5.159,10550.206,525.432,17.31,0.696,3
59,190,121,103902,11,6001,0,0,62.96,102334403,97.999,25.3,5.159,10550.206,525.432,17.31,0.696,3
59,191,133,104035,9,6010,0,0,62.96,102334403,97.999,25.3,5.159,10550.206,525.432,17.31,0.696,3
59,192,121,104156,7,6017,0,0,62.96,102334403,97.999,25.3,5.159,10550.206,525.432,17.31,0.696,3
59,193,106,104262,12,6029,0,0,62.96,102334403,97.999,25.3,5.159,10550.206,525.432,17.31,0.696,3
59,194,125,104387,11,6040,0,0,62.96,102334403,97.999,25.3,5.159,10550.206,525.432,17.31,0.696,3
59,195,0,104387,0,6040,0,0,62.96,102334403,97.999,25.3,5.159,10550.206,525.432,17.31,0.696,3
59,196,261,104648,22,6062,0,0,62.96,102334403,97.999,25.3,5.159,10550.206,525.432,17.31,0.696,3
59,197,139,104787,9,6071,0,0,62.96,102334403,97.999,25.3,5.159,10550.206,525.432,17.31,0.696,3
59,198,128,104915,6,6077,0,0,62.96,102334403,97.999,25.3,5.159,10550.206,525.432,17.31,0.696,3
59,199,118,105033,11,6088,0,0,62.96,102334403,97.999,25.3,5.159,10550.206,525.432,17.31,0.696,3
59,200,126,105159,11,6099,0,0,62.96,102334403,97.999,25.3,5.159,10550.206,525.432,17.31,0.696,3
59,201,138,105297,10,6109,0,0,62.96,102334403,97.999,25.3,5.159,10550.206,525.432,17.31,0.696,3
59,202,127,105424,11,6120,0,0,62.96,102334403,97.999,25.3,5.159,10550.206,525.432,17.31,0.696,3
59,203,123,105547,10,6130,0,0,62.96,102334403,97.999,25.3,5.159,10550.206,525.432,17.31,0.696,3
59,204,158,105705,12,6142,0,0,62.96,102334403,97.999,25.3,5.159,10550.206,525.432,17.31,0.696,3
60,1,0,32,1,1,0,0,88.89,6486201,307.811,27.6,8.273,7292.458,167.295,8.87,0.674,0
60,2,9,41,1,2,0,0,88.89,6486201,307.811,27.6,8.273,7292.458,167.295,8.87,0.674,0
60,3,5,46,0,2,0,0,88.89,6486201,307.811,27.6,8.273,7292.458,167.295,8.87,0.674,0
60,4,10,56,1,3,0,0,88.89,6486201,307.811,27.6,8.273,7292.458,167.295,8.87,0.674,0
60,5,6,62,0,3,0,0,88.89,6486201,307.811,27.6,8.273,7292.458,167.295,8.87,0.674,0
60,6,7,69,0,3,0,0,88.89,6486201,307.811,27.6,8.273,7292.458,167.295,8.87,0.674,0
60,7,9,78,1,4,0,0,88.89,6486201,307.811,27.6,8.273,7292.458,167.295,8.87,0.674,0
60,8,0,78,0,4,0,0,88.89,6486201,307.811,27.6,8.273,7292.458,167.295,8.87,0.674,0
60,9,25,103,1,5,0,0,88.89,6486201,307.811,27.6,8.273,7292.458,167.295,8.87,0.674,0
60,10,14,117,1,6,0,5760,88.89,6486201,307.811,27.6,8.273,7292.458,167.295,8.87,0.674,0
60,11,1,118,0,6,512,6272,88.89,6486201,307.811,27.6,8.273,7292.458,167.295,8.87,0.674,0
60,12,0,118,0,6,457,6729,88.89,6486201,307.811,27.6,8.273,7292.458,167.295,8.87,0.674,0
60,13,7,125,0,6,501,7230,88.89,6486201,307.811,27.6,8.273,7292.458,167.295,8.87,0.674,0
60,14,24,149,0,6,555,7785,88.89,6486201,307.811,27.6,8.273,7292.458,167.295,8.87,0.674,0
60,15,10,159,0,6,548,8333,88.89,6486201,307.811,27.6,8.273,7292.458,167.295,8.87,0.674,0
60,16,0,159,0,6,934,9267,88.89,6486201,307.811,27.6,8.273,7292.458,167.295,8.87,0.674,0
60,17,5,164,0,6,924,10191,88.89,6486201,307.811,27.6,8.273,7292.458,167.295,8.87,0.674,0
60,18,13,177,1,7,969,11160,88.89,6486201,307.811,27.6,8.273,7292.458,167.295,8.87,0.674,0
60,19,13,190,0,7,1050,12210,88.89,6486201,307.811,27.6,8.273,7292.458,167.295,8.87,0.674,0
60,20,11,201,0,7,1142,13352,88.89,6486201,307.811,27.6,8.273,7292.458,167.295,8.87,0.674,0
60,21,17,218,0,7,1023,14375,94.44,6486201,307.811,27.6,8.273,7292.458,167.295,8.87,0.674,0
60,22,7,225,0,7,1010,15385,94.44,6486201,307.811,27.6,8.273,7292.458,167.295,8.87,0.674,0
60,23,12,237,1,8,1033,16418,94.44,6486201,307.811,27.6,8.273,7292.458,167.295,8.87,0.674,0
60,24,13,250,0,8,1005,17423,94.44,6486201,307.811,27.6,8.273,7292.458,167.295,8.87,0.674,0
60,25,11,261,0,8,1263,18686,94.44,6486201,307.811,27.6,8.273,7292.458,167.295,8.87,0.674,0
60,26,37,298,0,8,1423,20109,94.44,6486201,307.811,27.6,8.273,7292.458,167.295,8.87,0.674,0
60,27,0,298,0,8,1255,21364,94.44,6486201,307.811,27.6,8.273,7292.458,167.295,8.87,0.674,0
60,28,25,323,0,8,1229,22593,94.44,6486201,307.811,27.6,8.273,7292.458,167.295,8.87,0.674,0
60,29,22,345,1,9,1464,24057,94.44,6486201,307.811,27.6,8.273,7292.458,167.295,8.87,0.674,0
60,30,32,377,0,9,1435,25492,94.44,6486201,307.811,27.6,8.273,7292.458,167.295,8.87,0.674,0
60,31,47,424,1,10,1469,26961,94.44,6486201,307.811,27.6,8.273,7292.458,167.295,8.87,0.674,0
60,32,22,446,0,10,1635,28596,94.44,6486201,307.811,27.6,8.273,7292.458,167.295,8.87,0.674,0
60,33,0,446,1,11,1791,30387,94.44,6486201,307.811,27.6,8.273,7292.458,167.295,8.87,0.674,0
60,34,109,555,1,12,1643,32030,94.44,6486201,307.811,27.6,8.273,7292.458,167.295,8.87,0.674,0
60,35,32,587,1,13,1598,33628,94.44,6486201,307.811,27.6,8.273,7292.458,167.295,8.87,0.674,0
60,36,0,587,1,14,1783,35411,94.44,6486201,307.811,27.6,8.273,7292.458,167.295,8.87,0.674,0
60,37,108,695,1,15,1895,37306,100,6486201,307.811,27.6,8.273,7292.458,167.295,8.87,0.674,0
60,38,0,695,0,15,1773,39079,100,6486201,307.811,27.6,8.273,7292.458,167.295,8.87,0.674,0
60,39,89,784,1,16,2011,41090,100,6486201,307.811,27.6,8.273,7292.458,167.295,8.87,0.674,0
60,40,105,889,1,17,1953,43043,100,6486201,307.811,27.6,8.273,7292.458,167.295,8.87,0.674,0
60,41,69,958,0,17,1883,44926,100,6486201,307.811,27.6,8.273,7292.458,167.295,8.87,0.674,0
60,42,40,998,1,18,1905,46831,100,6486201,307.811,27.6,8.273,7292.458,167.295,8.87,0.674,0
60,43,39,1037,2,20,2082,48913,100,6486201,307.811,27.6,8.273,7292.458,167.295,8.87,0.674,0
60,44,75,1112,0,20,2229,51142,100,6486201,307.811,27.6,8.273,7292.458,167.295,8.87,0.674,0
60,45,98,1210,3,23,2270,53412,100,6486201,307.811,27.6,8.273,7292.458,167.295,8.87,0.674,0
60,46,55,1265,2,25,2282,55694,100,6486201,307.811,27.6,8.273,7292.458,167.295,8.87,0.674,0
60,47,0,1265,1,26,2189,57883,100,6486201,307.811,27.6,8.273,7292.458,167.295,8.87,0.674,0
60,48,73,1338,4,30,2458,60341,100,6486201,307.811,27.6,8.273,7292.458,167.295,8.87,0.674,0
60,49,75,1413,0,30,2497,62838,100,6486201,307.811,27.6,8.273,7292.458,167.295,8.87,0.674,0
60,50,85,1498,1,31,2388,65226,100,6486201,307.811,27.6,8.273,7292.458,167.295,8.87,0.674,0
60,51,73,1571,1,32,2437,67663,100,6486201,307.811,27.6,8.273,7292.458,167.295,8.87,0.674,0
60,52,69,1640,1,33,2562,70225,100,6486201,307.811,27.6,8.273,7292.458,167.295,8.87,0.674,0
60,53,85,1725,0,33,2391,72616,100,6486201,307.811,27.6,8.273,7292.458,167.295,8.87,0.674,0
60,54,94,1819,2,35,2530,75146,100,6486201,307.811,27.6,8.273,7292.458,167.295,8.87,0.674,0
60,55,96,1915,0,35,2336,77482,100,6486201,307.811,27.6,8.273,7292.458,167.295,8.87,0.674,0
60,56,68,1983,1,36,2229,79711,100,6486201,307.811,27.6,8.273,7292.458,167.295,8.87,0.674,0
60,57,59,2042,0,36,2532,82243,100,6486201,307.811,27.6,8.273,7292.458,167.295,8.87,0.674,0
60,58,67,2109,3,39,2407,84650,100,6486201,307.811,27.6,8.273,7292.458,167.295,8.87,0.674,0
60,59,85,2194,0,39,2322,86972,100,6486201,307.811,27.6,8.273,7292.458,167.295,8.87,0.674,0
60,60,84,2278,4,43,2386,89358,100,6486201,307.811,27.6,8.273,7292.458,167.295,8.87,0.674,0
60,61,239,2517,3,46,2479,91837,100,6486201,307.811,27.6,8.273,7292.458,167.295,8.87,0.674,0
60,62,0,2517,0,46,2435,94272,100,6486201,307.811,27.6,8.273,7292.458,167.295,8.87,0.674,0
60,63,65,2582,0,46,2375,96647,96.3,6486201,307.811,27.6,8.273,7292.458,167.295,8.87,0.674,0
60,64,71,2653,3,49,2531,99178,96.3,6486201,307.811,27.6,8.273,7292.458,167.295,8.87,0.674,0
60,65,52,2705,2,51,2426,101604,96.3,6486201,307.811,27.6,8.273,7292.458,167.295,8.87,0.674,0
60,66,76,2781,1,52,2456,104060,96.3,6486201,307.811,27.6,8.273,7292.458,167.295,8.87,0.674,0
60,67,68,2849,1,53,2398,106458,96.3,6486201,307.811,27.6,8.273,7292.458,167.295,8.87,0.674,0
60,68,85,2934,0,53,2466,108924,96.3,6486201,307.811,27.6,8.273,7292.458,167.295,8.87,0.674,0
60,69,81,3015,2,55,2350,111274,96.3,6486201,307.811,27.6,8.273,7292.458,167.295,8.87,0.674,0
60,70,89,3104,3,58,2382,113656,96.3,6486201,307.811,27.6,8.273,7292.458,167.295,8.87,0.674,0
60,71,87,3191,2,60,2371,116027,96.3,6486201,307.811,27.6,8.273,7292.458,167.295,8.87,0.674,0
60,72,83,3274,4,64,2456,118483,96.3,6486201,307.811,27.6,8.273,7292.458,167.295,8.87,0.674,0
60,73,207,3481,4,68,2458,120941,96.3,6486201,307.811,27.6,8.273,7292.458,167.295,8.87,0.674,0
60,74,0,3481,4,72,2419,123360,96.3,6486201,307.811,27.6,8.273,7292.458,167.295,8.87,0.674,0
60,75,122,3603,0,72,2399,125759,96.3,6486201,307.811,27.6,8.273,7292.458,167.295,8.87,0.674,0
60,76,117,3720,2,74,2445,128204,96.3,6486201,307.811,27.6,8.273,7292.458,167.295,8.87,0.674,0
60,77,106,3826,2,76,2473,130677,90.74,6486201,307.811,27.6,8.273,7292.458,167.295,8.87,0.674,0
60,78,115,3941,2,78,2474,133151,90.74,6486201,307.811,27.6,8.273,7292.458,167.295,8.87,0.674,0
60,79,125,4066,4,82,2419,135570,90.74,6486201,307.811,27.6,8.273,7292.458,167.295,8.87,0.674,0
60,80,134,4200,4,86,2426,137996,90.74,6486201,307.811,27.6,8.273,7292.458,167.295,8.87,0.674,0
60,81,129,4329,7,93,2433,140429,90.74,6486201,307.811,27.6,8.273,7292.458,167.295,8.87,0.674,0
60,82,297,4626,5,98,2457,142886,90.74,6486201,307.811,27.6,8.273,7292.458,167.295,8.87,0.674,0
60,83,0,4626,9,107,2455,145341,90.74,6486201,307.811,27.6,8.273,7292.458,167.295,8.87,0.674,0
60,84,182,4808,0,107,2430,147771,90.74,6486201,307.811,27.6,8.273,7292.458,167.295,8.87,0.674,0
60,85,165,4973,6,113,2481,150252,90.74,6486201,307.811,27.6,8.273,7292.458,167.295,8.87,0.674,0
60,86,177,5150,13,126,2477,152729,90.74,6486201,307.811,27.6,8.273,7292.458,167.295,8.87,0.674,0
60,87,186,5336,7,133,2572,155301,90.74,6486201,307.811,27.6,8.273,7292.458,167.295,8.87,0.674,0
60,88,181,5517,10,143,2498,157799,90.74,6486201,307.811,27.6,8.273,7292.458,167.295,8.87,0.674,0
60,89,417,5934,9,152,2417,160216,90.74,6486201,307.811,27.6,8.273,7292.458,167.295,8.87,0.674,0
60,90,0,5934,12,164,2495,162711,90.74,6486201,307.811,27.6,8.273,7292.458,167.295,8.87,0.674,0
60,91,239,6173,0,164,2450,165161,89.81,6486201,307.811,27.6,8.273,7292.458,167.295,8.87,0.674,0
60,92,265,6438,10,174,2423,167584,89.81,6486201,307.811,27.6,8.273,7292.458,167.295,8.87,0.674,0
60,93,298,6736,8,182,2433,170017,89.81,6486201,307.811,27.6,8.273,7292.458,167.295,8.87,0.674,0
60,94,264,7000,9,191,2438,172455,89.81,6486201,307.811,27.6,8.273,7292.458,167.295,8.87,0.674,0
60,95,267,7267,19,210,2475,174930,89.81,6486201,307.811,27.6,8.273,7292.458,167.295,8.87,0.674,0
60,96,240,7507,0,210,2436,177366,89.81,6486201,307.811,27.6,8.273,7292.458,167.295,8.87,0.674,0
60,97,270,7777,7,217,2496,179862,89.81,6486201,307.811,27.6,8.273,7292.458,167.295,8.87,0.674,0
60,98,250,8027,6,223,2499,182361,89.81,6486201,307.811,27.6,8.273,7292.458,167.295,8.87,0.674,0
60,99,280,8307,6,229,2470,184831,89.81,6486201,307.811,27.6,8.273,7292.458,167.295,8.87,0.674,0
60,100,259,8566,6,235,2485,187316,89.81,6486201,307.811,27.6,8.273,7292.458,167.295,8.87,0.674,0
60,101,278,8844,8,243,2430,189746,89.81,6486201,307.811,27.6,8.273,7292.458,167.295,8.87,0.674,0
60,102,298,9142,6,249,2460,192206,89.81,6486201,307.811,27.6,8.273,7292.458,167.295,8.87,0.674,0
60,103,249,9391,5,254,2449,194655,89.81,6486201,307.811,27.6,8.273,7292.458,167.295,8.87,0.674,0
60,104,283,9674,13,267,2496,197151,89.81,6486201,307.811,27.6,8.273,7292.458,167.295,8.87,0.674,0
60,105,304,9978,11,278,2486,199637,89.81,6486201,307.811,27.6,8.273,7292.458,167.295,8.87,0.674,0
60,106,325,10303,0,278,2489,202126,89.81,6486201,307.811,27.6,8.273,7292.458,167.295,8.87,0.674,0
60,107,342,10645,20,298,2483,204609,89.81,6486201,307.811,27.6,8.273,7292.458,167.295,8.87,0.674,0
60,108,312,10957,11,309,2415,207024,89.81,6486201,307.811,27.6,8.273,7292.458,167.295,8.87,0.674,0
60,109,250,11207,15,324,2422,209446,89.81,6486201,307.811,27.6,8.273,7292.458,167.295,8.87,0.674,0
60,110,301,11508,0,324,2450,211896,89.81,6486201,307.811,27.6,8.273,7292.458,167.295,8.87,0.674,0
60,111,338,11846,20,344,2547,214443,89.81,6486201,307.811,27.6,8.273,7292.458,167.295,8.87,0.674,0
60,112,361,12207,8,352,2473,216916,89.81,6486201,307.811,27.6,8.273,7292.458,167.295,8.87,0.674,0
60,113,375,12582,11,363,2475,219391,89.81,6486201,307.811,27.6,8.273,7292.458,167.295,8.87,0.674,0
60,114,393,12975,0,363,2429,221820,89.81,6486201,307.811,27.6,8.273,7292.458,167.295,8.87,0.674,0
60,115,402,13377,9,372,2442,224262,89.81,6486201,307.811,27.6,8.273,7292.458,167.295,8.87,0.674,0
60,116,415,13792,18,390,2456,226718,89.81,6486201,307.811,27.6,8.273,7292.458,167.295,8.87,0.674,0
60,117,429,14221,0,390,2468,229186,89.81,6486201,307.811,27.6,8.273,7292.458,167.295,8.87,0.674,0
60,118,409,14630,18,408,2498,231684,89.81,6486201,307.811,27.6,8.273,7292.458,167.295,8.87,0.674,0
60,119,405,15035,0,408,2402,234086,89.81,6486201,307.811,27.6,8.273,7292.458,167.295,8.87,0.674,0
60,120,411,15446,9,417,2415,236501,89.81,6486201,307.811,27.6,8.273,7292.458,167.295,8.87,0.674,0
60,121,395,15841,13,430,2416,238917,89.81,6486201,307.811,27.6,8.273,7292.458,167.295,8.87,0.674,0
60,122,389,16230,9,439,2442,241359,89.81,6486201,307.811,27.6,8.273,7292.458,167.295,8.87,0.674,0
60,123,402,16632,9,448,2483,243842,89.81,6486201,307.811,27.6,8.273,7292.458,167.295,8.87,0.674,0
60,124,418,17050,19,467,2460,246302,89.81,6486201,307.811,27.6,8.273,7292.458,167.295,8.87,0.674,0
60,125,398,17448,0,467,2489,248791,89.81,6486201,307.811,27.6,8.273,7292.458,167.295,8.87,0.674,0
60,126,395,17843,19,486,2480,251271,89.81,6486201,307.811,27.6,8.273,7292.458,167.295,8.87,0.674,0
60,127,419,18262,0,486,2441,253712,89.81,6486201,307.811,27.6,8.273,7292.458,167.295,8.87,0.674,0
60,128,439,18701,27,513,2464,256176,89.81,6486201,307.811,27.6,8.273,7292.458,167.295,8.87,0.674,0
60,129,425,19126,7,520,2471,258647,89.81,6486201,307.811,27.6,8.273,7292.458,167.295,8.87,0.674,0
60,130,418,19544,16,536,2483,261130,89.81,6486201,307.811,27.6,8.273,7292.458,167.295,8.87,0.674,0
60,131,434,19978,0,536,2457,263587,89.81,6486201,307.811,27.6,8.273,7292.458,167.295,8.87,0.674,0
60,132,445,20423,27,563,2492,266079,89.81,6486201,307.811,27.6,8.273,7292.458,167.295,8.87,0.674,0
60,133,449,20872,7,570,2460,268539,89.81,6486201,307.811,27.6,8.273,7292.458,167.295,8.87,0.674,0
60,134,397,21269,7,577,2518,271057,89.81,6486201,307.811,27.6,8.273,7292.458,167.295,8.87,0.674,0
60,135,375,21644,0,577,2452,273509,89.81,6486201,307.811,27.6,8.273,7292.458,167.295,8.87,0.674,0
60,136,349,21993,7,584,2484,275993,89.81,6486201,307.811,27.6,8.273,7292.458,167.295,8.87,0.674,0
60,137,321,22314,11,595,2452,278445,89.81,6486201,307.811,27.6,8.273,7292.458,167.295,8.87,0.674,0
60,138,305,22619,17,612,2498,280943,89.81,6486201,307.811,27.6,8.273,7292.458,167.295,8.87,0.674,0
60,139,293,22912,6,618,2452,283395,89.81,6486201,307.811,27.6,8.273,7292.458,167.295,8.87,0.674,0
60,140,281,23193,0,618,2498,285893,89.81,6486201,307.811,27.6,8.273,7292.458,167.295,8.87,0.674,0
60,141,269,23462,15,633,2414,288307,89.81,6486201,307.811,27.6,8.273,7292.458,167.295,8.87,0.674,0
60,142,255,23717,7,640,2434,290741,89.81,6486201,307.811,27.6,8.273,7292.458,167.295,8.87,0.674,0
60,143,247,23964,0,640,2477,293218,89.81,6486201,307.811,27.6,8.273,7292.458,167.295,8.87,0.674,0
60,144,456,24420,14,654,2447,295665,89.81,6486201,307.811,27.6,8.273,7292.458,167.295,8.87,0.674,0
60,145,0,24420,0,654,2447,298112,89.81,6486201,307.811,27.6,8.273,7292.458,167.295,8.87,0.674,0
60,146,202,24622,15,669,2422,300534,80.56,6486201,307.811,27.6,8.273,7292.458,167.295,8.87,0.674,0
60,147,189,24811,9,678,2497,303031,80.56,6486201,307.811,27.6,8.273,7292.458,167.295,8.87,0.674,0
60,148,175,24986,9,687,2461,305492,80.56,6486201,307.811,27.6,8.273,7292.458,167.295,8.87,0.674,0
60,149,154,25140,0,687,2485,307977,80.56,6486201,307.811,27.6,8.273,7292.458,167.295,8.87,0.674,0
60,150,144,25284,7,694,2467,310444,80.56,6486201,307.811,27.6,8.273,7292.458,167.295,8.87,0.674,0
60,151,131,25415,8,702,2405,312849,80.56,6486201,307.811,27.6,8.273,7292.458,167.295,8.87,0.674,0
60,152,220,25635,11,713,2471,315320,80.56,6486201,307.811,27.6,8.273,7292.458,167.295,8.87,0.674,0
60,153,94,25729,4,717,2489,317809,80.56,6486201,307.811,27.6,8.273,7292.458,167.295,8.87,0.674,0
60,154,91,25820,7,724,2458,320267,80.56,6486201,307.811,27.6,8.273,7292.458,167.295,8.87,0.674,0
60,155,84,25904,7,731,2499,322766,80.56,6486201,307.811,27.6,8.273,7292.458,167.295,8.87,0.674,0
60,156,0,25904,8,739,2473,325239,80.56,6486201,307.811,27.6,8.273,7292.458,167.295,8.87,0.674,0
60,157,96,26000,5,744,2480,327719,80.56,6486201,307.811,27.6,8.273,7292.458,167.295,8.87,0.674,0
60,158,99,26099,8,752,2491,330210,80.56,6486201,307.811,27.6,8.273,7292.458,167.295,8.87,0.674,0
60,159,209,26308,7,759,2454,332664,80.56,6486201,307.811,27.6,8.273,7292.458,167.295,8.87,0.674,0
60,160,0,26308,5,764,2435,335099,80.56,6486201,307.811,27.6,8.273,7292.458,167.295,8.87,0.674,0
60,161,105,26413,0,764,2432,337531,80.56,6486201,307.811,27.6,8.273,7292.458,167.295,8.87,0.674,0
60,162,98,26511,1,765,2465,339996,80.56,6486201,307.811,27.6,8.273,7292.458,167.295,8.87,0.674,0
60,163,91,26602,5,770,2422,342418,80.56,6486201,307.811,27.6,8.273,7292.458,167.295,8.87,0.674,0
60,164,86,26688,7,777,2500,344918,80.56,6486201,307.811,27.6,8.273,7292.458,167.295,8.87,0.674,0
60,165,163,26851,5,782,2494,347412,80.56,6486201,307.811,27.6,8.273,7292.458,167.295,8.87,0.674,0
60,166,77,26928,3,785,2486,349898,80.56,6486201,307.811,27.6,8.273,7292.458,167.295,8.87,0.674,0
60,167,81,27009,3,788,2481,352379,80.56,6486201,307.811,27.6,8.273,7292.458,167.295,8.87,0.674,0
60,168,79,27088,4,792,2500,354879,80.56,6486201,307.811,27.6,8.273,7292.458,167.295,8.87,0.674,0
60,169,75,27163,4,796,2430,357309,80.56,6486201,307.811,27.6,8.273,7292.458,167.295,8.87,0.674,0
60,170,0,27163,5,801,2456,359765,80.56,6486201,307.811,27.6,8.273,7292.458,167.295,8.87,0.674,0
60,171,86,27249,0,801,2264,362029,80.56,6486201,307.811,27.6,8.273,7292.458,167.295,8.87,0.674,0
60,172,97,27346,7,808,2464,364493,61.11,6486201,307.811,27.6,8.273,7292.458,167.295,8.87,0.674,0
60,173,82,27428,3,811,3427,367920,61.11,6486201,307.811,27.6,8.273,7292.458,167.295,8.87,0.674,0
60,174,125,27553,1,812,3467,371387,61.11,6486201,307.811,27.6,8.273,7292.458,167.295,8.87,0.674,0
60,175,245,27798,2,814,3434,374821,61.11,6486201,307.811,27.6,8.273,7292.458,167.295,8.87,0.674,0
60,176,156,27954,5,819,3452,378273,61.11,6486201,307.811,27.6,8.273,7292.458,167.295,8.87,0.674,0
60,177,0,27954,0,819,5498,383771,61.11,6486201,307.811,27.6,8.273,7292.458,167.295,8.87,0.674,0
60,178,247,28201,4,823,2454,386225,61.11,6486201,307.811,27.6,8.273,7292.458,167.295,8.87,0.674,0
60,179,214,28415,3,826,2423,388648,61.11,6486201,307.811,27.6,8.273,7292.458,167.295,8.87,0.674,0
60,180,0,28415,0,826,2403,391051,61.11,6486201,307.811,27.6,8.273,7292.458,167.295,8.87,0.674,0
60,181,215,28630,0,826,2421,393472,61.11,6486201,307.811,27.6,8.273,7292.458,167.295,8.87,0.674,0
60,182,179,28809,5,831,2449,395921,61.11,6486201,307.811,27.6,8.273,7292.458,167.295,8.87,0.674,0
60,183,172,28981,12,843,2480,398401,52.78,6486201,307.811,27.6,8.273,7292.458,167.295,8.87,0.674,0
60,184,96,29077,0,843,2448,400849,52.78,6486201,307.811,27.6,8.273,7292.458,167.295,8.87,0.674,0
60,185,98,29175,5,848,2496,403345,52.78,6486201,307.811,27.6,8.273,7292.458,167.295,8.87,0.674,0
60,186,0,29175,5,853,2462,405807,52.78,6486201,307.811,27.6,8.273,7292.458,167.295,8.87,0.674,0
60,187,183,29358,10,863,2405,408212,52.78,6486201,307.811,27.6,8.273,7292.458,167.295,8.87,0.674,0
60,188,92,29450,0,863,2410,410622,52.78,6486201,307.811,27.6,8.273,7292.458,167.295,8.87,0.674,0
60,189,193,29643,6,869,2414,413036,52.78,6486201,307.811,27.6,8.273,7292.458,167.295,8.87,0.674,0
60,190,94,29737,4,873,2403,415439,52.78,6486201,307.811,27.6,8.273,7292.458,167.295,8.87,0.674,0
60,191,105,29842,4,877,2441,417880,52.78,6486201,307.811,27.6,8.273,7292.458,167.295,8.87,0.674,0
60,192,0,29842,4,881,2483,420363,52.78,6486201,307.811,27.6,8.273,7292.458,167.295,8.87,0.674,0
60,193,109,29951,0,881,2495,422858,52.78,6486201,307.811,27.6,8.273,7292.458,167.295,8.87,0.674,0
60,194,0,29951,6,887,2437,425295,52.78,6486201,307.811,27.6,8.273,7292.458,167.295,8.87,0.674,0
60,195,245,30196,7,894,2414,427709,52.78,6486201,307.811,27.6,8.273,7292.458,167.295,8.87,0.674,0
60,196,0,30196,0,894,2409,430118,52.78,6486201,307.811,27.6,8.273,7292.458,167.295,8.87,0.674,0
60,197,284,30480,5,899,2463,432581,52.78,6486201,307.811,27.6,8.273,7292.458,167.295,8.87,0.674,0
60,198,286,30766,5,904,5438,438019,52.78,6486201,307.811,27.6,8.273,7292.458,167.295,8.87,0.674,0
60,199,295,31061,8,912,3471,441490,52.78,6486201,307.811,27.6,8.273,7292.458,167.295,8.87,0.674,0
60,200,204,31265,5,917,2433,443923,52.78,6486201,307.811,27.6,8.273,7292.458,167.295,8.87,0.674,0
60,201,191,31456,5,922,0,443923,52.78,6486201,307.811,27.6,8.273,7292.458,167.295,8.87,0.674,0
60,202,210,31666,0,922,0,443923,52.78,6486201,307.811,27.6,8.273,7292.458,167.295,8.87,0.674,0
60,203,0,31666,4,926,0,443923,52.78,6486201,307.811,27.6,8.273,7292.458,167.295,8.87,0.674,0
60,204,309,31975,7,933,0,443923,52.78,6486201,307.811,27.6,8.273,7292.458,167.295,8.87,0.674,0
61,1,1,15,0,0,0,0,0,1402985,45.194,22.4,2.846,22604.873,202.812,7.78,0.591,0
61,2,0,15,0,0,0,0,0,1402985,45.194,22.4,2.846,22604.873,202.812,7.78,0.591,0
61,3,0,15,0,0,0,0,0,1402985,45.194,22.4,2.846,22604.873,202.812,7.78,0.591,0
61,4,1,16,0,0,0,0,0,1402985,45.194,22.4,2.846,22604.873,202.812,7.78,0.591,0
61,5,0,16,0,0,0,0,0,1402985,45.194,22.4,2.846,22604.873,202.812,7.78,0.591,0
61,6,0,16,0,0,0,0,0,1402985,45.194,22.4,2.846,22604.873,202.812,7.78,0.591,0
61,7,0,16,0,0,0,0,0,1402985,45.194,22.4,2.846,22604.873,202.812,7.78,0.591,0
61,8,0,16,0,0,0,0,0,1402985,45.194,22.4,2.846,22604.873,202.812,7.78,0.591,0
61,9,2,18,0,0,0,0,0,1402985,45.194,22.4,2.846,22604.873,202.812,7.78,0.591,0
61,10,0,18,0,0,0,0,0,1402985,45.194,22.4,2.846,22604.873,202.812,7.78,0.591,0
61,11,0,18,0,0,0,0,0,1402985,45.194,22.4,2.846,22604.873,202.812,7.78,0.591,0
61,12,0,18,0,0,0,0,0,1402985,45.194,22.4,2.846,22604.873,202.812,7.78,0.591,0
61,13,3,21,0,0,0,0,0,1402985,45.194,22.4,2.846,22604.873,202.812,7.78,0.591,0
61,14,0,21,0,0,0,0,0,1402985,45.194,22.4,2.846,22604.873,202.812,7.78,0.591,0
61,15,20,41,0,0,0,0,0,1402985,45.194,22.4,2.846,22604.873,202.812,7.78,0.591,0
61,16,10,51,0,0,0,0,0,1402985,45.194,22.4,2.846,22604.873,202.812,7.78,0.591,0
61,17,0,51,0,0,0,0,0,1402985,45.194,22.4,2.846,22604.873,202.812,7.78,0.591,0
61,18,28,79,0,0,0,0,0,1402985,45.194,22.4,2.846,22604.873,202.812,7.78,0.591,0
61,19,0,79,0,0,0,0,0,1402985,45.194,22.4,2.846,22604.873,202.812,7.78,0.591,0
61,20,0,79,0,0,0,0,0,1402985,45.194,22.4,2.846,22604.873,202.812,7.78,0.591,0
61,21,0,79,0,0,0,0,0,1402985,45.194,22.4,2.846,22604.873,202.812,7.78,0.591,0
61,22,0,79,0,0,0,0,0,1402985,45.194,22.4,2.846,22604.873,202.812,7.78,0.591,0
61,23,4,83,0,0,0,0,0,1402985,45.194,22.4,2.846,22604.873,202.812,7.78,0.591,0
61,24,1,84,1,1,0,0,0,1402985,45.194,22.4,2.846,22604.873,202.812,7.78,0.591,0
61,25,128,212,0,1,0,0,0,1402985,45.194,22.4,2.846,22604.873,202.812,7.78,0.591,0
61,26,2,214,0,1,0,0,0,1402985,45.194,22.4,2.846,22604.873,202.812,7.78,0.591,0
61,27,44,258,0,1,0,0,0,1402985,45.194,22.4,2.846,22604.873,202.812,7.78,0.591,0
61,28,0,258,0,1,0,0,0,1402985,45.194,22.4,2.846,22604.873,202.812,7.78,0.591,0
61,29,57,315,0,1,0,0,0,1402985,45.194,22.4,2.846,22604.873,202.812,7.78,0.591,0
61,30,0,315,0,1,0,0,0,1402985,45.194,22.4,2.846,22604.873,202.812,7.78,0.591,0
61,31,0,315,0,1,0,0,0,1402985,45.194,22.4,2.846,22604.873,202.812,7.78,0.591,0
61,32,0,315,0,1,0,0,0,1402985,45.194,22.4,2.846,22604.873,202.812,7.78,0.591,0
61,33,0,315,0,1,0,0,0,1402985,45.194,22.4,2.846,22604.873,202.812,7.78,0.591,0
61,34,0,315,0,1,0,0,0,1402985,45.194,22.4,2.846,22604.873,202.812,7.78,0.591,0
61,35,0,315,1,2,0,0,0,1402985,45.194,22.4,2.846,22604.873,202.812,7.78,0.591,0
61,36,124,439,2,4,0,0,0,1402985,45.194,22.4,2.846,22604.873,202.812,7.78,0.591,0
61,37,0,439,0,4,0,0,0,1402985,45.194,22.4,2.846,22604.873,202.812,7.78,0.591,0
61,38,0,439,0,4,0,0,0,1402985,45.194,22.4,2.846,22604.873,202.812,7.78,0.591,0
61,39,0,439,0,4,0,0,0,1402985,45.194,22.4,2.846,22604.873,202.812,7.78,0.591,0
61,40,0,439,0,4,0,0,0,1402985,45.194,22.4,2.846,22604.873,202.812,7.78,0.591,0
61,41,0,439,0,4,0,0,0,1402985,45.194,22.4,2.846,22604.873,202.812,7.78,0.591,0
61,42,0,439,0,4,0,0,0,1402985,45.194,22.4,2.846,22604.873,202.812,7.78,0.591,0
61,43,0,439,0,4,0,0,0,1402985,45.194,22.4,2.846,22604.873,202.812,7.78,0.591,0
61,44,83,522,2,6,0,0,0,1402985,45.194,22.4,2.846,22604.873,202.812,7.78,0.591,0
61,45,72,594,1,7,0,0,0,1402985,45.194,22.4,2.846,22604.873,202.812,7.78,0.591,0
61,46,0,594,0,7,0,0,0,1402985,45.194,22.4,2.846,22604.873,202.812,7.78,0.591,0
61,47,0,594,0,7,0,0,0,1402985,45.194,22.4,2.846,22604.873,202.812,7.78,0.591,0
61,48,0,594,0,7,0,0,0,1402985,45.194,22.4,2.846,22604.873,202.812,7.78,0.591,0
61,49,125,719,0,7,0,0,0,1402985,45.194,22.4,2.846,22604.873,202.812,7.78,0.591,0
61,50,171,890,0,7,0,0,0,1402985,45.194,22.4,2.846,22604.873,202.812,7.78,0.591,0
61,51,0,890,0,7,0,0,0,1402985,45.194,22.4,2.846,22604.873,202.812,7.78,0.591,0
61,52,13,903,3,10,0,0,0,1402985,45.194,22.4,2.846,22604.873,202.812,7.78,0.591,0
61,53,0,903,0,10,0,0,0,1402985,45.194,22.4,2.846,22604.873,202.812,7.78,0.591,0
61,54,140,1043,2,12,0,0,0,1402985,45.194,22.4,2.846,22604.873,202.812,7.78,0.591,0
61,55,0,1043,0,12,0,0,0,1402985,45.194,22.4,2.846,22604.873,202.812,7.78,0.591,0
61,56,0,1043,0,12,0,0,0,1402985,45.194,22.4,2.846,22604.873,202.812,7.78,0.591,0
61,57,0,1043,0,12,0,0,0,1402985,45.194,22.4,2.846,22604.873,202.812,7.78,0.591,0
61,58,0,1043,0,12,0,0,0,1402985,45.194,22.4,2.846,22604.873,202.812,7.78,0.591,0
61,59,0,1043,0,12,0,0,0,1402985,45.194,22.4,2.846,22604.873,202.812,7.78,0.591,0
61,60,0,1043,0,12,0,0,0,1402985,45.194,22.4,2.846,22604.873,202.812,7.78,0.591,0
61,61,263,1306,0,12,0,0,0,1402985,45.194,22.4,2.846,22604.873,202.812,7.78,0.591,0
61,62,0,1306,0,12,0,0,0,1402985,45.194,22.4,2.846,22604.873,202.812,7.78,0.591,0
61,63,0,1306,0,12,0,0,0,1402985,45.194,22.4,2.846,22604.873,202.812,7.78,0.591,0
61,64,0,1306,0,12,0,0,0,1402985,45.194,22.4,2.846,22604.873,202.812,7.78,0.591,0
61,65,0,1306,0,12,0,0,0,1402985,45.194,22.4,2.846,22604.873,202.812,7.78,0.591,0
61,66,0,1306,0,12,0,0,0,1402985,45.194,22.4,2.846,22604.873,202.812,7.78,0.591,0
61,67,0,1306,0,12,0,0,0,1402985,45.194,22.4,2.846,22604.873,202.812,7.78,0.591,0
61,68,0,1306,0,12,0,0,0,1402985,45.194,22.4,2.846,22604.873,202.812,7.78,0.591,0
61,69,0,1306,0,12,0,0,0,1402985,45.194,22.4,2.846,22604.873,202.812,7.78,0.591,0
61,70,0,1306,0,12,0,0,0,1402985,45.194,22.4,2.846,22604.873,202.812,7.78,0.591,0
61,71,0,1306,0,12,0,0,0,1402985,45.194,22.4,2.846,22604.873,202.812,7.78,0.591,0
61,72,0,1306,0,12,0,0,0,1402985,45.194,22.4,2.846,22604.873,202.812,7.78,0.591,0
61,73,0,1306,0,12,0,0,0,1402985,45.194,22.4,2.846,22604.873,202.812,7.78,0.591,0
61,74,0,1306,0,12,0,0,0,1402985,45.194,22.4,2.846,22604.873,202.812,7.78,0.591,0
61,75,0,1306,0,12,0,0,0,1402985,45.194,22.4,2.846,22604.873,202.812,7.78,0.591,0
61,76,0,1306,0,12,0,0,0,1402985,45.194,22.4,2.846,22604.873,202.812,7.78,0.591,0
61,77,0,1306,0,12,0,0,0,1402985,45.194,22.4,2.846,22604.873,202.812,7.78,0.591,0
61,78,0,1306,0,12,0,0,0,1402985,45.194,22.4,2.846,22604.873,202.812,7.78,0.591,0
61,79,0,1306,0,12,0,0,0,1402985,45.194,22.4,2.846,22604.873,202.812,7.78,0.591,0
61,80,0,1306,0,12,0,0,0,1402985,45.194,22.4,2.846,22604.873,202.812,7.78,0.591,0
61,81,358,1664,20,32,0,0,0,1402985,45.194,22.4,2.846,22604.873,202.812,7.78,0.591,0
61,82,0,1664,0,32,0,0,0,1402985,45.194,22.4,2.846,22604.873,202.812,7.78,0.591,0
61,83,0,1664,0,32,0,0,0,1402985,45.194,22.4,2.846,22604.873,202.812,7.78,0.591,0
61,84,337,2001,0,32,0,0,0,1402985,45.194,22.4,2.846,22604.873,202.812,7.78,0.591,0
61,85,0,2001,0,32,0,0,0,1402985,45.194,22.4,2.846,22604.873,202.812,7.78,0.591,0
61,86,0,2001,0,32,0,0,0,1402985,45.194,22.4,2.846,22604.873,202.812,7.78,0.591,0
61,87,0,2001,0,32,0,0,0,1402985,45.194,22.4,2.846,22604.873,202.812,7.78,0.591,0
61,88,0,2001,0,32,0,0,0,1402985,45.194,22.4,2.846,22604.873,202.812,7.78,0.591,0
61,89,0,2001,0,32,0,0,0,1402985,45.194,22.4,2.846,22604.873,202.812,7.78,0.591,0
61,90,0,2001,0,32,0,0,0,1402985,45.194,22.4,2.846,22604.873,202.812,7.78,0.591,0
61,91,0,2001,0,32,0,0,0,1402985,45.194,22.4,2.846,22604.873,202.812,7.78,0.591,0
61,92,0,2001,0,32,0,0,0,1402985,45.194,22.4,2.846,22604.873,202.812,7.78,0.591,0
61,93,0,2001,0,32,0,0,0,1402985,45.194,22.4,2.846,22604.873,202.812,7.78,0.591,0
61,94,1070,3071,19,51,0,0,0,1402985,45.194,22.4,2.846,22604.873,202.812,7.78,0.591,0
61,95,0,3071,0,51,0,0,0,1402985,45.194,22.4,2.846,22604.873,202.812,7.78,0.591,0
61,96,0,3071,0,51,0,0,0,1402985,45.194,22.4,2.846,22604.873,202.812,7.78,0.591,0
61,97,0,3071,0,51,0,0,0,1402985,45.194,22.4,2.846,22604.873,202.812,7.78,0.591,0
61,98,0,3071,0,51,0,0,0,1402985,45.194,22.4,2.846,22604.873,202.812,7.78,0.591,0
61,99,0,3071,0,51,0,0,0,1402985,45.194,22.4,2.846,22604.873,202.812,7.78,0.591,0
61,100,0,3071,0,51,0,0,0,1402985,45.194,22.4,2.846,22604.873,202.812,7.78,0.591,0
61,101,0,3071,0,51,0,0,0,1402985,45.194,22.4,2.846,22604.873,202.812,7.78,0.591,0
61,102,0,3071,0,51,0,0,0,1402985,45.194,22.4,2.846,22604.873,202.812,7.78,0.591,0
61,103,0,3071,0,51,0,0,0,1402985,45.194,22.4,2.846,22604.873,202.812,7.78,0.591,0
61,104,0,3071,0,51,0,0,0,1402985,45.194,22.4,2.846,22604.873,202.812,7.78,0.591,0
61,105,0,3071,0,51,0,0,0,1402985,45.194,22.4,2.846,22604.873,202.812,7.78,0.591,0
61,106,0,3071,0,51,0,0,0,1402985,45.194,22.4,2.846,22604.873,202.812,7.78,0.591,0
61,107,0,3071,0,51,0,0,0,1402985,45.194,22.4,2.846,22604.873,202.812,7.78,0.591,0
61,108,0,3071,0,51,0,0,0,1402985,45.194,22.4,2.846,22604.873,202.812,7.78,0.591,0
61,109,0,3071,0,51,0,0,0,1402985,45.194,22.4,2.846,22604.873,202.812,7.78,0.591,0
61,110,0,3071,0,51,0,0,0,1402985,45.194,22.4,2.846,22604.873,202.812,7.78,0.591,0
61,111,0,3071,0,51,0,0,0,1402985,45.194,22.4,2.846,22604.873,202.812,7.78,0.591,0
61,112,0,3071,0,51,0,0,0,1402985,45.194,22.4,2.846,22604.873,202.812,7.78,0.591,0
61,113,0,3071,0,51,0,0,0,1402985,45.194,22.4,2.846,22604.873,202.812,7.78,0.591,0
61,114,0,3071,0,51,0,0,0,1402985,45.194,22.4,2.846,22604.873,202.812,7.78,0.591,0
61,115,0,3071,0,51,0,0,0,1402985,45.194,22.4,2.846,22604.873,202.812,7.78,0.591,0
61,116,0,3071,0,51,0,0,0,1402985,45.194,22.4,2.846,22604.873,202.812,7.78,0.591,0
61,117,0,3071,0,51,0,0,0,1402985,45.194,22.4,2.846,22604.873,202.812,7.78,0.591,0
61,118,0,3071,0,51,0,0,0,1402985,45.194,22.4,2.846,22604.873,202.812,7.78,0.591,0
61,119,0,3071,0,51,0,0,0,1402985,45.194,22.4,2.846,22604.873,202.812,7.78,0.591,0
61,120,0,3071,0,51,0,0,0,1402985,45.194,22.4,2.846,22604.873,202.812,7.78,0.591,0
61,121,0,3071,0,51,0,0,0,1402985,45.194,22.4,2.846,22604.873,202.812,7.78,0.591,0
61,122,0,3071,0,51,0,0,0,1402985,45.194,22.4,2.846,22604.873,202.812,7.78,0.591,0
61,123,0,3071,0,51,0,0,0,1402985,45.194,22.4,2.846,22604.873,202.812,7.78,0.591,0
61,124,1750,4821,32,83,0,0,0,1402985,45.194,22.4,2.846,22604.873,202.812,7.78,0.591,0
61,125,0,4821,0,83,0,0,0,1402985,45.194,22.4,2.846,22604.873,202.812,7.78,0.591,0
61,126,0,4821,0,83,0,0,0,1402985,45.194,22.4,2.846,22604.873,202.812,7.78,0.591,0
61,127,0,4821,0,83,0,0,0,1402985,45.194,22.4,2.846,22604.873,202.812,7.78,0.591,0
61,128,0,4821,0,83,0,0,0,1402985,45.194,22.4,2.846,22604.873,202.812,7.78,0.591,0
61,129,0,4821,0,83,0,0,0,1402985,45.194,22.4,2.846,22604.873,202.812,7.78,0.591,0
61,130,0,4821,0,83,0,0,0,1402985,45.194,22.4,2.846,22604.873,202.812,7.78,0.591,0
61,131,0,4821,0,83,0,0,0,1402985,45.194,22.4,2.846,22604.873,202.812,7.78,0.591,0
61,132,0,4821,0,83,0,0,0,1402985,45.194,22.4,2.846,22604.873,202.812,7.78,0.591,0
61,133,0,4821,0,83,0,0,0,1402985,45.194,22.4,2.846,22604.873,202.812,7.78,0.591,0
61,134,0,4821,0,83,0,0,0,1402985,45.194,22.4,2.846,22604.873,202.812,7.78,0.591,0
61,135,0,4821,0,83,0,0,0,1402985,45.194,22.4,2.846,22604.873,202.812,7.78,0.591,0
61,136,0,4821,0,83,0,0,0,1402985,45.194,22.4,2.846,22604.873,202.812,7.78,0.591,0
61,137,0,4821,0,83,0,0,0,1402985,45.194,22.4,2.846,22604.873,202.812,7.78,0.591,0
61,138,0,4821,0,83,0,0,0,1402985,45.194,22.4,2.846,22604.873,202.812,7.78,0.591,0
61,139,0,4821,0,83,0,0,0,1402985,45.194,22.4,2.846,22604.873,202.812,7.78,0.591,0
61,140,0,4821,0,83,0,0,0,1402985,45.194,22.4,2.846,22604.873,202.812,7.78,0.591,0
61,141,71,4892,0,83,0,0,0,1402985,45.194,22.4,2.846,22604.873,202.812,7.78,0.591,0
61,142,0,4892,0,83,0,0,0,1402985,45.194,22.4,2.846,22604.873,202.812,7.78,0.591,0
61,143,0,4892,0,83,0,0,0,1402985,45.194,22.4,2.846,22604.873,202.812,7.78,0.591,0
61,144,0,4892,0,83,0,0,0,1402985,45.194,22.4,2.846,22604.873,202.812,7.78,0.591,0
61,145,34,4926,0,83,0,0,0,1402985,45.194,22.4,2.846,22604.873,202.812,7.78,0.591,0
61,146,0,4926,0,83,0,0,0,1402985,45.194,22.4,2.846,22604.873,202.812,7.78,0.591,0
61,147,0,4926,0,83,0,0,0,1402985,45.194,22.4,2.846,22604.873,202.812,7.78,0.591,0
61,148,0,4926,0,83,0,0,0,1402985,45.194,22.4,2.846,22604.873,202.812,7.78,0.591,0
61,149,0,4926,0,83,0,0,0,1402985,45.194,22.4,2.846,22604.873,202.812,7.78,0.591,0
61,150,2,4928,0,83,0,0,0,1402985,45.194,22.4,2.846,22604.873,202.812,7.78,0.591,0
61,151,0,4928,0,83,0,0,0,1402985,45.194,22.4,2.846,22604.873,202.812,7.78,0.591,0
61,152,13,4941,0,83,0,0,0,1402985,45.194,22.4,2.846,22604.873,202.812,7.78,0.591,0
61,153,0,4941,0,83,0,0,0,1402985,45.194,22.4,2.846,22604.873,202.812,7.78,0.591,0
61,154,0,4941,0,83,0,0,0,1402985,45.194,22.4,2.846,22604.873,202.812,7.78,0.591,0
61,155,24,4965,0,83,0,0,0,1402985,45.194,22.4,2.846,22604.873,202.812,7.78,0.591,0
61,156,0,4965,0,83,0,0,0,1402985,45.194,22.4,2.846,22604.873,202.812,7.78,0.591,0
61,157,0,4965,0,83,0,0,0,1402985,45.194,22.4,2.846,22604.873,202.812,7.78,0.591,0
61,158,7,4972,0,83,0,0,0,1402985,45.194,22.4,2.846,22604.873,202.812,7.78,0.591,0
61,159,0,4972,0,83,0,0,0,1402985,45.194,22.4,2.846,22604.873,202.812,7.78,0.591,0
61,160,0,4972,0,83,0,0,0,1402985,45.194,22.4,2.846,22604.873,202.812,7.78,0.591,0
61,161,0,4972,0,83,0,0,0,1402985,45.194,22.4,2.846,22604.873,202.812,7.78,0.591,0
61,162,13,4985,0,83,0,0,0,1402985,45.194,22.4,2.846,22604.873,202.812,7.78,0.591,0
61,163,0,4985,0,83,0,0,0,1402985,45.194,22.4,2.846,22604.873,202.812,7.78,0.591,0
61,164,5,4990,0,83,0,0,0,1402985,45.194,22.4,2.846,22604.873,202.812,7.78,0.591,0
61,165,0,4990,0,83,0,0,0,1402985,45.194,22.4,2.846,22604.873,202.812,7.78,0.591,0
61,166,6,4996,0,83,0,0,0,1402985,45.194,22.4,2.846,22604.873,202.812,7.78,0.591,0
61,167,0,4996,0,83,0,0,0,1402985,45.194,22.4,2.846,22604.873,202.812,7.78,0.591,0
61,168,4,5000,0,83,0,0,0,1402985,45.194,22.4,2.846,22604.873,202.812,7.78,0.591,0
61,169,0,5000,0,83,0,0,0,1402985,45.194,22.4,2.846,22604.873,202.812,7.78,0.591,0
61,170,0,5000,0,83,0,0,0,1402985,45.194,22.4,2.846,22604.873,202.812,7.78,0.591,0
61,171,0,5000,0,83,0,0,0,1402985,45.194,22.4,2.846,22604.873,202.812,7.78,0.591,0
61,172,2,5002,0,83,0,0,0,1402985,45.194,22.4,2.846,22604.873,202.812,7.78,0.591,0
61,173,0,5002,0,83,0,0,0,1402985,45.194,22.4,2.846,22604.873,202.812,7.78,0.591,0
61,174,0,5002,0,83,0,0,0,1402985,45.194,22.4,2.846,22604.873,202.812,7.78,0.591,0
61,175,16,5018,0,83,0,0,0,1402985,45.194,22.4,2.846,22604.873,202.812,7.78,0.591,0
61,176,0,5018,0,83,0,0,0,1402985,45.194,22.4,2.846,22604.873,202.812,7.78,0.591,0
61,177,0,5018,0,83,0,0,0,1402985,45.194,22.4,2.846,22604.873,202.812,7.78,0.591,0
61,178,0,5018,0,83,0,0,0,1402985,45.194,22.4,2.846,22604.873,202.812,7.78,0.591,0
61,179,0,5018,0,83,0,0,0,1402985,45.194,22.4,2.846,22604.873,202.812,7.78,0.591,0
61,180,10,5028,0,83,0,0,0,1402985,45.194,22.4,2.846,22604.873,202.812,7.78,0.591,0
61,181,0,5028,0,83,0,0,0,1402985,45.194,22.4,2.846,22604.873,202.812,7.78,0.591,0
61,182,0,5028,0,83,0,0,0,1402985,45.194,22.4,2.846,22604.873,202.812,7.78,0.591,0
61,183,2,5030,0,83,0,0,0,1402985,45.194,22.4,2.846,22604.873,202.812,7.78,0.591,0
61,184,0,5030,0,83,0,0,0,1402985,45.194,22.4,2.846,22604.873,202.812,7.78,0.591,0
61,185,15,5045,0,83,0,0,0,1402985,45.194,22.4,2.846,22604.873,202.812,7.78,0.591,0
61,186,0,5045,0,83,0,0,0,1402985,45.194,22.4,2.846,22604.873,202.812,7.78,0.591,0
61,187,0,5045,0,83,0,0,0,1402985,45.194,22.4,2.846,22604.873,202.812,7.78,0.591,0
61,188,0,5045,0,83,0,0,0,1402985,45.194,22.4,2.846,22604.873,202.812,7.78,0.591,0
61,189,7,5052,0,83,0,0,0,1402985,45.194,22.4,2.846,22604.873,202.812,7.78,0.591,0
61,190,0,5052,0,83,0,0,0,1402985,45.194,22.4,2.846,22604.873,202.812,7.78,0.591,0
61,191,10,5062,0,83,0,0,0,1402985,45.194,22.4,2.846,22604.873,202.812,7.78,0.591,0
61,192,0,5062,0,83,0,0,0,1402985,45.194,22.4,2.846,22604.873,202.812,7.78,0.591,0
61,193,1,5063,0,83,0,0,0,1402985,45.194,22.4,2.846,22604.873,202.812,7.78,0.591,0
61,194,0,5063,0,83,0,0,0,1402985,45.194,22.4,2.846,22604.873,202.812,7.78,0.591,0
61,195,0,5063,0,83,0,0,0,1402985,45.194,22.4,2.846,22604.873,202.812,7.78,0.591,0
61,196,3,5066,0,83,0,0,0,1402985,45.194,22.4,2.846,22604.873,202.812,7.78,0.591,0
61,197,0,5066,0,83,0,0,0,1402985,45.194,22.4,2.846,22604.873,202.812,7.78,0.591,0
61,198,2,5068,0,83,0,0,0,1402985,45.194,22.4,2.846,22604.873,202.812,7.78,0.591,0
61,199,0,5068,0,83,0,0,0,1402985,45.194,22.4,2.846,22604.873,202.812,7.78,0.591,0
61,200,2,5070,0,83,0,0,0,1402985,45.194,22.4,2.846,22604.873,202.812,7.78,0.591,0
61,201,0,5070,0,83,0,0,0,1402985,45.194,22.4,2.846,22604.873,202.812,7.78,0.591,0
61,202,0,5070,0,83,0,0,0,1402985,45.194,22.4,2.846,22604.873,202.812,7.78,0.591,0
61,203,0,5070,0,83,0,0,0,1402985,45.194,22.4,2.846,22604.873,202.812,7.78,0.591,0
61,204,4,5074,0,83,0,0,0,1402985,45.194,22.4,2.846,22604.873,202.812,7.78,0.591,0
62,1,3,15,0,0,0,0,93.52,3546427,44.304,19.3,3.607,1510.459,311.11,6.05,0.44,0
62,2,3,18,0,0,0,0,93.52,3546427,44.304,19.3,3.607,1510.459,311.11,6.05,0.44,0
62,3,4,22,0,0,0,0,93.52,3546427,44.304,19.3,3.607,1510.459,311.11,6.05,0.44,0
62,4,0,22,0,0,0,0,93.52,3546427,44.304,19.3,3.607,1510.459,311.11,6.05,0.44,0
62,5,7,29,0,0,0,0,93.52,3546427,44.304,19.3,3.607,1510.459,311.11,6.05,0.44,0
62,6,0,29,0,0,0,0,93.52,3546427,44.304,19.3,3.607,1510.459,311.11,6.05,0.44,0
62,7,2,31,0,0,0,0,93.52,3546427,44.304,19.3,3.607,1510.459,311.11,6.05,0.44,0
62,8,0,31,0,0,0,0,93.52,3546427,44.304,19.3,3.607,1510.459,311.11,6.05,0.44,0
62,9,2,33,0,0,0,0,93.52,3546427,44.304,19.3,3.607,1510.459,311.11,6.05,0.44,0
62,10,0,33,0,0,0,0,93.52,3546427,44.304,19.3,3.607,1510.459,311.11,6.05,0.44,0
62,11,1,34,0,0,0,0,93.52,3546427,44.304,19.3,3.607,1510.459,311.11,6.05,0.44,0
62,12,0,34,0,0,0,0,93.52,3546427,44.304,19.3,3.607,1510.459,311.11,6.05,0.44,0
62,13,0,34,0,0,0,0,93.52,3546427,44.304,19.3,3.607,1510.459,311.11,6.05,0.44,0
62,14,0,34,0,0,0,0,93.52,3546427,44.304,19.3,3.607,1510.459,311.11,6.05,0.44,0
62,15,1,35,0,0,0,0,93.52,3546427,44.304,19.3,3.607,1510.459,311.11,6.05,0.44,0
62,16,0,35,0,0,0,0,93.52,3546427,44.304,19.3,3.607,1510.459,311.11,6.05,0.44,0
62,17,0,35,0,0,0,0,93.52,3546427,44.304,19.3,3.607,1510.459,311.11,6.05,0.44,0
62,18,0,35,0,0,0,0,93.52,3546427,44.304,19.3,3.607,1510.459,311.11,6.05,0.44,0
62,19,0,35,0,0,0,0,93.52,3546427,44.304,19.3,3.607,1510.459,311.11,6.05,0.44,0
62,20,4,39,0,0,0,0,93.52,3546427,44.304,19.3,3.607,1510.459,311.11,6.05,0.44,0
62,21,0,39,0,0,0,0,93.52,3546427,44.304,19.3,3.607,1510.459,311.11,6.05,0.44,0
62,22,0,39,0,0,0,0,93.52,3546427,44.304,19.3,3.607,1510.459,311.11,6.05,0.44,0
62,23,0,39,0,0,0,0,93.52,3546427,44.304,19.3,3.607,1510.459,311.11,6.05,0.44,0
62,24,0,39,0,0,0,0,93.52,3546427,44.304,19.3,3.607,1510.459,311.11,6.05,0.44,0
62,25,0,39,0,0,0,0,93.52,3546427,44.304,19.3,3.607,1510.459,311.11,6.05,0.44,0
62,26,0,39,0,0,0,0,93.52,3546427,44.304,19.3,3.607,1510.459,311.11,6.05,0.44,0
62,27,0,39,0,0,0,0,93.52,3546427,44.304,19.3,3.607,1510.459,311.11,6.05,0.44,0
62,28,0,39,0,0,0,0,93.52,3546427,44.304,19.3,3.607,1510.459,311.11,6.05,0.44,0
62,29,0,39,0,0,0,0,93.52,3546427,44.304,19.3,3.607,1510.459,311.11,6.05,0.44,0
62,30,0,39,0,0,0,0,93.52,3546427,44.304,19.3,3.607,1510.459,311.11,6.05,0.44,0
62,31,0,39,0,0,0,0,93.52,3546427,44.304,19.3,3.607,1510.459,311.11,6.05,0.44,0
62,32,0,39,0,0,0,0,93.52,3546427,44.304,19.3,3.607,1510.459,311.11,6.05,0.44,0
62,33,0,39,0,0,0,0,93.52,3546427,44.304,19.3,3.607,1510.459,311.11,6.05,0.44,0
62,34,0,39,0,0,0,0,93.52,3546427,44.304,19.3,3.607,1510.459,311.11,6.05,0.44,0
62,35,0,39,0,0,0,0,93.52,3546427,44.304,19.3,3.607,1510.459,311.11,6.05,0.44,0
62,36,0,39,0,0,0,0,93.52,3546427,44.304,19.3,3.607,1510.459,311.11,6.05,0.44,0
62,37,0,39,0,0,0,0,93.52,3546427,44.304,19.3,3.607,1510.459,311.11,6.05,0.44,0
62,38,0,39,0,0,0,0,93.52,3546427,44.304,19.3,3.607,1510.459,311.11,6.05,0.44,0
62,39,0,39,0,0,0,0,93.52,3546427,44.304,19.3,3.607,1510.459,311.11,6.05,0.44,0
62,40,0,39,0,0,0,0,93.52,3546427,44.304,19.3,3.607,1510.459,311.11,6.05,0.44,0
62,41,0,39,0,0,0,0,93.52,3546427,44.304,19.3,3.607,1510.459,311.11,6.05,0.44,0
62,42,0,39,0,0,0,0,93.52,3546427,44.304,19.3,3.607,1510.459,311.11,6.05,0.44,0
62,43,0,39,0,0,0,0,93.52,3546427,44.304,19.3,3.607,1510.459,311.11,6.05,0.44,0
62,44,0,39,0,0,0,0,93.52,3546427,44.304,19.3,3.607,1510.459,311.11,6.05,0.44,0
62,45,0,39,0,0,0,0,93.52,3546427,44.304,19.3,3.607,1510.459,311.11,6.05,0.44,0
62,46,0,39,0,0,0,0,93.52,3546427,44.304,19.3,3.607,1510.459,311.11,6.05,0.44,0
62,47,0,39,0,0,0,0,93.52,3546427,44.304,19.3,3.607,1510.459,311.11,6.05,0.44,0
62,48,0,39,0,0,0,0,93.52,3546427,44.304,19.3,3.607,1510.459,311.11,6.05,0.44,0
62,49,0,39,0,0,0,0,93.52,3546427,44.304,19.3,3.607,1510.459,311.11,6.05,0.44,0
62,50,0,39,0,0,0,0,93.52,3546427,44.304,19.3,3.607,1510.459,311.11,6.05,0.44,0
62,51,0,39,0,0,0,0,93.52,3546427,44.304,19.3,3.607,1510.459,311.11,6.05,0.44,0
62,52,0,39,0,0,0,0,93.52,3546427,44.304,19.3,3.607,1510.459,311.11,6.05,0.44,0
62,53,0,39,0,0,0,0,93.52,3546427,44.304,19.3,3.607,1510.459,311.11,6.05,0.44,0
62,54,0,39,0,0,0,0,93.52,3546427,44.304,19.3,3.607,1510.459,311.11,6.05,0.44,0
62,55,0,39,0,0,0,0,93.52,3546427,44.304,19.3,3.607,1510.459,311.11,6.05,0.44,0
62,56,0,39,0,0,0,0,93.52,3546427,44.304,19.3,3.607,1510.459,311.11,6.05,0.44,0
62,57,0,39,0,0,0,0,93.52,3546427,44.304,19.3,3.607,1510.459,311.11,6.05,0.44,0
62,58,0,39,0,0,0,0,93.52,3546427,44.304,19.3,3.607,1510.459,311.11,6.05,0.44,0
62,59,0,39,0,0,0,0,93.52,3546427,44.304,19.3,3.607,1510.459,311.11,6.05,0.44,0
62,60,0,39,0,0,0,0,93.52,3546427,44.304,19.3,3.607,1510.459,311.11,6.05,0.44,0
62,61,0,39,0,0,0,0,93.52,3546427,44.304,19.3,3.607,1510.459,311.11,6.05,0.44,0
62,62,0,39,0,0,0,0,93.52,3546427,44.304,19.3,3.607,1510.459,311.11,6.05,0.44,0
62,63,0,39,0,0,0,0,93.52,3546427,44.304,19.3,3.607,1510.459,311.11,6.05,0.44,0
62,64,0,39,0,0,0,0,93.52,3546427,44.304,19.3,3.607,1510.459,311.11,6.05,0.44,0
62,65,1,40,0,0,0,0,93.52,3546427,44.304,19.3,3.607,1510.459,311.11,6.05,0.44,0
62,66,1,41,0,0,0,0,93.52,3546427,44.304,19.3,3.607,1510.459,311.11,6.05,0.44,0
62,67,0,41,0,0,0,0,93.52,3546427,44.304,19.3,3.607,1510.459,311.11,6.05,0.44,0
62,68,0,41,0,0,0,0,93.52,3546427,44.304,19.3,3.607,1510.459,311.11,6.05,0.44,0
62,69,0,41,0,0,0,0,93.52,3546427,44.304,19.3,3.607,1510.459,311.11,6.05,0.44,0
62,70,0,41,0,0,0,0,93.52,3546427,44.304,19.3,3.607,1510.459,311.11,6.05,0.44,0
62,71,0,41,0,0,0,0,93.52,3546427,44.304,19.3,3.607,1510.459,311.11,6.05,0.44,0
62,72,0,41,0,0,0,0,93.52,3546427,44.304,19.3,3.607,1510.459,311.11,6.05,0.44,0
62,73,0,41,0,0,0,0,93.52,3546427,44.304,19.3,3.607,1510.459,311.11,6.05,0.44,0
62,74,0,41,0,0,0,0,93.52,3546427,44.304,19.3,3.607,1510.459,311.11,6.05,0.44,0
62,75,24,65,0,0,0,0,93.52,3546427,44.304,19.3,3.607,1510.459,311.11,6.05,0.44,0
62,76,31,96,0,0,0,0,93.52,3546427,44.304,19.3,3.607,1510.459,311.11,6.05,0.44,0
62,77,13,109,0,0,0,0,93.52,3546427,44.304,19.3,3.607,1510.459,311.11,6.05,0.44,0
62,78,12,121,0,0,0,0,93.52,3546427,44.304,19.3,3.607,1510.459,311.11,6.05,0.44,0
62,79,10,131,0,0,0,0,93.52,3546427,44.304,19.3,3.607,1510.459,311.11,6.05,0.44,0
62,80,11,142,0,0,0,0,93.52,3546427,44.304,19.3,3.607,1510.459,311.11,6.05,0.44,0
62,81,0,142,0,0,0,0,93.52,3546427,44.304,19.3,3.607,1510.459,311.11,6.05,0.44,0
62,82,1,143,0,0,0,0,93.52,3546427,44.304,19.3,3.607,1510.459,311.11,6.05,0.44,0
62,83,0,143,0,0,0,0,93.52,3546427,44.304,19.3,3.607,1510.459,311.11,6.05,0.44,0
62,84,0,143,0,0,0,0,93.52,3546427,44.304,19.3,3.607,1510.459,311.11,6.05,0.44,0
62,85,0,143,0,0,0,0,93.52,3546427,44.304,19.3,3.607,1510.459,311.11,6.05,0.44,0
62,86,0,143,0,0,0,0,93.52,3546427,44.304,19.3,3.607,1510.459,311.11,6.05,0.44,0
62,87,1,144,0,0,0,0,93.52,3546427,44.304,19.3,3.607,1510.459,311.11,6.05,0.44,0
62,88,23,167,0,0,0,0,93.52,3546427,44.304,19.3,3.607,1510.459,311.11,6.05,0.44,0
62,89,24,191,0,0,0,0,93.52,3546427,44.304,19.3,3.607,1510.459,311.11,6.05,0.44,0
62,90,0,191,0,0,0,0,93.52,3546427,44.304,19.3,3.607,1510.459,311.11,6.05,0.44,0
62,91,0,191,0,0,0,0,93.52,3546427,44.304,19.3,3.607,1510.459,311.11,6.05,0.44,0
62,92,12,203,0,0,0,0,93.52,3546427,44.304,19.3,3.607,1510.459,311.11,6.05,0.44,0
62,93,0,203,0,0,0,0,93.52,3546427,44.304,19.3,3.607,1510.459,311.11,6.05,0.44,0
62,94,12,215,0,0,0,0,93.52,3546427,44.304,19.3,3.607,1510.459,311.11,6.05,0.44,0
62,95,0,215,0,0,0,0,93.52,3546427,44.304,19.3,3.607,1510.459,311.11,6.05,0.44,0
62,96,0,215,0,0,0,0,93.52,3546427,44.304,19.3,3.607,1510.459,311.11,6.05,0.44,0
62,97,0,215,0,0,0,0,93.52,3546427,44.304,19.3,3.607,1510.459,311.11,6.05,0.44,0
62,98,0,215,0,0,0,0,93.52,3546427,44.304,19.3,3.607,1510.459,311.11,6.05,0.44,0
62,99,0,215,0,0,0,0,93.52,3546427,44.304,19.3,3.607,1510.459,311.11,6.05,0.44,0
62,100,0,215,0,0,0,0,93.52,3546427,44.304,19.3,3.607,1510.459,311.11,6.05,0.44,0
62,101,17,232,0,0,0,0,93.52,3546427,44.304,19.3,3.607,1510.459,311.11,6.05,0.44,0
62,102,0,232,0,0,0,0,93.52,3546427,44.304,19.3,3.607,1510.459,311.11,6.05,0.44,0
62,103,0,232,0,0,0,0,93.52,3546427,44.304,19.3,3.607,1510.459,311.11,6.05,0.44,0
62,104,0,232,0,0,0,0,93.52,3546427,44.304,19.3,3.607,1510.459,311.11,6.05,0.44,0
62,105,0,232,0,0,0,0,93.52,3546427,44.304,19.3,3.607,1510.459,311.11,6.05,0.44,0
62,106,0,232,0,0,0,0,93.52,3546427,44.304,19.3,3.607,1510.459,311.11,6.05,0.44,0
62,107,0,232,0,0,0,0,93.52,3546427,44.304,19.3,3.607,1510.459,311.11,6.05,0.44,0
62,108,19,251,0,0,0,0,93.52,3546427,44.304,19.3,3.607,1510.459,311.11,6.05,0.44,0
62,109,0,251,0,0,0,0,93.52,3546427,44.304,19.3,3.607,1510.459,311.11,6.05,0.44,0
62,110,0,251,0,0,0,0,93.52,3546427,44.304,19.3,3.607,1510.459,311.11,6.05,0.44,0
62,111,0,251,0,0,0,0,93.52,3546427,44.304,19.3,3.607,1510.459,311.11,6.05,0.44,0
62,112,0,251,0,0,0,0,93.52,3546427,44.304,19.3,3.607,1510.459,311.11,6.05,0.44,0
62,113,0,251,0,0,0,0,93.52,3546427,44.304,19.3,3.607,1510.459,311.11,6.05,0.44,0
62,114,0,251,0,0,0,0,93.52,3546427,44.304,19.3,3.607,1510.459,311.11,6.05,0.44,0
62,115,10,261,0,0,0,0,93.52,3546427,44.304,19.3,3.607,1510.459,311.11,6.05,0.44,0
62,116,0,261,0,0,0,0,93.52,3546427,44.304,19.3,3.607,1510.459,311.11,6.05,0.44,0
62,117,2,263,0,0,0,0,93.52,3546427,44.304,19.3,3.607,1510.459,311.11,6.05,0.44,0
62,118,0,263,0,0,0,0,93.52,3546427,44.304,19.3,3.607,1510.459,311.11,6.05,0.44,0
62,119,2,265,0,0,0,0,93.52,3546427,44.304,19.3,3.607,1510.459,311.11,6.05,0.44,0
62,120,0,265,0,0,0,0,93.52,3546427,44.304,19.3,3.607,1510.459,311.11,6.05,0.44,0
62,121,0,265,0,0,0,0,93.52,3546427,44.304,19.3,3.607,1510.459,311.11,6.05,0.44,0
62,122,14,279,0,0,0,0,93.52,3546427,44.304,19.3,3.607,1510.459,311.11,6.05,0.44,0
62,123,0,279,0,0,0,0,93.52,3546427,44.304,19.3,3.607,1510.459,311.11,6.05,0.44,0
62,124,0,279,0,0,0,0,93.52,3546427,44.304,19.3,3.607,1510.459,311.11,6.05,0.44,0
62,125,0,279,0,0,0,0,93.52,3546427,44.304,19.3,3.607,1510.459,311.11,6.05,0.44,0
62,126,3,282,0,0,0,0,93.52,3546427,44.304,19.3,3.607,1510.459,311.11,6.05,0.44,0
62,127,0,282,0,0,0,0,93.52,3546427,44.304,19.3,3.607,1510.459,311.11,6.05,0.44,0
62,128,0,282,0,0,0,0,93.52,3546427,44.304,19.3,3.607,1510.459,311.11,6.05,0.44,0
62,129,0,282,0,0,0,0,93.52,3546427,44.304,19.3,3.607,1510.459,311.11,6.05,0.44,0
62,130,3,285,0,0,0,0,93.52,3546427,44.304,19.3,3.607,1510.459,311.11,6.05,0.44,0
62,131,0,285,0,0,0,0,93.52,3546427,44.304,19.3,3.607,1510.459,311.11,6.05,0.44,0
62,132,0,285,0,0,0,0,93.52,3546427,44.304,19.3,3.607,1510.459,311.11,6.05,0.44,0
62,133,0,285,0,0,0,0,93.52,3546427,44.304,19.3,3.607,1510.459,311.11,6.05,0.44,0
62,134,0,285,0,0,0,0,93.52,3546427,44.304,19.3,3.607,1510.459,311.11,6.05,0.44,0
62,135,0,285,0,0,0,0,93.52,3546427,44.304,19.3,3.607,1510.459,311.11,6.05,0.44,0
62,136,0,285,0,0,0,0,93.52,3546427,44.304,19.3,3.607,1510.459,311.11,6.05,0.44,0
62,137,0,285,0,0,0,0,93.52,3546427,44.304,19.3,3.607,1510.459,311.11,6.05,0.44,0
62,138,0,285,0,0,0,0,93.52,3546427,44.304,19.3,3.607,1510.459,311.11,6.05,0.44,0
62,139,0,285,0,0,0,0,93.52,3546427,44.304,19.3,3.607,1510.459,311.11,6.05,0.44,0
62,140,0,285,0,0,0,0,93.52,3546427,44.304,19.3,3.607,1510.459,311.11,6.05,0.44,0
62,141,19,304,0,0,0,0,93.52,3546427,44.304,19.3,3.607,1510.459,311.11,6.05,0.44,0
62,142,0,304,0,0,0,0,93.52,3546427,44.304,19.3,3.607,1510.459,311.11,6.05,0.44,0
62,143,0,304,0,0,0,0,93.52,3546427,44.304,19.3,3.607,1510.459,311.11,6.05,0.44,0
62,144,2,306,0,0,0,0,93.52,3546427,44.304,19.3,3.607,1510.459,311.11,6.05,0.44,0
62,145,0,306,0,0,0,0,93.52,3546427,44.304,19.3,3.607,1510.459,311.11,6.05,0.44,0
62,146,0,306,0,0,0,0,93.52,3546427,44.304,19.3,3.607,1510.459,311.11,6.05,0.44,0
62,147,0,306,0,0,0,0,93.52,3546427,44.304,19.3,3.607,1510.459,311.11,6.05,0.44,0
62,148,9,315,0,0,0,0,93.52,3546427,44.304,19.3,3.607,1510.459,311.11,6.05,0.44,0
62,149,0,315,0,0,0,0,93.52,3546427,44.304,19.3,3.607,1510.459,311.11,6.05,0.44,0
62,150,2,317,0,0,0,0,93.52,3546427,44.304,19.3,3.607,1510.459,311.11,6.05,0.44,0
62,151,0,317,0,0,0,0,93.52,3546427,44.304,19.3,3.607,1510.459,311.11,6.05,0.44,0
62,152,1,318,0,0,0,0,93.52,3546427,44.304,19.3,3.607,1510.459,311.11,6.05,0.44,0
62,153,0,318,0,0,0,0,93.52,3546427,44.304,19.3,3.607,1510.459,311.11,6.05,0.44,0
62,154,0,318,0,0,0,0,93.52,3546427,44.304,19.3,3.607,1510.459,311.11,6.05,0.44,0
62,155,1,319,0,0,0,0,93.52,3546427,44.304,19.3,3.607,1510.459,311.11,6.05,0.44,0
62,156,0,319,0,0,0,0,93.52,3546427,44.304,19.3,3.607,1510.459,311.11,6.05,0.44,0
62,157,11,330,0,0,0,0,93.52,3546427,44.304,19.3,3.607,1510.459,311.11,6.05,0.44,0
62,158,0,330,0,0,0,0,93.52,3546427,44.304,19.3,3.607,1510.459,311.11,6.05,0.44,0
62,159,0,330,0,0,0,0,93.52,3546427,44.304,19.3,3.607,1510.459,311.11,6.05,0.44,0
62,160,0,330,0,0,0,0,96.3,3546427,44.304,19.3,3.607,1510.459,311.11,6.05,0.44,0
62,161,0,330,0,0,0,0,96.3,3546427,44.304,19.3,3.607,1510.459,311.11,6.05,0.44,0
62,162,11,341,0,0,0,0,96.3,3546427,44.304,19.3,3.607,1510.459,311.11,6.05,0.44,0
62,163,0,341,0,0,0,0,96.3,3546427,44.304,19.3,3.607,1510.459,311.11,6.05,0.44,0
62,164,20,361,0,0,0,0,96.3,3546427,44.304,19.3,3.607,1510.459,311.11,6.05,0.44,0
62,165,0,361,0,0,0,0,96.3,3546427,44.304,19.3,3.607,1510.459,311.11,6.05,0.44,0
62,166,0,361,0,0,0,0,96.3,3546427,44.304,19.3,3.607,1510.459,311.11,6.05,0.44,0
62,167,0,361,0,0,0,0,96.3,3546427,44.304,19.3,3.607,1510.459,311.11,6.05,0.44,0
62,168,0,361,0,0,0,0,96.3,3546427,44.304,19.3,3.607,1510.459,311.11,6.05,0.44,0
62,169,0,361,0,0,0,0,96.3,3546427,44.304,19.3,3.607,1510.459,311.11,6.05,0.44,0
62,170,3,364,0,0,0,0,96.3,3546427,44.304,19.3,3.607,1510.459,311.11,6.05,0.44,0
62,171,0,364,0,0,0,0,89.81,3546427,44.304,19.3,3.607,1510.459,311.11,6.05,0.44,0
62,172,0,364,0,0,0,0,89.81,3546427,44.304,19.3,3.607,1510.459,311.11,6.05,0.44,0
62,173,0,364,0,0,0,0,89.81,3546427,44.304,19.3,3.607,1510.459,311.11,6.05,0.44,0
62,174,0,364,0,0,0,0,89.81,3546427,44.304,19.3,3.607,1510.459,311.11,6.05,0.44,0
62,175,0,364,0,0,0,0,89.81,3546427,44.304,19.3,3.607,1510.459,311.11,6.05,0.44,0
62,176,0,364,0,0,0,0,89.81,3546427,44.304,19.3,3.607,1510.459,311.11,6.05,0.44,0
62,177,0,364,0,0,0,0,89.81,3546427,44.304,19.3,3.607,1510.459,311.11,6.05,0.44,0
62,178,0,364,0,0,0,0,89.81,3546427,44.304,19.3,3.607,1510.459,311.11,6.05,0.44,0
62,179,5,369,0,0,0,0,89.81,3546427,44.304,19.3,3.607,1510.459,311.11,6.05,0.44,0
62,180,6,375,0,0,0,0,89.81,3546427,44.304,19.3,3.607,1510.459,311.11,6.05,0.44,0
62,181,0,375,0,0,0,0,89.81,3546427,44.304,19.3,3.607,1510.459,311.11,6.05,0.44,0
62,182,0,375,0,0,0,0,86.11,3546427,44.304,19.3,3.607,1510.459,311.11,6.05,0.44,0
62,183,0,375,0,0,0,0,86.11,3546427,44.304,19.3,3.607,1510.459,311.11,6.05,0.44,0
62,184,0,375,0,0,0,0,86.11,3546427,44.304,19.3,3.607,1510.459,311.11,6.05,0.44,0
62,185,0,375,0,0,0,0,86.11,3546427,44.304,19.3,3.607,1510.459,311.11,6.05,0.44,0
62,186,6,381,0,0,0,0,86.11,3546427,44.304,19.3,3.607,1510.459,311.11,6.05,0.44,0
62,187,17,398,0,0,0,0,86.11,3546427,44.304,19.3,3.607,1510.459,311.11,6.05,0.44,0
62,188,0,398,0,0,0,0,86.11,3546427,44.304,19.3,3.607,1510.459,311.11,6.05,0.44,0
62,189,0,398,0,0,0,0,86.11,3546427,44.304,19.3,3.607,1510.459,311.11,6.05,0.44,0
62,190,0,398,0,0,0,0,86.11,3546427,44.304,19.3,3.607,1510.459,311.11,6.05,0.44,0
62,191,0,398,0,0,0,0,86.11,3546427,44.304,19.3,3.607,1510.459,311.11,6.05,0.44,0
62,192,7,405,0,0,0,0,86.11,3546427,44.304,19.3,3.607,1510.459,311.11,6.05,0.44,0
62,193,0,405,0,0,0,0,86.11,3546427,44.304,19.3,3.607,1510.459,311.11,6.05,0.44,0
62,194,9,414,0,0,0,0,86.11,3546427,44.304,19.3,3.607,1510.459,311.11,6.05,0.44,0
62,195,0,414,0,0,0,0,86.11,3546427,44.304,19.3,3.607,1510.459,311.11,6.05,0.44,0
62,196,0,414,0,0,0,0,86.11,3546427,44.304,19.3,3.607,1510.459,311.11,6.05,0.44,0
62,197,0,414,0,0,0,0,86.11,3546427,44.304,19.3,3.607,1510.459,311.11,6.05,0.44,0
62,198,0,414,0,0,0,0,86.11,3546427,44.304,19.3,3.607,1510.459,311.11,6.05,0.44,0
62,199,0,414,0,0,0,0,86.11,3546427,44.304,19.3,3.607,1510.459,311.11,6.05,0.44,0
62,200,8,422,0,0,0,0,86.11,3546427,44.304,19.3,3.607,1510.459,311.11,6.05,0.44,0
62,201,0,422,0,0,0,0,86.11,3546427,44.304,19.3,3.607,1510.459,311.11,6.05,0.44,0
62,202,3,425,0,0,0,0,86.11,3546427,44.304,19.3,3.607,1510.459,311.11,6.05,0.44,0
62,203,27,452,0,0,0,0,86.11,3546427,44.304,19.3,3.607,1510.459,311.11,6.05,0.44,0
62,204,0,452,0,0,0,0,86.11,3546427,44.304,19.3,3.607,1510.459,311.11,6.05,0.44,0
63,1,30,745,1,4,1375,15758,77.78,1326539,31.033,42.7,19.452,29481.252,255.569,4.02,0.871,0
63,2,34,779,1,5,2506,18264,77.78,1326539,31.033,42.7,19.452,29481.252,255.569,4.02,0.871,0
63,3,79,858,6,11,1533,19797,77.78,1326539,31.033,42.7,19.452,29481.252,255.569,4.02,0.871,0
63,4,103,961,1,12,1186,20983,77.78,1326539,31.033,42.7,19.452,29481.252,255.569,4.02,0.871,0
63,5,57,1018,1,13,859,21842,77.78,1326539,31.033,42.7,19.452,29481.252,255.569,4.02,0.871,0
63,6,79,1097,2,15,1679,23521,77.78,1326539,31.033,42.7,19.452,29481.252,255.569,4.02,0.871,0
63,7,11,1108,4,19,1272,24793,77.78,1326539,31.033,42.7,19.452,29481.252,255.569,4.02,0.871,0
63,8,41,1149,2,21,1605,26398,77.78,1326539,31.033,42.7,19.452,29481.252,255.569,4.02,0.871,0
63,9,36,1185,3,24,1466,27864,77.78,1326539,31.033,42.7,19.452,29481.252,255.569,4.02,0.871,0
63,10,22,1207,0,24,1570,29434,77.78,1326539,31.033,42.7,19.452,29481.252,255.569,4.02,0.871,0
63,11,51,1258,0,24,895,30329,77.78,1326539,31.033,42.7,19.452,29481.252,255.569,4.02,0.871,0
63,12,46,1304,0,24,409,30738,77.78,1326539,31.033,42.7,19.452,29481.252,255.569,4.02,0.871,0
63,13,5,1309,1,25,1508,32246,77.78,1326539,31.033,42.7,19.452,29481.252,255.569,4.02,0.871,0
63,14,23,1332,3,28,1706,33952,77.78,1326539,31.033,42.7,19.452,29481.252,255.569,4.02,0.871,0
63,15,41,1373,3,31,2049,36001,77.78,1326539,31.033,42.7,19.452,29481.252,255.569,4.02,0.871,0
63,16,29,1402,4,35,1572,37573,77.78,1326539,31.033,42.7,19.452,29481.252,255.569,4.02,0.871,0
63,17,32,1434,1,36,2010,39583,77.78,1326539,31.033,42.7,19.452,29481.252,255.569,4.02,0.871,0
63,18,25,1459,2,38,722,40305,77.78,1326539,31.033,42.7,19.452,29481.252,255.569,4.02,0.871,0
63,19,53,1512,0,38,599,40904,77.78,1326539,31.033,42.7,19.452,29481.252,255.569,4.02,0.871,0
63,20,16,1528,2,40,1289,42193,77.78,1326539,31.033,42.7,19.452,29481.252,255.569,4.02,0.871,0
63,21,7,1535,0,40,1420,43613,77.78,1326539,31.033,42.7,19.452,29481.252,255.569,4.02,0.871,0
63,22,17,1552,3,43,1545,45158,77.78,1326539,31.033,42.7,19.452,29481.252,255.569,4.02,0.871,0
63,23,7,1559,1,44,1099,46257,77.78,1326539,31.033,42.7,19.452,29481.252,255.569,4.02,0.871,0
63,24,33,1592,1,45,1050,47307,77.78,1326539,31.033,42.7,19.452,29481.252,255.569,4.02,0.871,0
63,25,13,1605,1,46,603,47910,77.78,1326539,31.033,42.7,19.452,29481.252,255.569,4.02,0.871,0
63,26,30,1635,0,46,469,48379,77.78,1326539,31.033,42.7,19.452,29481.252,255.569,4.02,0.871,0
63,27,8,1643,3,49,1108,49487,75,1326539,31.033,42.7,19.452,29481.252,255.569,4.02,0.871,0
63,28,4,1647,1,50,1670,51157,75,1326539,31.033,42.7,19.452,29481.252,255.569,4.02,0.871,0
63,29,13,1660,0,50,1560,52717,75,1326539,31.033,42.7,19.452,29481.252,255.569,4.02,0.871,0
63,30,6,1666,0,50,1027,53744,75,1326539,31.033,42.7,19.452,29481.252,255.569,4.02,0.871,0
63,31,23,1689,2,52,694,54438,75,1326539,31.033,42.7,19.452,29481.252,255.569,4.02,0.871,0
63,32,5,1694,0,52,734,55172,75,1326539,31.033,42.7,19.452,29481.252,255.569,4.02,0.871,0
63,33,5,1699,1,53,576,55748,75,1326539,31.033,42.7,19.452,29481.252,255.569,4.02,0.871,0
63,34,1,1700,2,55,1648,57396,75,1326539,31.033,42.7,19.452,29481.252,255.569,4.02,0.871,0
63,35,3,1703,0,55,1538,58934,75,1326539,31.033,42.7,19.452,29481.252,255.569,4.02,0.871,0
63,36,8,1711,0,55,1538,60472,75,1326539,31.033,42.7,19.452,29481.252,255.569,4.02,0.871,0
63,37,2,1713,0,55,1276,61748,75,1326539,31.033,42.7,19.452,29481.252,255.569,4.02,0.871,0
63,38,7,1720,1,56,950,62698,66.67,1326539,31.033,42.7,19.452,29481.252,255.569,4.02,0.871,0
63,39,5,1725,0,56,649,63347,66.67,1326539,31.033,42.7,19.452,29481.252,255.569,4.02,0.871,0
63,40,8,1733,4,60,590,63937,66.67,1326539,31.033,42.7,19.452,29481.252,255.569,4.02,0.871,0
63,41,6,1739,0,60,1012,64949,62.96,1326539,31.033,42.7,19.452,29481.252,255.569,4.02,0.871,0
63,42,2,1741,1,61,1126,66075,62.96,1326539,31.033,42.7,19.452,29481.252,255.569,4.02,0.871,0
63,43,5,1746,0,61,1040,67115,62.96,1326539,31.033,42.7,19.452,29481.252,255.569,4.02,0.871,0
63,44,5,1751,0,61,965,68080,62.96,1326539,31.033,42.7,19.452,29481.252,255.569,4.02,0.871,0
63,45,7,1758,1,62,745,68825,55.56,1326539,31.033,42.7,19.452,29481.252,255.569,4.02,0.871,0
63,46,8,1766,1,63,677,69502,55.56,1326539,31.033,42.7,19.452,29481.252,255.569,4.02,0.871,0
63,47,4,1770,0,63,667,70169,55.56,1326539,31.033,42.7,19.452,29481.252,255.569,4.02,0.871,0
63,48,4,1774,0,63,1256,71425,50,1326539,31.033,42.7,19.452,29481.252,255.569,4.02,0.871,0
63,49,10,1784,0,63,1019,72444,50,1326539,31.033,42.7,19.452,29481.252,255.569,4.02,0.871,0
63,50,7,1791,0,63,1272,73716,50,1326539,31.033,42.7,19.452,29481.252,255.569,4.02,0.871,0
63,51,3,1794,0,63,876,74592,50,1326539,31.033,42.7,19.452,29481.252,255.569,4.02,0.871,0
63,52,6,1800,0,63,649,75241,50,1326539,31.033,42.7,19.452,29481.252,255.569,4.02,0.871,0
63,53,7,1807,0,63,527,75768,50,1326539,31.033,42.7,19.452,29481.252,255.569,4.02,0.871,0
63,54,14,1821,0,63,808,76576,50,1326539,31.033,42.7,19.452,29481.252,255.569,4.02,0.871,0
63,55,2,1823,0,63,1497,78073,50,1326539,31.033,42.7,19.452,29481.252,255.569,4.02,0.871,0
63,56,1,1824,0,63,1522,79595,50,1326539,31.033,42.7,19.452,29481.252,255.569,4.02,0.871,0
63,57,10,1834,0,63,1119,80714,50,1326539,31.033,42.7,19.452,29481.252,255.569,4.02,0.871,0
63,58,6,1840,0,63,994,81708,50,1326539,31.033,42.7,19.452,29481.252,255.569,4.02,0.871,0
63,59,11,1851,0,63,1033,82741,50,1326539,31.033,42.7,19.452,29481.252,255.569,4.02,0.871,0
63,60,8,1859,0,63,691,83432,50,1326539,31.033,42.7,19.452,29481.252,255.569,4.02,0.871,0
63,61,6,1865,0,63,711,84143,50,1326539,31.033,42.7,19.452,29481.252,255.569,4.02,0.871,0
63,62,4,1869,0,63,1023,85166,37.96,1326539,31.033,42.7,19.452,29481.252,255.569,4.02,0.871,0
63,63,1,1870,0,63,1258,86424,37.96,1326539,31.033,42.7,19.452,29481.252,255.569,4.02,0.871,0
63,64,0,1870,0,63,1023,87447,37.96,1326539,31.033,42.7,19.452,29481.252,255.569,4.02,0.871,0
63,65,10,1880,0,63,1116,88563,37.96,1326539,31.033,42.7,19.452,29481.252,255.569,4.02,0.871,0
63,66,10,1890,0,63,853,89416,37.96,1326539,31.033,42.7,19.452,29481.252,255.569,4.02,0.871,0
63,67,20,1910,0,63,648,90064,37.96,1326539,31.033,42.7,19.452,29481.252,255.569,4.02,0.871,0
63,68,21,1931,0,63,548,90612,37.96,1326539,31.033,42.7,19.452,29481.252,255.569,4.02,0.871,0
63,69,8,1939,0,63,1114,91726,37.96,1326539,31.033,42.7,19.452,29481.252,255.569,4.02,0.871,0
63,70,1,1940,0,63,1153,92879,37.96,1326539,31.033,42.7,19.452,29481.252,255.569,4.02,0.871,0
63,71,7,1947,0,63,951,93830,37.96,1326539,31.033,42.7,19.452,29481.252,255.569,4.02,0.871,0
63,72,11,1958,0,63,880,94710,37.96,1326539,31.033,42.7,19.452,29481.252,255.569,4.02,0.871,0
63,73,7,1965,0,63,661,95371,37.96,1326539,31.033,42.7,19.452,29481.252,255.569,4.02,0.871,0
63,74,5,1970,0,63,615,95986,37.96,1326539,31.033,42.7,19.452,29481.252,255.569,4.02,0.871,0
63,75,3,1973,0,63,643,96629,37.96,1326539,31.033,42.7,19.452,29481.252,255.569,4.02,0.871,0
63,76,0,1973,0,63,1067,97696,37.96,1326539,31.033,42.7,19.452,29481.252,255.569,4.02,0.871,0
63,77,1,1974,0,63,1449,99145,37.96,1326539,31.033,42.7,19.452,29481.252,255.569,4.02,0.871,0
63,78,1,1975,0,63,1241,100386,37.96,1326539,31.033,42.7,19.452,29481.252,255.569,4.02,0.871,0
63,79,2,1977,0,63,1355,101741,37.96,1326539,31.033,42.7,19.452,29481.252,255.569,4.02,0.871,0
63,80,0,1977,0,63,744,102485,37.96,1326539,31.033,42.7,19.452,29481.252,255.569,4.02,0.871,0
63,81,2,1979,0,63,440,102925,37.96,1326539,31.033,42.7,19.452,29481.252,255.569,4.02,0.871,0
63,82,2,1981,0,63,285,103210,37.96,1326539,31.033,42.7,19.452,29481.252,255.569,4.02,0.871,0
63,83,0,1981,0,63,474,103684,37.96,1326539,31.033,42.7,19.452,29481.252,255.569,4.02,0.871,0
63,84,0,1981,0,63,266,103950,37.96,1326539,31.033,42.7,19.452,29481.252,255.569,4.02,0.871,0
63,85,1,1982,0,63,348,104298,37.96,1326539,31.033,42.7,19.452,29481.252,255.569,4.02,0.871,0
63,86,1,1983,0,63,562,104860,37.96,1326539,31.033,42.7,19.452,29481.252,255.569,4.02,0.871,0
63,87,1,1984,0,63,446,105306,37.96,1326539,31.033,42.7,19.452,29481.252,255.569,4.02,0.871,0
63,88,2,1986,0,63,363,105669,25,1326539,31.033,42.7,19.452,29481.252,255.569,4.02,0.871,0
63,89,0,1986,0,63,350,106019,25,1326539,31.033,42.7,19.452,29481.252,255.569,4.02,0.871,0
63,90,1,1987,0,63,763,106782,25,1326539,31.033,42.7,19.452,29481.252,255.569,4.02,0.871,0
63,91,0,1987,0,63,656,107438,25,1326539,31.033,42.7,19.452,29481.252,255.569,4.02,0.871,0
63,92,2,1989,0,63,710,108148,22.22,1326539,31.033,42.7,19.452,29481.252,255.569,4.02,0.871,0
63,93,0,1989,0,63,390,108538,22.22,1326539,31.033,42.7,19.452,29481.252,255.569,4.02,0.871,0
63,94,1,1990,0,63,264,108802,22.22,1326539,31.033,42.7,19.452,29481.252,255.569,4.02,0.871,0
63,95,1,1991,0,63,287,109089,22.22,1326539,31.033,42.7,19.452,29481.252,255.569,4.02,0.871,0
63,96,2,1993,0,63,291,109380,22.22,1326539,31.033,42.7,19.452,29481.252,255.569,4.02,0.871,0
63,97,0,1993,0,63,592,109972,22.22,1326539,31.033,42.7,19.452,29481.252,255.569,4.02,0.871,0
63,98,1,1994,0,63,574,110546,22.22,1326539,31.033,42.7,19.452,29481.252,255.569,4.02,0.871,0
63,99,1,1995,0,63,476,111022,22.22,1326539,31.033,42.7,19.452,29481.252,255.569,4.02,0.871,0
63,100,8,2003,0,63,444,111466,22.22,1326539,31.033,42.7,19.452,29481.252,255.569,4.02,0.871,0
63,101,8,2011,0,63,338,111804,22.22,1326539,31.033,42.7,19.452,29481.252,255.569,4.02,0.871,0
63,102,2,2013,0,63,151,111955,22.22,1326539,31.033,42.7,19.452,29481.252,255.569,4.02,0.871,0
63,103,1,2014,0,63,215,112170,22.22,1326539,31.033,42.7,19.452,29481.252,255.569,4.02,0.871,0
63,104,0,2014,0,63,408,112578,22.22,1326539,31.033,42.7,19.452,29481.252,255.569,4.02,0.871,0
63,105,0,2014,0,63,538,113116,22.22,1326539,31.033,42.7,19.452,29481.252,255.569,4.02,0.871,0
63,106,1,2015,0,63,437,113553,22.22,1326539,31.033,42.7,19.452,29481.252,255.569,4.02,0.871,0
63,107,1,2016,0,63,425,113978,22.22,1326539,31.033,42.7,19.452,29481.252,255.569,4.02,0.871,0
63,108,0,2016,0,63,287,114265,22.22,1326539,31.033,42.7,19.452,29481.252,255.569,4.02,0.871,0
63,109,4,2020,0,63,157,114422,22.22,1326539,31.033,42.7,19.452,29481.252,255.569,4.02,0.871,0
63,110,1,2021,0,63,90,114512,22.22,1326539,31.033,42.7,19.452,29481.252,255.569,4.02,0.871,0
63,111,0,2021,0,63,374,114886,22.22,1326539,31.033,42.7,19.452,29481.252,255.569,4.02,0.871,0
63,112,0,2021,0,63,514,115400,22.22,1326539,31.033,42.7,19.452,29481.252,255.569,4.02,0.871,0
63,113,1,2022,0,63,483,115883,22.22,1326539,31.033,42.7,19.452,29481.252,255.569,4.02,0.871,0
63,114,3,2025,0,63,373,116256,22.22,1326539,31.033,42.7,19.452,29481.252,255.569,4.02,0.871,0
63,115,2,2027,0,63,362,116618,22.22,1326539,31.033,42.7,19.452,29481.252,255.569,4.02,0.871,0
63,116,1,2028,0,63,238,116856,22.22,1326539,31.033,42.7,19.452,29481.252,255.569,4.02,0.871,0
63,117,5,2033,0,63,118,116974,22.22,1326539,31.033,42.7,19.452,29481.252,255.569,4.02,0.871,0
63,118,1,2034,0,63,277,117251,22.22,1326539,31.033,42.7,19.452,29481.252,255.569,4.02,0.871,0
63,119,4,2038,0,63,549,117800,19.44,1326539,31.033,42.7,19.452,29481.252,255.569,4.02,0.871,0
63,120,0,2038,0,63,680,118480,19.44,1326539,31.033,42.7,19.452,29481.252,255.569,4.02,0.871,0
63,121,4,2042,0,63,715,119195,19.44,1326539,31.033,42.7,19.452,29481.252,255.569,4.02,0.871,0
63,122,9,2051,0,63,530,119725,19.44,1326539,31.033,42.7,19.452,29481.252,255.569,4.02,0.871,0
63,123,13,2064,0,63,344,120069,19.44,1326539,31.033,42.7,19.452,29481.252,255.569,4.02,0.871,0
63,124,8,2072,0,63,251,120320,19.44,1326539,31.033,42.7,19.452,29481.252,255.569,4.02,0.871,0
63,125,7,2079,0,63,635,120955,19.44,1326539,31.033,42.7,19.452,29481.252,255.569,4.02,0.871,0
63,126,1,2080,0,63,957,121912,19.44,1326539,31.033,42.7,19.452,29481.252,255.569,4.02,0.871,0
63,127,11,2091,0,63,950,122862,19.44,1326539,31.033,42.7,19.452,29481.252,255.569,4.02,0.871,0
63,128,22,2113,0,63,958,123820,19.44,1326539,31.033,42.7,19.452,29481.252,255.569,4.02,0.871,0
63,129,11,2124,0,63,1397,125217,19.44,1326539,31.033,42.7,19.452,29481.252,255.569,4.02,0.871,0
63,130,9,2133,0,63,380,125597,19.44,1326539,31.033,42.7,19.452,29481.252,255.569,4.02,0.871,0
63,131,14,2147,0,63,1113,126710,19.44,1326539,31.033,42.7,19.452,29481.252,255.569,4.02,0.871,0
63,132,5,2152,0,63,1495,128205,19.44,1326539,31.033,42.7,19.452,29481.252,255.569,4.02,0.871,0
63,133,6,2158,0,63,1425,129630,19.44,1326539,31.033,42.7,19.452,29481.252,255.569,4.02,0.871,0
63,134,9,2167,0,63,1191,130821,19.44,1326539,31.033,42.7,19.452,29481.252,255.569,4.02,0.871,0
63,135,7,2174,0,63,1451,132272,19.44,1326539,31.033,42.7,19.452,29481.252,255.569,4.02,0.871,0
63,136,0,2174,0,63,1236,133508,19.44,1326539,31.033,42.7,19.452,29481.252,255.569,4.02,0.871,0
63,137,3,2177,0,63,1042,134550,19.44,1326539,31.033,42.7,19.452,29481.252,255.569,4.02,0.871,0
63,138,7,2184,0,63,307,134857,19.44,1326539,31.033,42.7,19.452,29481.252,255.569,4.02,0.871,0
63,139,6,2190,0,63,1270,136127,19.44,1326539,31.033,42.7,19.452,29481.252,255.569,4.02,0.871,0
63,140,2,2192,0,63,1157,137284,19.44,1326539,31.033,42.7,19.452,29481.252,255.569,4.02,0.871,0
63,141,8,2200,0,63,881,138165,19.44,1326539,31.033,42.7,19.452,29481.252,255.569,4.02,0.871,0
63,142,7,2207,0,63,892,139057,19.44,1326539,31.033,42.7,19.452,29481.252,255.569,4.02,0.871,0
63,143,20,2227,0,63,1149,140206,19.44,1326539,31.033,42.7,19.452,29481.252,255.569,4.02,0.871,0
63,144,17,2244,0,63,456,140662,19.44,1326539,31.033,42.7,19.452,29481.252,255.569,4.02,0.871,0
63,145,21,2265,0,63,314,140976,19.44,1326539,31.033,42.7,19.452,29481.252,255.569,4.02,0.871,0
63,146,7,2272,0,63,1174,142150,19.44,1326539,31.033,42.7,19.452,29481.252,255.569,4.02,0.871,0
63,147,3,2275,1,64,1336,143486,19.44,1326539,31.033,42.7,19.452,29481.252,255.569,4.02,0.871,0
63,148,19,2294,0,64,1374,144860,19.44,1326539,31.033,42.7,19.452,29481.252,255.569,4.02,0.871,0
63,149,17,2311,0,64,1264,146124,19.44,1326539,31.033,42.7,19.452,29481.252,255.569,4.02,0.871,0
63,150,14,2325,0,64,1111,147235,19.44,1326539,31.033,42.7,19.452,29481.252,255.569,4.02,0.871,0
63,151,18,2343,0,64,664,147899,19.44,1326539,31.033,42.7,19.452,29481.252,255.569,4.02,0.871,0
63,152,20,2363,0,64,220,148119,19.44,1326539,31.033,42.7,19.452,29481.252,255.569,4.02,0.871,0
63,153,10,2373,0,64,2216,150335,19.44,1326539,31.033,42.7,19.452,29481.252,255.569,4.02,0.871,0
63,154,2,2375,0,64,1579,151914,19.44,1326539,31.033,42.7,19.452,29481.252,255.569,4.02,0.871,0
63,155,20,2395,0,64,2259,154173,19.44,1326539,31.033,42.7,19.452,29481.252,255.569,4.02,0.871,0
63,156,20,2415,0,64,2101,156274,19.44,1326539,31.033,42.7,19.452,29481.252,255.569,4.02,0.871,0
63,157,26,2441,0,64,2355,158629,19.44,1326539,31.033,42.7,19.452,29481.252,255.569,4.02,0.871,0
63,158,15,2456,0,64,1064,159693,19.44,1326539,31.033,42.7,19.452,29481.252,255.569,4.02,0.871,0
63,159,34,2490,0,64,711,160404,19.44,1326539,31.033,42.7,19.452,29481.252,255.569,4.02,0.871,0
63,160,25,2515,0,64,1731,162135,19.44,1326539,31.033,42.7,19.452,29481.252,255.569,4.02,0.871,0
63,161,16,2531,0,64,1830,163965,19.44,1326539,31.033,42.7,19.452,29481.252,255.569,4.02,0.871,0
63,162,32,2563,0,64,1894,165859,19.44,1326539,31.033,42.7,19.452,29481.252,255.569,4.02,0.871,0
63,163,22,2585,0,64,1834,167693,19.44,1326539,31.033,42.7,19.452,29481.252,255.569,4.02,0.871,0
63,164,15,2600,0,64,2194,169887,19.44,1326539,31.033,42.7,19.452,29481.252,255.569,4.02,0.871,0
63,165,32,2632,0,64,1594,171481,19.44,1326539,31.033,42.7,19.452,29481.252,255.569,4.02,0.871,0
63,166,23,2655,0,64,1350,172831,19.44,1326539,31.033,42.7,19.452,29481.252,255.569,4.02,0.871,0
63,167,21,2676,0,64,2234,175065,22.22,1326539,31.033,42.7,19.452,29481.252,255.569,4.02,0.871,0
63,168,22,2698,0,64,2423,177488,22.22,1326539,31.033,42.7,19.452,29481.252,255.569,4.02,0.871,0
63,169,24,2722,0,64,2957,180445,22.22,1326539,31.033,42.7,19.452,29481.252,255.569,4.02,0.871,0
63,170,34,2756,0,64,2175,182620,22.22,1326539,31.033,42.7,19.452,29481.252,255.569,4.02,0.871,0
63,171,22,2778,0,64,3192,185812,22.22,1326539,31.033,42.7,19.452,29481.252,255.569,4.02,0.871,0
63,172,36,2814,0,64,1810,187622,22.22,1326539,31.033,42.7,19.452,29481.252,255.569,4.02,0.871,0
63,173,61,2875,0,64,1570,189192,22.22,1326539,31.033,42.7,19.452,29481.252,255.569,4.02,0.871,0
63,174,49,2924,0,64,2840,192032,22.22,1326539,31.033,42.7,19.452,29481.252,255.569,4.02,0.871,0
63,175,17,2941,0,64,2320,194352,22.22,1326539,31.033,42.7,19.452,29481.252,255.569,4.02,0.871,0
63,176,35,2976,0,64,3011,197363,22.22,1326539,31.033,42.7,19.452,29481.252,255.569,4.02,0.871,0
63,177,57,3033,0,64,2528,199891,22.22,1326539,31.033,42.7,19.452,29481.252,255.569,4.02,0.871,0
63,178,43,3076,0,64,2639,202530,22.22,1326539,31.033,42.7,19.452,29481.252,255.569,4.02,0.871,0
63,179,42,3118,0,64,2335,204865,22.22,1326539,31.033,42.7,19.452,29481.252,255.569,4.02,0.871,0
63,180,47,3165,0,64,2868,207733,22.22,1326539,31.033,42.7,19.452,29481.252,255.569,4.02,0.871,0
63,181,35,3200,0,64,2537,210270,22.22,1326539,31.033,42.7,19.452,29481.252,255.569,4.02,0.871,0
63,182,67,3267,0,64,2718,212988,22.22,1326539,31.033,42.7,19.452,29481.252,255.569,4.02,0.871,0
63,183,48,3315,0,64,2678,215666,22.22,1326539,31.033,42.7,19.452,29481.252,255.569,4.02,0.871,0
63,184,56,3371,0,64,2026,217692,22.22,1326539,31.033,42.7,19.452,29481.252,255.569,4.02,0.871,0
63,185,79,3450,1,65,2419,220111,22.22,1326539,31.033,42.7,19.452,29481.252,255.569,4.02,0.871,0
63,186,57,3507,1,66,1229,221340,22.22,1326539,31.033,42.7,19.452,29481.252,255.569,4.02,0.871,0
63,187,70,3577,1,67,624,221964,22.22,1326539,31.033,42.7,19.452,29481.252,255.569,4.02,0.871,0
63,188,30,3607,0,67,2181,224145,22.22,1326539,31.033,42.7,19.452,29481.252,255.569,4.02,0.871,0
63,189,10,3617,0,67,1138,225283,22.22,1326539,31.033,42.7,19.452,29481.252,255.569,4.02,0.871,0
63,190,42,3659,0,67,2616,227899,22.22,1326539,31.033,42.7,19.452,29481.252,255.569,4.02,0.871,0
63,191,56,3715,0,67,1679,229578,22.22,1326539,31.033,42.7,19.452,29481.252,255.569,4.02,0.871,0
63,192,45,3760,0,67,1809,231387,22.22,1326539,31.033,42.7,19.452,29481.252,255.569,4.02,0.871,0
63,193,49,3809,1,68,951,232338,22.22,1326539,31.033,42.7,19.452,29481.252,255.569,4.02,0.871,0
63,194,37,3846,0,68,868,233206,22.22,1326539,31.033,42.7,19.452,29481.252,255.569,4.02,0.871,0
63,195,19,3865,0,68,1985,235191,22.22,1326539,31.033,42.7,19.452,29481.252,255.569,4.02,0.871,0
63,196,18,3883,0,68,1647,236838,22.22,1326539,31.033,42.7,19.452,29481.252,255.569,4.02,0.871,0
63,197,25,3908,0,68,1997,238835,22.22,1326539,31.033,42.7,19.452,29481.252,255.569,4.02,0.871,0
63,198,39,3947,0,68,1264,240099,22.22,1326539,31.033,42.7,19.452,29481.252,255.569,4.02,0.871,0
63,199,33,3980,0,68,1759,241858,22.22,1326539,31.033,42.7,19.452,29481.252,255.569,4.02,0.871,0
63,200,37,4017,0,68,796,242654,22.22,1326539,31.033,42.7,19.452,29481.252,255.569,4.02,0.871,0
63,201,35,4052,0,68,676,243330,22.22,1326539,31.033,42.7,19.452,29481.252,255.569,4.02,0.871,0
63,202,26,4078,0,68,1706,245036,22.22,1326539,31.033,42.7,19.452,29481.252,255.569,4.02,0.871,0
63,203,7,4085,0,68,0,245036,22.22,1326539,31.033,42.7,19.452,29481.252,255.569,4.02,0.871,0
63,204,42,4127,3,71,0,245036,22.22,1326539,31.033,42.7,19.452,29481.252,255.569,4.02,0.871,0
64,1,2,25,0,0,68,1081,68.52,114963583,104.957,19.8,3.526,1729.927,182.634,7.47,0.463,3
64,2,4,29,0,0,65,1146,68.52,114963583,104.957,19.8,3.526,1729.927,182.634,7.47,0.463,3
64,3,0,29,0,0,74,1220,68.52,114963583,104.957,19.8,3.526,1729.927,182.634,7.47,0.463,3
64,4,6,35,0,0,91,1311,68.52,114963583,104.957,19.8,3.526,1729.927,182.634,7.47,0.463,3
64,5,3,38,0,0,532,1843,68.52,114963583,104.957,19.8,3.526,1729.927,182.634,7.47,0.463,3
64,6,5,43,2,2,164,2007,68.52,114963583,104.957,19.8,3.526,1729.927,182.634,7.47,0.463,3
64,7,1,44,0,2,264,2271,68.52,114963583,104.957,19.8,3.526,1729.927,182.634,7.47,0.463,3
64,8,8,52,0,2,225,2496,80.56,114963583,104.957,19.8,3.526,1729.927,182.634,7.47,0.463,3
64,9,3,55,0,2,294,2790,80.56,114963583,104.957,19.8,3.526,1729.927,182.634,7.47,0.463,3
64,10,1,56,0,2,442,3232,80.56,114963583,104.957,19.8,3.526,1729.927,182.634,7.47,0.463,3
64,11,9,65,0,2,345,3577,80.56,114963583,104.957,19.8,3.526,1729.927,182.634,7.47,0.463,3
64,12,4,69,1,3,286,3863,80.56,114963583,104.957,19.8,3.526,1729.927,182.634,7.47,0.463,3
64,13,2,71,0,3,247,4110,80.56,114963583,104.957,19.8,3.526,1729.927,182.634,7.47,0.463,3
64,14,3,74,0,3,447,4557,80.56,114963583,104.957,19.8,3.526,1729.927,182.634,7.47,0.463,3
64,15,8,82,0,3,431,4988,80.56,114963583,104.957,19.8,3.526,1729.927,182.634,7.47,0.463,3
64,16,3,85,0,3,401,5389,80.56,114963583,104.957,19.8,3.526,1729.927,182.634,7.47,0.463,3
64,17,7,92,0,3,842,6231,80.56,114963583,104.957,19.8,3.526,1729.927,182.634,7.47,0.463,3
64,18,4,96,0,3,659,6890,80.56,114963583,104.957,19.8,3.526,1729.927,182.634,7.47,0.463,3
64,19,9,105,0,3,667,7557,80.56,114963583,104.957,19.8,3.526,1729.927,182.634,7.47,0.463,3
64,20,3,108,0,3,396,7953,80.56,114963583,104.957,19.8,3.526,1729.927,182.634,7.47,0.463,3
64,21,3,111,0,3,745,8698,80.56,114963583,104.957,19.8,3.526,1729.927,182.634,7.47,0.463,3
64,22,3,114,0,3,1073,9771,80.56,114963583,104.957,19.8,3.526,1729.927,182.634,7.47,0.463,3
64,23,2,116,0,3,965,10736,80.56,114963583,104.957,19.8,3.526,1729.927,182.634,7.47,0.463,3
64,24,0,116,0,3,933,11669,80.56,114963583,104.957,19.8,3.526,1729.927,182.634,7.47,0.463,3
64,25,1,117,0,3,1019,12688,80.56,114963583,104.957,19.8,3.526,1729.927,182.634,7.47,0.463,3
64,26,5,122,0,3,957,13645,80.56,114963583,104.957,19.8,3.526,1729.927,182.634,7.47,0.463,3
64,27,1,123,0,3,943,14588,80.56,114963583,104.957,19.8,3.526,1729.927,182.634,7.47,0.463,3
64,28,1,124,0,3,1080,15668,80.56,114963583,104.957,19.8,3.526,1729.927,182.634,7.47,0.463,3
64,29,2,126,0,3,766,16434,80.56,114963583,104.957,19.8,3.526,1729.927,182.634,7.47,0.463,3
64,30,4,130,0,3,1408,17842,80.56,114963583,104.957,19.8,3.526,1729.927,182.634,7.47,0.463,3
64,31,1,131,0,3,912,18754,80.56,114963583,104.957,19.8,3.526,1729.927,182.634,7.47,0.463,3
64,32,2,133,0,3,1103,19857,80.56,114963583,104.957,19.8,3.526,1729.927,182.634,7.47,0.463,3
64,33,0,133,0,3,2473,22330,80.56,114963583,104.957,19.8,3.526,1729.927,182.634,7.47,0.463,3
64,34,2,135,0,3,1758,24088,80.56,114963583,104.957,19.8,3.526,1729.927,182.634,7.47,0.463,3
64,35,5,140,0,3,1047,25135,80.56,114963583,104.957,19.8,3.526,1729.927,182.634,7.47,0.463,3
64,36,5,145,1,4,1382,26517,80.56,114963583,104.957,19.8,3.526,1729.927,182.634,7.47,0.463,3
64,37,17,162,0,4,1928,28445,80.56,114963583,104.957,19.8,3.526,1729.927,182.634,7.47,0.463,3
64,38,29,191,0,4,1861,30306,80.56,114963583,104.957,19.8,3.526,1729.927,182.634,7.47,0.463,3
64,39,3,194,0,4,2383,32689,80.56,114963583,104.957,19.8,3.526,1729.927,182.634,7.47,0.463,3
64,40,16,210,1,5,2171,34860,80.56,114963583,104.957,19.8,3.526,1729.927,182.634,7.47,0.463,3
64,41,29,239,0,5,1764,36624,80.56,114963583,104.957,19.8,3.526,1729.927,182.634,7.47,0.463,3
64,42,11,250,0,5,2424,39048,80.56,114963583,104.957,19.8,3.526,1729.927,182.634,7.47,0.463,3
64,43,11,261,0,5,2650,41698,80.56,114963583,104.957,19.8,3.526,1729.927,182.634,7.47,0.463,3
64,44,2,263,0,5,3580,45278,80.56,114963583,104.957,19.8,3.526,1729.927,182.634,7.47,0.463,3
64,45,9,272,0,5,3707,48985,80.56,114963583,104.957,19.8,3.526,1729.927,182.634,7.47,0.463,3
64,46,15,287,0,5,4044,53029,80.56,114963583,104.957,19.8,3.526,1729.927,182.634,7.47,0.463,3
64,47,19,306,0,5,4225,57254,80.56,114963583,104.957,19.8,3.526,1729.927,182.634,7.47,0.463,3
64,48,11,317,0,5,1775,59029,80.56,114963583,104.957,19.8,3.526,1729.927,182.634,7.47,0.463,3
64,49,35,352,0,5,4271,63300,80.56,114963583,104.957,19.8,3.526,1729.927,182.634,7.47,0.463,3
64,50,13,365,0,5,2460,65760,80.56,114963583,104.957,19.8,3.526,1729.927,182.634,7.47,0.463,3
64,51,24,389,0,5,3747,69507,80.56,114963583,104.957,19.8,3.526,1729.927,182.634,7.47,0.463,3
64,52,10,399,0,5,3657,73164,80.56,114963583,104.957,19.8,3.526,1729.927,182.634,7.47,0.463,3
64,53,34,433,0,5,6798,79962,80.56,114963583,104.957,19.8,3.526,1729.927,182.634,7.47,0.463,3
64,54,61,494,0,5,1048,81010,80.56,114963583,104.957,19.8,3.526,1729.927,182.634,7.47,0.463,3
64,55,88,582,0,5,2844,83854,80.56,114963583,104.957,19.8,3.526,1729.927,182.634,7.47,0.463,3
64,56,73,655,0,5,3410,87264,80.56,114963583,104.957,19.8,3.526,1729.927,182.634,7.47,0.463,3
64,57,46,701,1,6,4352,91616,80.56,114963583,104.957,19.8,3.526,1729.927,182.634,7.47,0.463,3
64,58,30,731,0,6,4950,96566,80.56,114963583,104.957,19.8,3.526,1729.927,182.634,7.47,0.463,3
64,59,100,831,1,7,5015,101581,80.56,114963583,104.957,19.8,3.526,1729.927,182.634,7.47,0.463,3
64,60,137,968,1,8,5034,106615,80.56,114963583,104.957,19.8,3.526,1729.927,182.634,7.47,0.463,3
64,61,95,1063,0,8,2836,109451,80.56,114963583,104.957,19.8,3.526,1729.927,182.634,7.47,0.463,3
64,62,109,1172,3,11,2926,112377,80.56,114963583,104.957,19.8,3.526,1729.927,182.634,7.47,0.463,3
64,63,85,1257,1,12,3932,116309,80.56,114963583,104.957,19.8,3.526,1729.927,182.634,7.47,0.463,3
64,64,87,1344,2,14,4120,120429,80.56,114963583,104.957,19.8,3.526,1729.927,182.634,7.47,0.463,3
64,65,142,1486,3,17,5141,125570,80.56,114963583,104.957,19.8,3.526,1729.927,182.634,7.47,0.463,3
64,66,150,1636,1,18,5798,131368,80.56,114963583,104.957,19.8,3.526,1729.927,182.634,7.47,0.463,3
64,67,169,1805,1,19,5500,136868,80.56,114963583,104.957,19.8,3.526,1729.927,182.634,7.47,0.463,3
64,68,129,1934,1,20,6092,142960,80.56,114963583,104.957,19.8,3.526,1729.927,182.634,7.47,0.463,3
64,69,86,2020,7,27,4775,147735,80.56,114963583,104.957,19.8,3.526,1729.927,182.634,7.47,0.463,3
64,70,136,2156,0,27,4599,152334,80.56,114963583,104.957,19.8,3.526,1729.927,182.634,7.47,0.463,3
64,71,180,2336,5,32,6187,158521,80.56,114963583,104.957,19.8,3.526,1729.927,182.634,7.47,0.463,3
64,72,170,2506,3,35,6630,165151,80.56,114963583,104.957,19.8,3.526,1729.927,182.634,7.47,0.463,3
64,73,164,2670,5,40,5709,170860,80.56,114963583,104.957,19.8,3.526,1729.927,182.634,7.47,0.463,3
64,74,245,2915,7,47,5644,176504,80.56,114963583,104.957,19.8,3.526,1729.927,182.634,7.47,0.463,3
64,75,251,3166,8,55,4845,181349,80.56,114963583,104.957,19.8,3.526,1729.927,182.634,7.47,0.463,3
64,76,179,3345,2,57,5636,186985,80.56,114963583,104.957,19.8,3.526,1729.927,182.634,7.47,0.463,3
64,77,176,3521,3,60,5102,192087,80.56,114963583,104.957,19.8,3.526,1729.927,182.634,7.47,0.463,3
64,78,109,3630,1,61,5274,197361,80.56,114963583,104.957,19.8,3.526,1729.927,182.634,7.47,0.463,3
64,79,129,3759,2,63,4853,202214,80.56,114963583,104.957,19.8,3.526,1729.927,182.634,7.47,0.463,3
64,80,195,3954,2,65,4809,207023,80.56,114963583,104.957,19.8,3.526,1729.927,182.634,7.47,0.463,3
64,81,116,4070,7,72,4848,211871,80.56,114963583,104.957,19.8,3.526,1729.927,182.634,7.47,0.463,3
64,82,399,4469,0,72,4457,216328,80.56,114963583,104.957,19.8,3.526,1729.927,182.634,7.47,0.463,3
64,83,63,4532,2,74,3238,219566,80.56,114963583,104.957,19.8,3.526,1729.927,182.634,7.47,0.463,3
64,84,131,4663,1,75,3775,223341,80.56,114963583,104.957,19.8,3.526,1729.927,182.634,7.47,0.463,3
64,85,185,4848,0,75,4034,227375,80.56,114963583,104.957,19.8,3.526,1729.927,182.634,7.47,0.463,3
64,86,186,5034,3,78,4675,232050,80.56,114963583,104.957,19.8,3.526,1729.927,182.634,7.47,0.463,3
64,87,141,5175,3,81,5414,237464,80.56,114963583,104.957,19.8,3.526,1729.927,182.634,7.47,0.463,3
64,88,250,5425,8,89,5552,243016,80.56,114963583,104.957,19.8,3.526,1729.927,182.634,7.47,0.463,3
64,89,145,5570,5,94,3895,246911,80.56,114963583,104.957,19.8,3.526,1729.927,182.634,7.47,0.463,3
64,90,119,5689,4,98,3693,250604,80.56,114963583,104.957,19.8,3.526,1729.927,182.634,7.47,0.463,3
64,91,157,5846,5,103,3300,253904,80.56,114963583,104.957,19.8,3.526,1729.927,182.634,7.47,0.463,3
64,92,0,5846,0,103,1398,255302,80.56,114963583,104.957,19.8,3.526,1729.927,182.634,7.47,0.463,3
64,93,0,5846,0,103,1346,256648,80.56,114963583,104.957,19.8,3.526,1729.927,182.634,7.47,0.463,3
64,94,0,5846,0,103,1742,258390,80.56,114963583,104.957,19.8,3.526,1729.927,182.634,7.47,0.463,3
64,95,0,5846,0,103,2192,260582,80.56,114963583,104.957,19.8,3.526,1729.927,182.634,7.47,0.463,3
64,96,0,5846,0,103,3315,263897,80.56,114963583,104.957,19.8,3.526,1729.927,182.634,7.47,0.463,3
64,97,0,5846,0,103,2426,266323,80.56,114963583,104.957,19.8,3.526,1729.927,182.634,7.47,0.463,3
64,98,540,6386,13,116,1969,268292,80.56,114963583,104.957,19.8,3.526,1729.927,182.634,7.47,0.463,3
64,99,280,6666,3,119,4162,272454,80.56,114963583,104.957,19.8,3.526,1729.927,182.634,7.47,0.463,3
64,100,108,6774,1,120,3476,275930,80.56,114963583,104.957,19.8,3.526,1729.927,182.634,7.47,0.463,3
64,101,199,6973,0,120,5139,281069,80.56,114963583,104.957,19.8,3.526,1729.927,182.634,7.47,0.463,3
64,102,147,7120,4,124,4559,285628,80.56,114963583,104.957,19.8,3.526,1729.927,182.634,7.47,0.463,3
64,103,282,7402,0,124,3922,289550,80.56,114963583,104.957,19.8,3.526,1729.927,182.634,7.47,0.463,3
64,104,158,7560,3,127,4385,293935,80.56,114963583,104.957,19.8,3.526,1729.927,182.634,7.47,0.463,3
64,105,206,7766,1,128,3607,297542,80.56,114963583,104.957,19.8,3.526,1729.927,182.634,7.47,0.463,3
64,106,203,7969,11,139,5186,302728,80.56,114963583,104.957,19.8,3.526,1729.927,182.634,7.47,0.463,3
64,107,212,8181,7,146,6911,309639,80.56,114963583,104.957,19.8,3.526,1729.927,182.634,7.47,0.463,3
64,108,294,8475,2,148,7407,317046,80.56,114963583,104.957,19.8,3.526,1729.927,182.634,7.47,0.463,3
64,109,328,8803,2,150,6886,323932,80.56,114963583,104.957,19.8,3.526,1729.927,182.634,7.47,0.463,3
64,110,344,9147,13,163,7334,331266,80.56,114963583,104.957,19.8,3.526,1729.927,182.634,7.47,0.463,3
64,111,356,9503,4,167,5056,336322,80.56,114963583,104.957,19.8,3.526,1729.927,182.634,7.47,0.463,3
64,112,704,10207,3,170,6544,342866,80.56,114963583,104.957,19.8,3.526,1729.927,182.634,7.47,0.463,3
64,113,304,10511,3,173,7294,350160,80.56,114963583,104.957,19.8,3.526,1729.927,182.634,7.47,0.463,3
64,114,561,11072,7,180,6898,357058,80.56,114963583,104.957,19.8,3.526,1729.927,182.634,7.47,0.463,3
64,115,452,11524,8,188,7264,364322,80.56,114963583,104.957,19.8,3.526,1729.927,182.634,7.47,0.463,3
64,116,409,11933,9,197,8490,372812,80.56,114963583,104.957,19.8,3.526,1729.927,182.634,7.47,0.463,3
64,117,760,12693,3,200,9527,382339,80.56,114963583,104.957,19.8,3.526,1729.927,182.634,7.47,0.463,3
64,118,1275,13968,23,223,7009,389348,80.56,114963583,104.957,19.8,3.526,1729.927,182.634,7.47,0.463,3
64,119,579,14547,5,228,6503,395851,80.56,114963583,104.957,19.8,3.526,1729.927,182.634,7.47,0.463,3
64,120,653,15200,11,239,7760,403611,80.56,114963583,104.957,19.8,3.526,1729.927,182.634,7.47,0.463,3
64,121,610,15810,14,253,9786,413397,80.56,114963583,104.957,19.8,3.526,1729.927,182.634,7.47,0.463,3
64,122,805,16615,10,263,8957,422354,80.56,114963583,104.957,19.8,3.526,1729.927,182.634,7.47,0.463,3
64,123,915,17530,11,274,7358,429712,80.56,114963583,104.957,19.8,3.526,1729.927,182.634,7.47,0.463,3
64,124,469,17999,10,284,7607,437319,80.56,114963583,104.957,19.8,3.526,1729.927,182.634,7.47,0.463,3
64,125,0,17999,0,284,6907,444226,80.56,114963583,104.957,19.8,3.526,1729.927,182.634,7.47,0.463,3
64,126,1290,19289,52,336,8201,452427,80.56,114963583,104.957,19.8,3.526,1729.927,182.634,7.47,0.463,3
64,127,588,19877,7,343,7319,459746,80.56,114963583,104.957,19.8,3.526,1729.927,182.634,7.47,0.463,3
64,128,459,20336,13,356,9068,468814,80.56,114963583,104.957,19.8,3.526,1729.927,182.634,7.47,0.463,3
64,129,564,20900,9,365,9203,478017,80.56,114963583,104.957,19.8,3.526,1729.927,182.634,7.47,0.463,3
64,130,552,21452,15,380,10919,488936,80.56,114963583,104.957,19.8,3.526,1729.927,182.634,7.47,0.463,3
64,131,801,22253,10,390,9035,497971,80.56,114963583,104.957,19.8,3.526,1729.927,182.634,7.47,0.463,3
64,132,565,22818,17,407,11039,509010,80.56,114963583,104.957,19.8,3.526,1729.927,182.634,7.47,0.463,3
64,133,773,23591,13,420,11881,520891,80.56,114963583,104.957,19.8,3.526,1729.927,182.634,7.47,0.463,3
64,134,584,24175,20,440,14540,535431,80.56,114963583,104.957,19.8,3.526,1729.927,182.634,7.47,0.463,3
64,135,943,25118,23,463,14688,550119,80.56,114963583,104.957,19.8,3.526,1729.927,182.634,7.47,0.463,3
64,136,1086,26204,16,479,17323,567442,80.56,114963583,104.957,19.8,3.526,1729.927,182.634,7.47,0.463,3
64,137,1038,27242,13,492,22252,589694,80.56,114963583,104.957,19.8,3.526,1729.927,182.634,7.47,0.463,3
64,138,1652,28894,17,509,19769,609463,80.56,114963583,104.957,19.8,3.526,1729.927,182.634,7.47,0.463,3
64,139,982,29876,19,528,19747,629210,80.56,114963583,104.957,19.8,3.526,1729.927,182.634,7.47,0.463,3
64,140,1460,31336,16,544,22101,651311,80.56,114963583,104.957,19.8,3.526,1729.927,182.634,7.47,0.463,3
64,141,1386,32722,28,572,21326,672637,80.56,114963583,104.957,19.8,3.526,1729.927,182.634,7.47,0.463,3
64,142,1336,34058,28,600,21456,694093,80.56,114963583,104.957,19.8,3.526,1729.927,182.634,7.47,0.463,3
64,143,1778,35836,20,620,23035,717128,80.56,114963583,104.957,19.8,3.526,1729.927,182.634,7.47,0.463,3
64,144,1829,37665,17,637,19776,736904,80.56,114963583,104.957,19.8,3.526,1729.927,182.634,7.47,0.463,3
64,145,1368,39033,25,662,20153,757057,80.56,114963583,104.957,19.8,3.526,1729.927,182.634,7.47,0.463,3
64,146,1638,40671,16,678,18851,775908,80.56,114963583,104.957,19.8,3.526,1729.927,182.634,7.47,0.463,3
64,147,1472,42143,14,692,18778,794686,80.56,114963583,104.957,19.8,3.526,1729.927,182.634,7.47,0.463,3
64,148,1545,43688,17,709,18724,813410,80.56,114963583,104.957,19.8,3.526,1729.927,182.634,7.47,0.463,3
64,149,1533,45221,16,725,18060,831470,80.56,114963583,104.957,19.8,3.526,1729.927,182.634,7.47,0.463,3
64,150,1186,46407,20,745,18766,850236,80.56,114963583,104.957,19.8,3.526,1729.927,182.634,7.47,0.463,3
64,151,1733,48140,13,758,19194,869430,80.56,114963583,104.957,19.8,3.526,1729.927,182.634,7.47,0.463,3
64,152,1514,49654,12,770,21499,890929,80.56,114963583,104.957,19.8,3.526,1729.927,182.634,7.47,0.463,3
64,153,1468,51122,23,793,19364,910293,80.56,114963583,104.957,19.8,3.526,1729.927,182.634,7.47,0.463,3
64,154,1009,52131,16,809,18160,928453,80.56,114963583,104.957,19.8,3.526,1729.927,182.634,7.47,0.463,3
64,155,1173,53304,19,828,21360,949813,80.56,114963583,104.957,19.8,3.526,1729.927,182.634,7.47,0.463,3
64,156,1105,54409,18,846,20778,970591,80.56,114963583,104.957,19.8,3.526,1729.927,182.634,7.47,0.463,3
64,157,804,55213,10,856,23712,994303,80.56,114963583,104.957,19.8,3.526,1729.927,182.634,7.47,0.463,3
64,158,1303,56516,24,880,24544,1018847,80.56,114963583,104.957,19.8,3.526,1729.927,182.634,7.47,0.463,3
64,159,950,57466,17,897,25158,1044005,80.56,114963583,104.957,19.8,3.526,1729.927,182.634,7.47,0.463,3
64,160,1206,58672,21,918,19449,1063454,80.56,114963583,104.957,19.8,3.526,1729.927,182.634,7.47,0.463,3
64,161,976,59648,15,933,14815,1078269,80.56,114963583,104.957,19.8,3.526,1729.927,182.634,7.47,0.463,3
64,162,1136,60784,16,949,15561,1093830,80.56,114963583,104.957,19.8,3.526,1729.927,182.634,7.47,0.463,3
64,163,916,61700,17,966,16665,1110495,80.56,114963583,104.957,19.8,3.526,1729.927,182.634,7.47,0.463,3
64,164,878,62578,8,974,12164,1122659,77.78,114963583,104.957,19.8,3.526,1729.927,182.634,7.47,0.463,3
64,165,789,63367,12,986,8191,1130850,77.78,114963583,104.957,19.8,3.526,1729.927,182.634,7.47,0.463,3
64,166,521,63888,10,996,7162,1138012,77.78,114963583,104.957,19.8,3.526,1729.927,182.634,7.47,0.463,3
64,167,413,64301,17,1013,9256,1147268,77.78,114963583,104.957,19.8,3.526,1729.927,182.634,7.47,0.463,3
64,168,485,64786,9,1022,10024,1157292,77.78,114963583,104.957,19.8,3.526,1729.927,182.634,7.47,0.463,3
64,169,700,65486,13,1035,8355,1165647,77.78,114963583,104.957,19.8,3.526,1729.927,182.634,7.47,0.463,3
64,170,738,66224,10,1045,10605,1176252,77.78,114963583,104.957,19.8,3.526,1729.927,182.634,7.47,0.463,3
64,171,689,66913,15,1060,8221,1184473,77.78,114963583,104.957,19.8,3.526,1729.927,182.634,7.47,0.463,3
64,172,602,67515,12,1072,10322,1194795,77.78,114963583,104.957,19.8,3.526,1729.927,182.634,7.47,0.463,3
64,173,616,68131,17,1089,8023,1202818,77.78,114963583,104.957,19.8,3.526,1729.927,182.634,7.47,0.463,3
64,174,689,68820,7,1096,8115,1210933,77.78,114963583,104.957,19.8,3.526,1729.927,182.634,7.47,0.463,3
64,175,889,69709,12,1108,6813,1217746,77.78,114963583,104.957,19.8,3.526,1729.927,182.634,7.47,0.463,3
64,176,713,70422,19,1127,8551,1226297,77.78,114963583,104.957,19.8,3.526,1729.927,182.634,7.47,0.463,3
64,177,661,71083,14,1141,8348,1234645,77.78,114963583,104.957,19.8,3.526,1729.927,182.634,7.47,0.463,3
64,178,604,71687,7,1148,7227,1241872,77.78,114963583,104.957,19.8,3.526,1729.927,182.634,7.47,0.463,3
64,179,486,72173,7,1155,7679,1249551,77.78,114963583,104.957,19.8,3.526,1729.927,182.634,7.47,0.463,3
64,180,527,72700,10,1165,6631,1256182,77.78,114963583,104.957,19.8,3.526,1729.927,182.634,7.47,0.463,3
64,181,632,73332,5,1170,4747,1260929,77.78,114963583,104.957,19.8,3.526,1729.927,182.634,7.47,0.463,3
64,182,612,73944,7,1177,5284,1266213,77.78,114963583,104.957,19.8,3.526,1729.927,182.634,7.47,0.463,3
64,183,640,74584,14,1191,6139,1272352,77.78,114963583,104.957,19.8,3.526,1729.927,182.634,7.47,0.463,3
64,184,784,75368,7,1198,6475,1278827,77.78,114963583,104.957,19.8,3.526,1729.927,182.634,7.47,0.463,3
64,185,730,76098,7,1205,6916,1285743,77.78,114963583,104.957,19.8,3.526,1729.927,182.634,7.47,0.463,3
64,186,890,76988,3,1208,7726,1293469,77.78,114963583,104.957,19.8,3.526,1729.927,182.634,7.47,0.463,3
64,187,872,77860,6,1214,8101,1301570,77.78,114963583,104.957,19.8,3.526,1729.927,182.634,7.47,0.463,3
64,188,959,78819,8,1222,6062,1307632,77.78,114963583,104.957,19.8,3.526,1729.927,182.634,7.47,0.463,3
64,189,618,79437,8,1230,5278,1312910,77.78,114963583,104.957,19.8,3.526,1729.927,182.634,7.47,0.463,3
64,190,566,80003,8,1238,8254,1321164,77.78,114963583,104.957,19.8,3.526,1729.927,182.634,7.47,0.463,3
64,191,892,80895,17,1255,6668,1327832,77.78,114963583,104.957,19.8,3.526,1729.927,182.634,7.47,0.463,3
64,192,902,81797,7,1262,8024,1335856,77.78,114963583,104.957,19.8,3.526,1729.927,182.634,7.47,0.463,3
64,193,865,82662,9,1271,7394,1343250,77.78,114963583,104.957,19.8,3.526,1729.927,182.634,7.47,0.463,3
64,194,767,83429,6,1277,7383,1350633,77.78,114963583,104.957,19.8,3.526,1729.927,182.634,7.47,0.463,3
64,195,866,84295,10,1287,5997,1356630,77.78,114963583,104.957,19.8,3.526,1729.927,182.634,7.47,0.463,3
64,196,841,85136,14,1301,6344,1362974,77.78,114963583,104.957,19.8,3.526,1729.927,182.634,7.47,0.463,3
64,197,582,85718,4,1305,7121,1370095,77.78,114963583,104.957,19.8,3.526,1729.927,182.634,7.47,0.463,3
64,198,712,86430,7,1312,6985,1377080,77.78,114963583,104.957,19.8,3.526,1729.927,182.634,7.47,0.463,3
64,199,739,87169,13,1325,6569,1383649,77.78,114963583,104.957,19.8,3.526,1729.927,182.634,7.47,0.463,3
64,200,665,87834,12,1337,6548,1390197,77.78,114963583,104.957,19.8,3.526,1729.927,182.634,7.47,0.463,3
64,201,600,88434,9,1346,7151,1397348,77.78,114963583,104.957,19.8,3.526,1729.927,182.634,7.47,0.463,3
64,202,703,89137,6,1352,6546,1403894,77.78,114963583,104.957,19.8,3.526,1729.927,182.634,7.47,0.463,3
64,203,723,89860,13,1365,0,1403894,77.78,114963583,104.957,19.8,3.526,1729.927,182.634,7.47,0.463,3
64,204,630,90490,6,1371,0,1403894,77.78,114963583,104.957,19.8,3.526,1729.927,182.634,7.47,0.463,3
67,1,0,5,0,0,17,384,88.89,896444,49.562,28.6,6.224,8702.975,412.82,14.49,0.741,0
67,2,2,7,0,0,24,408,88.89,896444,49.562,28.6,6.224,8702.975,412.82,14.49,0.741,0
67,3,0,7,0,0,0,408,88.89,896444,49.562,28.6,6.224,8702.975,412.82,14.49,0.741,0
67,4,5,12,0,0,0,445,88.89,896444,49.562,28.6,6.224,8702.975,412.82,14.49,0.741,0
67,5,0,12,0,0,44,489,88.89,896444,49.562,28.6,6.224,8702.975,412.82,14.49,0.741,0
67,6,2,14,0,0,23,512,88.89,896444,49.562,28.6,6.224,8702.975,412.82,14.49,0.741,0
67,7,0,14,0,0,25,537,88.89,896444,49.562,28.6,6.224,8702.975,412.82,14.49,0.741,0
67,8,1,15,0,0,29,566,88.89,896444,49.562,28.6,6.224,8702.975,412.82,14.49,0.741,0
67,9,0,15,0,0,25,591,88.89,896444,49.562,28.6,6.224,8702.975,412.82,14.49,0.741,0
67,10,0,15,0,0,21,612,88.89,896444,49.562,28.6,6.224,8702.975,412.82,14.49,0.741,0
67,11,1,16,0,0,9,621,88.89,896444,49.562,28.6,6.224,8702.975,412.82,14.49,0.741,0
67,12,0,16,0,0,1,622,88.89,896444,49.562,28.6,6.224,8702.975,412.82,14.49,0.741,0
67,13,0,16,0,0,27,649,88.89,896444,49.562,28.6,6.224,8702.975,412.82,14.49,0.741,0
67,14,0,16,0,0,12,661,88.89,896444,49.562,28.6,6.224,8702.975,412.82,14.49,0.741,0
67,15,0,16,0,0,0,661,88.89,896444,49.562,28.6,6.224,8702.975,412.82,14.49,0.741,0
67,16,0,16,0,0,0,684,88.89,896444,49.562,28.6,6.224,8702.975,412.82,14.49,0.741,0
67,17,1,17,0,0,21,705,88.89,896444,49.562,28.6,6.224,8702.975,412.82,14.49,0.741,0
67,18,0,17,0,0,40,745,88.89,896444,49.562,28.6,6.224,8702.975,412.82,14.49,0.741,0
67,19,0,17,0,0,38,783,88.89,896444,49.562,28.6,6.224,8702.975,412.82,14.49,0.741,0
67,20,0,17,0,0,24,807,88.89,896444,49.562,28.6,6.224,8702.975,412.82,14.49,0.741,0
67,21,1,18,0,0,22,829,88.89,896444,49.562,28.6,6.224,8702.975,412.82,14.49,0.741,0
67,22,0,18,0,0,68,897,88.89,896444,49.562,28.6,6.224,8702.975,412.82,14.49,0.741,0
67,23,0,18,0,0,54,951,88.89,896444,49.562,28.6,6.224,8702.975,412.82,14.49,0.741,0
67,24,0,18,0,0,2,953,88.89,896444,49.562,28.6,6.224,8702.975,412.82,14.49,0.741,0
67,25,0,18,0,0,60,1013,88.89,896444,49.562,28.6,6.224,8702.975,412.82,14.49,0.741,0
67,26,0,18,0,0,0,1013,88.89,896444,49.562,28.6,6.224,8702.975,412.82,14.49,0.741,0
67,27,0,18,0,0,0,1060,88.89,896444,49.562,28.6,6.224,8702.975,412.82,14.49,0.741,0
67,28,0,18,0,0,30,1090,88.89,896444,49.562,28.6,6.224,8702.975,412.82,14.49,0.741,0
67,29,0,18,0,0,33,1123,88.89,896444,49.562,28.6,6.224,8702.975,412.82,14.49,0.741,0
67,30,0,18,0,0,37,1160,88.89,896444,49.562,28.6,6.224,8702.975,412.82,14.49,0.741,0
67,31,0,18,0,0,41,1201,88.89,896444,49.562,28.6,6.224,8702.975,412.82,14.49,0.741,0
67,32,0,18,0,0,47,1248,88.89,896444,49.562,28.6,6.224,8702.975,412.82,14.49,0.741,0
67,33,0,18,0,0,78,1326,88.89,896444,49.562,28.6,6.224,8702.975,412.82,14.49,0.741,0
67,34,0,18,0,0,0,1326,88.89,896444,49.562,28.6,6.224,8702.975,412.82,14.49,0.741,0
67,35,0,18,0,0,0,1326,88.89,896444,49.562,28.6,6.224,8702.975,412.82,14.49,0.741,0
67,36,0,18,0,0,29,1394,88.89,896444,49.562,28.6,6.224,8702.975,412.82,14.49,0.741,0
67,37,0,18,0,0,43,1437,88.89,896444,49.562,28.6,6.224,8702.975,412.82,14.49,0.741,0
67,38,0,18,0,0,52,1489,88.89,896444,49.562,28.6,6.224,8702.975,412.82,14.49,0.741,0
67,39,0,18,0,0,43,1532,88.89,896444,49.562,28.6,6.224,8702.975,412.82,14.49,0.741,0
67,40,0,18,0,0,67,1599,88.89,896444,49.562,28.6,6.224,8702.975,412.82,14.49,0.741,0
67,41,0,18,0,0,0,1599,88.89,896444,49.562,28.6,6.224,8702.975,412.82,14.49,0.741,0
67,42,0,18,0,0,0,1632,88.89,896444,49.562,28.6,6.224,8702.975,412.82,14.49,0.741,0
67,43,0,18,0,0,67,1699,88.89,896444,49.562,28.6,6.224,8702.975,412.82,14.49,0.741,0
67,44,0,18,0,0,76,1775,88.89,896444,49.562,28.6,6.224,8702.975,412.82,14.49,0.741,0
67,45,0,18,0,0,87,1862,78.7,896444,49.562,28.6,6.224,8702.975,412.82,14.49,0.741,0
67,46,0,18,0,0,74,1936,78.7,896444,49.562,28.6,6.224,8702.975,412.82,14.49,0.741,0
67,47,0,18,0,0,0,1936,78.7,896444,49.562,28.6,6.224,8702.975,412.82,14.49,0.741,0
67,48,0,18,0,0,0,1991,78.7,896444,49.562,28.6,6.224,8702.975,412.82,14.49,0.741,0
67,49,0,18,0,0,78,2069,78.7,896444,49.562,28.6,6.224,8702.975,412.82,14.49,0.741,0
67,50,0,18,0,0,68,2137,78.7,896444,49.562,28.6,6.224,8702.975,412.82,14.49,0.741,0
67,51,0,18,0,0,56,2193,78.7,896444,49.562,28.6,6.224,8702.975,412.82,14.49,0.741,0
67,52,0,18,0,0,66,2259,78.7,896444,49.562,28.6,6.224,8702.975,412.82,14.49,0.741,0
67,53,0,18,0,0,104,2363,78.7,896444,49.562,28.6,6.224,8702.975,412.82,14.49,0.741,0
67,54,0,18,0,0,4,2367,78.7,896444,49.562,28.6,6.224,8702.975,412.82,14.49,0.741,0
67,55,0,18,0,0,64,2431,78.7,896444,49.562,28.6,6.224,8702.975,412.82,14.49,0.741,0
67,56,0,18,0,0,53,2484,78.7,896444,49.562,28.6,6.224,8702.975,412.82,14.49,0.741,0
67,57,0,18,0,0,111,2595,78.7,896444,49.562,28.6,6.224,8702.975,412.82,14.49,0.741,0
67,58,0,18,0,0,78,2673,78.7,896444,49.562,28.6,6.224,8702.975,412.82,14.49,0.741,0
67,59,0,18,0,0,150,2823,78.7,896444,49.562,28.6,6.224,8702.975,412.82,14.49,0.741,0
67,60,0,18,0,0,77,2900,78.7,896444,49.562,28.6,6.224,8702.975,412.82,14.49,0.741,0
67,61,0,18,0,0,61,2961,78.7,896444,49.562,28.6,6.224,8702.975,412.82,14.49,0.741,0
67,62,0,18,0,0,0,2961,78.7,896444,49.562,28.6,6.224,8702.975,412.82,14.49,0.741,0
67,63,0,18,0,0,0,3041,78.7,896444,49.562,28.6,6.224,8702.975,412.82,14.49,0.741,0
67,64,0,18,0,0,88,3129,78.7,896444,49.562,28.6,6.224,8702.975,412.82,14.49,0.741,0
67,65,0,18,0,0,66,3195,78.7,896444,49.562,28.6,6.224,8702.975,412.82,14.49,0.741,0
67,66,0,18,0,0,113,3308,78.7,896444,49.562,28.6,6.224,8702.975,412.82,14.49,0.741,0
67,67,0,18,0,0,92,3400,78.7,896444,49.562,28.6,6.224,8702.975,412.82,14.49,0.741,0
67,68,0,18,0,0,232,3632,78.7,896444,49.562,28.6,6.224,8702.975,412.82,14.49,0.741,0
67,69,0,18,0,0,97,3729,78.7,896444,49.562,28.6,6.224,8702.975,412.82,14.49,0.741,0
67,70,0,18,0,0,81,3810,78.7,896444,49.562,28.6,6.224,8702.975,412.82,14.49,0.741,0
67,71,0,18,0,0,129,3939,78.7,896444,49.562,28.6,6.224,8702.975,412.82,14.49,0.741,0
67,72,0,18,0,0,0,3939,78.7,896444,49.562,28.6,6.224,8702.975,412.82,14.49,0.741,0
67,73,0,18,0,0,0,4004,78.7,896444,49.562,28.6,6.224,8702.975,412.82,14.49,0.741,0
67,74,0,18,0,0,102,4106,78.7,896444,49.562,28.6,6.224,8702.975,412.82,14.49,0.741,0
67,75,0,18,0,0,20,4126,78.7,896444,49.562,28.6,6.224,8702.975,412.82,14.49,0.741,0
67,76,0,18,0,0,43,4169,78.7,896444,49.562,28.6,6.224,8702.975,412.82,14.49,0.741,0
67,77,0,18,0,0,39,4208,78.7,896444,49.562,28.6,6.224,8702.975,412.82,14.49,0.741,0
67,78,0,18,0,0,0,4208,78.7,896444,49.562,28.6,6.224,8702.975,412.82,14.49,0.741,0
67,79,0,18,0,0,0,4305,78.7,896444,49.562,28.6,6.224,8702.975,412.82,14.49,0.741,0
67,80,0,18,0,0,120,4425,78.7,896444,49.562,28.6,6.224,8702.975,412.82,14.49,0.741,0
67,81,0,18,0,0,26,4451,78.7,896444,49.562,28.6,6.224,8702.975,412.82,14.49,0.741,0
67,82,0,18,0,0,0,4451,73.15,896444,49.562,28.6,6.224,8702.975,412.82,14.49,0.741,0
67,83,0,18,0,0,0,4529,62.04,896444,49.562,28.6,6.224,8702.975,412.82,14.49,0.741,0
67,84,0,18,0,0,55,4584,62.04,896444,49.562,28.6,6.224,8702.975,412.82,14.49,0.741,0
67,85,0,18,0,0,50,4634,62.04,896444,49.562,28.6,6.224,8702.975,412.82,14.49,0.741,0
67,86,0,18,0,0,151,4785,62.04,896444,49.562,28.6,6.224,8702.975,412.82,14.49,0.741,0
67,87,0,18,0,0,31,4816,62.04,896444,49.562,28.6,6.224,8702.975,412.82,14.49,0.741,0
67,88,0,18,0,0,11,4827,62.04,896444,49.562,28.6,6.224,8702.975,412.82,14.49,0.741,0
67,89,0,18,0,0,26,4853,62.04,896444,49.562,28.6,6.224,8702.975,412.82,14.49,0.741,0
67,90,0,18,0,0,162,5015,62.04,896444,49.562,28.6,6.224,8702.975,412.82,14.49,0.741,0
67,91,0,18,0,0,45,5060,58.33,896444,49.562,28.6,6.224,8702.975,412.82,14.49,0.741,0
67,92,0,18,0,0,45,5105,58.33,896444,49.562,28.6,6.224,8702.975,412.82,14.49,0.741,0
67,93,0,18,0,0,51,5156,58.33,896444,49.562,28.6,6.224,8702.975,412.82,14.49,0.741,0
67,94,0,18,0,0,86,5242,58.33,896444,49.562,28.6,6.224,8702.975,412.82,14.49,0.741,0
67,95,0,18,0,0,26,5268,58.33,896444,49.562,28.6,6.224,8702.975,412.82,14.49,0.741,0
67,96,0,18,0,0,43,5311,58.33,896444,49.562,28.6,6.224,8702.975,412.82,14.49,0.741,0
67,97,0,18,0,0,0,5311,50.93,896444,49.562,28.6,6.224,8702.975,412.82,14.49,0.741,0
67,98,1,19,0,0,0,5371,50.93,896444,49.562,28.6,6.224,8702.975,412.82,14.49,0.741,0
67,99,0,19,0,0,115,5486,50.93,896444,49.562,28.6,6.224,8702.975,412.82,14.49,0.741,0
67,100,2,21,0,0,135,5621,50.93,896444,49.562,28.6,6.224,8702.975,412.82,14.49,0.741,0
67,101,0,21,0,0,-357,5264,50.93,896444,49.562,28.6,6.224,8702.975,412.82,14.49,0.741,0
67,102,0,21,0,0,576,5840,50.93,896444,49.562,28.6,6.224,8702.975,412.82,14.49,0.741,0
67,103,0,21,0,0,97,5937,50.93,896444,49.562,28.6,6.224,8702.975,412.82,14.49,0.741,0
67,104,5,26,0,0,20,5957,50.93,896444,49.562,28.6,6.224,8702.975,412.82,14.49,0.741,0
67,105,0,26,0,0,151,6108,50.93,896444,49.562,28.6,6.224,8702.975,412.82,14.49,0.741,0
67,106,0,26,0,0,0,6108,50.93,896444,49.562,28.6,6.224,8702.975,412.82,14.49,0.741,0
67,107,0,26,0,0,0,6328,50.93,896444,49.562,28.6,6.224,8702.975,412.82,14.49,0.741,0
67,108,0,26,0,0,38,6366,48.15,896444,49.562,28.6,6.224,8702.975,412.82,14.49,0.741,0
67,109,0,26,0,0,22,6388,48.15,896444,49.562,28.6,6.224,8702.975,412.82,14.49,0.741,0
67,110,0,26,0,0,13,6401,48.15,896444,49.562,28.6,6.224,8702.975,412.82,14.49,0.741,0
67,111,0,26,0,0,13,6414,48.15,896444,49.562,28.6,6.224,8702.975,412.82,14.49,0.741,0
67,112,0,26,0,0,40,6454,48.15,896444,49.562,28.6,6.224,8702.975,412.82,14.49,0.741,0
67,113,1,27,0,0,81,6535,48.15,896444,49.562,28.6,6.224,8702.975,412.82,14.49,0.741,0
67,114,0,27,0,0,49,6584,48.15,896444,49.562,28.6,6.224,8702.975,412.82,14.49,0.741,0
67,115,0,27,0,0,55,6639,48.15,896444,49.562,28.6,6.224,8702.975,412.82,14.49,0.741,0
67,116,0,27,0,0,29,6668,48.15,896444,49.562,28.6,6.224,8702.975,412.82,14.49,0.741,0
67,117,0,27,0,0,25,6693,48.15,896444,49.562,28.6,6.224,8702.975,412.82,14.49,0.741,0
67,118,0,27,0,0,26,6719,48.15,896444,49.562,28.6,6.224,8702.975,412.82,14.49,0.741,0
67,119,0,27,0,0,37,6756,50.93,896444,49.562,28.6,6.224,8702.975,412.82,14.49,0.741,0
67,120,0,27,0,0,129,6885,50.93,896444,49.562,28.6,6.224,8702.975,412.82,14.49,0.741,0
67,121,0,27,0,0,39,6924,50.93,896444,49.562,28.6,6.224,8702.975,412.82,14.49,0.741,0
67,122,0,27,0,0,12,6936,50.93,896444,49.562,28.6,6.224,8702.975,412.82,14.49,0.741,0
67,123,0,27,1,1,1,6937,50.93,896444,49.562,28.6,6.224,8702.975,412.82,14.49,0.741,0
67,124,0,27,0,1,0,6937,50.93,896444,49.562,28.6,6.224,8702.975,412.82,14.49,0.741,0
67,125,0,27,0,1,0,7013,50.93,896444,49.562,28.6,6.224,8702.975,412.82,14.49,0.741,0
67,126,0,27,0,1,64,7077,50.93,896444,49.562,28.6,6.224,8702.975,412.82,14.49,0.741,0
67,127,0,27,0,1,169,7246,50.93,896444,49.562,28.6,6.224,8702.975,412.82,14.49,0.741,0
67,128,0,27,0,1,60,7306,50.93,896444,49.562,28.6,6.224,8702.975,412.82,14.49,0.741,0
67,129,0,27,0,1,12,7318,50.93,896444,49.562,28.6,6.224,8702.975,412.82,14.49,0.741,0
67,130,0,27,0,1,16,7334,50.93,896444,49.562,28.6,6.224,8702.975,412.82,14.49,0.741,0
67,131,0,27,0,1,7,7341,50.93,896444,49.562,28.6,6.224,8702.975,412.82,14.49,0.741,0
67,132,0,27,0,1,4,7345,50.93,896444,49.562,28.6,6.224,8702.975,412.82,14.49,0.741,0
67,133,0,27,0,1,40,7385,50.93,896444,49.562,28.6,6.224,8702.975,412.82,14.49,0.741,0
67,134,0,27,0,1,125,7510,50.93,896444,49.562,28.6,6.224,8702.975,412.82,14.49,0.741,0
67,135,0,27,0,1,34,7544,50.93,896444,49.562,28.6,6.224,8702.975,412.82,14.49,0.741,0
67,136,0,27,0,1,50,7594,50.93,896444,49.562,28.6,6.224,8702.975,412.82,14.49,0.741,0
67,137,0,27,0,1,12,7606,50.93,896444,49.562,28.6,6.224,8702.975,412.82,14.49,0.741,0
67,138,0,27,0,1,17,7623,50.93,896444,49.562,28.6,6.224,8702.975,412.82,14.49,0.741,0
67,139,1,28,0,1,15,7638,50.93,896444,49.562,28.6,6.224,8702.975,412.82,14.49,0.741,0
67,140,0,28,0,1,25,7663,50.93,896444,49.562,28.6,6.224,8702.975,412.82,14.49,0.741,0
67,141,0,28,0,1,178,7841,50.93,896444,49.562,28.6,6.224,8702.975,412.82,14.49,0.741,0
67,142,0,28,0,1,48,7889,50.93,896444,49.562,28.6,6.224,8702.975,412.82,14.49,0.741,0
67,143,0,28,0,1,53,7942,50.93,896444,49.562,28.6,6.224,8702.975,412.82,14.49,0.741,0
67,144,0,28,0,1,19,7961,50.93,896444,49.562,28.6,6.224,8702.975,412.82,14.49,0.741,0
67,145,0,28,0,1,18,7979,50.93,896444,49.562,28.6,6.224,8702.975,412.82,14.49,0.741,0
67,146,0,28,0,1,7,7986,50.93,896444,49.562,28.6,6.224,8702.975,412.82,14.49,0.741,0
67,147,0,28,0,1,51,8037,48.15,896444,49.562,28.6,6.224,8702.975,412.82,14.49,0.741,0
67,148,0,28,0,1,160,8197,48.15,896444,49.562,28.6,6.224,8702.975,412.82,14.49,0.741,0
67,149,0,28,0,1,47,8244,48.15,896444,49.562,28.6,6.224,8702.975,412.82,14.49,0.741,0
67,150,0,28,0,1,38,8282,48.15,896444,49.562,28.6,6.224,8702.975,412.82,14.49,0.741,0
67,151,0,28,1,2,21,8303,48.15,896444,49.562,28.6,6.224,8702.975,412.82,14.49,0.741,0
67,152,0,28,0,2,62,8365,48.15,896444,49.562,28.6,6.224,8702.975,412.82,14.49,0.741,0
67,153,0,28,0,2,43,8408,48.15,896444,49.562,28.6,6.224,8702.975,412.82,14.49,0.741,0
67,154,0,28,0,2,19,8427,48.15,896444,49.562,28.6,6.224,8702.975,412.82,14.49,0.741,0
67,155,1,29,0,2,123,8550,48.15,896444,49.562,28.6,6.224,8702.975,412.82,14.49,0.741,0
67,156,0,29,0,2,0,8550,48.15,896444,49.562,28.6,6.224,8702.975,412.82,14.49,0.741,0
67,157,2,31,0,2,0,8646,48.15,896444,49.562,28.6,6.224,8702.975,412.82,14.49,0.741,0
67,158,0,31,0,2,139,8785,48.15,896444,49.562,28.6,6.224,8702.975,412.82,14.49,0.741,0
67,159,0,31,0,2,108,8893,48.15,896444,49.562,28.6,6.224,8702.975,412.82,14.49,0.741,0
67,160,0,31,0,2,12,8905,48.15,896444,49.562,28.6,6.224,8702.975,412.82,14.49,0.741,0
67,161,0,31,0,2,171,9076,48.15,896444,49.562,28.6,6.224,8702.975,412.82,14.49,0.741,0
67,162,0,31,0,2,159,9235,48.15,896444,49.562,28.6,6.224,8702.975,412.82,14.49,0.741,0
67,163,1,32,0,2,33,9268,48.15,896444,49.562,28.6,6.224,8702.975,412.82,14.49,0.741,0
67,164,0,32,0,2,26,9294,48.15,896444,49.562,28.6,6.224,8702.975,412.82,14.49,0.741,0
67,165,0,32,0,2,28,9322,48.15,896444,49.562,28.6,6.224,8702.975,412.82,14.49,0.741,0
67,166,0,32,0,2,17,9339,48.15,896444,49.562,28.6,6.224,8702.975,412.82,14.49,0.741,0
67,167,0,32,0,2,23,9362,48.15,896444,49.562,28.6,6.224,8702.975,412.82,14.49,0.741,0
67,168,0,32,0,2,208,9570,48.15,896444,49.562,28.6,6.224,8702.975,412.82,14.49,0.741,0
67,169,0,32,0,2,183,9753,48.15,896444,49.562,28.6,6.224,8702.975,412.82,14.49,0.741,0
67,170,0,32,0,2,53,9806,48.15,896444,49.562,28.6,6.224,8702.975,412.82,14.49,0.741,0
67,171,0,32,0,2,20,9826,48.15,896444,49.562,28.6,6.224,8702.975,412.82,14.49,0.741,0
67,172,0,32,0,2,33,9859,48.15,896444,49.562,28.6,6.224,8702.975,412.82,14.49,0.741,0
67,173,0,32,0,2,28,9887,48.15,896444,49.562,28.6,6.224,8702.975,412.82,14.49,0.741,0
67,174,0,32,0,2,25,9912,48.15,896444,49.562,28.6,6.224,8702.975,412.82,14.49,0.741,0
67,175,0,32,0,2,100,10012,48.15,896444,49.562,28.6,6.224,8702.975,412.82,14.49,0.741,0
67,176,0,32,0,2,180,10192,48.15,896444,49.562,28.6,6.224,8702.975,412.82,14.49,0.741,0
67,177,0,32,0,2,24,10216,48.15,896444,49.562,28.6,6.224,8702.975,412.82,14.49,0.741,0
67,178,0,32,0,2,64,10280,48.15,896444,49.562,28.6,6.224,8702.975,412.82,14.49,0.741,0
67,179,0,32,0,2,65,10345,48.15,896444,49.562,28.6,6.224,8702.975,412.82,14.49,0.741,0
67,180,0,32,0,2,40,10385,48.15,896444,49.562,28.6,6.224,8702.975,412.82,14.49,0.741,0
67,181,0,32,0,2,16,10401,48.15,896444,49.562,28.6,6.224,8702.975,412.82,14.49,0.741,0
67,182,0,32,0,2,158,10559,48.15,896444,49.562,28.6,6.224,8702.975,412.82,14.49,0.741,0
67,183,0,32,0,2,227,10786,48.15,896444,49.562,28.6,6.224,8702.975,412.82,14.49,0.741,0
67,184,0,32,0,2,39,10825,48.15,896444,49.562,28.6,6.224,8702.975,412.82,14.49,0.741,0
67,185,0,32,0,2,58,10883,45.37,896444,49.562,28.6,6.224,8702.975,412.82,14.49,0.741,0
67,186,0,32,0,2,111,10994,45.37,896444,49.562,28.6,6.224,8702.975,412.82,14.49,0.741,0
67,187,0,32,0,2,-35,10959,45.37,896444,49.562,28.6,6.224,8702.975,412.82,14.49,0.741,0
67,188,0,32,0,2,34,10993,45.37,896444,49.562,28.6,6.224,8702.975,412.82,14.49,0.741,0
67,189,0,32,0,2,41,11034,45.37,896444,49.562,28.6,6.224,8702.975,412.82,14.49,0.741,0
67,190,0,32,0,2,0,11034,45.37,896444,49.562,28.6,6.224,8702.975,412.82,14.49,0.741,0
67,191,0,32,0,2,0,11318,45.37,896444,49.562,28.6,6.224,8702.975,412.82,14.49,0.741,0
67,192,0,32,0,2,102,11420,45.37,896444,49.562,28.6,6.224,8702.975,412.82,14.49,0.741,0
67,193,0,32,0,2,30,11450,45.37,896444,49.562,28.6,6.224,8702.975,412.82,14.49,0.741,0
67,194,0,32,0,2,0,11450,45.37,896444,49.562,28.6,6.224,8702.975,412.82,14.49,0.741,0
67,195,0,32,0,2,0,11508,45.37,896444,49.562,28.6,6.224,8702.975,412.82,14.49,0.741,0
67,196,0,32,0,2,85,11593,45.37,896444,49.562,28.6,6.224,8702.975,412.82,14.49,0.741,0
67,197,0,32,0,2,178,11771,45.37,896444,49.562,28.6,6.224,8702.975,412.82,14.49,0.741,0
67,198,0,32,0,2,0,11771,45.37,896444,49.562,28.6,6.224,8702.975,412.82,14.49,0.741,0
67,199,0,32,0,2,0,11771,45.37,896444,49.562,28.6,6.224,8702.975,412.82,14.49,0.741,0
67,200,0,32,0,2,0,11771,45.37,896444,49.562,28.6,6.224,8702.975,412.82,14.49,0.741,0
67,201,0,32,0,2,0,11771,45.37,896444,49.562,28.6,6.224,8702.975,412.82,14.49,0.741,0
67,202,0,32,0,2,0,11771,45.37,896444,49.562,28.6,6.224,8702.975,412.82,14.49,0.741,0
67,203,0,32,0,2,0,11771,45.37,896444,49.562,28.6,6.224,8702.975,412.82,14.49,0.741,0
67,204,1,33,0,2,0,11771,45.37,896444,49.562,28.6,6.224,8702.975,412.82,14.49,0.741,0
68,1,71,1384,4,17,1611,25209,62.96,5540718,18.136,42.8,21.228,40585.721,153.507,5.76,0.92,0
68,2,62,1446,0,17,2331,27540,62.96,5540718,18.136,42.8,21.228,40585.721,153.507,5.76,0.92,0
68,3,72,1518,2,19,1691,29231,62.96,5540718,18.136,42.8,21.228,40585.721,153.507,5.76,0.92,0
68,4,97,1615,1,20,3224,32455,62.96,5540718,18.136,42.8,21.228,40585.721,153.507,5.76,0.92,0
68,5,267,1882,5,25,1647,34102,62.96,5540718,18.136,42.8,21.228,40585.721,153.507,5.76,0.92,0
68,6,45,1927,2,27,1971,36073,62.96,5540718,18.136,42.8,21.228,40585.721,153.507,5.76,0.92,0
68,7,249,2176,0,27,2167,38240,62.96,5540718,18.136,42.8,21.228,40585.721,153.507,5.76,0.92,0
68,8,132,2308,7,34,3295,41535,62.96,5540718,18.136,42.8,21.228,40585.721,153.507,5.76,0.92,0
68,9,179,2487,6,40,2549,44084,62.96,5540718,18.136,42.8,21.228,40585.721,153.507,5.76,0.92,0
68,10,118,2605,2,42,3287,47371,62.96,5540718,18.136,42.8,21.228,40585.721,153.507,5.76,0.92,0
68,11,164,2769,6,48,1318,48689,62.96,5540718,18.136,42.8,21.228,40585.721,153.507,5.76,0.92,0
68,12,136,2905,1,49,1589,50278,62.96,5540718,18.136,42.8,21.228,40585.721,153.507,5.76,0.92,0
68,13,69,2974,7,56,920,51198,62.96,5540718,18.136,42.8,21.228,40585.721,153.507,5.76,0.92,0
68,14,90,3064,3,59,1225,52423,62.96,5540718,18.136,42.8,21.228,40585.721,153.507,5.76,0.92,0
68,15,97,3161,5,64,2492,54915,60.19,5540718,18.136,42.8,21.228,40585.721,153.507,5.76,0.92,0
68,16,76,3237,8,72,3507,58422,60.19,5540718,18.136,42.8,21.228,40585.721,153.507,5.76,0.92,0
68,17,132,3369,3,75,2710,61132,60.19,5540718,18.136,42.8,21.228,40585.721,153.507,5.76,0.92,0
68,18,120,3489,7,82,3692,64824,60.19,5540718,18.136,42.8,21.228,40585.721,153.507,5.76,0.92,0
68,19,192,3681,8,90,2362,67186,60.19,5540718,18.136,42.8,21.228,40585.721,153.507,5.76,0.92,0
68,20,102,3783,4,94,1844,69030,60.19,5540718,18.136,42.8,21.228,40585.721,153.507,5.76,0.92,0
68,21,85,3868,4,98,3620,72650,60.19,5540718,18.136,42.8,21.228,40585.721,153.507,5.76,0.92,0
68,22,146,4014,43,141,4202,76852,60.19,5540718,18.136,42.8,21.228,40585.721,153.507,5.76,0.92,0
68,23,115,4129,8,149,3664,80516,60.19,5540718,18.136,42.8,21.228,40585.721,153.507,5.76,0.92,0
68,24,155,4284,23,172,4280,84796,60.19,5540718,18.136,42.8,21.228,40585.721,153.507,5.76,0.92,0
68,25,111,4395,5,177,3141,87937,60.19,5540718,18.136,42.8,21.228,40585.721,153.507,5.76,0.92,0
68,26,80,4475,9,186,2485,90422,60.19,5540718,18.136,42.8,21.228,40585.721,153.507,5.76,0.92,0
68,27,101,4576,4,190,2440,92862,60.19,5540718,18.136,42.8,21.228,40585.721,153.507,5.76,0.92,0
68,28,119,4695,3,193,3788,96650,60.19,5540718,18.136,42.8,21.228,40585.721,153.507,5.76,0.92,0
68,29,45,4740,6,199,4450,101100,60.19,5540718,18.136,42.8,21.228,40585.721,153.507,5.76,0.92,0
68,30,166,4906,7,206,4179,105279,60.19,5540718,18.136,42.8,21.228,40585.721,153.507,5.76,0.92,0
68,31,89,4995,5,211,3375,108654,60.19,5540718,18.136,42.8,21.228,40585.721,153.507,5.76,0.92,0
68,32,56,5051,7,218,1483,110137,60.19,5540718,18.136,42.8,21.228,40585.721,153.507,5.76,0.92,0
68,33,128,5179,2,220,1649,111786,60.19,5540718,18.136,42.8,21.228,40585.721,153.507,5.76,0.92,0
68,34,75,5254,10,230,1761,113547,60.19,5540718,18.136,42.8,21.228,40585.721,153.507,5.76,0.92,0
68,35,73,5327,10,240,3771,117318,60.19,5540718,18.136,42.8,21.228,40585.721,153.507,5.76,0.92,0
68,36,85,5412,6,246,3808,121126,60.19,5540718,18.136,42.8,21.228,40585.721,153.507,5.76,0.92,0
68,37,161,5573,6,252,3832,124958,60.19,5540718,18.136,42.8,21.228,40585.721,153.507,5.76,0.92,0
68,38,100,5673,3,255,3322,128280,60.19,5540718,18.136,42.8,21.228,40585.721,153.507,5.76,0.92,0
68,39,65,5738,5,260,2810,131090,60.19,5540718,18.136,42.8,21.228,40585.721,153.507,5.76,0.92,0
68,40,142,5880,5,265,1819,132909,60.19,5540718,18.136,42.8,21.228,40585.721,153.507,5.76,0.92,0
68,41,82,5962,2,267,2208,135117,60.19,5540718,18.136,42.8,21.228,40585.721,153.507,5.76,0.92,0
68,42,22,5984,4,271,4055,139172,60.19,5540718,18.136,42.8,21.228,40585.721,153.507,5.76,0.92,0
68,43,19,6003,4,275,4011,143183,60.19,5540718,18.136,42.8,21.228,40585.721,153.507,5.76,0.92,0
68,44,51,6054,9,284,3897,147080,53.7,5540718,18.136,42.8,21.228,40585.721,153.507,5.76,0.92,0
68,45,91,6145,3,287,4353,151433,53.7,5540718,18.136,42.8,21.228,40585.721,153.507,5.76,0.92,0
68,46,83,6228,6,293,3450,154883,53.7,5540718,18.136,42.8,21.228,40585.721,153.507,5.76,0.92,0
68,47,58,6286,4,297,2312,157195,53.7,5540718,18.136,42.8,21.228,40585.721,153.507,5.76,0.92,0
68,48,61,6347,1,298,2360,159555,53.7,5540718,18.136,42.8,21.228,40585.721,153.507,5.76,0.92,0
68,49,33,6380,2,300,4946,164501,53.7,5540718,18.136,42.8,21.228,40585.721,153.507,5.76,0.92,0
68,50,19,6399,1,301,3696,168197,53.7,5540718,18.136,42.8,21.228,40585.721,153.507,5.76,0.92,0
68,51,44,6443,3,304,2965,171162,53.7,5540718,18.136,42.8,21.228,40585.721,153.507,5.76,0.92,0
68,52,50,6493,2,306,2216,173378,53.7,5540718,18.136,42.8,21.228,40585.721,153.507,5.76,0.92,0
68,53,44,6537,0,306,2630,176008,53.7,5540718,18.136,42.8,21.228,40585.721,153.507,5.76,0.92,0
68,54,31,6568,0,306,1554,177562,53.7,5540718,18.136,42.8,21.228,40585.721,153.507,5.76,0.92,0
68,55,11,6579,1,307,1744,179306,53.7,5540718,18.136,42.8,21.228,40585.721,153.507,5.76,0.92,0
68,56,20,6599,1,308,3638,182944,53.7,5540718,18.136,42.8,21.228,40585.721,153.507,5.76,0.92,0
68,57,29,6628,4,312,2971,185915,53.7,5540718,18.136,42.8,21.228,40585.721,153.507,5.76,0.92,0
68,58,64,6692,1,313,2945,188860,53.7,5540718,18.136,42.8,21.228,40585.721,153.507,5.76,0.92,0
68,59,51,6743,0,313,2804,191664,48.15,5540718,18.136,42.8,21.228,40585.721,153.507,5.76,0.92,0
68,60,33,6776,1,314,1945,193609,48.15,5540718,18.136,42.8,21.228,40585.721,153.507,5.76,0.92,0
68,61,50,6826,2,316,1295,194904,48.15,5540718,18.136,42.8,21.228,40585.721,153.507,5.76,0.92,0
68,62,33,6859,4,320,1685,196589,44.44,5540718,18.136,42.8,21.228,40585.721,153.507,5.76,0.92,0
68,63,26,6885,0,320,3882,200471,44.44,5540718,18.136,42.8,21.228,40585.721,153.507,5.76,0.92,0
68,64,2,6887,0,320,2860,203331,44.44,5540718,18.136,42.8,21.228,40585.721,153.507,5.76,0.92,0
68,65,24,6911,1,321,2798,206129,44.44,5540718,18.136,42.8,21.228,40585.721,153.507,5.76,0.92,0
68,66,0,6911,1,322,2321,208450,44.44,5540718,18.136,42.8,21.228,40585.721,153.507,5.76,0.92,0
68,67,30,6941,0,322,2042,210492,44.44,5540718,18.136,42.8,21.228,40585.721,153.507,5.76,0.92,0
68,68,23,6964,0,322,962,211454,44.44,5540718,18.136,42.8,21.228,40585.721,153.507,5.76,0.92,0
68,69,17,6981,1,323,1842,213296,44.44,5540718,18.136,42.8,21.228,40585.721,153.507,5.76,0.92,0
68,70,20,7001,0,323,2950,216246,44.44,5540718,18.136,42.8,21.228,40585.721,153.507,5.76,0.92,0
68,71,24,7025,1,324,2956,219202,44.44,5540718,18.136,42.8,21.228,40585.721,153.507,5.76,0.92,0
68,72,15,7040,0,324,2973,222175,44.44,5540718,18.136,42.8,21.228,40585.721,153.507,5.76,0.92,0
68,73,24,7064,1,325,2496,224671,44.44,5540718,18.136,42.8,21.228,40585.721,153.507,5.76,0.92,0
68,74,9,7073,0,325,1553,226224,44.44,5540718,18.136,42.8,21.228,40585.721,153.507,5.76,0.92,0
68,75,14,7087,0,325,826,227050,44.44,5540718,18.136,42.8,21.228,40585.721,153.507,5.76,0.92,0
68,76,17,7104,1,326,1899,228949,35.19,5540718,18.136,42.8,21.228,40585.721,153.507,5.76,0.92,0
68,77,4,7108,0,326,2991,231940,35.19,5540718,18.136,42.8,21.228,40585.721,153.507,5.76,0.92,0
68,78,4,7112,0,326,2731,234671,35.19,5540718,18.136,42.8,21.228,40585.721,153.507,5.76,0.92,0
68,79,5,7117,0,326,2069,236740,35.19,5540718,18.136,42.8,21.228,40585.721,153.507,5.76,0.92,0
68,80,0,7117,0,326,1433,238173,35.19,5540718,18.136,42.8,21.228,40585.721,153.507,5.76,0.92,0
68,81,16,7133,0,326,742,238915,35.19,5540718,18.136,42.8,21.228,40585.721,153.507,5.76,0.92,0
68,82,9,7142,0,326,687,239602,35.19,5540718,18.136,42.8,21.228,40585.721,153.507,5.76,0.92,0
68,83,1,7143,0,326,1604,241206,35.19,5540718,18.136,42.8,21.228,40585.721,153.507,5.76,0.92,0
68,84,1,7144,1,327,2635,243841,35.19,5540718,18.136,42.8,21.228,40585.721,153.507,5.76,0.92,0
68,85,11,7155,0,327,2330,246171,35.19,5540718,18.136,42.8,21.228,40585.721,153.507,5.76,0.92,0
68,86,12,7167,0,327,2693,248864,35.19,5540718,18.136,42.8,21.228,40585.721,153.507,5.76,0.92,0
68,87,5,7172,0,327,2176,251040,35.19,5540718,18.136,42.8,21.228,40585.721,153.507,5.76,0.92,0
68,88,19,7191,1,328,1556,252596,35.19,5540718,18.136,42.8,21.228,40585.721,153.507,5.76,0.92,0
68,89,0,7191,0,328,965,253561,35.19,5540718,18.136,42.8,21.228,40585.721,153.507,5.76,0.92,0
68,90,0,7191,0,328,1695,255256,35.19,5540718,18.136,42.8,21.228,40585.721,153.507,5.76,0.92,0
68,91,18,7209,0,328,2837,258093,35.19,5540718,18.136,42.8,21.228,40585.721,153.507,5.76,0.92,0
68,92,5,7214,0,328,2776,260869,35.19,5540718,18.136,42.8,21.228,40585.721,153.507,5.76,0.92,0
68,93,22,7236,0,328,3769,264638,35.19,5540718,18.136,42.8,21.228,40585.721,153.507,5.76,0.92,0
68,94,5,7241,0,328,3240,267878,35.19,5540718,18.136,42.8,21.228,40585.721,153.507,5.76,0.92,0
68,95,28,7269,0,328,2645,270523,35.19,5540718,18.136,42.8,21.228,40585.721,153.507,5.76,0.92,0
68,96,1,7270,0,328,1310,271833,35.19,5540718,18.136,42.8,21.228,40585.721,153.507,5.76,0.92,0
68,97,2,7272,0,328,2230,274063,35.19,5540718,18.136,42.8,21.228,40585.721,153.507,5.76,0.92,0
68,98,3,7275,0,328,4541,278604,35.19,5540718,18.136,42.8,21.228,40585.721,153.507,5.76,0.92,0
68,99,1,7276,0,328,4391,282995,35.19,5540718,18.136,42.8,21.228,40585.721,153.507,5.76,0.92,0
68,100,7,7283,0,328,4873,287868,40.74,5540718,18.136,42.8,21.228,40585.721,153.507,5.76,0.92,0
68,101,4,7287,0,328,4382,292250,40.74,5540718,18.136,42.8,21.228,40585.721,153.507,5.76,0.92,0
68,102,3,7290,0,328,3292,295542,40.74,5540718,18.136,42.8,21.228,40585.721,153.507,5.76,0.92,0
68,103,0,7290,0,328,2327,297869,40.74,5540718,18.136,42.8,21.228,40585.721,153.507,5.76,0.92,0
68,104,2,7292,0,328,3091,300960,40.74,5540718,18.136,42.8,21.228,40585.721,153.507,5.76,0.92,0
68,105,1,7293,0,328,5346,306306,40.74,5540718,18.136,42.8,21.228,40585.721,153.507,5.76,0.92,0
68,106,0,7293,0,328,5416,311722,40.74,5540718,18.136,42.8,21.228,40585.721,153.507,5.76,0.92,0
68,107,0,7293,0,328,4965,316687,40.74,5540718,18.136,42.8,21.228,40585.721,153.507,5.76,0.92,0
68,108,0,7293,0,328,5098,321785,35.19,5540718,18.136,42.8,21.228,40585.721,153.507,5.76,0.92,0
68,109,8,7301,0,328,4125,325910,35.19,5540718,18.136,42.8,21.228,40585.721,153.507,5.76,0.92,0
68,110,17,7318,0,328,2135,328045,35.19,5540718,18.136,42.8,21.228,40585.721,153.507,5.76,0.92,0
68,111,20,7338,0,328,3284,331329,35.19,5540718,18.136,42.8,21.228,40585.721,153.507,5.76,0.92,0
68,112,2,7340,0,328,5454,336783,35.19,5540718,18.136,42.8,21.228,40585.721,153.507,5.76,0.92,0
68,113,11,7351,0,328,5034,341817,35.19,5540718,18.136,42.8,21.228,40585.721,153.507,5.76,0.92,0
68,114,11,7362,0,328,5469,347286,35.19,5540718,18.136,42.8,21.228,40585.721,153.507,5.76,0.92,0
68,115,10,7372,0,328,4747,352033,35.19,5540718,18.136,42.8,21.228,40585.721,153.507,5.76,0.92,0
68,116,8,7380,1,329,3757,355790,35.19,5540718,18.136,42.8,21.228,40585.721,153.507,5.76,0.92,0
68,117,8,7388,0,329,2282,358072,35.19,5540718,18.136,42.8,21.228,40585.721,153.507,5.76,0.92,0
68,118,5,7393,0,329,3389,361461,35.19,5540718,18.136,42.8,21.228,40585.721,153.507,5.76,0.92,0
68,119,5,7398,0,329,5729,367190,35.19,5540718,18.136,42.8,21.228,40585.721,153.507,5.76,0.92,0
68,120,6,7404,0,329,5531,372721,35.19,5540718,18.136,42.8,21.228,40585.721,153.507,5.76,0.92,0
68,121,10,7414,0,329,5610,378331,35.19,5540718,18.136,42.8,21.228,40585.721,153.507,5.76,0.92,0
68,122,9,7423,0,329,5548,383879,35.19,5540718,18.136,42.8,21.228,40585.721,153.507,5.76,0.92,0
68,123,9,7432,0,329,4189,388068,35.19,5540718,18.136,42.8,21.228,40585.721,153.507,5.76,0.92,0
68,124,11,7443,0,329,4562,392630,35.19,5540718,18.136,42.8,21.228,40585.721,153.507,5.76,0.92,0
68,125,10,7453,0,329,5237,397867,35.19,5540718,18.136,42.8,21.228,40585.721,153.507,5.76,0.92,0
68,126,13,7466,0,329,6815,404682,35.19,5540718,18.136,42.8,21.228,40585.721,153.507,5.76,0.92,0
68,127,17,7483,2,331,8534,413216,35.19,5540718,18.136,42.8,21.228,40585.721,153.507,5.76,0.92,0
68,128,29,7512,0,331,7093,420309,35.19,5540718,18.136,42.8,21.228,40585.721,153.507,5.76,0.92,0
68,129,20,7532,0,331,8799,429108,35.19,5540718,18.136,42.8,21.228,40585.721,153.507,5.76,0.92,0
68,130,22,7554,0,331,6319,435427,35.19,5540718,18.136,42.8,21.228,40585.721,153.507,5.76,0.92,0
68,131,14,7568,0,331,5932,441359,35.19,5540718,18.136,42.8,21.228,40585.721,153.507,5.76,0.92,0
68,132,16,7584,0,331,7250,448609,35.19,5540718,18.136,42.8,21.228,40585.721,153.507,5.76,0.92,0
68,133,17,7601,2,333,10633,459242,35.19,5540718,18.136,42.8,21.228,40585.721,153.507,5.76,0.92,0
68,134,22,7623,0,333,11595,470837,35.19,5540718,18.136,42.8,21.228,40585.721,153.507,5.76,0.92,0
68,135,19,7642,0,333,12102,482939,35.19,5540718,18.136,42.8,21.228,40585.721,153.507,5.76,0.92,0
68,136,41,7683,0,333,9616,492555,32.41,5540718,18.136,42.8,21.228,40585.721,153.507,5.76,0.92,0
68,137,17,7700,0,333,10349,502904,32.41,5540718,18.136,42.8,21.228,40585.721,153.507,5.76,0.92,0
68,138,20,7720,0,333,10951,513855,32.41,5540718,18.136,42.8,21.228,40585.721,153.507,5.76,0.92,0
68,139,11,7731,0,333,10794,524649,32.41,5540718,18.136,42.8,21.228,40585.721,153.507,5.76,0.92,0
68,140,21,7752,1,334,12166,536815,32.41,5540718,18.136,42.8,21.228,40585.721,153.507,5.76,0.92,0
68,141,24,7776,0,334,14244,551059,32.41,5540718,18.136,42.8,21.228,40585.721,153.507,5.76,0.92,0
68,142,0,7776,0,334,13547,564606,32.41,5540718,18.136,42.8,21.228,40585.721,153.507,5.76,0.92,0
68,143,66,7842,0,334,14517,579123,32.41,5540718,18.136,42.8,21.228,40585.721,153.507,5.76,0.92,0
68,144,29,7871,0,334,10432,589555,32.41,5540718,18.136,42.8,21.228,40585.721,153.507,5.76,0.92,0
68,145,0,7871,0,334,10608,600163,32.41,5540718,18.136,42.8,21.228,40585.721,153.507,5.76,0.92,0
68,146,0,7871,0,334,13577,613740,32.41,5540718,18.136,42.8,21.228,40585.721,153.507,5.76,0.92,0
68,147,67,7938,1,335,15167,628907,32.41,5540718,18.136,42.8,21.228,40585.721,153.507,5.76,0.92,0
68,148,43,7981,0,335,14513,643420,32.41,5540718,18.136,42.8,21.228,40585.721,153.507,5.76,0.92,0
68,149,21,8002,0,335,14525,657945,32.41,5540718,18.136,42.8,21.228,40585.721,153.507,5.76,0.92,0
68,150,17,8019,0,335,12611,670556,32.41,5540718,18.136,42.8,21.228,40585.721,153.507,5.76,0.92,0
68,151,23,8042,0,335,13165,683721,32.41,5540718,18.136,42.8,21.228,40585.721,153.507,5.76,0.92,0
68,152,7,8049,0,335,12240,695961,32.41,5540718,18.136,42.8,21.228,40585.721,153.507,5.76,0.92,0
68,153,28,8077,0,335,13092,709053,32.41,5540718,18.136,42.8,21.228,40585.721,153.507,5.76,0.92,0
68,154,9,8086,0,335,14775,723828,32.41,5540718,18.136,42.8,21.228,40585.721,153.507,5.76,0.92,0
68,155,56,8142,0,335,17881,741709,32.41,5540718,18.136,42.8,21.228,40585.721,153.507,5.76,0.92,0
68,156,19,8161,0,335,16858,758567,32.41,5540718,18.136,42.8,21.228,40585.721,153.507,5.76,0.92,0
68,157,39,8200,0,335,16056,774623,32.41,5540718,18.136,42.8,21.228,40585.721,153.507,5.76,0.92,0
68,158,25,8225,0,335,14155,788778,32.41,5540718,18.136,42.8,21.228,40585.721,153.507,5.76,0.92,0
68,159,0,8225,0,335,9519,798297,32.41,5540718,18.136,42.8,21.228,40585.721,153.507,5.76,0.92,0
68,160,0,8225,0,335,7262,805559,32.41,5540718,18.136,42.8,21.228,40585.721,153.507,5.76,0.92,0
68,161,102,8327,1,336,12028,817587,32.41,5540718,18.136,42.8,21.228,40585.721,153.507,5.76,0.92,0
68,162,10,8337,0,336,14177,831764,32.41,5540718,18.136,42.8,21.228,40585.721,153.507,5.76,0.92,0
68,163,93,8430,1,337,12974,844738,32.41,5540718,18.136,42.8,21.228,40585.721,153.507,5.76,0.92,0
68,164,39,8469,0,337,14417,859155,32.41,5540718,18.136,42.8,21.228,40585.721,153.507,5.76,0.92,0
68,165,43,8512,0,337,10320,869475,32.41,5540718,18.136,42.8,21.228,40585.721,153.507,5.76,0.92,0
68,166,0,8512,0,337,8393,877868,32.41,5540718,18.136,42.8,21.228,40585.721,153.507,5.76,0.92,0
68,167,68,8580,0,337,9136,887004,32.41,5540718,18.136,42.8,21.228,40585.721,153.507,5.76,0.92,0
68,168,47,8627,2,339,13562,900566,32.41,5540718,18.136,42.8,21.228,40585.721,153.507,5.76,0.92,0
68,169,98,8725,0,339,17118,917684,32.41,5540718,18.136,42.8,21.228,40585.721,153.507,5.76,0.92,0
68,170,25,8750,0,339,18389,936073,32.41,5540718,18.136,42.8,21.228,40585.721,153.507,5.76,0.92,0
68,171,49,8799,0,339,16865,952938,32.41,5540718,18.136,42.8,21.228,40585.721,153.507,5.76,0.92,0
68,172,59,8858,0,339,12241,965179,32.41,5540718,18.136,42.8,21.228,40585.721,153.507,5.76,0.92,0
68,173,64,8922,0,339,10306,975485,32.41,5540718,18.136,42.8,21.228,40585.721,153.507,5.76,0.92,0
68,174,58,8980,0,339,8706,984191,32.41,5540718,18.136,42.8,21.228,40585.721,153.507,5.76,0.92,0
68,175,66,9046,2,341,14150,998341,32.41,5540718,18.136,42.8,21.228,40585.721,153.507,5.76,0.92,0
68,176,149,9195,0,341,13622,1011963,32.41,5540718,18.136,42.8,21.228,40585.721,153.507,5.76,0.92,0
68,177,93,9288,2,343,16516,1028479,32.41,5540718,18.136,42.8,21.228,40585.721,153.507,5.76,0.92,0
68,178,91,9379,0,343,14460,1042939,32.41,5540718,18.136,42.8,21.228,40585.721,153.507,5.76,0.92,0
68,179,105,9484,0,343,14739,1057678,32.41,5540718,18.136,42.8,21.228,40585.721,153.507,5.76,0.92,0
68,180,93,9577,0,343,8962,1066640,32.41,5540718,18.136,42.8,21.228,40585.721,153.507,5.76,0.92,0
68,181,105,9682,0,343,11218,1077858,32.41,5540718,18.136,42.8,21.228,40585.721,153.507,5.76,0.92,0
68,182,52,9734,0,343,11737,1089595,32.41,5540718,18.136,42.8,21.228,40585.721,153.507,5.76,0.92,0
68,183,158,9892,0,343,15358,1104953,32.41,5540718,18.136,42.8,21.228,40585.721,153.507,5.76,0.92,0
68,184,100,9992,1,344,10876,1115829,32.41,5540718,18.136,42.8,21.228,40585.721,153.507,5.76,0.92,0
68,185,111,10103,0,344,11579,1127408,32.41,5540718,18.136,42.8,21.228,40585.721,153.507,5.76,0.92,0
68,186,101,10204,1,345,10447,1137855,32.41,5540718,18.136,42.8,21.228,40585.721,153.507,5.76,0.92,0
68,187,40,10244,0,345,9104,1146959,32.41,5540718,18.136,42.8,21.228,40585.721,153.507,5.76,0.92,0
68,188,294,10538,0,345,10303,1157262,32.41,5540718,18.136,42.8,21.228,40585.721,153.507,5.76,0.92,0
68,189,164,10702,1,346,13404,1170666,32.41,5540718,18.136,42.8,21.228,40585.721,153.507,5.76,0.92,0
68,190,227,10929,0,346,15332,1185998,32.41,5540718,18.136,42.8,21.228,40585.721,153.507,5.76,0.92,0
68,191,120,11049,0,346,14344,1200342,32.41,5540718,18.136,42.8,21.228,40585.721,153.507,5.76,0.92,0
68,192,296,11345,0,346,15812,1216154,32.41,5540718,18.136,42.8,21.228,40585.721,153.507,5.76,0.92,0
68,193,235,11580,0,346,12169,1228323,32.41,5540718,18.136,42.8,21.228,40585.721,153.507,5.76,0.92,0
68,194,0,11580,0,346,8815,1237138,32.41,5540718,18.136,42.8,21.228,40585.721,153.507,5.76,0.92,0
68,195,0,11580,0,346,12326,1249464,32.41,5540718,18.136,42.8,21.228,40585.721,153.507,5.76,0.92,0
68,196,632,12212,0,346,15083,1264547,32.41,5540718,18.136,42.8,21.228,40585.721,153.507,5.76,0.92,0
68,197,287,12499,0,346,15493,1280040,32.41,5540718,18.136,42.8,21.228,40585.721,153.507,5.76,0.92,0
68,198,204,12703,4,350,14777,1294817,32.41,5540718,18.136,42.8,21.228,40585.721,153.507,5.76,0.92,0
68,199,291,12994,0,350,12601,1307418,32.41,5540718,18.136,42.8,21.228,40585.721,153.507,5.76,0.92,0
68,200,139,13133,1,351,10151,1317569,32.41,5540718,18.136,42.8,21.228,40585.721,153.507,5.76,0.92,0
68,201,0,13133,0,351,7231,1324800,32.41,5540718,18.136,42.8,21.228,40585.721,153.507,5.76,0.92,0
68,202,291,13424,0,351,0,1324800,32.41,5540718,18.136,42.8,21.228,40585.721,153.507,5.76,0.92,0
68,203,131,13555,0,351,0,1324800,32.41,5540718,18.136,42.8,21.228,40585.721,153.507,5.76,0.92,0
68,204,294,13849,0,351,0,1324800,32.41,5540718,18.136,42.8,21.228,40585.721,153.507,5.76,0.92,0
69,1,7578,52128,499,3523,0,0,87.96,65273512,122.578,42,19.718,38605.671,86.06,4.77,0.901,4
69,2,4861,56989,509,4032,0,0,87.96,65273512,122.578,42,19.718,38605.671,86.06,4.77,0.901,4
69,3,2116,59105,471,4503,0,0,87.96,65273512,122.578,42,19.718,38605.671,86.06,4.77,0.901,4
69,4,5233,64338,2004,6507,0,0,87.96,65273512,122.578,42,19.718,38605.671,86.06,4.77,0.901,4
69,5,4267,68605,1053,7560,0,0,87.96,65273512,122.578,42,19.718,38605.671,86.06,4.77,0.901,4
69,6,1873,70478,518,8078,0,0,87.96,65273512,122.578,42,19.718,38605.671,86.06,4.77,0.901,4
69,7,3912,74390,833,8911,0,0,87.96,65273512,122.578,42,19.718,38605.671,86.06,4.77,0.901,4
69,8,3777,78167,1417,10328,0,0,87.96,65273512,122.578,42,19.718,38605.671,86.06,4.77,0.901,4
69,9,3881,82048,541,10869,0,0,87.96,65273512,122.578,42,19.718,38605.671,86.06,4.77,0.901,4
69,10,4286,86334,1341,12210,0,0,87.96,65273512,122.578,42,19.718,38605.671,86.06,4.77,0.901,4
69,11,4342,90676,987,13197,0,0,87.96,65273512,122.578,42,19.718,38605.671,86.06,4.77,0.901,4
69,12,3114,93790,635,13832,0,0,87.96,65273512,122.578,42,19.718,38605.671,86.06,4.77,0.901,4
69,13,1613,95403,561,14393,0,0,87.96,65273512,122.578,42,19.718,38605.671,86.06,4.77,0.901,4
69,14,2673,98076,574,14967,0,0,87.96,65273512,122.578,42,19.718,38605.671,86.06,4.77,0.901,4
69,15,5497,103573,762,15729,0,0,87.96,65273512,122.578,42,19.718,38605.671,86.06,4.77,0.901,4
69,16,2633,106206,1438,17167,0,0,87.96,65273512,122.578,42,19.718,38605.671,86.06,4.77,0.901,4
69,17,2641,108847,753,17920,0,0,87.96,65273512,122.578,42,19.718,38605.671,86.06,4.77,0.901,4
69,18,405,109252,761,18681,0,0,87.96,65273512,122.578,42,19.718,38605.671,86.06,4.77,0.901,4
69,19,2569,111821,642,19323,0,0,87.96,65273512,122.578,42,19.718,38605.671,86.06,4.77,0.901,4
69,20,785,112606,395,19718,0,0,87.96,65273512,122.578,42,19.718,38605.671,86.06,4.77,0.901,4
69,21,2051,114657,547,20265,0,0,87.96,65273512,122.578,42,19.718,38605.671,86.06,4.77,0.901,4
69,22,2667,117324,531,20796,0,0,87.96,65273512,122.578,42,19.718,38605.671,86.06,4.77,0.901,4
69,23,1827,119151,544,21340,0,0,87.96,65273512,122.578,42,19.718,38605.671,86.06,4.77,0.901,4
69,24,1653,120804,516,21856,0,0,87.96,65273512,122.578,42,19.718,38605.671,86.06,4.77,0.901,4
69,25,1773,122577,389,22245,0,0,87.96,65273512,122.578,42,19.718,38605.671,86.06,4.77,0.901,4
69,26,1537,124114,369,22614,0,0,87.96,65273512,122.578,42,19.718,38605.671,86.06,4.77,0.901,4
69,27,461,124575,242,22856,0,0,87.96,65273512,122.578,42,19.718,38605.671,86.06,4.77,0.901,4
69,28,1195,125770,437,23293,0,0,87.96,65273512,122.578,42,19.718,38605.671,86.06,4.77,0.901,4
69,29,1065,126835,367,23660,0,0,87.96,65273512,122.578,42,19.718,38605.671,86.06,4.77,0.901,4
69,30,1607,128442,427,24087,0,0,87.96,65273512,122.578,42,19.718,38605.671,86.06,4.77,0.901,4
69,31,1139,129581,289,24376,0,0,87.96,65273512,122.578,42,19.718,38605.671,86.06,4.77,0.901,4
69,32,604,130185,218,24594,0,0,87.96,65273512,122.578,42,19.718,38605.671,86.06,4.77,0.901,4
69,33,794,130979,166,24760,0,0,87.96,65273512,122.578,42,19.718,38605.671,86.06,4.77,0.901,4
69,34,308,131287,135,24895,0,0,87.96,65273512,122.578,42,19.718,38605.671,86.06,4.77,0.901,4
69,35,576,131863,306,25201,0,0,87.96,65273512,122.578,42,19.718,38605.671,86.06,4.77,0.901,4
69,36,1104,132967,330,25531,0,0,87.96,65273512,122.578,42,19.718,38605.671,86.06,4.77,0.901,4
69,37,4183,137150,278,25809,0,0,87.96,65273512,122.578,42,19.718,38605.671,86.06,4.77,0.901,4
69,38,629,137779,178,25987,0,0,87.96,65273512,122.578,42,19.718,38605.671,86.06,4.77,0.901,4
69,39,642,138421,243,26230,0,0,87.96,65273512,122.578,42,19.718,38605.671,86.06,4.77,0.901,4
69,40,433,138854,80,26310,0,0,87.96,65273512,122.578,42,19.718,38605.671,86.06,4.77,0.901,4
69,41,209,139063,70,26380,0,0,74.07,65273512,122.578,42,19.718,38605.671,86.06,4.77,0.901,4
69,42,456,139519,263,26643,0,0,74.07,65273512,122.578,42,19.718,38605.671,86.06,4.77,0.901,4
69,43,708,140227,348,26991,40031,0,74.07,65273512,122.578,42,19.718,38605.671,86.06,4.77,0.901,4
69,44,507,140734,83,27074,43348,0,74.07,65273512,122.578,42,19.718,38605.671,86.06,4.77,0.901,4
69,45,622,141356,351,27425,48657,0,74.07,65273512,122.578,42,19.718,38605.671,86.06,4.77,0.901,4
69,46,563,141919,130,27555,16729,0,74.07,65273512,122.578,42,19.718,38605.671,86.06,4.77,0.901,4
69,47,372,142291,88,27643,6692,0,74.07,65273512,122.578,42,19.718,38605.671,86.06,4.77,0.901,4
69,48,120,142411,68,27711,52156,0,74.07,65273512,122.578,42,19.718,38605.671,86.06,4.77,0.901,4
69,49,492,142903,186,27897,53771,0,74.07,65273512,122.578,42,19.718,38605.671,86.06,4.77,0.901,4
69,50,524,143427,125,28022,54144,0,74.07,65273512,122.578,42,19.718,38605.671,86.06,4.77,0.901,4
69,51,418,143845,110,28132,9747,0,74.07,65273512,122.578,42,19.718,38605.671,86.06,4.77,0.901,4
69,52,318,144163,83,28215,51336,0,74.07,65273512,122.578,42,19.718,38605.671,86.06,4.77,0.901,4
69,53,403,144566,74,28289,19150,0,74.07,65273512,122.578,42,19.718,38605.671,86.06,4.77,0.901,4
69,54,240,144806,43,28332,7129,0,74.07,65273512,122.578,42,19.718,38605.671,86.06,4.77,0.901,4
69,55,115,144921,35,28367,52510,0,74.07,65273512,122.578,42,19.718,38605.671,86.06,4.77,0.901,4
69,56,358,145279,65,28432,54624,0,72.22,65273512,122.578,42,19.718,38605.671,86.06,4.77,0.901,4
69,57,276,145555,98,28530,47271,0,72.22,65273512,122.578,42,19.718,38605.671,86.06,4.77,0.901,4
69,58,191,145746,66,28596,45170,0,72.22,65273512,122.578,42,19.718,38605.671,86.06,4.77,0.901,4
69,59,3325,149071,66,28662,50092,0,72.22,65273512,122.578,42,19.718,38605.671,86.06,4.77,0.901,4
69,60,597,149668,52,28714,20337,0,72.22,65273512,122.578,42,19.718,38605.671,86.06,4.77,0.901,4
69,61,1828,151496,57,28771,8553,0,72.22,65273512,122.578,42,19.718,38605.671,86.06,4.77,0.901,4
69,62,257,151753,31,28802,10111,0,72.22,65273512,122.578,42,19.718,38605.671,86.06,4.77,0.901,4
69,63,338,152091,31,28833,49623,0,69.44,65273512,122.578,42,19.718,38605.671,86.06,4.77,0.901,4
69,64,-766,151325,107,28940,45549,0,69.44,65273512,122.578,42,19.718,38605.671,86.06,4.77,0.901,4
69,65,352,151677,81,29021,41917,0,69.44,65273512,122.578,42,19.718,38605.671,86.06,4.77,0.901,4
69,66,767,152444,44,29065,47097,0,69.44,65273512,122.578,42,19.718,38605.671,86.06,4.77,0.901,4
69,67,611,153055,46,29111,19725,0,69.44,65273512,122.578,42,19.718,38605.671,86.06,4.77,0.901,4
69,68,579,153634,31,29142,7513,0,69.44,65273512,122.578,42,19.718,38605.671,86.06,4.77,0.901,4
69,69,343,153977,13,29155,45718,0,69.44,65273512,122.578,42,19.718,38605.671,86.06,4.77,0.901,4
69,70,211,154188,54,29209,44390,0,66.67,65273512,122.578,42,19.718,38605.671,86.06,4.77,0.901,4
69,71,403,154591,87,29296,40878,0,66.67,65273512,122.578,42,19.718,38605.671,86.06,4.77,0.901,4
69,72,545,155136,23,29319,38985,0,66.67,65273512,122.578,42,19.718,38605.671,86.06,4.77,0.901,4
69,73,425,155561,27,29346,44749,0,66.67,65273512,122.578,42,19.718,38605.671,86.06,4.77,0.901,4
69,74,726,156287,28,29374,19177,0,65.28,65273512,122.578,42,19.718,38605.671,86.06,4.77,0.901,4
69,75,526,156813,24,29398,6590,0,65.28,65273512,122.578,42,19.718,38605.671,86.06,4.77,0.901,4
69,76,407,157220,9,29407,44111,0,65.28,65273512,122.578,42,19.718,38605.671,86.06,4.77,0.901,4
69,77,152,157372,29,29436,43158,0,65.28,65273512,122.578,42,19.718,38605.671,86.06,4.77,0.901,4
69,78,344,157716,111,29547,40357,0,65.28,65273512,122.578,42,19.718,38605.671,86.06,4.77,0.901,4
69,79,458,158174,28,29575,38193,0,65.28,65273512,122.578,42,19.718,38605.671,86.06,4.77,0.901,4
69,80,467,158641,28,29603,45994,0,65.28,65273512,122.578,42,19.718,38605.671,86.06,4.77,0.901,4
69,81,811,159452,14,29617,21676,0,65.28,65273512,122.578,42,19.718,38605.671,86.06,4.77,0.901,4
69,82,641,160093,16,29633,6477,0,65.28,65273512,122.578,42,19.718,38605.671,86.06,4.77,0.901,4
69,83,284,160377,7,29640,48592,0,41.2,65273512,122.578,42,19.718,38605.671,86.06,4.77,0.901,4
69,84,373,160750,23,29663,48578,0,41.2,65273512,122.578,42,19.718,38605.671,86.06,4.77,0.901,4
69,85,517,161267,57,29720,45678,0,41.2,65273512,122.578,42,19.718,38605.671,86.06,4.77,0.901,4
69,86,81,161348,11,29731,40375,0,41.2,65273512,122.578,42,19.718,38605.671,86.06,4.77,0.901,4
69,87,0,161348,21,29752,51680,0,41.2,65273512,122.578,42,19.718,38605.671,86.06,4.77,0.901,4
69,88,1588,162936,26,29778,24747,0,41.2,65273512,122.578,42,19.718,38605.671,86.06,4.77,0.901,4
69,89,0,162936,0,29778,8403,0,41.2,65273512,122.578,42,19.718,38605.671,86.06,4.77,0.901,4
69,90,0,162936,0,29778,62011,0,41.2,65273512,122.578,42,19.718,38605.671,86.06,4.77,0.901,4
69,91,1324,164260,35,29813,59532,0,41.2,65273512,122.578,42,19.718,38605.671,86.06,4.77,0.901,4
69,92,541,164801,30,29843,57174,0,41.2,65273512,122.578,42,19.718,38605.671,86.06,4.77,0.901,4
69,93,918,165719,18,29861,55017,0,41.2,65273512,122.578,42,19.718,38605.671,86.06,4.77,0.901,4
69,94,659,166378,14,29875,64565,0,41.2,65273512,122.578,42,19.718,38605.671,86.06,4.77,0.901,4
69,95,582,166960,18,29893,29194,0,41.2,65273512,122.578,42,19.718,38605.671,86.06,4.77,0.901,4
69,96,0,166960,0,29893,8764,0,41.2,65273512,122.578,42,19.718,38605.671,86.06,4.77,0.901,4
69,97,0,166960,0,29893,67117,0,41.2,65273512,122.578,42,19.718,38605.671,86.06,4.77,0.901,4
69,98,1375,168335,27,29920,66144,0,41.2,65273512,122.578,42,19.718,38605.671,86.06,4.77,0.901,4
69,99,475,168810,13,29933,65252,0,41.2,65273512,122.578,42,19.718,38605.671,86.06,4.77,0.901,4
69,100,663,169473,32,29965,68855,0,41.2,65273512,122.578,42,19.718,38605.671,86.06,4.77,0.901,4
69,101,621,170094,14,29979,77252,0,41.2,65273512,122.578,42,19.718,38605.671,86.06,4.77,0.901,4
69,102,658,170752,25,30004,32463,0,38.43,65273512,122.578,42,19.718,38605.671,86.06,4.77,0.901,4
69,103,0,170752,0,30004,8585,0,38.43,65273512,122.578,42,19.718,38605.671,86.06,4.77,0.901,4
69,104,0,170752,0,30004,80361,0,38.43,65273512,122.578,42,19.718,38605.671,86.06,4.77,0.901,4
69,105,1625,172377,25,30029,12496,0,38.43,65273512,122.578,42,19.718,38605.671,86.06,4.77,0.901,4
69,106,0,172377,0,30029,79974,0,38.43,65273512,122.578,42,19.718,38605.671,86.06,4.77,0.901,4
69,107,927,173304,91,30120,84196,0,38.43,65273512,122.578,42,19.718,38605.671,86.06,4.77,0.901,4
69,108,534,173838,18,30138,93819,0,38.43,65273512,122.578,42,19.718,38605.671,86.06,4.77,0.901,4
69,109,836,174674,14,30152,40503,0,38.43,65273512,122.578,42,19.718,38605.671,86.06,4.77,0.901,4
69,110,0,174674,0,30152,12404,0,38.43,65273512,122.578,42,19.718,38605.671,86.06,4.77,0.901,4
69,111,0,174674,0,30152,92667,0,38.43,65273512,122.578,42,19.718,38605.671,86.06,4.77,0.901,4
69,112,2080,176754,13,30165,89058,0,38.43,65273512,122.578,42,19.718,38605.671,86.06,4.77,0.901,4
69,113,584,177338,0,30165,88518,0,38.43,65273512,122.578,42,19.718,38605.671,86.06,4.77,0.901,4
69,114,998,178336,7,30172,87887,0,38.43,65273512,122.578,42,19.718,38605.671,86.06,4.77,0.901,4
69,115,1062,179398,10,30182,95483,0,38.43,65273512,122.578,42,19.718,38605.671,86.06,4.77,0.901,4
69,116,1130,180528,10,30192,43193,0,38.43,65273512,122.578,42,19.718,38605.671,86.06,4.77,0.901,4
69,117,0,180528,0,30192,15059,0,38.43,65273512,122.578,42,19.718,38605.671,86.06,4.77,0.901,4
69,118,0,180528,0,30192,102766,0,38.43,65273512,122.578,42,19.718,38605.671,86.06,4.77,0.901,4
69,119,2551,183079,17,30209,103530,0,38.43,65273512,122.578,42,19.718,38605.671,86.06,4.77,0.901,4
69,120,725,183804,14,30223,107730,0,38.43,65273512,122.578,42,19.718,38605.671,86.06,4.77,0.901,4
69,121,1392,185196,15,30238,105666,0,38.43,65273512,122.578,42,19.718,38605.671,86.06,4.77,0.901,4
69,122,1377,186573,16,30254,109554,0,38.43,65273512,122.578,42,19.718,38605.671,86.06,4.77,0.901,4
69,123,1346,187919,11,30265,47588,0,38.43,65273512,122.578,42,19.718,38605.671,86.06,4.77,0.901,4
69,124,0,187919,0,30265,16644,0,38.43,65273512,122.578,42,19.718,38605.671,86.06,4.77,0.901,4
69,125,0,187919,0,30265,113117,0,38.43,65273512,122.578,42,19.718,38605.671,86.06,4.77,0.901,4
69,126,3376,191295,29,30294,106480,0,38.43,65273512,122.578,42,19.718,38605.671,86.06,4.77,0.901,4
69,127,1039,192334,2,30296,106540,0,38.43,65273512,122.578,42,19.718,38605.671,86.06,4.77,0.901,4
69,128,1695,194029,9,30305,109883,0,38.43,65273512,122.578,42,19.718,38605.671,86.06,4.77,0.901,4
69,129,1604,195633,7,30312,112187,0,38.43,65273512,122.578,42,19.718,38605.671,86.06,4.77,0.901,4
69,130,2288,197921,12,30324,49970,0,38.43,65273512,122.578,42,19.718,38605.671,86.06,4.77,0.901,4
69,131,0,197921,0,30324,17251,0,38.43,65273512,122.578,42,19.718,38605.671,86.06,4.77,0.901,4
69,132,0,197921,0,30324,117136,0,38.43,65273512,122.578,42,19.718,38605.671,86.06,4.77,0.901,4
69,133,4854,202775,16,30340,107033,0,38.43,65273512,122.578,42,19.718,38605.671,86.06,4.77,0.901,4
69,134,1397,204172,14,30354,112205,0,38.43,65273512,122.578,42,19.718,38605.671,86.06,4.77,0.901,4
69,135,2524,206696,17,30371,121931,0,38.43,65273512,122.578,42,19.718,38605.671,86.06,4.77,0.901,4
69,136,2669,209365,17,30388,133353,0,40.28,65273512,122.578,42,19.718,38605.671,86.06,4.77,0.901,4
69,137,2846,212211,18,30406,27003,0,40.28,65273512,122.578,42,19.718,38605.671,86.06,4.77,0.901,4
69,138,3310,215521,3,30409,22244,0,40.28,65273512,122.578,42,19.718,38605.671,86.06,4.77,0.901,4
69,139,3015,218536,1,30410,155029,0,40.28,65273512,122.578,42,19.718,38605.671,86.06,4.77,0.901,4
69,140,493,219029,19,30429,145915,0,40.28,65273512,122.578,42,19.718,38605.671,86.06,4.77,0.901,4
69,141,2238,221267,22,30451,145653,0,40.28,65273512,122.578,42,19.718,38605.671,86.06,4.77,0.901,4
69,142,3776,225043,17,30468,154455,0,40.28,65273512,122.578,42,19.718,38605.671,86.06,4.77,0.901,4
69,143,4771,229814,12,30480,165737,0,40.28,65273512,122.578,42,19.718,38605.671,86.06,4.77,0.901,4
69,144,4586,234400,23,30503,69771,0,40.28,65273512,122.578,42,19.718,38605.671,86.06,4.77,0.901,4
69,145,3602,238002,9,30512,23728,0,40.28,65273512,122.578,42,19.718,38605.671,86.06,4.77,0.901,4
69,146,4897,242899,1,30513,188545,0,40.28,65273512,122.578,42,19.718,38605.671,86.06,4.77,0.901,4
69,147,1955,244854,15,30528,178479,0,40.28,65273512,122.578,42,19.718,38605.671,86.06,4.77,0.901,4
69,148,3304,248158,16,30544,183255,0,40.28,65273512,122.578,42,19.718,38605.671,86.06,4.77,0.901,4
69,149,5429,253587,0,30544,196645,0,40.28,65273512,122.578,42,19.718,38605.671,86.06,4.77,0.901,4
69,150,6111,259698,32,30576,203502,0,40.28,65273512,122.578,42,19.718,38605.671,86.06,4.77,0.901,4
69,151,7379,267077,20,30596,85354,0,40.28,65273512,122.578,42,19.718,38605.671,86.06,4.77,0.901,4
69,152,5453,272530,6,30602,28030,0,40.28,65273512,122.578,42,19.718,38605.671,86.06,4.77,0.901,4
69,153,5413,277943,4,30606,221961,0,40.28,65273512,122.578,42,19.718,38605.671,86.06,4.77,0.901,4
69,154,3082,281025,29,30635,198107,0,40.28,65273512,122.578,42,19.718,38605.671,86.06,4.77,0.901,4
69,155,4982,286007,26,30661,197257,0,40.28,65273512,122.578,42,19.718,38605.671,86.06,4.77,0.901,4
69,156,7017,293024,25,30686,205765,0,45.83,65273512,122.578,42,19.718,38605.671,86.06,4.77,0.901,4
69,157,7157,300181,0,30686,220337,0,45.83,65273512,122.578,42,19.718,38605.671,86.06,4.77,0.901,4
69,158,8975,309156,0,30686,93958,0,45.83,65273512,122.578,42,19.718,38605.671,86.06,4.77,0.901,4
69,159,8550,317706,12,30698,28777,0,45.83,65273512,122.578,42,19.718,38605.671,86.06,4.77,0.901,4
69,160,7071,324777,3,30701,246783,0,45.83,65273512,122.578,42,19.718,38605.671,86.06,4.77,0.901,4
69,161,4203,328980,25,30726,243447,0,45.83,65273512,122.578,42,19.718,38605.671,86.06,4.77,0.901,4
69,162,6544,335524,38,30764,239591,0,45.83,65273512,122.578,42,19.718,38605.671,86.06,4.77,0.901,4
69,163,8577,344101,30,30794,254005,0,45.83,65273512,122.578,42,19.718,38605.671,86.06,4.77,0.901,4
69,164,9843,353944,19,30813,263963,0,45.83,65273512,122.578,42,19.718,38605.671,86.06,4.77,0.901,4
69,165,9406,363350,80,30893,102788,0,45.83,65273512,122.578,42,19.718,38605.671,86.06,4.77,0.901,4
69,166,10561,373911,17,30910,29379,0,45.83,65273512,122.578,42,19.718,38605.671,86.06,4.77,0.901,4
69,167,7183,381094,6,30916,278898,0,45.83,65273512,122.578,42,19.718,38605.671,86.06,4.77,0.901,4
69,168,6158,387252,34,30950,268512,0,45.83,65273512,122.578,42,19.718,38605.671,86.06,4.77,0.901,4
69,169,7852,395104,49,30999,250138,0,45.83,65273512,122.578,42,19.718,38605.671,86.06,4.77,0.901,4
69,170,9784,404888,46,31045,247174,0,45.83,65273512,122.578,42,19.718,38605.671,86.06,4.77,0.901,4
69,171,10593,415481,50,31095,247534,0,45.83,65273512,122.578,42,19.718,38605.671,86.06,4.77,0.901,4
69,172,13215,428696,154,31249,95793,0,45.83,65273512,122.578,42,19.718,38605.671,86.06,4.77,0.901,4
69,173,13498,442194,25,31274,30115,0,45.83,65273512,122.578,42,19.718,38605.671,86.06,4.77,0.901,4
69,174,11569,453763,11,31285,246415,0,45.83,65273512,122.578,42,19.718,38605.671,86.06,4.77,0.901,4
69,175,4298,458061,53,31338,221717,0,43.98,65273512,122.578,42,19.718,38605.671,86.06,4.77,0.901,4
69,176,10008,468069,78,31416,205224,0,43.98,65273512,122.578,42,19.718,38605.671,86.06,4.77,0.901,4
69,177,13072,481141,43,31459,206235,0,43.98,65273512,122.578,42,19.718,38605.671,86.06,4.77,0.901,4
69,178,16096,497237,52,31511,213029,0,43.98,65273512,122.578,42,19.718,38605.671,86.06,4.77,0.901,4
69,179,15797,513034,150,31661,86023,0,46.76,65273512,122.578,42,19.718,38605.671,86.06,4.77,0.901,4
69,180,14412,527446,39,31700,23594,0,46.76,65273512,122.578,42,19.718,38605.671,86.06,4.77,0.901,4
69,181,11123,538569,27,31727,221972,0,46.76,65273512,122.578,42,19.718,38605.671,86.06,4.77,0.901,4
69,182,4070,542639,81,31808,198738,0,46.76,65273512,122.578,42,19.718,38605.671,86.06,4.77,0.901,4
69,183,8051,550690,85,31893,190547,0,46.76,65273512,122.578,42,19.718,38605.671,86.06,4.77,0.901,4
69,184,12845,563535,63,31956,194635,0,46.76,65273512,122.578,42,19.718,38605.671,86.06,4.77,0.901,4
69,185,13970,577505,63,32019,208576,0,46.76,65273512,122.578,42,19.718,38605.671,86.06,4.77,0.901,4
69,186,12148,589653,136,32155,89856,0,46.76,65273512,122.578,42,19.718,38605.671,86.06,4.77,0.901,4
69,187,16972,606625,43,32198,25320,0,46.76,65273512,122.578,42,19.718,38605.671,86.06,4.77,0.901,4
69,188,12545,619170,32,32230,238587,0,46.76,65273512,122.578,42,19.718,38605.671,86.06,4.77,0.901,4
69,189,5104,624274,69,32299,215837,0,46.76,65273512,122.578,42,19.718,38605.671,86.06,4.77,0.901,4
69,190,10489,634763,66,32365,212665,0,46.76,65273512,122.578,42,19.718,38605.671,86.06,4.77,0.901,4
69,191,18746,653509,80,32445,229173,0,46.76,65273512,122.578,42,19.718,38605.671,86.06,4.77,0.901,4
69,192,18129,671638,76,32521,256730,0,46.76,65273512,122.578,42,19.718,38605.671,86.06,4.77,0.901,4
69,193,20339,691977,109,32630,113474,0,46.76,65273512,122.578,42,19.718,38605.671,86.06,4.77,0.901,4
69,194,26896,718873,54,32684,31855,0,46.76,65273512,122.578,42,19.718,38605.671,86.06,4.77,0.901,4
69,195,16101,734974,46,32730,294813,0,46.76,65273512,122.578,42,19.718,38605.671,86.06,4.77,0.901,4
69,196,8505,743479,95,32825,271111,0,46.76,65273512,122.578,42,19.718,38605.671,86.06,4.77,0.901,4
69,197,12993,756472,108,32933,272313,0,46.76,65273512,122.578,42,19.718,38605.671,86.06,4.77,0.901,4
69,198,22591,779063,104,33037,280009,0,46.76,65273512,122.578,42,19.718,38605.671,86.06,4.77,0.901,4
69,199,30621,809684,88,33125,0,0,46.76,65273512,122.578,42,19.718,38605.671,86.06,4.77,0.901,4
69,200,25086,834770,178,33303,0,0,46.76,65273512,122.578,42,19.718,38605.671,86.06,4.77,0.901,4
69,201,32427,867197,89,33392,0,0,46.76,65273512,122.578,42,19.718,38605.671,86.06,4.77,0.901,4
69,202,29837,897034,85,33477,0,0,46.76,65273512,122.578,42,19.718,38605.671,86.06,4.77,0.901,4
69,203,13243,910277,146,33623,0,0,46.76,65273512,122.578,42,19.718,38605.671,86.06,4.77,0.901,4
69,204,20468,930745,262,33885,0,0,46.76,65273512,122.578,42,19.718,38605.671,86.06,4.77,0.901,4
71,1,9,16,0,1,0,0,66.67,2225728,7.859,23.1,4.45,16562.413,259.967,7.2,0.702,0
71,2,2,18,0,1,0,0,66.67,2225728,7.859,23.1,4.45,16562.413,259.967,7.2,0.702,0
71,3,0,18,0,1,0,0,66.67,2225728,7.859,23.1,4.45,16562.413,259.967,7.2,0.702,0
71,4,3,21,0,1,0,0,66.67,2225728,7.859,23.1,4.45,16562.413,259.967,7.2,0.702,0
71,5,0,21,0,1,0,0,66.67,2225728,7.859,23.1,4.45,16562.413,259.967,7.2,0.702,0
71,6,0,21,0,1,0,0,66.67,2225728,7.859,23.1,4.45,16562.413,259.967,7.2,0.702,0
71,7,0,21,0,1,0,0,66.67,2225728,7.859,23.1,4.45,16562.413,259.967,7.2,0.702,0
71,8,9,30,0,1,0,0,66.67,2225728,7.859,23.1,4.45,16562.413,259.967,7.2,0.702,0
71,9,3,33,0,1,0,0,66.67,2225728,7.859,23.1,4.45,16562.413,259.967,7.2,0.702,0
71,10,11,44,0,1,0,0,76.85,2225728,7.859,23.1,4.45,16562.413,259.967,7.2,0.702,0
71,11,2,46,0,1,0,0,76.85,2225728,7.859,23.1,4.45,16562.413,259.967,7.2,0.702,0
71,12,3,49,0,1,0,0,78.7,2225728,7.859,23.1,4.45,16562.413,259.967,7.2,0.702,0
71,13,8,57,0,1,0,0,78.7,2225728,7.859,23.1,4.45,16562.413,259.967,7.2,0.702,0
71,14,0,57,0,1,0,0,81.48,2225728,7.859,23.1,4.45,16562.413,259.967,7.2,0.702,0
71,15,18,75,0,1,0,0,81.48,2225728,7.859,23.1,4.45,16562.413,259.967,7.2,0.702,0
71,16,12,87,0,1,0,0,81.48,2225728,7.859,23.1,4.45,16562.413,259.967,7.2,0.702,0
71,17,8,95,0,1,0,0,81.48,2225728,7.859,23.1,4.45,16562.413,259.967,7.2,0.702,0
71,18,13,108,0,1,0,0,81.48,2225728,7.859,23.1,4.45,16562.413,259.967,7.2,0.702,0
71,19,1,109,0,1,0,0,81.48,2225728,7.859,23.1,4.45,16562.413,259.967,7.2,0.702,0
71,20,0,109,0,1,0,0,81.48,2225728,7.859,23.1,4.45,16562.413,259.967,7.2,0.702,0
71,21,11,120,0,1,0,0,81.48,2225728,7.859,23.1,4.45,16562.413,259.967,7.2,0.702,0
71,22,36,156,0,1,0,0,81.48,2225728,7.859,23.1,4.45,16562.413,259.967,7.2,0.702,0
71,23,10,166,0,1,0,0,81.48,2225728,7.859,23.1,4.45,16562.413,259.967,7.2,0.702,0
71,24,1,167,1,2,0,0,81.48,2225728,7.859,23.1,4.45,16562.413,259.967,7.2,0.702,0
71,25,5,172,1,3,0,0,81.48,2225728,7.859,23.1,4.45,16562.413,259.967,7.2,0.702,0
71,26,4,176,0,3,0,0,81.48,2225728,7.859,23.1,4.45,16562.413,259.967,7.2,0.702,0
71,27,0,176,0,3,0,0,79.63,2225728,7.859,23.1,4.45,16562.413,259.967,7.2,0.702,0
71,28,35,211,0,3,0,0,79.63,2225728,7.859,23.1,4.45,16562.413,259.967,7.2,0.702,0
71,29,27,238,0,3,0,0,79.63,2225728,7.859,23.1,4.45,16562.413,259.967,7.2,0.702,0
71,30,38,276,0,3,0,0,79.63,2225728,7.859,23.1,4.45,16562.413,259.967,7.2,0.702,0
71,31,0,276,0,3,0,0,79.63,2225728,7.859,23.1,4.45,16562.413,259.967,7.2,0.702,0
71,32,32,308,1,4,0,0,79.63,2225728,7.859,23.1,4.45,16562.413,259.967,7.2,0.702,0
71,33,27,335,1,5,0,0,79.63,2225728,7.859,23.1,4.45,16562.413,259.967,7.2,0.702,0
71,34,0,335,0,5,0,0,79.63,2225728,7.859,23.1,4.45,16562.413,259.967,7.2,0.702,0
71,35,32,367,1,6,0,0,79.63,2225728,7.859,23.1,4.45,16562.413,259.967,7.2,0.702,0
71,36,30,397,0,6,0,0,79.63,2225728,7.859,23.1,4.45,16562.413,259.967,7.2,0.702,0
71,37,42,439,2,8,0,0,79.63,2225728,7.859,23.1,4.45,16562.413,259.967,7.2,0.702,0
71,38,65,504,0,8,0,0,79.63,2225728,7.859,23.1,4.45,16562.413,259.967,7.2,0.702,0
71,39,116,620,0,8,0,0,79.63,2225728,7.859,23.1,4.45,16562.413,259.967,7.2,0.702,0
71,40,41,661,0,8,0,0,79.63,2225728,7.859,23.1,4.45,16562.413,259.967,7.2,0.702,0
71,41,0,661,0,8,0,0,75,2225728,7.859,23.1,4.45,16562.413,259.967,7.2,0.702,0
71,42,141,802,1,9,0,0,75,2225728,7.859,23.1,4.45,16562.413,259.967,7.2,0.702,0
71,43,61,863,0,9,0,0,75,2225728,7.859,23.1,4.45,16562.413,259.967,7.2,0.702,0
71,44,141,1004,0,9,0,0,80.56,2225728,7.859,23.1,4.45,16562.413,259.967,7.2,0.702,0
71,45,100,1104,1,10,0,0,80.56,2225728,7.859,23.1,4.45,16562.413,259.967,7.2,0.702,0
71,46,105,1209,0,10,0,0,80.56,2225728,7.859,23.1,4.45,16562.413,259.967,7.2,0.702,0
71,47,111,1320,1,11,0,0,80.56,2225728,7.859,23.1,4.45,16562.413,259.967,7.2,0.702,0
71,48,0,1320,0,11,0,0,80.56,2225728,7.859,23.1,4.45,16562.413,259.967,7.2,0.702,0
71,49,112,1432,0,11,0,0,80.56,2225728,7.859,23.1,4.45,16562.413,259.967,7.2,0.702,0
71,50,70,1502,1,12,0,0,80.56,2225728,7.859,23.1,4.45,16562.413,259.967,7.2,0.702,0
71,51,65,1567,0,12,0,0,80.56,2225728,7.859,23.1,4.45,16562.413,259.967,7.2,0.702,0
71,52,0,1567,0,12,0,0,80.56,2225728,7.859,23.1,4.45,16562.413,259.967,7.2,0.702,0
71,53,161,1728,0,12,0,0,80.56,2225728,7.859,23.1,4.45,16562.413,259.967,7.2,0.702,0
71,54,206,1934,0,12,0,0,80.56,2225728,7.859,23.1,4.45,16562.413,259.967,7.2,0.702,0
71,55,0,1934,0,12,0,0,80.56,2225728,7.859,23.1,4.45,16562.413,259.967,7.2,0.702,0
71,56,201,2135,2,14,0,0,80.56,2225728,7.859,23.1,4.45,16562.413,259.967,7.2,0.702,0
71,57,103,2238,0,14,0,0,80.56,2225728,7.859,23.1,4.45,16562.413,259.967,7.2,0.702,0
71,58,81,2319,0,14,0,0,80.56,2225728,7.859,23.1,4.45,16562.413,259.967,7.2,0.702,0
71,59,112,2431,0,14,0,0,80.56,2225728,7.859,23.1,4.45,16562.413,259.967,7.2,0.702,0
71,60,182,2613,1,15,0,0,80.56,2225728,7.859,23.1,4.45,16562.413,259.967,7.2,0.702,0
71,61,42,2655,2,17,0,0,80.56,2225728,7.859,23.1,4.45,16562.413,259.967,7.2,0.702,0
71,62,0,2655,0,17,0,0,80.56,2225728,7.859,23.1,4.45,16562.413,259.967,7.2,0.702,0
71,63,0,2655,0,17,0,0,80.56,2225728,7.859,23.1,4.45,16562.413,259.967,7.2,0.702,0
71,64,148,2803,3,20,0,0,80.56,2225728,7.859,23.1,4.45,16562.413,259.967,7.2,0.702,0
71,65,99,2902,0,20,0,0,80.56,2225728,7.859,23.1,4.45,16562.413,259.967,7.2,0.702,0
71,66,53,2955,1,21,0,0,80.56,2225728,7.859,23.1,4.45,16562.413,259.967,7.2,0.702,0
71,67,146,3101,0,21,0,0,80.56,2225728,7.859,23.1,4.45,16562.413,259.967,7.2,0.702,0
71,68,0,3101,0,21,0,0,80.56,2225728,7.859,23.1,4.45,16562.413,259.967,7.2,0.702,0
71,69,0,3101,0,21,0,0,80.56,2225728,7.859,23.1,4.45,16562.413,259.967,7.2,0.702,0
71,70,146,3247,0,21,0,0,80.56,2225728,7.859,23.1,4.45,16562.413,259.967,7.2,0.702,0
71,71,47,3294,0,21,0,0,80.56,2225728,7.859,23.1,4.45,16562.413,259.967,7.2,0.702,0
71,72,81,3375,1,22,0,0,80.56,2225728,7.859,23.1,4.45,16562.413,259.967,7.2,0.702,0
71,73,88,3463,1,23,0,0,80.56,2225728,7.859,23.1,4.45,16562.413,259.967,7.2,0.702,0
71,74,0,3463,0,23,0,0,80.56,2225728,7.859,23.1,4.45,16562.413,259.967,7.2,0.702,0
71,75,0,3463,0,23,0,0,80.56,2225728,7.859,23.1,4.45,16562.413,259.967,7.2,0.702,0
71,76,0,3463,0,23,0,0,69.44,2225728,7.859,23.1,4.45,16562.413,259.967,7.2,0.702,0
71,77,570,4033,4,27,0,0,69.44,2225728,7.859,23.1,4.45,16562.413,259.967,7.2,0.702,0
71,78,81,4114,2,29,0,0,69.44,2225728,7.859,23.1,4.45,16562.413,259.967,7.2,0.702,0
71,79,115,4229,1,30,0,0,69.44,2225728,7.859,23.1,4.45,16562.413,259.967,7.2,0.702,0
71,80,111,4340,2,32,0,0,69.44,2225728,7.859,23.1,4.45,16562.413,259.967,7.2,0.702,0
71,81,88,4428,2,34,0,0,69.44,2225728,7.859,23.1,4.45,16562.413,259.967,7.2,0.702,0
71,82,0,4428,0,34,0,0,69.44,2225728,7.859,23.1,4.45,16562.413,259.967,7.2,0.702,0
71,83,0,4428,0,34,0,0,69.44,2225728,7.859,23.1,4.45,16562.413,259.967,7.2,0.702,0
71,84,311,4739,5,39,0,0,69.44,2225728,7.859,23.1,4.45,16562.413,259.967,7.2,0.702,0
71,85,134,4873,0,39,0,0,69.44,2225728,7.859,23.1,4.45,16562.413,259.967,7.2,0.702,0
71,86,83,4956,0,39,0,0,69.44,2225728,7.859,23.1,4.45,16562.413,259.967,7.2,0.702,0
71,87,131,5087,1,40,0,0,69.44,2225728,7.859,23.1,4.45,16562.413,259.967,7.2,0.702,0
71,88,122,5209,0,40,0,0,69.44,2225728,7.859,23.1,4.45,16562.413,259.967,7.2,0.702,0
71,89,0,5209,0,40,0,0,69.44,2225728,7.859,23.1,4.45,16562.413,259.967,7.2,0.702,0
71,90,0,5209,0,40,0,0,69.44,2225728,7.859,23.1,4.45,16562.413,259.967,7.2,0.702,0
71,91,185,5394,2,42,0,0,69.44,2225728,7.859,23.1,4.45,16562.413,259.967,7.2,0.702,0
71,92,0,5394,0,42,0,0,66.67,2225728,7.859,23.1,4.45,16562.413,259.967,7.2,0.702,0
71,93,119,5513,0,42,0,0,66.67,2225728,7.859,23.1,4.45,16562.413,259.967,7.2,0.702,0
71,94,0,5513,0,42,0,0,66.67,2225728,7.859,23.1,4.45,16562.413,259.967,7.2,0.702,0
71,95,107,5620,2,44,0,0,66.67,2225728,7.859,23.1,4.45,16562.413,259.967,7.2,0.702,0
71,96,0,5620,0,44,0,0,66.67,2225728,7.859,23.1,4.45,16562.413,259.967,7.2,0.702,0
71,97,0,5620,0,44,0,0,66.67,2225728,7.859,23.1,4.45,16562.413,259.967,7.2,0.702,0
71,98,123,5743,2,46,0,0,66.67,2225728,7.859,23.1,4.45,16562.413,259.967,7.2,0.702,0
71,99,0,5743,0,46,0,0,66.67,2225728,7.859,23.1,4.45,16562.413,259.967,7.2,0.702,0
71,100,128,5871,0,46,0,0,66.67,2225728,7.859,23.1,4.45,16562.413,259.967,7.2,0.702,0
71,101,0,5871,0,46,0,0,66.67,2225728,7.859,23.1,4.45,16562.413,259.967,7.2,0.702,0
71,102,71,5942,0,46,0,0,66.67,2225728,7.859,23.1,4.45,16562.413,259.967,7.2,0.702,0
71,103,0,5942,0,46,0,0,66.67,2225728,7.859,23.1,4.45,16562.413,259.967,7.2,0.702,0
71,104,0,5942,0,46,0,0,66.67,2225728,7.859,23.1,4.45,16562.413,259.967,7.2,0.702,0
71,105,84,6026,0,46,0,0,66.67,2225728,7.859,23.1,4.45,16562.413,259.967,7.2,0.702,0
71,106,0,6026,0,46,0,0,66.67,2225728,7.859,23.1,4.45,16562.413,259.967,7.2,0.702,0
71,107,95,6121,0,46,0,0,66.67,2225728,7.859,23.1,4.45,16562.413,259.967,7.2,0.702,0
71,108,0,6121,0,46,0,0,66.67,2225728,7.859,23.1,4.45,16562.413,259.967,7.2,0.702,0
71,109,194,6315,0,46,0,0,66.67,2225728,7.859,23.1,4.45,16562.413,259.967,7.2,0.702,0
71,110,0,6315,0,46,0,0,66.67,2225728,7.859,23.1,4.45,16562.413,259.967,7.2,0.702,0
71,111,0,6315,0,46,0,0,66.67,2225728,7.859,23.1,4.45,16562.413,259.967,7.2,0.702,0
71,112,118,6433,0,46,0,0,66.67,2225728,7.859,23.1,4.45,16562.413,259.967,7.2,0.702,0
71,113,0,6433,0,46,0,0,66.67,2225728,7.859,23.1,4.45,16562.413,259.967,7.2,0.702,0
71,114,155,6588,1,47,0,0,66.67,2225728,7.859,23.1,4.45,16562.413,259.967,7.2,0.702,0
71,115,0,6588,0,47,0,0,66.67,2225728,7.859,23.1,4.45,16562.413,259.967,7.2,0.702,0
71,116,396,6984,2,49,0,0,66.67,2225728,7.859,23.1,4.45,16562.413,259.967,7.2,0.702,0
71,117,0,6984,0,49,0,0,66.67,2225728,7.859,23.1,4.45,16562.413,259.967,7.2,0.702,0
71,118,0,6984,0,49,0,0,66.67,2225728,7.859,23.1,4.45,16562.413,259.967,7.2,0.702,0
71,119,205,7189,0,49,0,0,66.67,2225728,7.859,23.1,4.45,16562.413,259.967,7.2,0.702,0
71,120,0,7189,0,49,0,0,66.67,2225728,7.859,23.1,4.45,16562.413,259.967,7.2,0.702,0
71,121,163,7352,0,49,0,0,66.67,2225728,7.859,23.1,4.45,16562.413,259.967,7.2,0.702,0
71,122,0,7352,0,49,0,0,66.67,2225728,7.859,23.1,4.45,16562.413,259.967,7.2,0.702,0
71,123,0,7352,0,49,0,0,66.67,2225728,7.859,23.1,4.45,16562.413,259.967,7.2,0.702,0
71,124,179,7531,1,50,0,0,66.67,2225728,7.859,23.1,4.45,16562.413,259.967,7.2,0.702,0
71,125,0,7531,0,50,0,0,66.67,2225728,7.859,23.1,4.45,16562.413,259.967,7.2,0.702,0
71,126,115,7646,1,51,0,0,66.67,2225728,7.859,23.1,4.45,16562.413,259.967,7.2,0.702,0
71,127,0,7646,0,51,0,0,66.67,2225728,7.859,23.1,4.45,16562.413,259.967,7.2,0.702,0
71,128,141,7787,0,51,0,0,66.67,2225728,7.859,23.1,4.45,16562.413,259.967,7.2,0.702,0
71,129,0,7787,0,51,0,0,66.67,2225728,7.859,23.1,4.45,16562.413,259.967,7.2,0.702,0
71,130,136,7923,0,51,0,0,66.67,2225728,7.859,23.1,4.45,16562.413,259.967,7.2,0.702,0
71,131,0,7923,0,51,0,0,66.67,2225728,7.859,23.1,4.45,16562.413,259.967,7.2,0.702,0
71,132,0,7923,0,51,0,0,66.67,2225728,7.859,23.1,4.45,16562.413,259.967,7.2,0.702,0
71,133,83,8006,0,51,0,0,66.67,2225728,7.859,23.1,4.45,16562.413,259.967,7.2,0.702,0
71,134,0,8006,0,51,0,0,66.67,2225728,7.859,23.1,4.45,16562.413,259.967,7.2,0.702,0
71,135,71,8077,0,51,0,0,66.67,2225728,7.859,23.1,4.45,16562.413,259.967,7.2,0.702,0
71,136,0,8077,0,51,0,0,66.67,2225728,7.859,23.1,4.45,16562.413,259.967,7.2,0.702,0
71,137,148,8225,0,51,0,0,66.67,2225728,7.859,23.1,4.45,16562.413,259.967,7.2,0.702,0
71,138,0,8225,0,51,0,0,66.67,2225728,7.859,23.1,4.45,16562.413,259.967,7.2,0.702,0
71,139,0,8225,0,51,0,0,66.67,2225728,7.859,23.1,4.45,16562.413,259.967,7.2,0.702,0
71,140,45,8270,2,53,0,0,66.67,2225728,7.859,23.1,4.45,16562.413,259.967,7.2,0.702,0
71,141,0,8270,0,53,0,0,66.67,2225728,7.859,23.1,4.45,16562.413,259.967,7.2,0.702,0
71,142,49,8319,0,53,0,0,66.67,2225728,7.859,23.1,4.45,16562.413,259.967,7.2,0.702,0
71,143,0,8319,0,53,0,0,66.67,2225728,7.859,23.1,4.45,16562.413,259.967,7.2,0.702,0
71,144,69,8388,0,53,0,0,66.67,2225728,7.859,23.1,4.45,16562.413,259.967,7.2,0.702,0
71,145,0,8388,0,53,0,0,66.67,2225728,7.859,23.1,4.45,16562.413,259.967,7.2,0.702,0
71,146,0,8388,0,53,0,0,66.67,2225728,7.859,23.1,4.45,16562.413,259.967,7.2,0.702,0
71,147,21,8409,0,53,0,0,66.67,2225728,7.859,23.1,4.45,16562.413,259.967,7.2,0.702,0
71,148,0,8409,0,53,0,0,66.67,2225728,7.859,23.1,4.45,16562.413,259.967,7.2,0.702,0
71,149,59,8468,0,53,0,0,66.67,2225728,7.859,23.1,4.45,16562.413,259.967,7.2,0.702,0
71,150,0,8468,0,53,0,0,66.67,2225728,7.859,23.1,4.45,16562.413,259.967,7.2,0.702,0
71,151,37,8505,0,53,0,0,66.67,2225728,7.859,23.1,4.45,16562.413,259.967,7.2,0.702,0
71,152,0,8505,0,53,0,0,66.67,2225728,7.859,23.1,4.45,16562.413,259.967,7.2,0.702,0
71,153,0,8505,0,53,0,0,66.67,2225728,7.859,23.1,4.45,16562.413,259.967,7.2,0.702,0
71,154,28,8533,0,53,0,0,66.67,2225728,7.859,23.1,4.45,16562.413,259.967,7.2,0.702,0
71,155,0,8533,0,53,0,0,66.67,2225728,7.859,23.1,4.45,16562.413,259.967,7.2,0.702,0
71,156,5,8538,0,53,0,0,66.67,2225728,7.859,23.1,4.45,16562.413,259.967,7.2,0.702,0
71,157,0,8538,0,53,0,0,66.67,2225728,7.859,23.1,4.45,16562.413,259.967,7.2,0.702,0
71,158,63,8601,0,53,0,0,66.67,2225728,7.859,23.1,4.45,16562.413,259.967,7.2,0.702,0
71,159,0,8601,0,53,0,0,66.67,2225728,7.859,23.1,4.45,16562.413,259.967,7.2,0.702,0
71,160,0,8601,0,53,0,0,66.67,2225728,7.859,23.1,4.45,16562.413,259.967,7.2,0.702,0
71,161,7,8608,0,53,0,0,66.67,2225728,7.859,23.1,4.45,16562.413,259.967,7.2,0.702,0
71,162,0,8608,0,53,0,0,66.67,2225728,7.859,23.1,4.45,16562.413,259.967,7.2,0.702,0
71,163,13,8621,0,53,0,0,66.67,2225728,7.859,23.1,4.45,16562.413,259.967,7.2,0.702,0
71,164,0,8621,0,53,0,0,66.67,2225728,7.859,23.1,4.45,16562.413,259.967,7.2,0.702,0
71,165,22,8643,0,53,0,0,66.67,2225728,7.859,23.1,4.45,16562.413,259.967,7.2,0.702,0
71,166,0,8643,0,53,0,0,66.67,2225728,7.859,23.1,4.45,16562.413,259.967,7.2,0.702,0
71,167,0,8643,0,53,0,0,66.67,2225728,7.859,23.1,4.45,16562.413,259.967,7.2,0.702,0
71,168,11,8654,0,53,0,0,66.67,2225728,7.859,23.1,4.45,16562.413,259.967,7.2,0.702,0
71,169,0,8654,0,53,0,0,66.67,2225728,7.859,23.1,4.45,16562.413,259.967,7.2,0.702,0
71,170,24,8678,0,53,0,0,66.67,2225728,7.859,23.1,4.45,16562.413,259.967,7.2,0.702,0
71,171,0,8678,0,53,0,0,66.67,2225728,7.859,23.1,4.45,16562.413,259.967,7.2,0.702,0
71,172,18,8696,0,53,0,0,66.67,2225728,7.859,23.1,4.45,16562.413,259.967,7.2,0.702,0
71,173,0,8696,0,53,0,0,66.67,2225728,7.859,23.1,4.45,16562.413,259.967,7.2,0.702,0
71,174,0,8696,0,53,0,0,66.67,2225728,7.859,23.1,4.45,16562.413,259.967,7.2,0.702,0
71,175,8,8704,1,54,0,0,66.67,2225728,7.859,23.1,4.45,16562.413,259.967,7.2,0.702,0
71,176,0,8704,0,54,0,0,66.67,2225728,7.859,23.1,4.45,16562.413,259.967,7.2,0.702,0
71,177,12,8716,0,54,0,0,66.67,2225728,7.859,23.1,4.45,16562.413,259.967,7.2,0.702,0
71,178,0,8716,0,54,0,0,66.67,2225728,7.859,23.1,4.45,16562.413,259.967,7.2,0.702,0
71,179,12,8728,0,54,0,0,66.67,2225728,7.859,23.1,4.45,16562.413,259.967,7.2,0.702,0
71,180,0,8728,0,54,0,0,66.67,2225728,7.859,23.1,4.45,16562.413,259.967,7.2,0.702,0
71,181,0,8728,0,54,0,0,66.67,2225728,7.859,23.1,4.45,16562.413,259.967,7.2,0.702,0
71,182,24,8752,0,54,0,0,66.67,2225728,7.859,23.1,4.45,16562.413,259.967,7.2,0.702,0
71,183,0,8752,0,54,0,0,66.67,2225728,7.859,23.1,4.45,16562.413,259.967,7.2,0.702,0
71,184,14,8766,0,54,0,0,66.67,2225728,7.859,23.1,4.45,16562.413,259.967,7.2,0.702,0
71,185,0,8766,0,54,0,0,66.67,2225728,7.859,23.1,4.45,16562.413,259.967,7.2,0.702,0
71,186,31,8797,0,54,0,0,66.67,2225728,7.859,23.1,4.45,16562.413,259.967,7.2,0.702,0
71,187,0,8797,0,54,0,0,66.67,2225728,7.859,23.1,4.45,16562.413,259.967,7.2,0.702,0
71,188,0,8797,0,54,0,0,66.67,2225728,7.859,23.1,4.45,16562.413,259.967,7.2,0.702,0
71,189,11,8808,0,54,0,0,74.07,2225728,7.859,23.1,4.45,16562.413,259.967,7.2,0.702,0
71,190,0,8808,0,54,0,0,74.07,2225728,7.859,23.1,4.45,16562.413,259.967,7.2,0.702,0
71,191,7,8815,0,54,0,0,74.07,2225728,7.859,23.1,4.45,16562.413,259.967,7.2,0.702,0
71,192,0,8815,0,54,0,0,74.07,2225728,7.859,23.1,4.45,16562.413,259.967,7.2,0.702,0
71,193,20,8835,0,54,0,0,74.07,2225728,7.859,23.1,4.45,16562.413,259.967,7.2,0.702,0
71,194,0,8835,0,54,0,0,74.07,2225728,7.859,23.1,4.45,16562.413,259.967,7.2,0.702,0
71,195,0,8835,0,54,0,0,74.07,2225728,7.859,23.1,4.45,16562.413,259.967,7.2,0.702,0
71,196,25,8860,0,54,0,0,74.07,2225728,7.859,23.1,4.45,16562.413,259.967,7.2,0.702,0
71,197,0,8860,0,54,0,0,74.07,2225728,7.859,23.1,4.45,16562.413,259.967,7.2,0.702,0
71,198,9,8869,0,54,0,0,74.07,2225728,7.859,23.1,4.45,16562.413,259.967,7.2,0.702,0
71,199,0,8869,0,54,0,0,74.07,2225728,7.859,23.1,4.45,16562.413,259.967,7.2,0.702,0
71,200,12,8881,0,54,0,0,74.07,2225728,7.859,23.1,4.45,16562.413,259.967,7.2,0.702,0
71,201,0,8881,0,54,0,0,74.07,2225728,7.859,23.1,4.45,16562.413,259.967,7.2,0.702,0
71,202,0,8881,0,54,0,0,74.07,2225728,7.859,23.1,4.45,16562.413,259.967,7.2,0.702,0
71,203,3,8884,0,54,0,0,74.07,2225728,7.859,23.1,4.45,16562.413,259.967,7.2,0.702,0
71,204,0,8884,0,54,0,0,74.07,2225728,7.859,23.1,4.45,16562.413,259.967,7.2,0.702,0
72,1,0,4,0,1,0,0,78.7,2416664,207.566,17.5,2.339,1561.767,331.43,1.91,0.46,0
72,2,0,4,0,1,0,0,78.7,2416664,207.566,17.5,2.339,1561.767,331.43,1.91,0.46,0
72,3,0,4,0,1,0,0,78.7,2416664,207.566,17.5,2.339,1561.767,331.43,1.91,0.46,0
72,4,0,4,0,1,0,0,78.7,2416664,207.566,17.5,2.339,1561.767,331.43,1.91,0.46,0
72,5,0,4,0,1,0,0,78.7,2416664,207.566,17.5,2.339,1561.767,331.43,1.91,0.46,0
72,6,0,4,0,1,0,0,78.7,2416664,207.566,17.5,2.339,1561.767,331.43,1.91,0.46,0
72,7,0,4,0,1,0,0,78.7,2416664,207.566,17.5,2.339,1561.767,331.43,1.91,0.46,0
72,8,0,4,0,1,0,0,78.7,2416664,207.566,17.5,2.339,1561.767,331.43,1.91,0.46,0
72,9,0,4,0,1,0,0,78.7,2416664,207.566,17.5,2.339,1561.767,331.43,1.91,0.46,0
72,10,0,4,0,1,0,0,78.7,2416664,207.566,17.5,2.339,1561.767,331.43,1.91,0.46,0
72,11,0,4,0,1,0,0,78.7,2416664,207.566,17.5,2.339,1561.767,331.43,1.91,0.46,0
72,12,5,9,0,1,0,0,78.7,2416664,207.566,17.5,2.339,1561.767,331.43,1.91,0.46,0
72,13,0,9,0,1,0,0,78.7,2416664,207.566,17.5,2.339,1561.767,331.43,1.91,0.46,0
72,14,0,9,0,1,0,0,78.7,2416664,207.566,17.5,2.339,1561.767,331.43,1.91,0.46,0
72,15,0,9,0,1,0,0,78.7,2416664,207.566,17.5,2.339,1561.767,331.43,1.91,0.46,0
72,16,0,9,0,1,0,0,78.7,2416664,207.566,17.5,2.339,1561.767,331.43,1.91,0.46,0
72,17,0,9,0,1,0,0,78.7,2416664,207.566,17.5,2.339,1561.767,331.43,1.91,0.46,0
72,18,0,9,0,1,0,0,78.7,2416664,207.566,17.5,2.339,1561.767,331.43,1.91,0.46,0
72,19,0,9,0,1,0,0,78.7,2416664,207.566,17.5,2.339,1561.767,331.43,1.91,0.46,0
72,20,1,10,0,1,0,0,78.7,2416664,207.566,17.5,2.339,1561.767,331.43,1.91,0.46,0
72,21,0,10,0,1,0,0,78.7,2416664,207.566,17.5,2.339,1561.767,331.43,1.91,0.46,0
72,22,0,10,0,1,0,0,78.7,2416664,207.566,17.5,2.339,1561.767,331.43,1.91,0.46,0
72,23,0,10,0,1,0,0,78.7,2416664,207.566,17.5,2.339,1561.767,331.43,1.91,0.46,0
72,24,0,10,0,1,0,0,78.7,2416664,207.566,17.5,2.339,1561.767,331.43,1.91,0.46,0
72,25,0,10,0,1,0,0,78.7,2416664,207.566,17.5,2.339,1561.767,331.43,1.91,0.46,0
72,26,0,10,0,1,0,0,78.7,2416664,207.566,17.5,2.339,1561.767,331.43,1.91,0.46,0
72,27,0,10,0,1,0,0,78.7,2416664,207.566,17.5,2.339,1561.767,331.43,1.91,0.46,0
72,28,0,10,0,1,0,0,78.7,2416664,207.566,17.5,2.339,1561.767,331.43,1.91,0.46,0
72,29,0,10,0,1,0,0,78.7,2416664,207.566,17.5,2.339,1561.767,331.43,1.91,0.46,0
72,30,1,11,0,1,0,0,78.7,2416664,207.566,17.5,2.339,1561.767,331.43,1.91,0.46,0
72,31,1,12,0,1,0,0,78.7,2416664,207.566,17.5,2.339,1561.767,331.43,1.91,0.46,0
72,32,0,12,0,1,0,0,78.7,2416664,207.566,17.5,2.339,1561.767,331.43,1.91,0.46,0
72,33,5,17,0,1,0,0,78.7,2416664,207.566,17.5,2.339,1561.767,331.43,1.91,0.46,0
72,34,0,17,0,1,0,0,78.7,2416664,207.566,17.5,2.339,1561.767,331.43,1.91,0.46,0
72,35,0,17,0,1,0,0,78.7,2416664,207.566,17.5,2.339,1561.767,331.43,1.91,0.46,0
72,36,0,17,0,1,0,0,78.7,2416664,207.566,17.5,2.339,1561.767,331.43,1.91,0.46,0
72,37,0,17,0,1,0,0,78.7,2416664,207.566,17.5,2.339,1561.767,331.43,1.91,0.46,0
72,38,1,18,0,1,0,0,78.7,2416664,207.566,17.5,2.339,1561.767,331.43,1.91,0.46,0
72,39,2,20,0,1,0,0,78.7,2416664,207.566,17.5,2.339,1561.767,331.43,1.91,0.46,0
72,40,0,20,0,1,0,0,78.7,2416664,207.566,17.5,2.339,1561.767,331.43,1.91,0.46,0
72,41,0,20,0,1,0,0,78.7,2416664,207.566,17.5,2.339,1561.767,331.43,1.91,0.46,0
72,42,2,22,0,1,0,0,78.7,2416664,207.566,17.5,2.339,1561.767,331.43,1.91,0.46,0
72,43,1,23,0,1,0,0,78.7,2416664,207.566,17.5,2.339,1561.767,331.43,1.91,0.46,0
72,44,0,23,0,1,0,0,78.7,2416664,207.566,17.5,2.339,1561.767,331.43,1.91,0.46,0
72,45,0,23,0,1,0,0,78.7,2416664,207.566,17.5,2.339,1561.767,331.43,1.91,0.46,0
72,46,0,23,0,1,0,0,78.7,2416664,207.566,17.5,2.339,1561.767,331.43,1.91,0.46,0
72,47,0,23,0,1,0,0,78.7,2416664,207.566,17.5,2.339,1561.767,331.43,1.91,0.46,0
72,48,0,23,0,1,0,0,77.78,2416664,207.566,17.5,2.339,1561.767,331.43,1.91,0.46,0
72,49,1,24,0,1,0,0,77.78,2416664,207.566,17.5,2.339,1561.767,331.43,1.91,0.46,0
72,50,0,24,0,1,0,0,77.78,2416664,207.566,17.5,2.339,1561.767,331.43,1.91,0.46,0
72,51,0,24,0,1,0,0,77.78,2416664,207.566,17.5,2.339,1561.767,331.43,1.91,0.46,0
72,52,0,24,0,1,0,0,77.78,2416664,207.566,17.5,2.339,1561.767,331.43,1.91,0.46,0
72,53,1,25,0,1,0,0,77.78,2416664,207.566,17.5,2.339,1561.767,331.43,1.91,0.46,0
72,54,0,25,0,1,0,0,77.78,2416664,207.566,17.5,2.339,1561.767,331.43,1.91,0.46,0
72,55,0,25,0,1,0,0,77.78,2416664,207.566,17.5,2.339,1561.767,331.43,1.91,0.46,0
72,56,0,25,0,1,0,0,77.78,2416664,207.566,17.5,2.339,1561.767,331.43,1.91,0.46,0
72,57,0,25,0,1,0,0,77.78,2416664,207.566,17.5,2.339,1561.767,331.43,1.91,0.46,0
72,58,0,25,0,1,0,0,77.78,2416664,207.566,17.5,2.339,1561.767,331.43,1.91,0.46,0
72,59,0,25,0,1,0,0,77.78,2416664,207.566,17.5,2.339,1561.767,331.43,1.91,0.46,0
72,60,0,25,0,1,0,0,77.78,2416664,207.566,17.5,2.339,1561.767,331.43,1.91,0.46,0
72,61,0,25,0,1,0,0,77.78,2416664,207.566,17.5,2.339,1561.767,331.43,1.91,0.46,0
72,62,0,25,0,1,0,0,77.78,2416664,207.566,17.5,2.339,1561.767,331.43,1.91,0.46,0
72,63,0,25,0,1,0,0,77.78,2416664,207.566,17.5,2.339,1561.767,331.43,1.91,0.46,0
72,64,1,26,0,1,0,0,77.78,2416664,207.566,17.5,2.339,1561.767,331.43,1.91,0.46,0
72,65,0,26,0,1,0,0,74.07,2416664,207.566,17.5,2.339,1561.767,331.43,1.91,0.46,0
72,66,0,26,0,1,0,0,74.07,2416664,207.566,17.5,2.339,1561.767,331.43,1.91,0.46,0
72,67,0,26,0,1,0,0,74.07,2416664,207.566,17.5,2.339,1561.767,331.43,1.91,0.46,0
72,68,0,26,0,1,0,0,74.07,2416664,207.566,17.5,2.339,1561.767,331.43,1.91,0.46,0
72,69,0,26,0,1,0,0,74.07,2416664,207.566,17.5,2.339,1561.767,331.43,1.91,0.46,0
72,70,2,28,0,1,0,0,74.07,2416664,207.566,17.5,2.339,1561.767,331.43,1.91,0.46,0
72,71,0,28,0,1,0,0,74.07,2416664,207.566,17.5,2.339,1561.767,331.43,1.91,0.46,0
72,72,0,28,0,1,0,0,74.07,2416664,207.566,17.5,2.339,1561.767,331.43,1.91,0.46,0
72,73,0,28,0,1,0,0,74.07,2416664,207.566,17.5,2.339,1561.767,331.43,1.91,0.46,0
72,74,0,28,0,1,0,0,74.07,2416664,207.566,17.5,2.339,1561.767,331.43,1.91,0.46,0
72,75,0,28,0,1,0,0,74.07,2416664,207.566,17.5,2.339,1561.767,331.43,1.91,0.46,0
72,76,0,28,0,1,0,0,74.07,2416664,207.566,17.5,2.339,1561.767,331.43,1.91,0.46,0
72,77,2,30,0,1,0,0,74.07,2416664,207.566,17.5,2.339,1561.767,331.43,1.91,0.46,0
72,78,4,34,0,1,0,0,74.07,2416664,207.566,17.5,2.339,1561.767,331.43,1.91,0.46,0
72,79,0,34,0,1,0,0,74.07,2416664,207.566,17.5,2.339,1561.767,331.43,1.91,0.46,0
72,80,2,36,0,1,0,0,74.07,2416664,207.566,17.5,2.339,1561.767,331.43,1.91,0.46,0
72,81,0,36,0,1,0,0,74.07,2416664,207.566,17.5,2.339,1561.767,331.43,1.91,0.46,0
72,82,1,37,1,2,0,0,74.07,2416664,207.566,17.5,2.339,1561.767,331.43,1.91,0.46,0
72,83,0,37,0,2,0,0,74.07,2416664,207.566,17.5,2.339,1561.767,331.43,1.91,0.46,0
72,84,4,41,0,2,0,0,74.07,2416664,207.566,17.5,2.339,1561.767,331.43,1.91,0.46,0
72,85,1,42,0,2,0,0,74.07,2416664,207.566,17.5,2.339,1561.767,331.43,1.91,0.46,0
72,86,0,42,0,2,0,0,74.07,2416664,207.566,17.5,2.339,1561.767,331.43,1.91,0.46,0
72,87,1,43,0,2,0,0,74.07,2416664,207.566,17.5,2.339,1561.767,331.43,1.91,0.46,0
72,88,1,44,0,2,0,0,74.07,2416664,207.566,17.5,2.339,1561.767,331.43,1.91,0.46,0
72,89,1,45,0,2,0,0,74.07,2416664,207.566,17.5,2.339,1561.767,331.43,1.91,0.46,0
72,90,0,45,0,2,0,0,67.13,2416664,207.566,17.5,2.339,1561.767,331.43,1.91,0.46,0
72,91,2,47,0,2,0,0,67.13,2416664,207.566,17.5,2.339,1561.767,331.43,1.91,0.46,0
72,92,0,47,0,2,0,0,67.13,2416664,207.566,17.5,2.339,1561.767,331.43,1.91,0.46,0
72,93,2,49,0,2,0,0,67.13,2416664,207.566,17.5,2.339,1561.767,331.43,1.91,0.46,0
72,94,6,55,0,2,0,0,67.13,2416664,207.566,17.5,2.339,1561.767,331.43,1.91,0.46,0
72,95,0,55,0,2,0,0,67.13,2416664,207.566,17.5,2.339,1561.767,331.43,1.91,0.46,0
72,96,2,57,0,2,0,0,67.13,2416664,207.566,17.5,2.339,1561.767,331.43,1.91,0.46,0
72,97,0,57,0,2,0,0,67.13,2416664,207.566,17.5,2.339,1561.767,331.43,1.91,0.46,0
72,98,4,61,1,3,0,0,67.13,2416664,207.566,17.5,2.339,1561.767,331.43,1.91,0.46,0
72,99,0,61,0,3,0,0,67.13,2416664,207.566,17.5,2.339,1561.767,331.43,1.91,0.46,0
72,100,2,63,0,3,0,0,67.13,2416664,207.566,17.5,2.339,1561.767,331.43,1.91,0.46,0
72,101,1,64,0,3,0,0,67.13,2416664,207.566,17.5,2.339,1561.767,331.43,1.91,0.46,0
72,102,0,64,0,3,0,0,67.13,2416664,207.566,17.5,2.339,1561.767,331.43,1.91,0.46,0
72,103,0,64,0,3,0,0,67.13,2416664,207.566,17.5,2.339,1561.767,331.43,1.91,0.46,0
72,104,0,64,0,3,0,0,67.13,2416664,207.566,17.5,2.339,1561.767,331.43,1.91,0.46,0
72,105,0,64,0,3,0,0,67.13,2416664,207.566,17.5,2.339,1561.767,331.43,1.91,0.46,0
72,106,0,64,0,3,0,0,67.13,2416664,207.566,17.5,2.339,1561.767,331.43,1.91,0.46,0
72,107,0,64,0,3,0,0,67.13,2416664,207.566,17.5,2.339,1561.767,331.43,1.91,0.46,0
72,108,14,78,0,3,0,0,67.13,2416664,207.566,17.5,2.339,1561.767,331.43,1.91,0.46,0
72,109,0,78,0,3,0,0,67.13,2416664,207.566,17.5,2.339,1561.767,331.43,1.91,0.46,0
72,110,15,93,1,4,0,0,67.13,2416664,207.566,17.5,2.339,1561.767,331.43,1.91,0.46,0
72,111,0,93,0,4,0,0,67.13,2416664,207.566,17.5,2.339,1561.767,331.43,1.91,0.46,0
72,112,19,112,0,4,0,0,67.13,2416664,207.566,17.5,2.339,1561.767,331.43,1.91,0.46,0
72,113,0,112,0,4,0,0,31.94,2416664,207.566,17.5,2.339,1561.767,331.43,1.91,0.46,0
72,114,34,146,1,5,0,0,31.94,2416664,207.566,17.5,2.339,1561.767,331.43,1.91,0.46,0
72,115,24,170,0,5,0,0,31.94,2416664,207.566,17.5,2.339,1561.767,331.43,1.91,0.46,0
72,116,46,216,1,6,0,0,31.94,2416664,207.566,17.5,2.339,1561.767,331.43,1.91,0.46,0
72,117,61,277,0,6,0,0,31.94,2416664,207.566,17.5,2.339,1561.767,331.43,1.91,0.46,0
72,118,0,277,0,6,0,0,31.94,2416664,207.566,17.5,2.339,1561.767,331.43,1.91,0.46,0
72,119,49,326,2,8,0,0,31.94,2416664,207.566,17.5,2.339,1561.767,331.43,1.91,0.46,0
72,120,0,326,0,8,0,0,31.94,2416664,207.566,17.5,2.339,1561.767,331.43,1.91,0.46,0
72,121,0,326,0,8,0,0,31.94,2416664,207.566,17.5,2.339,1561.767,331.43,1.91,0.46,0
72,122,77,403,0,8,0,0,31.94,2416664,207.566,17.5,2.339,1561.767,331.43,1.91,0.46,0
72,123,95,498,1,9,0,0,31.94,2416664,207.566,17.5,2.339,1561.767,331.43,1.91,0.46,0
72,124,0,498,0,9,0,0,31.94,2416664,207.566,17.5,2.339,1561.767,331.43,1.91,0.46,0
72,125,0,498,0,9,0,0,31.94,2416664,207.566,17.5,2.339,1561.767,331.43,1.91,0.46,0
72,126,0,498,0,9,0,0,31.94,2416664,207.566,17.5,2.339,1561.767,331.43,1.91,0.46,0
72,127,173,671,5,14,0,0,31.94,2416664,207.566,17.5,2.339,1561.767,331.43,1.91,0.46,0
72,128,128,799,2,16,0,0,77.78,2416664,207.566,17.5,2.339,1561.767,331.43,1.91,0.46,0
72,129,136,935,0,16,0,0,77.78,2416664,207.566,17.5,2.339,1561.767,331.43,1.91,0.46,0
72,130,155,1090,3,19,0,0,77.78,2416664,207.566,17.5,2.339,1561.767,331.43,1.91,0.46,0
72,131,0,1090,0,19,0,0,77.78,2416664,207.566,17.5,2.339,1561.767,331.43,1.91,0.46,0
72,132,145,1235,4,23,0,0,77.78,2416664,207.566,17.5,2.339,1561.767,331.43,1.91,0.46,0
72,133,0,1235,0,23,0,0,77.78,2416664,207.566,17.5,2.339,1561.767,331.43,1.91,0.46,0
72,134,111,1346,9,32,0,0,77.78,2416664,207.566,17.5,2.339,1561.767,331.43,1.91,0.46,0
72,135,131,1477,1,33,0,0,77.78,2416664,207.566,17.5,2.339,1561.767,331.43,1.91,0.46,0
72,136,79,1556,10,43,0,0,77.78,2416664,207.566,17.5,2.339,1561.767,331.43,1.91,0.46,0
72,137,67,1623,7,50,0,0,77.78,2416664,207.566,17.5,2.339,1561.767,331.43,1.91,0.46,0
72,138,66,1689,4,54,0,0,77.78,2416664,207.566,17.5,2.339,1561.767,331.43,1.91,0.46,0
72,139,183,1872,9,63,0,0,77.78,2416664,207.566,17.5,2.339,1561.767,331.43,1.91,0.46,0
72,140,0,1872,0,63,0,0,77.78,2416664,207.566,17.5,2.339,1561.767,331.43,1.91,0.46,0
72,141,0,1872,0,63,0,0,77.78,2416664,207.566,17.5,2.339,1561.767,331.43,1.91,0.46,0
72,142,416,2288,14,77,0,0,77.78,2416664,207.566,17.5,2.339,1561.767,331.43,1.91,0.46,0
72,143,113,2401,4,81,0,0,77.78,2416664,207.566,17.5,2.339,1561.767,331.43,1.91,0.46,0
72,144,36,2437,3,84,0,0,77.78,2416664,207.566,17.5,2.339,1561.767,331.43,1.91,0.46,0
72,145,0,2437,0,84,0,0,77.78,2416664,207.566,17.5,2.339,1561.767,331.43,1.91,0.46,0
72,146,0,2437,0,84,0,0,77.78,2416664,207.566,17.5,2.339,1561.767,331.43,1.91,0.46,0
72,147,148,2585,3,87,0,0,77.78,2416664,207.566,17.5,2.339,1561.767,331.43,1.91,0.46,0
72,148,101,2686,3,90,0,0,77.78,2416664,207.566,17.5,2.339,1561.767,331.43,1.91,0.46,0
72,149,22,2708,3,93,0,0,75.93,2416664,207.566,17.5,2.339,1561.767,331.43,1.91,0.46,0
72,150,35,2743,0,93,0,0,75.93,2416664,207.566,17.5,2.339,1561.767,331.43,1.91,0.46,0
72,151,54,2797,3,96,0,0,75.93,2416664,207.566,17.5,2.339,1561.767,331.43,1.91,0.46,0
72,152,98,2895,0,96,0,0,75.93,2416664,207.566,17.5,2.339,1561.767,331.43,1.91,0.46,0
72,153,68,2963,0,96,0,0,75.93,2416664,207.566,17.5,2.339,1561.767,331.43,1.91,0.46,0
72,154,0,2963,0,96,0,0,75.93,2416664,207.566,17.5,2.339,1561.767,331.43,1.91,0.46,0
72,155,66,3029,0,96,0,0,75.93,2416664,207.566,17.5,2.339,1561.767,331.43,1.91,0.46,0
72,156,38,3067,1,97,0,0,75.93,2416664,207.566,17.5,2.339,1561.767,331.43,1.91,0.46,0
72,157,34,3101,2,99,0,0,75.93,2416664,207.566,17.5,2.339,1561.767,331.43,1.91,0.46,0
72,158,19,3120,0,99,0,0,75.93,2416664,207.566,17.5,2.339,1561.767,331.43,1.91,0.46,0
72,159,30,3150,0,99,0,0,75.93,2416664,207.566,17.5,2.339,1561.767,331.43,1.91,0.46,0
72,160,47,3197,0,99,0,0,75.93,2416664,207.566,17.5,2.339,1561.767,331.43,1.91,0.46,0
72,161,0,3197,0,99,0,0,75.93,2416664,207.566,17.5,2.339,1561.767,331.43,1.91,0.46,0
72,162,78,3275,0,99,0,0,75.93,2416664,207.566,17.5,2.339,1561.767,331.43,1.91,0.46,0
72,163,18,3293,0,99,0,0,75.93,2416664,207.566,17.5,2.339,1561.767,331.43,1.91,0.46,0
72,164,37,3330,1,100,0,0,75.93,2416664,207.566,17.5,2.339,1561.767,331.43,1.91,0.46,0
72,165,32,3362,0,100,0,0,75.93,2416664,207.566,17.5,2.339,1561.767,331.43,1.91,0.46,0
72,166,14,3376,2,102,0,0,75.93,2416664,207.566,17.5,2.339,1561.767,331.43,1.91,0.46,0
72,167,29,3405,1,103,0,0,75.93,2416664,207.566,17.5,2.339,1561.767,331.43,1.91,0.46,0
72,168,0,3405,0,103,0,0,75.93,2416664,207.566,17.5,2.339,1561.767,331.43,1.91,0.46,0
72,169,23,3428,2,105,0,0,75.93,2416664,207.566,17.5,2.339,1561.767,331.43,1.91,0.46,0
72,170,12,3440,2,107,0,0,75.93,2416664,207.566,17.5,2.339,1561.767,331.43,1.91,0.46,0
72,171,33,3473,0,107,0,0,75.93,2416664,207.566,17.5,2.339,1561.767,331.43,1.91,0.46,0
72,172,12,3485,1,108,0,0,75.93,2416664,207.566,17.5,2.339,1561.767,331.43,1.91,0.46,0
72,173,19,3504,0,108,0,0,75.93,2416664,207.566,17.5,2.339,1561.767,331.43,1.91,0.46,0
72,174,22,3526,0,108,0,0,75.93,2416664,207.566,17.5,2.339,1561.767,331.43,1.91,0.46,0
72,175,14,3540,2,110,0,0,75.93,2416664,207.566,17.5,2.339,1561.767,331.43,1.91,0.46,0
72,176,0,3540,0,110,0,0,75.93,2416664,207.566,17.5,2.339,1561.767,331.43,1.91,0.46,0
72,177,2,3542,0,110,0,0,75.93,2416664,207.566,17.5,2.339,1561.767,331.43,1.91,0.46,0
72,178,10,3552,0,110,0,0,75.93,2416664,207.566,17.5,2.339,1561.767,331.43,1.91,0.46,0
72,179,3,3555,0,110,0,0,75.93,2416664,207.566,17.5,2.339,1561.767,331.43,1.91,0.46,0
72,180,0,3555,0,110,0,0,75.93,2416664,207.566,17.5,2.339,1561.767,331.43,1.91,0.46,0
72,181,14,3569,1,111,0,0,75.93,2416664,207.566,17.5,2.339,1561.767,331.43,1.91,0.46,0
72,182,0,3569,0,111,0,0,75.93,2416664,207.566,17.5,2.339,1561.767,331.43,1.91,0.46,0
72,183,10,3579,1,112,0,0,75.93,2416664,207.566,17.5,2.339,1561.767,331.43,1.91,0.46,0
72,184,0,3579,0,112,0,0,75.93,2416664,207.566,17.5,2.339,1561.767,331.43,1.91,0.46,0
72,185,5,3584,1,113,0,0,75.93,2416664,207.566,17.5,2.339,1561.767,331.43,1.91,0.46,0
72,186,1,3585,2,115,0,0,75.93,2416664,207.566,17.5,2.339,1561.767,331.43,1.91,0.46,0
72,187,5,3590,0,115,0,0,75.93,2416664,207.566,17.5,2.339,1561.767,331.43,1.91,0.46,0
72,188,4,3594,0,115,0,0,75.93,2416664,207.566,17.5,2.339,1561.767,331.43,1.91,0.46,0
72,189,0,3594,0,115,0,0,75.93,2416664,207.566,17.5,2.339,1561.767,331.43,1.91,0.46,0
72,190,19,3613,2,117,0,0,75.93,2416664,207.566,17.5,2.339,1561.767,331.43,1.91,0.46,0
72,191,0,3613,0,117,0,0,75.93,2416664,207.566,17.5,2.339,1561.767,331.43,1.91,0.46,0
72,192,4,3617,0,117,0,0,75.93,2416664,207.566,17.5,2.339,1561.767,331.43,1.91,0.46,0
72,193,4,3621,0,117,0,0,75.93,2416664,207.566,17.5,2.339,1561.767,331.43,1.91,0.46,0
72,194,7,3628,0,117,0,0,75.93,2416664,207.566,17.5,2.339,1561.767,331.43,1.91,0.46,0
72,195,4,3632,0,117,0,0,72.22,2416664,207.566,17.5,2.339,1561.767,331.43,1.91,0.46,0
72,196,4,3636,1,118,0,0,72.22,2416664,207.566,17.5,2.339,1561.767,331.43,1.91,0.46,0
72,197,0,3636,0,118,0,0,68.52,2416664,207.566,17.5,2.339,1561.767,331.43,1.91,0.46,0
72,198,8,3644,0,118,0,0,68.52,2416664,207.566,17.5,2.339,1561.767,331.43,1.91,0.46,0
72,199,0,3644,0,118,0,0,60.19,2416664,207.566,17.5,2.339,1561.767,331.43,1.91,0.46,0
72,200,5,3649,0,118,0,0,60.19,2416664,207.566,17.5,2.339,1561.767,331.43,1.91,0.46,0
72,201,0,3649,0,118,0,0,60.19,2416664,207.566,17.5,2.339,1561.767,331.43,1.91,0.46,0
72,202,0,3649,0,118,0,0,60.19,2416664,207.566,17.5,2.339,1561.767,331.43,1.91,0.46,0
72,203,6,3655,0,118,0,0,60.19,2416664,207.566,17.5,2.339,1561.767,331.43,1.91,0.46,0
72,204,0,3655,0,118,0,0,60.19,2416664,207.566,17.5,2.339,1561.767,331.43,1.91,0.46,0
73,1,12,110,0,0,0,0,100,3989175,65.032,38.7,14.864,9745.079,496.218,7.11,0.78,0
73,2,5,115,0,0,0,0,100,3989175,65.032,38.7,14.864,9745.079,496.218,7.11,0.78,0
73,3,6,121,0,0,0,0,100,3989175,65.032,38.7,14.864,9745.079,496.218,7.11,0.78,0
73,4,27,148,0,0,0,0,100,3989175,65.032,38.7,14.864,9745.079,496.218,7.11,0.78,0
73,5,9,157,0,0,0,0,100,3989175,65.032,38.7,14.864,9745.079,496.218,7.11,0.78,0
73,6,17,174,2,2,0,0,100,3989175,65.032,38.7,14.864,9745.079,496.218,7.11,0.78,0
73,7,14,188,0,2,0,0,100,3989175,65.032,38.7,14.864,9745.079,496.218,7.11,0.78,0
73,8,8,196,1,3,0,0,100,3989175,65.032,38.7,14.864,9745.079,496.218,7.11,0.78,0
73,9,15,211,0,3,0,0,100,3989175,65.032,38.7,14.864,9745.079,496.218,7.11,0.78,0
73,10,7,218,0,3,0,0,100,3989175,65.032,38.7,14.864,9745.079,496.218,7.11,0.78,0
73,11,16,234,0,3,0,0,100,3989175,65.032,38.7,14.864,9745.079,496.218,7.11,0.78,0
73,12,8,242,0,3,0,0,100,3989175,65.032,38.7,14.864,9745.079,496.218,7.11,0.78,0
73,13,15,257,0,3,0,0,100,3989175,65.032,38.7,14.864,9745.079,496.218,7.11,0.78,0
73,14,15,272,0,3,0,0,100,3989175,65.032,38.7,14.864,9745.079,496.218,7.11,0.78,0
73,15,28,300,0,3,0,0,100,3989175,65.032,38.7,14.864,9745.079,496.218,7.11,0.78,0
73,16,6,306,0,3,0,0,100,3989175,65.032,38.7,14.864,9745.079,496.218,7.11,0.78,0
73,17,42,348,0,3,0,0,100,3989175,65.032,38.7,14.864,9745.079,496.218,7.11,0.78,0
73,18,22,370,0,3,0,0,100,3989175,65.032,38.7,14.864,9745.079,496.218,7.11,0.78,0
73,19,18,388,1,4,0,0,100,3989175,65.032,38.7,14.864,9745.079,496.218,7.11,0.78,0
73,20,6,394,0,4,0,0,100,3989175,65.032,38.7,14.864,9745.079,496.218,7.11,0.78,0
73,21,8,402,0,4,0,0,100,3989175,65.032,38.7,14.864,9745.079,496.218,7.11,0.78,0
73,22,6,408,0,4,0,0,100,3989175,65.032,38.7,14.864,9745.079,496.218,7.11,0.78,0
73,23,8,416,1,5,0,0,100,3989175,65.032,38.7,14.864,9745.079,496.218,7.11,0.78,0
73,24,9,425,0,5,0,0,100,3989175,65.032,38.7,14.864,9745.079,496.218,7.11,0.78,0
73,25,19,444,0,5,0,0,100,3989175,65.032,38.7,14.864,9745.079,496.218,7.11,0.78,0
73,26,12,456,0,5,0,0,100,3989175,65.032,38.7,14.864,9745.079,496.218,7.11,0.78,0
73,27,30,486,1,6,0,0,96.3,3989175,65.032,38.7,14.864,9745.079,496.218,7.11,0.78,0
73,28,11,497,0,6,0,0,96.3,3989175,65.032,38.7,14.864,9745.079,496.218,7.11,0.78,0
73,29,14,511,0,6,0,0,96.3,3989175,65.032,38.7,14.864,9745.079,496.218,7.11,0.78,0
73,30,6,517,0,6,0,0,96.3,3989175,65.032,38.7,14.864,9745.079,496.218,7.11,0.78,0
73,31,22,539,0,6,0,0,96.3,3989175,65.032,38.7,14.864,9745.079,496.218,7.11,0.78,0
73,32,43,582,2,8,0,0,96.3,3989175,65.032,38.7,14.864,9745.079,496.218,7.11,0.78,0
73,33,0,582,0,8,0,0,96.3,3989175,65.032,38.7,14.864,9745.079,496.218,7.11,0.78,0
73,34,7,589,1,9,0,0,96.3,3989175,65.032,38.7,14.864,9745.079,496.218,7.11,0.78,0
73,35,4,593,0,9,0,0,96.3,3989175,65.032,38.7,14.864,9745.079,496.218,7.11,0.78,0
73,36,11,604,0,9,0,0,96.3,3989175,65.032,38.7,14.864,9745.079,496.218,7.11,0.78,0
73,37,6,610,0,9,0,0,96.3,3989175,65.032,38.7,14.864,9745.079,496.218,7.11,0.78,0
73,38,5,615,0,9,0,0,96.3,3989175,65.032,38.7,14.864,9745.079,496.218,7.11,0.78,0
73,39,8,623,1,10,0,0,96.3,3989175,65.032,38.7,14.864,9745.079,496.218,7.11,0.78,0
73,40,3,626,0,10,0,0,96.3,3989175,65.032,38.7,14.864,9745.079,496.218,7.11,0.78,0
73,41,9,635,0,10,0,0,96.3,3989175,65.032,38.7,14.864,9745.079,496.218,7.11,0.78,0
73,42,3,638,1,11,0,0,96.3,3989175,65.032,38.7,14.864,9745.079,496.218,7.11,0.78,0
73,43,4,642,0,11,0,0,96.3,3989175,65.032,38.7,14.864,9745.079,496.218,7.11,0.78,0
73,44,5,647,0,11,0,0,96.3,3989175,65.032,38.7,14.864,9745.079,496.218,7.11,0.78,0
73,45,20,667,1,12,0,0,96.3,3989175,65.032,38.7,14.864,9745.079,496.218,7.11,0.78,0
73,46,4,671,0,12,0,0,96.3,3989175,65.032,38.7,14.864,9745.079,496.218,7.11,0.78,0
73,47,24,695,0,12,0,0,96.3,3989175,65.032,38.7,14.864,9745.079,496.218,7.11,0.78,0
73,48,6,701,0,12,0,0,96.3,3989175,65.032,38.7,14.864,9745.079,496.218,7.11,0.78,0
73,49,1,702,0,12,0,0,96.3,3989175,65.032,38.7,14.864,9745.079,496.218,7.11,0.78,0
73,50,5,707,0,12,0,0,96.3,3989175,65.032,38.7,14.864,9745.079,496.218,7.11,0.78,0
73,51,6,713,0,12,0,0,96.3,3989175,65.032,38.7,14.864,9745.079,496.218,7.11,0.78,0
73,52,8,721,0,12,0,0,96.3,3989175,65.032,38.7,14.864,9745.079,496.218,7.11,0.78,0
73,53,2,723,0,12,0,0,86.11,3989175,65.032,38.7,14.864,9745.079,496.218,7.11,0.78,0
73,54,5,728,0,12,0,0,86.11,3989175,65.032,38.7,14.864,9745.079,496.218,7.11,0.78,0
73,55,2,730,0,12,0,0,86.11,3989175,65.032,38.7,14.864,9745.079,496.218,7.11,0.78,0
73,56,1,731,0,12,0,0,86.11,3989175,65.032,38.7,14.864,9745.079,496.218,7.11,0.78,0
73,57,1,732,0,12,0,0,86.11,3989175,65.032,38.7,14.864,9745.079,496.218,7.11,0.78,0
73,58,3,735,0,12,0,0,86.11,3989175,65.032,38.7,14.864,9745.079,496.218,7.11,0.78,0
73,59,3,738,0,12,0,0,71.3,3989175,65.032,38.7,14.864,9745.079,496.218,7.11,0.78,0
73,60,8,746,0,12,0,0,71.3,3989175,65.032,38.7,14.864,9745.079,496.218,7.11,0.78,0
73,61,11,757,0,12,0,0,71.3,3989175,65.032,38.7,14.864,9745.079,496.218,7.11,0.78,0
73,62,26,783,0,12,0,0,71.3,3989175,65.032,38.7,14.864,9745.079,496.218,7.11,0.78,0
73,63,13,796,0,12,0,0,71.3,3989175,65.032,38.7,14.864,9745.079,496.218,7.11,0.78,0
73,64,4,800,1,13,0,0,71.3,3989175,65.032,38.7,14.864,9745.079,496.218,7.11,0.78,0
73,65,0,800,0,13,0,0,71.3,3989175,65.032,38.7,14.864,9745.079,496.218,7.11,0.78,0
73,66,1,801,0,13,0,0,71.3,3989175,65.032,38.7,14.864,9745.079,496.218,7.11,0.78,0
73,67,4,805,0,13,0,0,71.3,3989175,65.032,38.7,14.864,9745.079,496.218,7.11,0.78,0
73,68,3,808,0,13,0,0,71.3,3989175,65.032,38.7,14.864,9745.079,496.218,7.11,0.78,0
73,69,0,808,0,13,0,0,71.3,3989175,65.032,38.7,14.864,9745.079,496.218,7.11,0.78,0
73,70,4,812,0,13,0,0,71.3,3989175,65.032,38.7,14.864,9745.079,496.218,7.11,0.78,0
73,71,6,818,0,13,0,0,71.3,3989175,65.032,38.7,14.864,9745.079,496.218,7.11,0.78,0
73,72,9,827,0,13,0,0,71.3,3989175,65.032,38.7,14.864,9745.079,496.218,7.11,0.78,0
73,73,4,831,0,13,0,0,71.3,3989175,65.032,38.7,14.864,9745.079,496.218,7.11,0.78,0
73,74,12,843,0,13,0,0,71.3,3989175,65.032,38.7,14.864,9745.079,496.218,7.11,0.78,0
73,75,8,851,1,14,0,0,71.3,3989175,65.032,38.7,14.864,9745.079,496.218,7.11,0.78,0
73,76,28,879,0,14,0,0,60.19,3989175,65.032,38.7,14.864,9745.079,496.218,7.11,0.78,0
73,77,0,879,0,14,0,0,60.19,3989175,65.032,38.7,14.864,9745.079,496.218,7.11,0.78,0
73,78,9,888,0,14,0,0,60.19,3989175,65.032,38.7,14.864,9745.079,496.218,7.11,0.78,0
73,79,5,893,0,14,0,0,60.19,3989175,65.032,38.7,14.864,9745.079,496.218,7.11,0.78,0
73,80,2,895,0,14,0,0,57.41,3989175,65.032,38.7,14.864,9745.079,496.218,7.11,0.78,0
73,81,1,896,0,14,0,0,57.41,3989175,65.032,38.7,14.864,9745.079,496.218,7.11,0.78,0
73,82,2,898,0,14,0,0,57.41,3989175,65.032,38.7,14.864,9745.079,496.218,7.11,0.78,0
73,83,10,908,0,14,0,0,57.41,3989175,65.032,38.7,14.864,9745.079,496.218,7.11,0.78,0
73,84,3,911,0,14,0,0,57.41,3989175,65.032,38.7,14.864,9745.079,496.218,7.11,0.78,0
73,85,3,914,0,14,0,0,57.41,3989175,65.032,38.7,14.864,9745.079,496.218,7.11,0.78,0
73,86,3,917,0,14,0,0,57.41,3989175,65.032,38.7,14.864,9745.079,496.218,7.11,0.78,0
73,87,2,919,0,14,0,0,57.41,3989175,65.032,38.7,14.864,9745.079,496.218,7.11,0.78,0
73,88,2,921,0,14,0,0,57.41,3989175,65.032,38.7,14.864,9745.079,496.218,7.11,0.78,0
73,89,3,924,1,15,0,0,57.41,3989175,65.032,38.7,14.864,9745.079,496.218,7.11,0.78,0
73,90,2,926,0,15,0,0,57.41,3989175,65.032,38.7,14.864,9745.079,496.218,7.11,0.78,0
73,91,2,928,0,15,0,0,60.19,3989175,65.032,38.7,14.864,9745.079,496.218,7.11,0.78,0
73,92,0,928,0,15,0,0,60.19,3989175,65.032,38.7,14.864,9745.079,496.218,7.11,0.78,0
73,93,3,931,0,15,0,0,60.19,3989175,65.032,38.7,14.864,9745.079,496.218,7.11,0.78,0
73,94,8,939,0,15,0,0,60.19,3989175,65.032,38.7,14.864,9745.079,496.218,7.11,0.78,0
73,95,7,946,0,15,0,0,60.19,3989175,65.032,38.7,14.864,9745.079,496.218,7.11,0.78,0
73,96,2,948,0,15,0,0,60.19,3989175,65.032,38.7,14.864,9745.079,496.218,7.11,0.78,0
73,97,5,953,0,15,0,0,60.19,3989175,65.032,38.7,14.864,9745.079,496.218,7.11,0.78,0
73,98,5,958,0,15,0,0,60.19,3989175,65.032,38.7,14.864,9745.079,496.218,7.11,0.78,0
73,99,5,963,0,15,0,0,60.19,3989175,65.032,38.7,14.864,9745.079,496.218,7.11,0.78,0
73,100,5,968,0,15,0,0,60.19,3989175,65.032,38.7,14.864,9745.079,496.218,7.11,0.78,0
73,101,5,973,0,15,0,0,59.26,3989175,65.032,38.7,14.864,9745.079,496.218,7.11,0.78,0
73,102,8,981,0,15,0,0,59.26,3989175,65.032,38.7,14.864,9745.079,496.218,7.11,0.78,0
73,103,5,986,0,15,0,0,59.26,3989175,65.032,38.7,14.864,9745.079,496.218,7.11,0.78,0
73,104,9,995,0,15,0,0,53.7,3989175,65.032,38.7,14.864,9745.079,496.218,7.11,0.78,0
73,105,4,999,0,15,0,0,53.7,3989175,65.032,38.7,14.864,9745.079,496.218,7.11,0.78,0
73,106,4,1003,0,15,0,0,53.7,3989175,65.032,38.7,14.864,9745.079,496.218,7.11,0.78,0
73,107,3,1006,0,15,0,0,53.7,3989175,65.032,38.7,14.864,9745.079,496.218,7.11,0.78,0
73,108,0,1006,0,15,0,0,53.7,3989175,65.032,38.7,14.864,9745.079,496.218,7.11,0.78,0
73,109,12,1018,0,15,0,0,53.7,3989175,65.032,38.7,14.864,9745.079,496.218,7.11,0.78,0
73,110,10,1028,0,15,0,0,53.7,3989175,65.032,38.7,14.864,9745.079,496.218,7.11,0.78,0
73,111,0,1028,0,15,0,0,53.7,3989175,65.032,38.7,14.864,9745.079,496.218,7.11,0.78,0
73,112,11,1039,1,16,0,0,53.7,3989175,65.032,38.7,14.864,9745.079,496.218,7.11,0.78,0
73,113,10,1049,0,16,0,0,53.7,3989175,65.032,38.7,14.864,9745.079,496.218,7.11,0.78,0
73,114,24,1073,0,16,0,0,53.7,3989175,65.032,38.7,14.864,9745.079,496.218,7.11,0.78,0
73,115,31,1104,0,16,0,0,53.7,3989175,65.032,38.7,14.864,9745.079,496.218,7.11,0.78,0
73,116,13,1117,0,16,0,0,53.7,3989175,65.032,38.7,14.864,9745.079,496.218,7.11,0.78,0
73,117,14,1131,0,16,0,0,53.7,3989175,65.032,38.7,14.864,9745.079,496.218,7.11,0.78,0
73,118,6,1137,0,16,0,0,53.7,3989175,65.032,38.7,14.864,9745.079,496.218,7.11,0.78,0
73,119,8,1145,0,16,0,0,53.7,3989175,65.032,38.7,14.864,9745.079,496.218,7.11,0.78,0
73,120,10,1155,0,16,0,0,53.7,3989175,65.032,38.7,14.864,9745.079,496.218,7.11,0.78,0
73,121,0,1155,1,17,0,0,53.7,3989175,65.032,38.7,14.864,9745.079,496.218,7.11,0.78,0
73,122,5,1160,0,17,0,0,53.7,3989175,65.032,38.7,14.864,9745.079,496.218,7.11,0.78,0
73,123,8,1168,0,17,0,0,53.7,3989175,65.032,38.7,14.864,9745.079,496.218,7.11,0.78,0
73,124,3,1171,0,17,0,0,53.7,3989175,65.032,38.7,14.864,9745.079,496.218,7.11,0.78,0
73,125,6,1177,0,17,0,0,53.7,3989175,65.032,38.7,14.864,9745.079,496.218,7.11,0.78,0
73,126,5,1182,0,17,0,0,53.7,3989175,65.032,38.7,14.864,9745.079,496.218,7.11,0.78,0
73,127,15,1197,0,17,0,0,53.7,3989175,65.032,38.7,14.864,9745.079,496.218,7.11,0.78,0
73,128,9,1206,0,17,0,0,53.7,3989175,65.032,38.7,14.864,9745.079,496.218,7.11,0.78,0
73,129,0,1206,0,17,0,0,53.7,3989175,65.032,38.7,14.864,9745.079,496.218,7.11,0.78,0
73,130,7,1213,0,17,0,0,53.7,3989175,65.032,38.7,14.864,9745.079,496.218,7.11,0.78,0
73,131,12,1225,0,17,0,0,53.7,3989175,65.032,38.7,14.864,9745.079,496.218,7.11,0.78,0
73,132,25,1250,0,17,0,0,53.7,3989175,65.032,38.7,14.864,9745.079,496.218,7.11,0.78,0
73,133,14,1264,0,17,0,0,59.26,3989175,65.032,38.7,14.864,9745.079,496.218,7.11,0.78,0
73,134,14,1278,0,17,0,0,59.26,3989175,65.032,38.7,14.864,9745.079,496.218,7.11,0.78,0
73,135,5,1283,0,17,0,0,59.26,3989175,65.032,38.7,14.864,9745.079,496.218,7.11,0.78,0
73,136,23,1306,0,17,0,0,59.26,3989175,65.032,38.7,14.864,9745.079,496.218,7.11,0.78,0
73,137,0,1306,0,17,0,0,59.26,3989175,65.032,38.7,14.864,9745.079,496.218,7.11,0.78,0
73,138,15,1321,0,17,0,0,59.26,3989175,65.032,38.7,14.864,9745.079,496.218,7.11,0.78,0
73,139,20,1341,0,17,0,0,59.26,3989175,65.032,38.7,14.864,9745.079,496.218,7.11,0.78,0
73,140,10,1351,0,17,0,0,59.26,3989175,65.032,38.7,14.864,9745.079,496.218,7.11,0.78,0
73,141,10,1361,0,17,0,0,59.26,3989175,65.032,38.7,14.864,9745.079,496.218,7.11,0.78,0
73,142,0,1361,0,17,0,0,59.26,3989175,65.032,38.7,14.864,9745.079,496.218,7.11,0.78,0
73,143,9,1370,0,17,0,0,59.26,3989175,65.032,38.7,14.864,9745.079,496.218,7.11,0.78,0
73,144,15,1385,0,17,0,0,59.26,3989175,65.032,38.7,14.864,9745.079,496.218,7.11,0.78,0
73,145,9,1394,0,17,0,0,59.26,3989175,65.032,38.7,14.864,9745.079,496.218,7.11,0.78,0
73,146,17,1411,0,17,0,0,59.26,3989175,65.032,38.7,14.864,9745.079,496.218,7.11,0.78,0
73,147,10,1421,1,18,0,0,59.26,3989175,65.032,38.7,14.864,9745.079,496.218,7.11,0.78,0
73,148,15,1436,1,19,0,0,59.26,3989175,65.032,38.7,14.864,9745.079,496.218,7.11,0.78,0
73,149,11,1447,0,19,0,0,59.26,3989175,65.032,38.7,14.864,9745.079,496.218,7.11,0.78,0
73,150,8,1455,0,19,0,0,59.26,3989175,65.032,38.7,14.864,9745.079,496.218,7.11,0.78,0
73,151,7,1462,0,19,0,0,59.26,3989175,65.032,38.7,14.864,9745.079,496.218,7.11,0.78,0
73,152,0,1462,0,19,0,0,59.26,3989175,65.032,38.7,14.864,9745.079,496.218,7.11,0.78,0
73,153,25,1487,0,19,0,0,59.26,3989175,65.032,38.7,14.864,9745.079,496.218,7.11,0.78,0
73,154,0,1487,0,19,0,0,59.26,3989175,65.032,38.7,14.864,9745.079,496.218,7.11,0.78,0
73,155,23,1510,0,19,0,0,59.26,3989175,65.032,38.7,14.864,9745.079,496.218,7.11,0.78,0
73,156,38,1548,0,19,0,0,59.26,3989175,65.032,38.7,14.864,9745.079,496.218,7.11,0.78,0
73,157,20,1568,0,19,0,0,69.44,3989175,65.032,38.7,14.864,9745.079,496.218,7.11,0.78,0
73,158,28,1596,0,19,0,0,69.44,3989175,65.032,38.7,14.864,9745.079,496.218,7.11,0.78,0
73,159,25,1621,0,19,0,0,69.44,3989175,65.032,38.7,14.864,9745.079,496.218,7.11,0.78,0
73,160,19,1640,0,19,0,0,69.44,3989175,65.032,38.7,14.864,9745.079,496.218,7.11,0.78,0
73,161,44,1684,0,19,0,0,69.44,3989175,65.032,38.7,14.864,9745.079,496.218,7.11,0.78,0
73,162,89,1773,0,19,0,0,69.44,3989175,65.032,38.7,14.864,9745.079,496.218,7.11,0.78,0
73,163,57,1830,0,19,0,0,69.44,3989175,65.032,38.7,14.864,9745.079,496.218,7.11,0.78,0
73,164,87,1917,0,19,0,0,69.44,3989175,65.032,38.7,14.864,9745.079,496.218,7.11,0.78,0
73,165,158,2075,0,19,0,0,69.44,3989175,65.032,38.7,14.864,9745.079,496.218,7.11,0.78,0
73,166,0,2075,0,19,0,0,69.44,3989175,65.032,38.7,14.864,9745.079,496.218,7.11,0.78,0
73,167,317,2392,0,19,0,0,69.44,3989175,65.032,38.7,14.864,9745.079,496.218,7.11,0.78,0
73,168,0,2392,0,19,0,0,60.19,3989175,65.032,38.7,14.864,9745.079,496.218,7.11,0.78,0
73,169,366,2758,0,19,0,0,60.19,3989175,65.032,38.7,14.864,9745.079,496.218,7.11,0.78,0
73,170,179,2937,0,19,0,0,60.19,3989175,65.032,38.7,14.864,9745.079,496.218,7.11,0.78,0
73,171,182,3119,0,19,0,0,60.19,3989175,65.032,38.7,14.864,9745.079,496.218,7.11,0.78,0
73,172,187,3306,0,19,0,0,60.19,3989175,65.032,38.7,14.864,9745.079,496.218,7.11,0.78,0
73,173,196,3502,0,19,0,0,60.19,3989175,65.032,38.7,14.864,9745.079,496.218,7.11,0.78,0
73,174,193,3695,1,20,0,0,60.19,3989175,65.032,38.7,14.864,9745.079,496.218,7.11,0.78,0
73,175,218,3913,2,22,0,0,60.19,3989175,65.032,38.7,14.864,9745.079,496.218,7.11,0.78,0
73,176,227,4140,2,24,0,0,60.19,3989175,65.032,38.7,14.864,9745.079,496.218,7.11,0.78,0
73,177,259,4399,1,25,0,0,60.19,3989175,65.032,38.7,14.864,9745.079,496.218,7.11,0.78,0
73,178,0,4399,0,25,0,0,60.19,3989175,65.032,38.7,14.864,9745.079,496.218,7.11,0.78,0
73,179,265,4664,2,27,0,0,60.19,3989175,65.032,38.7,14.864,9745.079,496.218,7.11,0.78,0
73,180,590,5254,1,28,0,0,60.19,3989175,65.032,38.7,14.864,9745.079,496.218,7.11,0.78,0
73,181,298,5552,0,28,0,0,60.19,3989175,65.032,38.7,14.864,9745.079,496.218,7.11,0.78,0
73,182,314,5866,5,33,0,0,60.19,3989175,65.032,38.7,14.864,9745.079,496.218,7.11,0.78,0
73,183,0,5866,0,33,0,0,60.19,3989175,65.032,38.7,14.864,9745.079,496.218,7.11,0.78,0
73,184,774,6640,6,39,0,0,56.48,3989175,65.032,38.7,14.864,9745.079,496.218,7.11,0.78,0
73,185,453,7093,4,43,0,0,56.48,3989175,65.032,38.7,14.864,9745.079,496.218,7.11,0.78,0
73,186,471,7564,5,48,0,0,56.48,3989175,65.032,38.7,14.864,9745.079,496.218,7.11,0.78,0
73,187,554,8118,2,50,0,0,56.48,3989175,65.032,38.7,14.864,9745.079,496.218,7.11,0.78,0
73,188,0,8118,0,50,0,0,56.48,3989175,65.032,38.7,14.864,9745.079,496.218,7.11,0.78,0
73,189,578,8696,4,54,0,0,56.48,3989175,65.032,38.7,14.864,9745.079,496.218,7.11,0.78,0
73,190,549,9245,4,58,0,0,56.48,3989175,65.032,38.7,14.864,9745.079,496.218,7.11,0.78,0
73,191,508,9753,5,63,0,0,56.48,3989175,65.032,38.7,14.864,9745.079,496.218,7.11,0.78,0
73,192,472,10225,3,66,0,0,61.11,3989175,65.032,38.7,14.864,9745.079,496.218,7.11,0.78,0
73,193,527,10752,6,72,0,0,61.11,3989175,65.032,38.7,14.864,9745.079,496.218,7.11,0.78,0
73,194,519,11271,6,78,0,0,61.11,3989175,65.032,38.7,14.864,9745.079,496.218,7.11,0.78,0
73,195,523,11794,7,85,0,0,61.11,3989175,65.032,38.7,14.864,9745.079,496.218,7.11,0.78,0
73,196,478,12272,8,93,0,0,61.11,3989175,65.032,38.7,14.864,9745.079,496.218,7.11,0.78,0
73,197,569,12841,9,102,0,0,61.11,3989175,65.032,38.7,14.864,9745.079,496.218,7.11,0.78,0
73,198,680,13521,7,109,0,0,61.11,3989175,65.032,38.7,14.864,9745.079,496.218,7.11,0.78,0
73,199,919,14440,4,113,0,0,61.11,3989175,65.032,38.7,14.864,9745.079,496.218,7.11,0.78,0
73,200,887,15327,11,124,0,0,61.11,3989175,65.032,38.7,14.864,9745.079,496.218,7.11,0.78,0
73,201,958,16285,4,128,0,0,61.11,3989175,65.032,38.7,14.864,9745.079,496.218,7.11,0.78,0
73,202,1192,17477,8,136,0,0,61.11,3989175,65.032,38.7,14.864,9745.079,496.218,7.11,0.78,0
73,203,1186,18663,7,143,0,0,61.11,3989175,65.032,38.7,14.864,9745.079,496.218,7.11,0.78,0
73,204,1194,19857,15,158,0,0,61.11,3989175,65.032,38.7,14.864,9745.079,496.218,7.11,0.78,0
74,1,5453,67366,149,732,0,0,76.85,83783945,237.016,46.6,21.453,45229.245,156.139,8.31,0.936,3
74,2,6156,73522,140,872,0,0,76.85,83783945,237.016,46.6,21.453,45229.245,156.139,8.31,0.936,3
74,3,6174,79696,145,1017,0,0,76.85,83783945,237.016,46.6,21.453,45229.245,156.139,8.31,0.936,3
74,4,6082,85778,141,1158,0,0,76.85,83783945,237.016,46.6,21.453,45229.245,156.139,8.31,0.936,3
74,5,5936,91714,184,1342,0,1370655,76.85,83783945,237.016,46.6,21.453,45229.245,156.139,8.31,0.936,3
74,6,3677,95391,92,1434,0,1370655,76.85,83783945,237.016,46.6,21.453,45229.245,156.139,8.31,0.936,3
74,7,3834,99225,173,1607,0,1370655,76.85,83783945,237.016,46.6,21.453,45229.245,156.139,8.31,0.936,3
74,8,4003,103228,254,1861,0,1370655,76.85,83783945,237.016,46.6,21.453,45229.245,156.139,8.31,0.936,3
74,9,4974,108202,246,2107,0,1370655,76.85,83783945,237.016,46.6,21.453,45229.245,156.139,8.31,0.936,3
74,10,5323,113525,266,2373,0,1370655,76.85,83783945,237.016,46.6,21.453,45229.245,156.139,8.31,0.936,3
74,11,4133,117658,171,2544,0,1370655,76.85,83783945,237.016,46.6,21.453,45229.245,156.139,8.31,0.936,3
74,12,2821,120479,129,2673,0,1750852,76.85,83783945,237.016,46.6,21.453,45229.245,156.139,8.31,0.936,3
74,13,2537,123016,126,2799,0,1750852,76.85,83783945,237.016,46.6,21.453,45229.245,156.139,8.31,0.936,3
74,14,2082,125098,170,2969,0,1750852,76.85,83783945,237.016,46.6,21.453,45229.245,156.139,8.31,0.936,3
74,15,2486,127584,285,3254,0,1750852,76.85,83783945,237.016,46.6,21.453,45229.245,156.139,8.31,0.936,3
74,16,2866,130450,315,3569,0,1750852,76.85,83783945,237.016,46.6,21.453,45229.245,156.139,8.31,0.936,3
74,17,3380,133830,299,3868,0,1750852,76.85,83783945,237.016,46.6,21.453,45229.245,156.139,8.31,0.936,3
74,18,3609,137439,242,4110,0,1750852,76.85,83783945,237.016,46.6,21.453,45229.245,156.139,8.31,0.936,3
74,19,2458,139897,184,4294,0,2082754,76.85,83783945,237.016,46.6,21.453,45229.245,156.139,8.31,0.936,3
74,20,1775,141672,110,4404,0,2082754,76.85,83783945,237.016,46.6,21.453,45229.245,156.139,8.31,0.936,3
74,21,1785,143457,194,4598,0,2082754,76.85,83783945,237.016,46.6,21.453,45229.245,156.139,8.31,0.936,3
74,22,2237,145694,281,4879,0,2082754,76.85,83783945,237.016,46.6,21.453,45229.245,156.139,8.31,0.936,3
74,23,2352,148046,215,5094,0,2082754,76.85,83783945,237.016,46.6,21.453,45229.245,156.139,8.31,0.936,3
74,24,2337,150383,227,5321,0,2082754,76.85,83783945,237.016,46.6,21.453,45229.245,156.139,8.31,0.936,3
74,25,2055,152438,179,5500,0,2082754,76.85,83783945,237.016,46.6,21.453,45229.245,156.139,8.31,0.936,3
74,26,1737,154175,140,5640,0,2446644,76.85,83783945,237.016,46.6,21.453,45229.245,156.139,8.31,0.936,3
74,27,1018,155193,110,5750,0,2446644,76.85,83783945,237.016,46.6,21.453,45229.245,156.139,8.31,0.936,3
74,28,1144,156337,163,5913,0,2446644,76.85,83783945,237.016,46.6,21.453,45229.245,156.139,8.31,0.936,3
74,29,1304,157641,202,6115,0,2446644,76.85,83783945,237.016,46.6,21.453,45229.245,156.139,8.31,0.936,3
74,30,1478,159119,173,6288,0,2446644,76.85,83783945,237.016,46.6,21.453,45229.245,156.139,8.31,0.936,3
74,31,1639,160758,193,6481,0,2446644,76.85,83783945,237.016,46.6,21.453,45229.245,156.139,8.31,0.936,3
74,32,945,161703,94,6575,0,2446644,76.85,83783945,237.016,46.6,21.453,45229.245,156.139,8.31,0.936,3
74,33,793,162496,74,6649,0,2773432,75.46,83783945,237.016,46.6,21.453,45229.245,156.139,8.31,0.936,3
74,34,679,163175,43,6692,0,2773432,71.76,83783945,237.016,46.6,21.453,45229.245,156.139,8.31,0.936,3
74,35,685,163860,139,6831,0,2773432,71.76,83783945,237.016,46.6,21.453,45229.245,156.139,8.31,0.936,3
74,36,1037,164897,165,6996,0,2773432,66.2,83783945,237.016,46.6,21.453,45229.245,156.139,8.31,0.936,3
74,37,1194,166091,123,7119,0,2773432,64.35,83783945,237.016,46.6,21.453,45229.245,156.139,8.31,0.936,3
74,38,1209,167300,147,7266,0,2773432,64.35,83783945,237.016,46.6,21.453,45229.245,156.139,8.31,0.936,3
74,39,1251,168551,103,7369,0,2773432,64.35,83783945,237.016,46.6,21.453,45229.245,156.139,8.31,0.936,3
74,40,667,169218,26,7395,0,3177307,64.35,83783945,237.016,46.6,21.453,45229.245,156.139,8.31,0.936,3
74,41,357,169575,22,7417,0,3177307,64.35,83783945,237.016,46.6,21.453,45229.245,156.139,8.31,0.936,3
74,42,933,170508,116,7533,0,3177307,64.35,83783945,237.016,46.6,21.453,45229.245,156.139,8.31,0.936,3
74,43,798,171306,101,7634,0,3177307,64.35,83783945,237.016,46.6,21.453,45229.245,156.139,8.31,0.936,3
74,44,933,172239,89,7723,0,3177307,64.35,83783945,237.016,46.6,21.453,45229.245,156.139,8.31,0.936,3
74,45,913,173152,101,7824,0,3177307,64.35,83783945,237.016,46.6,21.453,45229.245,156.139,8.31,0.936,3
74,46,620,173772,57,7881,0,3177307,61.57,83783945,237.016,46.6,21.453,45229.245,156.139,8.31,0.936,3
74,47,583,174355,33,7914,0,3609973,61.57,83783945,237.016,46.6,21.453,45229.245,156.139,8.31,0.936,3
74,48,342,174697,21,7935,0,3609973,61.57,83783945,237.016,46.6,21.453,45229.245,156.139,8.31,0.936,3
74,49,513,175210,72,8007,0,3609973,59.72,83783945,237.016,46.6,21.453,45229.245,156.139,8.31,0.936,3
74,50,797,176007,83,8090,0,3609973,59.72,83783945,237.016,46.6,21.453,45229.245,156.139,8.31,0.936,3
74,51,745,176752,57,8147,0,3609973,59.72,83783945,237.016,46.6,21.453,45229.245,156.139,8.31,0.936,3
74,52,460,177212,27,8174,0,3609973,59.72,83783945,237.016,46.6,21.453,45229.245,156.139,8.31,0.936,3
74,53,638,177850,42,8216,0,3609973,59.72,83783945,237.016,46.6,21.453,45229.245,156.139,8.31,0.936,3
74,54,431,178281,31,8247,0,3963440,59.72,83783945,237.016,46.6,21.453,45229.245,156.139,8.31,0.936,3
74,55,289,178570,10,8257,0,3963440,59.72,83783945,237.016,46.6,21.453,45229.245,156.139,8.31,0.936,3
74,56,432,179002,45,8302,0,3963440,59.72,83783945,237.016,46.6,21.453,45229.245,156.139,8.31,0.936,3
74,57,362,179364,47,8349,0,3963440,59.72,83783945,237.016,46.6,21.453,45229.245,156.139,8.31,0.936,3
74,58,353,179717,62,8411,0,3963440,59.72,83783945,237.016,46.6,21.453,45229.245,156.139,8.31,0.936,3
74,59,741,180458,39,8450,0,3963440,59.72,83783945,237.016,46.6,21.453,45229.245,156.139,8.31,0.936,3
74,60,738,181196,39,8489,0,3963440,59.72,83783945,237.016,46.6,21.453,45229.245,156.139,8.31,0.936,3
74,61,286,181482,11,8500,0,4368709,59.72,83783945,237.016,46.6,21.453,45229.245,156.139,8.31,0.936,3
74,62,333,181815,11,8511,0,4368709,59.72,83783945,237.016,46.6,21.453,45229.245,156.139,8.31,0.936,3
74,63,213,182028,11,8522,0,4368709,59.72,83783945,237.016,46.6,21.453,45229.245,156.139,8.31,0.936,3
74,64,342,182370,29,8551,0,4368709,59.72,83783945,237.016,46.6,21.453,45229.245,156.139,8.31,0.936,3
74,65,394,182764,30,8581,0,4368709,59.72,83783945,237.016,46.6,21.453,45229.245,156.139,8.31,0.936,3
74,66,507,183271,32,8613,0,4368709,59.72,83783945,237.016,46.6,21.453,45229.245,156.139,8.31,0.936,3
74,67,407,183678,33,8646,0,4368709,59.72,83783945,237.016,46.6,21.453,45229.245,156.139,8.31,0.936,3
74,68,301,183979,22,8668,0,4709695,59.72,83783945,237.016,46.6,21.453,45229.245,156.139,8.31,0.936,3
74,69,214,184193,6,8674,0,4709695,59.72,83783945,237.016,46.6,21.453,45229.245,156.139,8.31,0.936,3
74,70,350,184543,37,8711,0,4709695,59.72,83783945,237.016,46.6,21.453,45229.245,156.139,8.31,0.936,3
74,71,318,184861,18,8729,0,4709695,59.72,83783945,237.016,46.6,21.453,45229.245,156.139,8.31,0.936,3
74,72,555,185416,26,8755,0,4709695,59.72,83783945,237.016,46.6,21.453,45229.245,156.139,8.31,0.936,3
74,73,258,185674,8,8763,0,4709695,59.72,83783945,237.016,46.6,21.453,45229.245,156.139,8.31,0.936,3
74,74,348,186022,18,8781,0,4709695,59.72,83783945,237.016,46.6,21.453,45229.245,156.139,8.31,0.936,3
74,75,247,186269,6,8787,0,5036891,59.72,83783945,237.016,46.6,21.453,45229.245,156.139,8.31,0.936,3
74,76,192,186461,4,8791,0,5036891,59.72,83783945,237.016,46.6,21.453,45229.245,156.139,8.31,0.936,3
74,77,378,186839,9,8800,0,5036891,59.72,83783945,237.016,46.6,21.453,45229.245,156.139,8.31,0.936,3
74,78,345,187184,30,8830,0,5036891,59.72,83783945,237.016,46.6,21.453,45229.245,156.139,8.31,0.936,3
74,79,580,187764,26,8856,0,5036891,63.43,83783945,237.016,46.6,21.453,45229.245,156.139,8.31,0.936,3
74,80,770,188534,16,8872,0,5036891,63.43,83783945,237.016,46.6,21.453,45229.245,156.139,8.31,0.936,3
74,81,601,189135,10,8882,0,5036891,63.43,83783945,237.016,46.6,21.453,45229.245,156.139,8.31,0.936,3
74,82,687,189822,0,8882,0,5425078,63.43,83783945,237.016,46.6,21.453,45229.245,156.139,8.31,0.936,3
74,83,537,190359,3,8885,0,5425078,63.43,83783945,237.016,46.6,21.453,45229.245,156.139,8.31,0.936,3
74,84,503,190862,10,8895,0,5425078,63.43,83783945,237.016,46.6,21.453,45229.245,156.139,8.31,0.936,3
74,85,587,191449,19,8914,0,5425078,63.43,83783945,237.016,46.6,21.453,45229.245,156.139,8.31,0.936,3
74,86,630,192079,13,8927,0,5425078,63.43,83783945,237.016,46.6,21.453,45229.245,156.139,8.31,0.936,3
74,87,477,192556,21,8948,0,5425078,63.43,83783945,237.016,46.6,21.453,45229.245,156.139,8.31,0.936,3
74,88,687,193243,6,8954,0,5425078,63.43,83783945,237.016,46.6,21.453,45229.245,156.139,8.31,0.936,3
74,89,256,193499,3,8957,0,5892491,63.43,83783945,237.016,46.6,21.453,45229.245,156.139,8.31,0.936,3
74,90,262,193761,4,8961,0,5892491,63.43,83783945,237.016,46.6,21.453,45229.245,156.139,8.31,0.936,3
74,91,498,194259,12,8973,0,5892491,63.43,83783945,237.016,46.6,21.453,45229.245,156.139,8.31,0.936,3
74,92,466,194725,12,8985,0,5892491,63.43,83783945,237.016,46.6,21.453,45229.245,156.139,8.31,0.936,3
74,93,503,195228,9,8994,0,5892491,63.43,83783945,237.016,46.6,21.453,45229.245,156.139,8.31,0.936,3
74,94,446,195674,9,9003,0,5892491,63.43,83783945,237.016,46.6,21.453,45229.245,156.139,8.31,0.936,3
74,95,422,196096,7,9010,0,5892491,63.43,83783945,237.016,46.6,21.453,45229.245,156.139,8.31,0.936,3
74,96,239,196335,2,9012,0,6400154,63.43,83783945,237.016,46.6,21.453,45229.245,156.139,8.31,0.936,3
74,97,219,196554,4,9016,0,6400154,63.43,83783945,237.016,46.6,21.453,45229.245,156.139,8.31,0.936,3
74,98,390,196944,8,9024,0,6400154,55.09,83783945,237.016,46.6,21.453,45229.245,156.139,8.31,0.936,3
74,99,397,197341,12,9036,0,6400154,55.09,83783945,237.016,46.6,21.453,45229.245,156.139,8.31,0.936,3
74,100,442,197783,12,9048,0,6400154,55.09,83783945,237.016,46.6,21.453,45229.245,156.139,8.31,0.936,3
74,101,395,198178,6,9054,0,6400154,55.09,83783945,237.016,46.6,21.453,45229.245,156.139,8.31,0.936,3
74,102,378,198556,6,9060,0,6400154,55.09,83783945,237.016,46.6,21.453,45229.245,156.139,8.31,0.936,3
74,103,248,198804,3,9063,0,6910705,55.09,83783945,237.016,46.6,21.453,45229.245,156.139,8.31,0.936,3
74,104,159,198963,1,9064,0,6910705,55.09,83783945,237.016,46.6,21.453,45229.245,156.139,8.31,0.936,3
74,105,412,199375,4,9068,0,6910705,55.09,83783945,237.016,46.6,21.453,45229.245,156.139,8.31,0.936,3
74,106,351,199726,3,9071,0,6910705,55.09,83783945,237.016,46.6,21.453,45229.245,156.139,8.31,0.936,3
74,107,534,200260,7,9078,0,6910705,55.09,83783945,237.016,46.6,21.453,45229.245,156.139,8.31,0.936,3
74,108,583,200843,4,9082,0,6910705,55.09,83783945,237.016,46.6,21.453,45229.245,156.139,8.31,0.936,3
74,109,529,201372,1,9083,0,6910705,55.09,83783945,237.016,46.6,21.453,45229.245,156.139,8.31,0.936,3
74,110,202,201574,1,9084,0,7449406,55.09,83783945,237.016,46.6,21.453,45229.245,156.139,8.31,0.936,3
74,111,249,201823,2,9086,0,7449406,55.09,83783945,237.016,46.6,21.453,45229.245,156.139,8.31,0.936,3
74,112,522,202345,4,9090,0,7449406,55.09,83783945,237.016,46.6,21.453,45229.245,156.139,8.31,0.936,3
74,113,454,202799,5,9095,0,7449406,55.09,83783945,237.016,46.6,21.453,45229.245,156.139,8.31,0.936,3
74,114,569,203368,6,9101,0,7449406,55.09,83783945,237.016,46.6,21.453,45229.245,156.139,8.31,0.936,3
74,115,815,204183,10,9111,0,7449406,55.09,83783945,237.016,46.6,21.453,45229.245,156.139,8.31,0.936,3
74,116,781,204964,7,9118,0,7449406,55.09,83783945,237.016,46.6,21.453,45229.245,156.139,8.31,0.936,3
74,117,305,205269,0,9118,0,8024289,55.09,83783945,237.016,46.6,21.453,45229.245,156.139,8.31,0.936,3
74,118,340,205609,0,9118,0,8024289,55.09,83783945,237.016,46.6,21.453,45229.245,156.139,8.31,0.936,3
74,119,633,206242,4,9122,0,8024289,55.09,83783945,237.016,46.6,21.453,45229.245,156.139,8.31,0.936,3
74,120,684,206926,6,9128,0,8024289,55.09,83783945,237.016,46.6,21.453,45229.245,156.139,8.31,0.936,3
74,121,902,207828,6,9134,0,8024289,55.09,83783945,237.016,46.6,21.453,45229.245,156.139,8.31,0.936,3
74,122,870,208698,7,9141,0,8024289,57.87,83783945,237.016,46.6,21.453,45229.245,156.139,8.31,0.936,3
74,123,955,209653,0,9141,0,8024289,57.87,83783945,237.016,46.6,21.453,45229.245,156.139,8.31,0.936,3
74,124,240,209893,0,9141,0,8610909,57.87,83783945,237.016,46.6,21.453,45229.245,156.139,8.31,0.936,3
74,125,509,210402,7,9148,0,8610909,57.87,83783945,237.016,46.6,21.453,45229.245,156.139,8.31,0.936,3
74,126,879,211281,8,9156,0,8610909,57.87,83783945,237.016,46.6,21.453,45229.245,156.139,8.31,0.936,3
74,127,741,212022,12,9168,0,8610909,57.87,83783945,237.016,46.6,21.453,45229.245,156.139,8.31,0.936,3
74,128,1740,213762,7,9175,0,8610909,57.87,83783945,237.016,46.6,21.453,45229.245,156.139,8.31,0.936,3
74,129,1164,214926,8,9183,0,8610909,59.72,83783945,237.016,46.6,21.453,45229.245,156.139,8.31,0.936,3
74,130,995,215921,12,9195,0,8610909,56.94,83783945,237.016,46.6,21.453,45229.245,156.139,8.31,0.936,3
74,131,704,216625,1,9196,0,9347080,56.94,83783945,237.016,46.6,21.453,45229.245,156.139,8.31,0.936,3
74,132,317,216942,1,9197,0,9347080,56.94,83783945,237.016,46.6,21.453,45229.245,156.139,8.31,0.936,3
74,133,1079,218021,4,9201,0,9347080,56.94,83783945,237.016,46.6,21.453,45229.245,156.139,8.31,0.936,3
74,134,1182,219203,6,9207,0,9347080,56.94,83783945,237.016,46.6,21.453,45229.245,156.139,8.31,0.936,3
74,135,1521,220724,4,9211,0,9347080,56.94,83783945,237.016,46.6,21.453,45229.245,156.139,8.31,0.936,3
74,136,1452,222176,14,9225,0,9347080,56.94,83783945,237.016,46.6,21.453,45229.245,156.139,8.31,0.936,3
74,137,1339,223515,6,9231,0,9347080,56.94,83783945,237.016,46.6,21.453,45229.245,156.139,8.31,0.936,3
74,138,718,224233,0,9231,0,10211084,56.94,83783945,237.016,46.6,21.453,45229.245,156.139,8.31,0.936,3
74,139,481,224714,1,9232,0,10211084,56.94,83783945,237.016,46.6,21.453,45229.245,156.139,8.31,0.936,3
74,140,1431,226145,0,9232,0,10211084,56.94,83783945,237.016,46.6,21.453,45229.245,156.139,8.31,0.936,3
74,141,769,226914,11,9243,0,10211084,56.94,83783945,237.016,46.6,21.453,45229.245,156.139,8.31,0.936,3
74,142,1707,228621,10,9253,0,10211084,56.94,83783945,237.016,46.6,21.453,45229.245,156.139,8.31,0.936,3
74,143,2327,230948,7,9260,0,10211084,56.94,83783945,237.016,46.6,21.453,45229.245,156.139,8.31,0.936,3
74,144,1134,232082,7,9267,0,10211084,56.94,83783945,237.016,46.6,21.453,45229.245,156.139,8.31,0.936,3
74,145,782,232864,2,9269,0,11305590,56.94,83783945,237.016,46.6,21.453,45229.245,156.139,8.31,0.936,3
74,146,711,233575,3,9272,0,11305590,59.72,83783945,237.016,46.6,21.453,45229.245,156.139,8.31,0.936,3
74,147,1278,234853,5,9277,0,11305590,59.72,83783945,237.016,46.6,21.453,45229.245,156.139,8.31,0.936,3
74,148,1576,236429,3,9280,0,11305590,59.72,83783945,237.016,46.6,21.453,45229.245,156.139,8.31,0.936,3
74,149,1507,237936,5,9285,0,11305590,59.72,83783945,237.016,46.6,21.453,45229.245,156.139,8.31,0.936,3
74,150,1571,239507,3,9288,0,11305590,59.72,83783945,237.016,46.6,21.453,45229.245,156.139,8.31,0.936,3
74,151,1479,240986,1,9289,0,11305590,59.72,83783945,237.016,46.6,21.453,45229.245,156.139,8.31,0.936,3
74,152,785,241771,6,9295,0,12426804,59.72,83783945,237.016,46.6,21.453,45229.245,156.139,8.31,0.936,3
74,153,610,242381,3,9298,0,12426804,59.72,83783945,237.016,46.6,21.453,45229.245,156.139,8.31,0.936,3
74,154,1218,243599,4,9302,0,12426804,59.72,83783945,237.016,46.6,21.453,45229.245,156.139,8.31,0.936,3
74,155,1256,244855,11,9313,0,12426804,59.72,83783945,237.016,46.6,21.453,45229.245,156.139,8.31,0.936,3
74,156,1311,246166,8,9321,0,12426804,57.87,83783945,237.016,46.6,21.453,45229.245,156.139,8.31,0.936,3
74,157,1453,247619,1,9322,0,12426804,49.54,83783945,237.016,46.6,21.453,45229.245,156.139,8.31,0.936,3
74,158,1378,248997,2,9324,0,12426804,49.54,83783945,237.016,46.6,21.453,45229.245,156.139,8.31,0.936,3
74,159,988,249985,1,9325,0,13526364,49.54,83783945,237.016,46.6,21.453,45229.245,156.139,8.31,0.936,3
74,160,814,250799,0,9325,0,13526364,49.54,83783945,237.016,46.6,21.453,45229.245,156.139,8.31,0.936,3
74,161,1499,252298,4,9329,0,13526364,49.54,83783945,237.016,46.6,21.453,45229.245,156.139,8.31,0.936,3
74,162,1176,253474,9,9338,0,13526364,49.54,83783945,237.016,46.6,21.453,45229.245,156.139,8.31,0.936,3
74,163,1892,255366,3,9341,0,13526364,49.54,83783945,237.016,46.6,21.453,45229.245,156.139,8.31,0.936,3
74,164,1484,256850,1,9342,0,13526364,49.54,83783945,237.016,46.6,21.453,45229.245,156.139,8.31,0.936,3
74,165,1630,258480,5,9347,0,13526364,49.54,83783945,237.016,46.6,21.453,45229.245,156.139,8.31,0.936,3
74,166,948,259428,2,9349,0,14688497,49.54,83783945,237.016,46.6,21.453,45229.245,156.139,8.31,0.936,3
74,167,927,260355,1,9350,0,14688497,49.54,83783945,237.016,46.6,21.453,45229.245,156.139,8.31,0.936,3
74,168,1407,261762,12,9362,0,14688497,49.54,83783945,237.016,46.6,21.453,45229.245,156.139,8.31,0.936,3
74,169,1901,263663,6,9368,0,14688497,49.54,83783945,237.016,46.6,21.453,45229.245,156.139,8.31,0.936,3
74,170,2194,265857,3,9371,0,14688497,49.54,83783945,237.016,46.6,21.453,45229.245,156.139,8.31,0.936,3
74,171,1916,267773,7,9378,0,14688497,49.54,83783945,237.016,46.6,21.453,45229.245,156.139,8.31,0.936,3
74,172,2297,270070,6,9384,0,14688497,49.54,83783945,237.016,46.6,21.453,45229.245,156.139,8.31,0.936,3
74,173,1345,271415,2,9386,0,15837754,49.54,83783945,237.016,46.6,21.453,45229.245,156.139,8.31,0.936,3
74,174,922,272337,0,9386,0,15837754,49.54,83783945,237.016,46.6,21.453,45229.245,156.139,8.31,0.936,3
74,175,1821,274158,10,9396,0,15837754,49.54,83783945,237.016,46.6,21.453,45229.245,156.139,8.31,0.936,3
74,176,1769,275927,13,9409,0,15837754,49.54,83783945,237.016,46.6,21.453,45229.245,156.139,8.31,0.936,3
74,177,2143,278070,19,9428,0,15837754,49.54,83783945,237.016,46.6,21.453,45229.245,156.139,8.31,0.936,3
74,178,2153,280223,15,9443,0,15837754,49.54,83783945,237.016,46.6,21.453,45229.245,156.139,8.31,0.936,3
74,179,2507,282730,9,9452,0,15837754,49.54,83783945,237.016,46.6,21.453,45229.245,156.139,8.31,0.936,3
74,180,1410,284140,5,9457,0,17005624,49.54,83783945,237.016,46.6,21.453,45229.245,156.139,8.31,0.936,3
74,181,1192,285332,3,9460,0,17005624,49.54,83783945,237.016,46.6,21.453,45229.245,156.139,8.31,0.936,3
74,182,2089,287421,11,9471,0,17005624,49.54,83783945,237.016,46.6,21.453,45229.245,156.139,8.31,0.936,3
74,183,1798,289219,17,9488,0,17005624,49.54,83783945,237.016,46.6,21.453,45229.245,156.139,8.31,0.936,3
74,184,2503,291722,12,9500,0,17005624,46.76,83783945,237.016,46.6,21.453,45229.245,156.139,8.31,0.936,3
74,185,2673,294395,8,9508,0,17005624,46.76,83783945,237.016,46.6,21.453,45229.245,156.139,8.31,0.936,3
74,186,2563,296958,19,9527,0,17005624,46.76,83783945,237.016,46.6,21.453,45229.245,156.139,8.31,0.936,3
74,187,2279,299237,2,9529,0,18109079,46.76,83783945,237.016,46.6,21.453,45229.245,156.139,8.31,0.936,3
74,188,1382,300619,5,9534,0,18109079,46.76,83783945,237.016,46.6,21.453,45229.245,156.139,8.31,0.936,3
74,189,2639,303258,12,9546,0,18109079,46.76,83783945,237.016,46.6,21.453,45229.245,156.139,8.31,0.936,3
74,190,2828,306086,16,9562,0,18109079,46.76,83783945,237.016,46.6,21.453,45229.245,156.139,8.31,0.936,3
74,191,4058,310144,16,9578,0,18109079,46.76,83783945,237.016,46.6,21.453,45229.245,156.139,8.31,0.936,3
74,192,4516,314660,11,9589,0,18109079,46.76,83783945,237.016,46.6,21.453,45229.245,156.139,8.31,0.936,3
74,193,4721,319381,15,9604,0,18109079,46.76,83783945,237.016,46.6,21.453,45229.245,156.139,8.31,0.936,3
74,194,3483,322864,11,9615,0,19276507,46.76,83783945,237.016,46.6,21.453,45229.245,156.139,8.31,0.936,3
74,195,2467,325331,6,9621,0,19276507,46.76,83783945,237.016,46.6,21.453,45229.245,156.139,8.31,0.936,3
74,196,4122,329453,13,9634,0,19276507,46.76,83783945,237.016,46.6,21.453,45229.245,156.139,8.31,0.936,3
74,197,5132,334585,43,9677,0,19276507,46.76,83783945,237.016,46.6,21.453,45229.245,156.139,8.31,0.936,3
74,198,6638,341223,33,9710,0,19276507,46.76,83783945,237.016,46.6,21.453,45229.245,156.139,8.31,0.936,3
74,199,7334,348557,24,9734,0,19276507,46.76,83783945,237.016,46.6,21.453,45229.245,156.139,8.31,0.936,3
74,200,7830,356387,33,9767,0,19276507,46.76,83783945,237.016,46.6,21.453,45229.245,156.139,8.31,0.936,3
74,201,5587,361974,10,9777,0,19276507,46.76,83783945,237.016,46.6,21.453,45229.245,156.139,8.31,0.936,3
74,202,4325,366299,12,9789,0,19276507,46.76,83783945,237.016,46.6,21.453,45229.245,156.139,8.31,0.936,3
74,203,6868,373167,47,9836,0,19276507,46.76,83783945,237.016,46.6,21.453,45229.245,156.139,8.31,0.936,3
74,204,7595,380762,39,9875,0,19276507,46.76,83783945,237.016,46.6,21.453,45229.245,156.139,8.31,0.936,3
75,1,0,152,0,5,0,0,86.11,31072945,126.719,21.1,3.385,4227.63,298.245,4.97,0.592,4
75,2,43,195,0,5,0,0,86.11,31072945,126.719,21.1,3.385,4227.63,298.245,4.97,0.592,4
75,3,9,204,0,5,0,0,86.11,31072945,126.719,21.1,3.385,4227.63,298.245,4.97,0.592,4
75,4,1,205,0,5,0,0,86.11,31072945,126.719,21.1,3.385,4227.63,298.245,4.97,0.592,4
75,5,9,214,0,5,0,0,86.11,31072945,126.719,21.1,3.385,4227.63,298.245,4.97,0.592,4
75,6,0,214,0,5,0,0,86.11,31072945,126.719,21.1,3.385,4227.63,298.245,4.97,0.592,4
75,7,73,287,0,5,0,0,86.11,31072945,126.719,21.1,3.385,4227.63,298.245,4.97,0.592,4
75,8,0,287,0,5,0,0,86.11,31072945,126.719,21.1,3.385,4227.63,298.245,4.97,0.592,4
75,9,26,313,1,6,0,14611,86.11,31072945,126.719,21.1,3.385,4227.63,298.245,4.97,0.592,4
75,10,65,378,0,6,12735,27346,86.11,31072945,126.719,21.1,3.385,4227.63,298.245,4.97,0.592,4
75,11,0,378,0,6,10608,37954,86.11,31072945,126.719,21.1,3.385,4227.63,298.245,4.97,0.592,4
75,12,30,408,2,8,0,37954,86.11,31072945,126.719,21.1,3.385,4227.63,298.245,4.97,0.592,4
75,13,158,566,0,8,0,37954,86.11,31072945,126.719,21.1,3.385,4227.63,298.245,4.97,0.592,4
75,14,0,566,0,8,0,50719,86.11,31072945,126.719,21.1,3.385,4227.63,298.245,4.97,0.592,4
75,15,70,636,0,8,6281,57000,86.11,31072945,126.719,21.1,3.385,4227.63,298.245,4.97,0.592,4
75,16,5,641,0,8,0,57000,86.11,31072945,126.719,21.1,3.385,4227.63,298.245,4.97,0.592,4
75,17,0,641,0,8,0,57000,86.11,31072945,126.719,21.1,3.385,4227.63,298.245,4.97,0.592,4
75,18,0,641,0,8,0,60916,84.26,31072945,126.719,21.1,3.385,4227.63,298.245,4.97,0.592,4
75,19,193,834,1,9,7675,68591,70.37,31072945,126.719,21.1,3.385,4227.63,298.245,4.97,0.592,4
75,20,208,1042,0,9,0,68591,62.04,31072945,126.719,21.1,3.385,4227.63,298.245,4.97,0.592,4
75,21,0,1042,0,9,0,68591,62.04,31072945,126.719,21.1,3.385,4227.63,298.245,4.97,0.592,4
75,22,0,1042,0,9,0,88188,62.04,31072945,126.719,21.1,3.385,4227.63,298.245,4.97,0.592,4
75,23,112,1154,0,9,0,88188,62.04,31072945,126.719,21.1,3.385,4227.63,298.245,4.97,0.592,4
75,24,0,1154,0,9,0,88188,62.04,31072945,126.719,21.1,3.385,4227.63,298.245,4.97,0.592,4
75,25,125,1279,1,10,0,100622,62.04,31072945,126.719,21.1,3.385,4227.63,298.245,4.97,0.592,4
75,26,0,1279,0,10,0,100622,62.04,31072945,126.719,21.1,3.385,4227.63,298.245,4.97,0.592,4
75,27,271,1550,1,11,0,106090,62.04,31072945,126.719,21.1,3.385,4227.63,298.245,4.97,0.592,4
75,28,0,1550,0,11,7407,113497,62.04,31072945,126.719,21.1,3.385,4227.63,298.245,4.97,0.592,4
75,29,121,1671,5,16,0,113497,62.04,31072945,126.719,21.1,3.385,4227.63,298.245,4.97,0.592,4
75,30,0,1671,0,16,0,113497,62.04,31072945,126.719,21.1,3.385,4227.63,298.245,4.97,0.592,4
75,31,403,2074,1,17,0,117049,62.04,31072945,126.719,21.1,3.385,4227.63,298.245,4.97,0.592,4
75,32,0,2074,0,17,12412,129461,62.04,31072945,126.719,21.1,3.385,4227.63,298.245,4.97,0.592,4
75,33,95,2169,1,18,0,129461,62.04,31072945,126.719,21.1,3.385,4227.63,298.245,4.97,0.592,4
75,34,0,2169,0,18,0,135902,62.04,31072945,126.719,21.1,3.385,4227.63,298.245,4.97,0.592,4
75,35,550,2719,0,18,0,135902,62.04,31072945,126.719,21.1,3.385,4227.63,298.245,4.97,0.592,4
75,36,0,2719,0,18,0,135902,62.04,31072945,126.719,21.1,3.385,4227.63,298.245,4.97,0.592,4
75,37,372,3091,0,18,0,149948,62.04,31072945,126.719,21.1,3.385,4227.63,298.245,4.97,0.592,4
75,38,0,3091,0,18,5253,155201,62.04,31072945,126.719,21.1,3.385,4227.63,298.245,4.97,0.592,4
75,39,921,4012,0,18,0,155201,62.04,31072945,126.719,21.1,3.385,4227.63,298.245,4.97,0.592,4
75,40,251,4263,4,22,0,160501,62.04,31072945,126.719,21.1,3.385,4227.63,298.245,4.97,0.592,4
75,41,0,4263,0,22,1683,162184,62.04,31072945,126.719,21.1,3.385,4227.63,298.245,4.97,0.592,4
75,42,437,4700,0,22,3249,165433,62.04,31072945,126.719,21.1,3.385,4227.63,298.245,4.97,0.592,4
75,43,427,5127,0,22,3252,168685,62.04,31072945,126.719,21.1,3.385,4227.63,298.245,4.97,0.592,4
75,44,281,5408,2,24,3938,172623,62.04,31072945,126.719,21.1,3.385,4227.63,298.245,4.97,0.592,4
75,45,122,5530,0,24,1454,174077,62.04,31072945,126.719,21.1,3.385,4227.63,298.245,4.97,0.592,4
75,46,108,5638,4,28,0,174077,62.04,31072945,126.719,21.1,3.385,4227.63,298.245,4.97,0.592,4
75,47,97,5735,1,29,0,180567,62.04,31072945,126.719,21.1,3.385,4227.63,298.245,4.97,0.592,4
75,48,0,5735,0,29,3776,184343,62.04,31072945,126.719,21.1,3.385,4227.63,298.245,4.97,0.592,4
75,49,0,5735,0,29,3586,187929,62.04,31072945,126.719,21.1,3.385,4227.63,298.245,4.97,0.592,4
75,50,361,6096,2,31,4265,192194,62.04,31072945,126.719,21.1,3.385,4227.63,298.245,4.97,0.592,4
75,51,173,6269,0,31,1511,193705,62.04,31072945,126.719,21.1,3.385,4227.63,298.245,4.97,0.592,4
75,52,217,6486,0,31,1058,194763,62.04,31072945,126.719,21.1,3.385,4227.63,298.245,4.97,0.592,4
75,53,131,6617,0,31,3412,198175,62.04,31072945,126.719,21.1,3.385,4227.63,298.245,4.97,0.592,4
75,54,0,6617,0,31,3955,202130,62.04,31072945,126.719,21.1,3.385,4227.63,298.245,4.97,0.592,4
75,55,66,6683,1,32,1253,203383,62.04,31072945,126.719,21.1,3.385,4227.63,298.245,4.97,0.592,4
75,56,125,6808,0,32,2507,205890,56.48,31072945,126.719,21.1,3.385,4227.63,298.245,4.97,0.592,4
75,57,309,7117,2,34,2438,208328,56.48,31072945,126.719,21.1,3.385,4227.63,298.245,4.97,0.592,4
75,58,186,7303,0,34,3294,211622,56.48,31072945,126.719,21.1,3.385,4227.63,298.245,4.97,0.592,4
75,59,0,7303,0,34,3334,214956,56.48,31072945,126.719,21.1,3.385,4227.63,298.245,4.97,0.592,4
75,60,313,7616,0,34,3469,218425,56.48,31072945,126.719,21.1,3.385,4227.63,298.245,4.97,0.592,4
75,61,152,7768,1,35,1400,219825,56.48,31072945,126.719,21.1,3.385,4227.63,298.245,4.97,0.592,4
75,62,302,8070,1,36,328,220153,56.48,31072945,126.719,21.1,3.385,4227.63,298.245,4.97,0.592,4
75,63,0,8070,0,36,2912,223065,56.48,31072945,126.719,21.1,3.385,4227.63,298.245,4.97,0.592,4
75,64,227,8297,2,38,3676,226741,56.48,31072945,126.719,21.1,3.385,4227.63,298.245,4.97,0.592,4
75,65,251,8548,0,38,2352,229093,56.48,31072945,126.719,21.1,3.385,4227.63,298.245,4.97,0.592,4
75,66,337,8885,0,38,4641,233734,56.48,31072945,126.719,21.1,3.385,4227.63,298.245,4.97,0.592,4
75,67,283,9168,4,42,1709,235443,56.48,31072945,126.719,21.1,3.385,4227.63,298.245,4.97,0.592,4
75,68,294,9462,2,44,3952,239395,56.48,31072945,126.719,21.1,3.385,4227.63,298.245,4.97,0.592,4
75,69,176,9638,0,44,809,240204,56.48,31072945,126.719,21.1,3.385,4227.63,298.245,4.97,0.592,4
75,70,272,9910,4,48,2014,242218,56.48,31072945,126.719,21.1,3.385,4227.63,298.245,4.97,0.592,4
75,71,291,10201,0,48,3230,245448,56.48,31072945,126.719,21.1,3.385,4227.63,298.245,4.97,0.592,4
75,72,157,10358,0,48,2144,247592,56.48,31072945,126.719,21.1,3.385,4227.63,298.245,4.97,0.592,4
75,73,0,10358,0,48,3302,250894,56.48,31072945,126.719,21.1,3.385,4227.63,298.245,4.97,0.592,4
75,74,760,11118,0,48,3437,254331,56.48,31072945,126.719,21.1,3.385,4227.63,298.245,4.97,0.592,4
75,75,304,11422,3,51,1640,255971,56.48,31072945,126.719,21.1,3.385,4227.63,298.245,4.97,0.592,4
75,76,542,11964,3,54,2039,258010,56.48,31072945,126.719,21.1,3.385,4227.63,298.245,4.97,0.592,4
75,77,0,11964,0,54,3309,261319,56.48,31072945,126.719,21.1,3.385,4227.63,298.245,4.97,0.592,4
75,78,229,12193,4,58,2406,263725,56.48,31072945,126.719,21.1,3.385,4227.63,298.245,4.97,0.592,4
75,79,397,12590,8,66,3561,267286,56.48,31072945,126.719,21.1,3.385,4227.63,298.245,4.97,0.592,4
75,80,339,12929,0,66,0,267286,56.48,31072945,126.719,21.1,3.385,4227.63,298.245,4.97,0.592,4
75,81,274,13203,4,70,0,270300,56.48,31072945,126.719,21.1,3.385,4227.63,298.245,4.97,0.592,4
75,82,508,13711,15,85,7250,277550,56.48,31072945,126.719,21.1,3.385,4227.63,298.245,4.97,0.592,4
75,83,443,14154,0,85,2566,280116,52.78,31072945,126.719,21.1,3.385,4227.63,298.245,4.97,0.592,4
75,84,0,14154,0,85,3008,283124,52.78,31072945,126.719,21.1,3.385,4227.63,298.245,4.97,0.592,4
75,85,414,14568,10,95,3329,286453,52.78,31072945,126.719,21.1,3.385,4227.63,298.245,4.97,0.592,4
75,86,445,15013,0,95,2012,288465,52.78,31072945,126.719,21.1,3.385,4227.63,298.245,4.97,0.592,4
75,87,460,15473,0,95,1900,290365,52.78,31072945,126.719,21.1,3.385,4227.63,298.245,4.97,0.592,4
75,88,361,15834,8,103,4502,294867,52.78,31072945,126.719,21.1,3.385,4227.63,298.245,4.97,0.592,4
75,89,597,16431,0,103,2724,297591,52.78,31072945,126.719,21.1,3.385,4227.63,298.245,4.97,0.592,4
75,90,920,17351,9,112,2929,300520,52.78,31072945,126.719,21.1,3.385,4227.63,298.245,4.97,0.592,4
75,91,0,17351,0,112,0,300520,52.78,31072945,126.719,21.1,3.385,4227.63,298.245,4.97,0.592,4
75,92,390,17741,0,112,0,307133,52.78,31072945,126.719,21.1,3.385,4227.63,298.245,4.97,0.592,4
75,93,393,18134,5,117,3026,310159,52.78,31072945,126.719,21.1,3.385,4227.63,298.245,4.97,0.592,4
75,94,0,18134,0,117,3298,313457,52.78,31072945,126.719,21.1,3.385,4227.63,298.245,4.97,0.592,4
75,95,1254,19388,0,117,3341,316798,52.78,31072945,126.719,21.1,3.385,4227.63,298.245,4.97,0.592,4
75,96,0,19388,0,117,3273,320071,52.78,31072945,126.719,21.1,3.385,4227.63,298.245,4.97,0.592,4
75,97,697,20085,5,122,2839,322910,52.78,31072945,126.719,21.1,3.385,4227.63,298.245,4.97,0.592,4
75,98,992,21077,7,129,2540,325450,52.78,31072945,126.719,21.1,3.385,4227.63,298.245,4.97,0.592,4
75,99,891,21968,0,129,1559,327009,52.78,31072945,126.719,21.1,3.385,4227.63,298.245,4.97,0.592,4
75,100,854,22822,0,129,1374,328383,52.78,31072945,126.719,21.1,3.385,4227.63,298.245,4.97,0.592,4
75,101,641,23463,0,129,2983,331366,52.78,31072945,126.719,21.1,3.385,4227.63,298.245,4.97,0.592,4
75,102,371,23834,6,135,2735,334101,52.78,31072945,126.719,21.1,3.385,4227.63,298.245,4.97,0.592,4
75,103,414,24248,0,135,1992,336093,52.78,31072945,126.719,21.1,3.385,4227.63,298.245,4.97,0.592,4
75,104,270,24518,4,139,3398,339491,52.78,31072945,126.719,21.1,3.385,4227.63,298.245,4.97,0.592,4
75,105,470,24988,0,139,2428,341919,52.78,31072945,126.719,21.1,3.385,4227.63,298.245,4.97,0.592,4
75,106,0,24988,0,139,2218,344137,52.78,31072945,126.719,21.1,3.385,4227.63,298.245,4.97,0.592,4
75,107,442,25430,0,139,2853,346990,52.78,31072945,126.719,21.1,3.385,4227.63,298.245,4.97,0.592,4
75,108,695,26125,0,139,2762,349752,52.78,31072945,126.719,21.1,3.385,4227.63,298.245,4.97,0.592,4
75,109,447,26572,5,144,4000,353752,52.78,31072945,126.719,21.1,3.385,4227.63,298.245,4.97,0.592,4
75,110,488,27060,1,145,3468,357220,52.78,31072945,126.719,21.1,3.385,4227.63,298.245,4.97,0.592,4
75,111,607,27667,3,148,4322,361542,52.78,31072945,126.719,21.1,3.385,4227.63,298.245,4.97,0.592,4
75,112,763,28430,5,153,3739,365281,52.78,31072945,126.719,21.1,3.385,4227.63,298.245,4.97,0.592,4
75,113,559,28989,0,153,3899,369180,52.78,31072945,126.719,21.1,3.385,4227.63,298.245,4.97,0.592,4
75,114,683,29672,0,153,3393,372573,52.78,31072945,126.719,21.1,3.385,4227.63,298.245,4.97,0.592,4
75,115,694,30366,0,153,2039,374612,52.78,31072945,126.719,21.1,3.385,4227.63,298.245,4.97,0.592,4
75,116,691,31057,8,161,4123,378735,52.78,31072945,126.719,21.1,3.385,4227.63,298.245,4.97,0.592,4
75,117,794,31851,0,161,4017,382752,52.78,31072945,126.719,21.1,3.385,4227.63,298.245,4.97,0.592,4
75,118,1118,32969,7,168,4584,387336,52.78,31072945,126.719,21.1,3.385,4227.63,298.245,4.97,0.592,4
75,119,655,33624,0,168,4042,391378,52.78,31072945,126.719,21.1,3.385,4227.63,298.245,4.97,0.592,4
75,120,782,34406,0,168,0,391378,52.78,31072945,126.719,21.1,3.385,4227.63,298.245,4.97,0.592,4
75,121,736,35142,7,175,0,396731,52.78,31072945,126.719,21.1,3.385,4227.63,298.245,4.97,0.592,4
75,122,0,35142,0,175,2715,399446,52.78,31072945,126.719,21.1,3.385,4227.63,298.245,4.97,0.592,4
75,123,359,35501,7,182,3118,402564,52.78,31072945,126.719,21.1,3.385,4227.63,298.245,4.97,0.592,4
75,124,1513,37014,0,182,3253,405817,52.78,31072945,126.719,21.1,3.385,4227.63,298.245,4.97,0.592,4
75,125,0,37014,0,182,1771,407588,52.78,31072945,126.719,21.1,3.385,4227.63,298.245,4.97,0.592,4
75,126,798,37812,9,191,1785,409373,52.78,31072945,126.719,21.1,3.385,4227.63,298.245,4.97,0.592,4
75,127,0,37812,0,191,2166,411539,52.78,31072945,126.719,21.1,3.385,4227.63,298.245,4.97,0.592,4
75,128,1263,39075,8,199,2296,413835,52.78,31072945,126.719,21.1,3.385,4227.63,298.245,4.97,0.592,4
75,129,1022,40097,7,206,1836,415671,52.78,31072945,126.719,21.1,3.385,4227.63,298.245,4.97,0.592,4
75,130,0,40097,0,206,1317,416988,52.78,31072945,126.719,21.1,3.385,4227.63,298.245,4.97,0.592,4
75,131,436,40533,0,206,1340,418328,52.78,31072945,126.719,21.1,3.385,4227.63,298.245,4.97,0.592,4
75,132,470,41003,9,215,1262,419590,52.78,31072945,126.719,21.1,3.385,4227.63,298.245,4.97,0.592,4
75,133,209,41212,0,215,1998,421588,52.78,31072945,126.719,21.1,3.385,4227.63,298.245,4.97,0.592,4
75,134,192,41404,0,215,1420,423008,52.78,31072945,126.719,21.1,3.385,4227.63,298.245,4.97,0.592,4
75,135,321,41725,8,223,1307,424315,52.78,31072945,126.719,21.1,3.385,4227.63,298.245,4.97,0.592,4
75,136,122,41847,0,223,1654,425969,52.78,31072945,126.719,21.1,3.385,4227.63,298.245,4.97,0.592,4
75,137,216,42063,8,231,1152,427121,52.78,31072945,126.719,21.1,3.385,4227.63,298.245,4.97,0.592,4
75,138,147,42210,0,231,1574,428695,52.78,31072945,126.719,21.1,3.385,4227.63,298.245,4.97,0.592,4
75,139,322,42532,0,231,1078,429773,52.78,31072945,126.719,21.1,3.385,4227.63,298.245,4.97,0.592,4
75,140,121,42653,8,239,1499,431272,52.78,31072945,126.719,21.1,3.385,4227.63,298.245,4.97,0.592,4
75,141,340,42993,9,248,1100,432372,52.78,31072945,126.719,21.1,3.385,4227.63,298.245,4.97,0.592,4
75,142,101,43094,8,256,1131,433503,52.78,31072945,126.719,21.1,3.385,4227.63,298.245,4.97,0.592,4
75,143,166,43260,5,261,1606,435109,52.78,31072945,126.719,21.1,3.385,4227.63,298.245,4.97,0.592,4
75,144,65,43325,0,261,1144,436253,52.78,31072945,126.719,21.1,3.385,4227.63,298.245,4.97,0.592,4
75,145,180,43505,0,261,748,437001,52.78,31072945,126.719,21.1,3.385,4227.63,298.245,4.97,0.592,4
75,146,0,43505,0,261,749,437750,52.78,31072945,126.719,21.1,3.385,4227.63,298.245,4.97,0.592,4
75,147,117,43622,2,263,1496,439246,52.78,31072945,126.719,21.1,3.385,4227.63,298.245,4.97,0.592,4
75,148,95,43717,7,270,1738,440984,52.78,31072945,126.719,21.1,3.385,4227.63,298.245,4.97,0.592,4
75,149,124,43841,0,270,1201,442185,52.78,31072945,126.719,21.1,3.385,4227.63,298.245,4.97,0.592,4
75,150,0,43841,0,270,0,442185,52.78,31072945,126.719,21.1,3.385,4227.63,298.245,4.97,0.592,4
75,151,108,43949,0,270,0,444081,52.78,31072945,126.719,21.1,3.385,4227.63,298.245,4.97,0.592,4
75,152,169,44118,0,270,716,444797,52.78,31072945,126.719,21.1,3.385,4227.63,298.245,4.97,0.592,4
75,153,87,44205,6,276,856,445653,52.78,31072945,126.719,21.1,3.385,4227.63,298.245,4.97,0.592,4
75,154,93,44298,0,276,555,446208,44.44,31072945,126.719,21.1,3.385,4227.63,298.245,4.97,0.592,4
75,155,162,44460,0,276,659,446867,44.44,31072945,126.719,21.1,3.385,4227.63,298.245,4.97,0.592,4
75,156,198,44658,0,276,1034,447901,44.44,31072945,126.719,21.1,3.385,4227.63,298.245,4.97,0.592,4
75,157,55,44713,4,280,919,448820,44.44,31072945,126.719,21.1,3.385,4227.63,298.245,4.97,0.592,4
75,158,64,44777,3,283,868,449688,44.44,31072945,126.719,21.1,3.385,4227.63,298.245,4.97,0.592,4
75,159,0,44777,0,283,1184,450872,44.44,31072945,126.719,21.1,3.385,4227.63,298.245,4.97,0.592,4
75,160,0,44777,0,283,718,451590,44.44,31072945,126.719,21.1,3.385,4227.63,298.245,4.97,0.592,4
75,161,235,45012,0,283,594,452184,44.44,31072945,126.719,21.1,3.385,4227.63,298.245,4.97,0.592,4
75,162,0,45012,0,283,1066,453250,44.44,31072945,126.719,21.1,3.385,4227.63,298.245,4.97,0.592,4
75,163,301,45313,0,283,852,454102,44.44,31072945,126.719,21.1,3.385,4227.63,298.245,4.97,0.592,4
75,164,0,45313,0,283,810,454912,44.44,31072945,126.719,21.1,3.385,4227.63,298.245,4.97,0.592,4
75,165,75,45388,2,285,1137,456049,44.44,31072945,126.719,21.1,3.385,4227.63,298.245,4.97,0.592,4
75,166,46,45434,1,286,1043,457092,44.44,31072945,126.719,21.1,3.385,4227.63,298.245,4.97,0.592,4
75,167,0,45434,0,286,7328,464420,44.44,31072945,126.719,21.1,3.385,4227.63,298.245,4.97,0.592,4
75,168,167,45601,8,294,2425,466845,44.44,31072945,126.719,21.1,3.385,4227.63,298.245,4.97,0.592,4
75,169,54,45655,0,294,583,467428,44.44,31072945,126.719,21.1,3.385,4227.63,298.245,4.97,0.592,4
75,170,0,45655,0,294,1748,469176,44.44,31072945,126.719,21.1,3.385,4227.63,298.245,4.97,0.592,4
75,171,59,45714,0,294,1554,470730,44.44,31072945,126.719,21.1,3.385,4227.63,298.245,4.97,0.592,4
75,172,143,45857,1,295,1559,472289,44.44,31072945,126.719,21.1,3.385,4227.63,298.245,4.97,0.592,4
75,173,20,45877,2,297,1831,474120,44.44,31072945,126.719,21.1,3.385,4227.63,298.245,4.97,0.592,4
75,174,127,46004,0,297,1537,475657,44.44,31072945,126.719,21.1,3.385,4227.63,298.245,4.97,0.592,4
75,175,58,46062,0,297,955,476612,44.44,31072945,126.719,21.1,3.385,4227.63,298.245,4.97,0.592,4
75,176,54,46116,0,297,580,477192,44.44,31072945,126.719,21.1,3.385,4227.63,298.245,4.97,0.592,4
75,177,37,46153,2,299,1912,479104,44.44,31072945,126.719,21.1,3.385,4227.63,298.245,4.97,0.592,4
75,178,69,46222,0,299,827,479931,44.44,31072945,126.719,21.1,3.385,4227.63,298.245,4.97,0.592,4
75,179,0,46222,0,299,784,480715,44.44,31072945,126.719,21.1,3.385,4227.63,298.245,4.97,0.592,4
75,180,0,46222,0,299,2825,483540,44.44,31072945,126.719,21.1,3.385,4227.63,298.245,4.97,0.592,4
75,181,165,46387,0,299,770,484310,44.44,31072945,126.719,21.1,3.385,4227.63,298.245,4.97,0.592,4
75,182,95,46482,2,301,2010,486320,44.44,31072945,126.719,21.1,3.385,4227.63,298.245,4.97,0.592,4
75,183,0,46482,0,301,1352,487672,44.44,31072945,126.719,21.1,3.385,4227.63,298.245,4.97,0.592,4
75,184,174,46656,0,301,755,488427,44.44,31072945,126.719,21.1,3.385,4227.63,298.245,4.97,0.592,4
75,185,0,46656,0,301,0,488427,44.44,31072945,126.719,21.1,3.385,4227.63,298.245,4.97,0.592,4
75,186,38,46694,0,301,0,492768,44.44,31072945,126.719,21.1,3.385,4227.63,298.245,4.97,0.592,4
75,187,109,46803,2,303,741,493509,44.44,31072945,126.719,21.1,3.385,4227.63,298.245,4.97,0.592,4
75,188,26,46829,0,303,2116,495625,44.44,31072945,126.719,21.1,3.385,4227.63,298.245,4.97,0.592,4
75,189,0,46829,0,303,800,496425,44.44,31072945,126.719,21.1,3.385,4227.63,298.245,4.97,0.592,4
75,190,0,46829,0,303,1357,497782,44.44,31072945,126.719,21.1,3.385,4227.63,298.245,4.97,0.592,4
75,191,0,46829,0,303,1108,498890,44.44,31072945,126.719,21.1,3.385,4227.63,298.245,4.97,0.592,4
75,192,118,46947,3,306,1461,500351,44.44,31072945,126.719,21.1,3.385,4227.63,298.245,4.97,0.592,4
75,193,40,46987,0,306,2315,502666,44.44,31072945,126.719,21.1,3.385,4227.63,298.245,4.97,0.592,4
75,194,18,47005,0,306,431,503097,44.44,31072945,126.719,21.1,3.385,4227.63,298.245,4.97,0.592,4
75,195,0,47005,0,306,427,503524,44.44,31072945,126.719,21.1,3.385,4227.63,298.245,4.97,0.592,4
75,196,25,47030,2,308,1034,504558,44.44,31072945,126.719,21.1,3.385,4227.63,298.245,4.97,0.592,4
75,197,96,47126,2,310,2048,506606,44.44,31072945,126.719,21.1,3.385,4227.63,298.245,4.97,0.592,4
75,198,0,47126,0,310,0,506606,44.44,31072945,126.719,21.1,3.385,4227.63,298.245,4.97,0.592,4
75,199,47,47173,0,310,0,506606,44.44,31072945,126.719,21.1,3.385,4227.63,298.245,4.97,0.592,4
75,200,0,47173,0,310,0,506606,44.44,31072945,126.719,21.1,3.385,4227.63,298.245,4.97,0.592,4
75,201,59,47232,0,310,0,506606,44.44,31072945,126.719,21.1,3.385,4227.63,298.245,4.97,0.592,4
75,202,78,47310,0,310,0,506606,44.44,31072945,126.719,21.1,3.385,4227.63,298.245,4.97,0.592,4
75,203,62,47372,0,310,0,506606,44.44,31072945,126.719,21.1,3.385,4227.63,298.245,4.97,0.592,4
75,204,89,47461,2,312,0,506606,44.44,31072945,126.719,21.1,3.385,4227.63,298.245,4.97,0.592,4
77,1,102,1314,6,49,618,17350,84.26,10423056,83.479,45.3,20.396,24574.382,175.695,4.55,0.87,0
77,2,61,1375,1,50,1494,18844,84.26,10423056,83.479,45.3,20.396,24574.382,175.695,4.55,0.87,0
77,3,139,1514,3,53,3593,22437,84.26,10423056,83.479,45.3,20.396,24574.382,175.695,4.55,0.87,0
77,4,99,1613,6,59,896,23333,84.26,10423056,83.479,45.3,20.396,24574.382,175.695,4.55,0.87,0
77,5,60,1673,9,68,2120,25453,84.26,10423056,83.479,45.3,20.396,24574.382,175.695,4.55,0.87,0
77,6,62,1735,5,73,740,26193,84.26,10423056,83.479,45.3,20.396,24574.382,175.695,4.55,0.87,0
77,7,20,1755,6,79,2391,28584,84.26,10423056,83.479,45.3,20.396,24574.382,175.695,4.55,0.87,0
77,8,77,1832,2,81,3944,32528,84.26,10423056,83.479,45.3,20.396,24574.382,175.695,4.55,0.87,0
77,9,52,1884,2,83,1106,33634,84.26,10423056,83.479,45.3,20.396,24574.382,175.695,4.55,0.87,0
77,10,71,1955,3,86,1798,35432,84.26,10423056,83.479,45.3,20.396,24574.382,175.695,4.55,0.87,0
77,11,56,2011,4,90,1912,37344,84.26,10423056,83.479,45.3,20.396,24574.382,175.695,4.55,0.87,0
77,12,70,2081,3,93,4917,42261,84.26,10423056,83.479,45.3,20.396,24574.382,175.695,4.55,0.87,0
77,13,33,2114,5,98,1170,43431,84.26,10423056,83.479,45.3,20.396,24574.382,175.695,4.55,0.87,0
77,14,31,2145,1,99,0,43431,84.26,10423056,83.479,45.3,20.396,24574.382,175.695,4.55,0.87,0
77,15,25,2170,2,101,0,47389,84.26,10423056,83.479,45.3,20.396,24574.382,175.695,4.55,0.87,0
77,16,22,2192,1,102,2001,49390,84.26,10423056,83.479,45.3,20.396,24574.382,175.695,4.55,0.87,0
77,17,15,2207,3,105,2255,51645,84.26,10423056,83.479,45.3,20.396,24574.382,175.695,4.55,0.87,0
77,18,0,2207,0,105,1645,53290,84.26,10423056,83.479,45.3,20.396,24574.382,175.695,4.55,0.87,0
77,19,0,2207,0,105,0,53290,84.26,10423056,83.479,45.3,20.396,24574.382,175.695,4.55,0.87,0
77,20,28,2235,5,110,0,54344,84.26,10423056,83.479,45.3,20.396,24574.382,175.695,4.55,0.87,0
77,21,10,2245,6,116,1322,55666,84.26,10423056,83.479,45.3,20.396,24574.382,175.695,4.55,0.87,0
77,22,156,2401,5,121,1326,56992,84.26,10423056,83.479,45.3,20.396,24574.382,175.695,4.55,0.87,0
77,23,7,2408,0,121,2249,59241,84.26,10423056,83.479,45.3,20.396,24574.382,175.695,4.55,0.87,0
77,24,55,2463,4,125,2166,61407,84.26,10423056,83.479,45.3,20.396,24574.382,175.695,4.55,0.87,0
77,25,27,2490,5,130,1680,63087,84.26,10423056,83.479,45.3,20.396,24574.382,175.695,4.55,0.87,0
77,26,16,2506,0,130,1521,64608,84.26,10423056,83.479,45.3,20.396,24574.382,175.695,4.55,0.87,0
77,27,0,2506,0,130,1486,66094,84.26,10423056,83.479,45.3,20.396,24574.382,175.695,4.55,0.87,0
77,28,28,2534,6,136,3739,69833,84.26,10423056,83.479,45.3,20.396,24574.382,175.695,4.55,0.87,0
77,29,0,2534,0,136,2297,72130,84.26,10423056,83.479,45.3,20.396,24574.382,175.695,4.55,0.87,0
77,30,42,2576,3,139,3040,75170,84.26,10423056,83.479,45.3,20.396,24574.382,175.695,4.55,0.87,0
77,31,15,2591,1,140,2081,77251,84.26,10423056,83.479,45.3,20.396,24574.382,175.695,4.55,0.87,0
77,32,0,2591,0,140,956,78207,84.26,10423056,83.479,45.3,20.396,24574.382,175.695,4.55,0.87,0
77,33,29,2620,3,143,1125,79332,84.26,10423056,83.479,45.3,20.396,24574.382,175.695,4.55,0.87,0
77,34,6,2626,1,144,1619,80951,81.48,10423056,83.479,45.3,20.396,24574.382,175.695,4.55,0.87,0
77,35,6,2632,2,146,2799,83750,72.22,10423056,83.479,45.3,20.396,24574.382,175.695,4.55,0.87,0
77,36,10,2642,0,146,3302,87052,72.22,10423056,83.479,45.3,20.396,24574.382,175.695,4.55,0.87,0
77,37,21,2663,1,147,2991,90043,72.22,10423056,83.479,45.3,20.396,24574.382,175.695,4.55,0.87,0
77,38,15,2678,1,148,4248,94291,72.22,10423056,83.479,45.3,20.396,24574.382,175.695,4.55,0.87,0
77,39,13,2691,2,150,3093,97384,72.22,10423056,83.479,45.3,20.396,24574.382,175.695,4.55,0.87,0
77,40,19,2710,1,151,1493,98877,72.22,10423056,83.479,45.3,20.396,24574.382,175.695,4.55,0.87,0
77,41,6,2716,0,151,486,99363,68.52,10423056,83.479,45.3,20.396,24574.382,175.695,4.55,0.87,0
77,42,10,2726,0,151,6691,106054,68.52,10423056,83.479,45.3,20.396,24574.382,175.695,4.55,0.87,0
77,43,18,2744,1,152,5988,112042,68.52,10423056,83.479,45.3,20.396,24574.382,175.695,4.55,0.87,0
77,44,16,2760,3,155,4191,116233,68.52,10423056,83.479,45.3,20.396,24574.382,175.695,4.55,0.87,0
77,45,10,2770,1,156,3782,120015,68.52,10423056,83.479,45.3,20.396,24574.382,175.695,4.55,0.87,0
77,46,40,2810,4,160,6268,126283,68.52,10423056,83.479,45.3,20.396,24574.382,175.695,4.55,0.87,0
77,47,9,2819,2,162,2242,128525,68.52,10423056,83.479,45.3,20.396,24574.382,175.695,4.55,0.87,0
77,48,15,2834,1,163,3159,131684,68.52,10423056,83.479,45.3,20.396,24574.382,175.695,4.55,0.87,0
77,49,2,2836,2,165,4317,136001,68.52,10423056,83.479,45.3,20.396,24574.382,175.695,4.55,0.87,0
77,50,4,2840,0,165,3444,139445,68.52,10423056,83.479,45.3,20.396,24574.382,175.695,4.55,0.87,0
77,51,10,2850,1,166,4633,144078,68.52,10423056,83.479,45.3,20.396,24574.382,175.695,4.55,0.87,0
77,52,3,2853,2,168,3880,147958,68.52,10423056,83.479,45.3,20.396,24574.382,175.695,4.55,0.87,0
77,53,20,2873,1,169,5040,152998,68.52,10423056,83.479,45.3,20.396,24574.382,175.695,4.55,0.87,0
77,54,3,2876,2,171,965,153963,68.52,10423056,83.479,45.3,20.396,24574.382,175.695,4.55,0.87,0
77,55,2,2878,0,171,1074,155037,68.52,10423056,83.479,45.3,20.396,24574.382,175.695,4.55,0.87,0
77,56,4,2882,1,172,5954,160991,68.52,10423056,83.479,45.3,20.396,24574.382,175.695,4.55,0.87,0
77,57,10,2892,1,173,5254,166245,68.52,10423056,83.479,45.3,20.396,24574.382,175.695,4.55,0.87,0
77,58,11,2903,0,173,4222,170467,68.52,10423056,83.479,45.3,20.396,24574.382,175.695,4.55,0.87,0
77,59,3,2906,2,175,4377,174844,68.52,10423056,83.479,45.3,20.396,24574.382,175.695,4.55,0.87,0
77,60,3,2909,0,175,3472,178316,62.04,10423056,83.479,45.3,20.396,24574.382,175.695,4.55,0.87,0
77,61,6,2915,0,175,2202,180518,62.04,10423056,83.479,45.3,20.396,24574.382,175.695,4.55,0.87,0
77,62,2,2917,0,175,1905,182423,54.63,10423056,83.479,45.3,20.396,24574.382,175.695,4.55,0.87,0
77,63,1,2918,4,179,3167,185590,54.63,10423056,83.479,45.3,20.396,24574.382,175.695,4.55,0.87,0
77,64,19,2937,0,179,0,185590,54.63,10423056,83.479,45.3,20.396,24574.382,175.695,4.55,0.87,0
77,65,0,2937,0,179,0,193929,54.63,10423056,83.479,45.3,20.396,24574.382,175.695,4.55,0.87,0
77,66,15,2952,1,180,0,193929,54.63,10423056,83.479,45.3,20.396,24574.382,175.695,4.55,0.87,0
77,67,15,2967,0,180,0,193929,54.63,10423056,83.479,45.3,20.396,24574.382,175.695,4.55,0.87,0
77,68,13,2980,0,180,0,193929,54.63,10423056,83.479,45.3,20.396,24574.382,175.695,4.55,0.87,0
77,69,17,2997,0,180,0,229519,54.63,10423056,83.479,45.3,20.396,24574.382,175.695,4.55,0.87,0
77,70,52,3049,2,182,2240,231759,54.63,10423056,83.479,45.3,20.396,24574.382,175.695,4.55,0.87,0
77,71,9,3058,1,183,0,231759,54.63,10423056,83.479,45.3,20.396,24574.382,175.695,4.55,0.87,0
77,72,10,3068,0,183,0,237276,54.63,10423056,83.479,45.3,20.396,24574.382,175.695,4.55,0.87,0
77,73,20,3088,0,183,6591,243867,54.63,10423056,83.479,45.3,20.396,24574.382,175.695,4.55,0.87,0
77,74,20,3108,0,183,3585,247452,54.63,10423056,83.479,45.3,20.396,24574.382,175.695,4.55,0.87,0
77,75,4,3112,0,183,3471,250923,54.63,10423056,83.479,45.3,20.396,24574.382,175.695,4.55,0.87,0
77,76,9,3121,0,183,3931,254854,40.74,10423056,83.479,45.3,20.396,24574.382,175.695,4.55,0.87,0
77,77,13,3134,1,184,4882,259736,40.74,10423056,83.479,45.3,20.396,24574.382,175.695,4.55,0.87,0
77,78,14,3148,1,185,5194,264930,40.74,10423056,83.479,45.3,20.396,24574.382,175.695,4.55,0.87,0
77,79,55,3203,2,187,5408,270338,40.74,10423056,83.479,45.3,20.396,24574.382,175.695,4.55,0.87,0
77,80,24,3227,1,188,4373,274711,40.74,10423056,83.479,45.3,20.396,24574.382,175.695,4.55,0.87,0
77,81,10,3237,1,189,4184,278895,40.74,10423056,83.479,45.3,20.396,24574.382,175.695,4.55,0.87,0
77,82,19,3256,1,190,4251,283146,40.74,10423056,83.479,45.3,20.396,24574.382,175.695,4.55,0.87,0
77,83,10,3266,0,190,2843,285989,46.3,10423056,83.479,45.3,20.396,24574.382,175.695,4.55,0.87,0
77,84,21,3287,0,190,5198,291187,46.3,10423056,83.479,45.3,20.396,24574.382,175.695,4.55,0.87,0
77,85,15,3302,0,190,0,291187,46.3,10423056,83.479,45.3,20.396,24574.382,175.695,4.55,0.87,0
77,86,8,3310,0,190,0,291840,46.3,10423056,83.479,45.3,20.396,24574.382,175.695,4.55,0.87,0
77,87,11,3321,1,191,4011,295851,46.3,10423056,83.479,45.3,20.396,24574.382,175.695,4.55,0.87,0
77,88,22,3343,0,191,5293,301144,40.74,10423056,83.479,45.3,20.396,24574.382,175.695,4.55,0.87,0
77,89,23,3366,0,191,3993,305137,40.74,10423056,83.479,45.3,20.396,24574.382,175.695,4.55,0.87,0
77,90,10,3376,0,191,3255,308392,40.74,10423056,83.479,45.3,20.396,24574.382,175.695,4.55,0.87,0
77,91,14,3390,0,191,4383,312775,40.74,10423056,83.479,45.3,20.396,24574.382,175.695,4.55,0.87,0
77,92,19,3409,1,192,3207,315982,40.74,10423056,83.479,45.3,20.396,24574.382,175.695,4.55,0.87,0
77,93,23,3432,0,192,4445,320427,46.3,10423056,83.479,45.3,20.396,24574.382,175.695,4.55,0.87,0
77,94,26,3458,0,192,5024,325451,46.3,10423056,83.479,45.3,20.396,24574.382,175.695,4.55,0.87,0
77,95,28,3486,0,192,6252,331703,46.3,10423056,83.479,45.3,20.396,24574.382,175.695,4.55,0.87,0
77,96,25,3511,0,192,5451,337154,46.3,10423056,83.479,45.3,20.396,24574.382,175.695,4.55,0.87,0
77,97,8,3519,0,192,3174,340328,46.3,10423056,83.479,45.3,20.396,24574.382,175.695,4.55,0.87,0
77,98,43,3562,0,192,8756,349084,46.3,10423056,83.479,45.3,20.396,24574.382,175.695,4.55,0.87,0
77,99,27,3589,1,193,6106,355190,46.3,10423056,83.479,45.3,20.396,24574.382,175.695,4.55,0.87,0
77,100,33,3622,0,193,3535,358725,46.3,10423056,83.479,45.3,20.396,24574.382,175.695,4.55,0.87,0
77,101,50,3672,0,193,4687,363412,46.3,10423056,83.479,45.3,20.396,24574.382,175.695,4.55,0.87,0
77,102,60,3732,0,193,7755,371167,46.3,10423056,83.479,45.3,20.396,24574.382,175.695,4.55,0.87,0
77,103,40,3772,0,193,2765,373932,46.3,10423056,83.479,45.3,20.396,24574.382,175.695,4.55,0.87,0
77,104,31,3803,0,193,8520,382452,57.41,10423056,83.479,45.3,20.396,24574.382,175.695,4.55,0.87,0
77,105,23,3826,0,193,3855,386307,57.41,10423056,83.479,45.3,20.396,24574.382,175.695,4.55,0.87,0
77,106,57,3883,0,193,5466,391773,57.41,10423056,83.479,45.3,20.396,24574.382,175.695,4.55,0.87,0
77,107,27,3910,0,193,6574,398347,57.41,10423056,83.479,45.3,20.396,24574.382,175.695,4.55,0.87,0
77,108,29,3939,0,193,4325,402672,57.41,10423056,83.479,45.3,20.396,24574.382,175.695,4.55,0.87,0
77,109,25,3964,1,194,3368,406040,57.41,10423056,83.479,45.3,20.396,24574.382,175.695,4.55,0.87,0
77,110,19,3983,0,194,4726,410766,57.41,10423056,83.479,45.3,20.396,24574.382,175.695,4.55,0.87,0
77,111,24,4007,0,194,2994,413760,57.41,10423056,83.479,45.3,20.396,24574.382,175.695,4.55,0.87,0
77,112,5,4012,1,195,6146,419906,57.41,10423056,83.479,45.3,20.396,24574.382,175.695,4.55,0.87,0
77,113,36,4048,2,197,4769,424675,57.41,10423056,83.479,45.3,20.396,24574.382,175.695,4.55,0.87,0
77,114,29,4077,3,200,6189,430864,57.41,10423056,83.479,45.3,20.396,24574.382,175.695,4.55,0.87,0
77,115,33,4110,1,201,5646,436510,57.41,10423056,83.479,45.3,20.396,24574.382,175.695,4.55,0.87,0
77,116,25,4135,0,201,0,436510,57.41,10423056,83.479,45.3,20.396,24574.382,175.695,4.55,0.87,0
77,117,31,4166,0,201,0,447685,57.41,10423056,83.479,45.3,20.396,24574.382,175.695,4.55,0.87,0
77,118,27,4193,1,202,3632,451317,57.41,10423056,83.479,45.3,20.396,24574.382,175.695,4.55,0.87,0
77,119,34,4227,0,202,6223,457540,57.41,10423056,83.479,45.3,20.396,24574.382,175.695,4.55,0.87,0
77,120,52,4279,1,203,53889,511429,57.41,10423056,83.479,45.3,20.396,24574.382,175.695,4.55,0.87,0
77,121,57,4336,0,203,8458,519887,57.41,10423056,83.479,45.3,20.396,24574.382,175.695,4.55,0.87,0
77,122,65,4401,0,203,0,519887,57.41,10423056,83.479,45.3,20.396,24574.382,175.695,4.55,0.87,0
77,123,76,4477,3,206,0,539493,46.3,10423056,83.479,45.3,20.396,24574.382,175.695,4.55,0.87,0
77,124,110,4587,0,206,5946,545439,46.3,10423056,83.479,45.3,20.396,24574.382,175.695,4.55,0.87,0
77,125,75,4662,2,208,19417,564856,46.3,10423056,83.479,45.3,20.396,24574.382,175.695,4.55,0.87,0
77,126,75,4737,1,209,34853,599709,46.3,10423056,83.479,45.3,20.396,24574.382,175.695,4.55,0.87,0
77,127,118,4855,0,209,9874,609583,46.3,10423056,83.479,45.3,20.396,24574.382,175.695,4.55,0.87,0
77,128,118,4973,1,210,9810,619393,46.3,10423056,83.479,45.3,20.396,24574.382,175.695,4.55,0.87,0
77,129,150,5123,0,210,11590,630983,46.3,10423056,83.479,45.3,20.396,24574.382,175.695,4.55,0.87,0
77,130,147,5270,0,210,9314,640297,46.3,10423056,83.479,45.3,20.396,24574.382,175.695,4.55,0.87,0
77,131,151,5421,1,211,10701,650998,46.3,10423056,83.479,45.3,20.396,24574.382,175.695,4.55,0.87,0
77,132,202,5623,1,212,7180,658178,46.3,10423056,83.479,45.3,20.396,24574.382,175.695,4.55,0.87,0
77,133,126,5749,1,213,10561,668739,46.3,10423056,83.479,45.3,20.396,24574.382,175.695,4.55,0.87,0
77,134,193,5942,1,214,11046,679785,46.3,10423056,83.479,45.3,20.396,24574.382,175.695,4.55,0.87,0
77,135,235,6177,2,216,7553,687338,57.41,10423056,83.479,45.3,20.396,24574.382,175.695,4.55,0.87,0
77,136,204,6381,5,221,17583,704921,57.41,10423056,83.479,45.3,20.396,24574.382,175.695,4.55,0.87,0
77,137,251,6632,2,223,10582,715503,57.41,10423056,83.479,45.3,20.396,24574.382,175.695,4.55,0.87,0
77,138,226,6858,3,226,3808,719311,57.41,10423056,83.479,45.3,20.396,24574.382,175.695,4.55,0.87,0
77,139,217,7075,2,228,7650,726961,56.02,10423056,83.479,45.3,20.396,24574.382,175.695,4.55,0.87,0
77,140,147,7222,2,230,13910,740871,56.02,10423056,83.479,45.3,20.396,24574.382,175.695,4.55,0.87,0
77,141,250,7472,2,232,63411,804282,56.02,10423056,83.479,45.3,20.396,24574.382,175.695,4.55,0.87,0
77,142,212,7684,3,235,12168,816450,56.02,10423056,83.479,45.3,20.396,24574.382,175.695,4.55,0.87,0
77,143,250,7934,0,235,0,816450,56.02,10423056,83.479,45.3,20.396,24574.382,175.695,4.55,0.87,0
77,144,204,8138,3,238,0,816450,56.02,10423056,83.479,45.3,20.396,24574.382,175.695,4.55,0.87,0
77,145,243,8381,2,240,0,848380,56.02,10423056,83.479,45.3,20.396,24574.382,175.695,4.55,0.87,0
77,146,283,8664,2,242,9758,858138,56.02,10423056,83.479,45.3,20.396,24574.382,175.695,4.55,0.87,0
77,147,155,8819,0,242,14412,872550,56.02,10423056,83.479,45.3,20.396,24574.382,175.695,4.55,0.87,0
77,148,168,8987,1,243,0,872550,56.02,10423056,83.479,45.3,20.396,24574.382,175.695,4.55,0.87,0
77,149,293,9280,5,248,0,903432,56.02,10423056,83.479,45.3,20.396,24574.382,175.695,4.55,0.87,0
77,150,251,9531,6,254,13833,917265,56.02,10423056,83.479,45.3,20.396,24574.382,175.695,4.55,0.87,0
77,151,269,9800,5,259,13737,931002,56.02,10423056,83.479,45.3,20.396,24574.382,175.695,4.55,0.87,0
77,152,177,9977,1,260,9880,940882,56.02,10423056,83.479,45.3,20.396,24574.382,175.695,4.55,0.87,0
77,153,157,10134,2,262,8485,949367,56.02,10423056,83.479,45.3,20.396,24574.382,175.695,4.55,0.87,0
77,154,183,10317,4,266,16979,966346,56.02,10423056,83.479,45.3,20.396,24574.382,175.695,4.55,0.87,0
77,155,207,10524,5,271,14154,980500,56.02,10423056,83.479,45.3,20.396,24574.382,175.695,4.55,0.87,0
77,156,233,10757,2,273,12066,992566,56.02,10423056,83.479,45.3,20.396,24574.382,175.695,4.55,0.87,0
77,157,241,10998,5,278,10576,1003142,56.02,10423056,83.479,45.3,20.396,24574.382,175.695,4.55,0.87,0
77,158,202,11200,1,279,11922,1015064,56.02,10423056,83.479,45.3,20.396,24574.382,175.695,4.55,0.87,0
77,159,186,11386,1,280,0,1015064,56.02,10423056,83.479,45.3,20.396,24574.382,175.695,4.55,0.87,0
77,160,138,11524,4,284,0,1015064,56.02,10423056,83.479,45.3,20.396,24574.382,175.695,4.55,0.87,0
77,161,139,11663,5,289,0,1015064,64.81,10423056,83.479,45.3,20.396,24574.382,175.695,4.55,0.87,0
77,162,169,11832,1,290,0,1066305,64.81,10423056,83.479,45.3,20.396,24574.382,175.695,4.55,0.87,0
77,163,248,12080,3,293,0,1066305,64.81,10423056,83.479,45.3,20.396,24574.382,175.695,4.55,0.87,0
77,164,372,12452,4,297,0,1094354,64.81,10423056,83.479,45.3,20.396,24574.382,175.695,4.55,0.87,0
77,165,282,12734,3,300,0,1094354,64.81,10423056,83.479,45.3,20.396,24574.382,175.695,4.55,0.87,0
77,166,302,13036,2,302,0,1125882,64.81,10423056,83.479,45.3,20.396,24574.382,175.695,4.55,0.87,0
77,167,204,13240,3,305,7145,1133027,53.7,10423056,83.479,45.3,20.396,24574.382,175.695,4.55,0.87,0
77,168,180,13420,5,310,0,1133027,53.7,10423056,83.479,45.3,20.396,24574.382,175.695,4.55,0.87,0
77,169,310,13730,3,313,0,1157897,53.7,10423056,83.479,45.3,20.396,24574.382,175.695,4.55,0.87,0
77,170,311,14041,3,316,0,1157897,53.7,10423056,83.479,45.3,20.396,24574.382,175.695,4.55,0.87,0
77,171,359,14400,9,325,0,1181712,50.93,10423056,83.479,45.3,20.396,24574.382,175.695,4.55,0.87,0
77,172,338,14738,2,327,12301,1194013,50.93,10423056,83.479,45.3,20.396,24574.382,175.695,4.55,0.87,0
77,173,240,14978,4,331,8200,1202213,50.93,10423056,83.479,45.3,20.396,24574.382,175.695,4.55,0.87,0
77,174,164,15142,7,338,7905,1210118,50.93,10423056,83.479,45.3,20.396,24574.382,175.695,4.55,0.87,0
77,175,453,15595,6,344,10899,1221017,50.93,10423056,83.479,45.3,20.396,24574.382,175.695,4.55,0.87,0
77,176,333,15928,8,352,12212,1233229,50.93,10423056,83.479,45.3,20.396,24574.382,175.695,4.55,0.87,0
77,177,358,16286,5,357,13134,1246363,50.93,10423056,83.479,45.3,20.396,24574.382,175.695,4.55,0.87,0
77,178,341,16627,9,366,10073,1256436,50.93,10423056,83.479,45.3,20.396,24574.382,175.695,4.55,0.87,0
77,179,286,16913,3,369,12619,1269055,50.93,10423056,83.479,45.3,20.396,24574.382,175.695,4.55,0.87,0
77,180,315,17228,7,376,9532,1278587,50.93,10423056,83.479,45.3,20.396,24574.382,175.695,4.55,0.87,0
77,181,216,17444,3,379,6107,1284694,50.93,10423056,83.479,45.3,20.396,24574.382,175.695,4.55,0.87,0
77,182,263,17707,4,383,12101,1296795,46.76,10423056,83.479,45.3,20.396,24574.382,175.695,4.55,0.87,0
77,183,416,18123,5,388,10754,1307549,46.76,10423056,83.479,45.3,20.396,24574.382,175.695,4.55,0.87,0
77,184,352,18475,3,391,10787,1318336,46.76,10423056,83.479,45.3,20.396,24574.382,175.695,4.55,0.87,0
77,185,411,18886,2,393,9706,1328042,46.76,10423056,83.479,45.3,20.396,24574.382,175.695,4.55,0.87,0
77,186,460,19346,5,398,11622,1339664,46.76,10423056,83.479,45.3,20.396,24574.382,175.695,4.55,0.87,0
77,187,267,19613,7,405,9459,1349123,46.76,10423056,83.479,45.3,20.396,24574.382,175.695,4.55,0.87,0
77,188,229,19842,4,409,6003,1355126,46.76,10423056,83.479,45.3,20.396,24574.382,175.695,4.55,0.87,0
77,189,300,20142,8,417,12105,1367231,46.76,10423056,83.479,45.3,20.396,24574.382,175.695,4.55,0.87,0
77,190,399,20541,3,420,11805,1379036,46.76,10423056,83.479,45.3,20.396,24574.382,175.695,4.55,0.87,0
77,191,406,20947,4,424,11234,1390270,46.76,10423056,83.479,45.3,20.396,24574.382,175.695,4.55,0.87,0
77,192,434,21381,6,430,10587,1400857,46.76,10423056,83.479,45.3,20.396,24574.382,175.695,4.55,0.87,0
77,193,391,21772,1,431,12981,1413838,46.76,10423056,83.479,45.3,20.396,24574.382,175.695,4.55,0.87,0
77,194,306,22078,5,436,9162,1423000,46.76,10423056,83.479,45.3,20.396,24574.382,175.695,4.55,0.87,0
77,195,280,22358,13,449,6670,1429670,46.76,10423056,83.479,45.3,20.396,24574.382,175.695,4.55,0.87,0
77,196,294,22652,7,456,19561,1449231,46.76,10423056,83.479,45.3,20.396,24574.382,175.695,4.55,0.87,0
77,197,408,23060,6,462,20126,1469357,46.76,10423056,83.479,45.3,20.396,24574.382,175.695,4.55,0.87,0
77,198,435,23495,7,469,19856,1489213,46.76,10423056,83.479,45.3,20.396,24574.382,175.695,4.55,0.87,0
77,199,452,23947,13,482,19247,1508460,46.76,10423056,83.479,45.3,20.396,24574.382,175.695,4.55,0.87,0
77,200,503,24450,8,490,18798,1527258,46.76,10423056,83.479,45.3,20.396,24574.382,175.695,4.55,0.87,0
77,201,482,24932,10,500,14898,1542156,46.76,10423056,83.479,45.3,20.396,24574.382,175.695,4.55,0.87,0
77,202,438,25370,9,509,0,1542156,46.76,10423056,83.479,45.3,20.396,24574.382,175.695,4.55,0.87,0
77,203,432,25802,11,520,0,1542156,46.76,10423056,83.479,45.3,20.396,24574.382,175.695,4.55,0.87,0
77,204,667,26469,8,528,0,1542156,46.76,10423056,83.479,45.3,20.396,24574.382,175.695,4.55,0.87,0
79,1,0,9,0,0,0,0,0,112519,317.132,29.4,7.304,13593.877,243.964,10.71,0.772,0
79,2,1,10,0,0,0,0,0,112519,317.132,29.4,7.304,13593.877,243.964,10.71,0.772,0
79,3,0,10,0,0,0,0,0,112519,317.132,29.4,7.304,13593.877,243.964,10.71,0.772,0
79,4,2,12,0,0,0,0,0,112519,317.132,29.4,7.304,13593.877,243.964,10.71,0.772,0
79,5,0,12,0,0,0,0,0,112519,317.132,29.4,7.304,13593.877,243.964,10.71,0.772,0
79,6,0,12,0,0,0,0,0,112519,317.132,29.4,7.304,13593.877,243.964,10.71,0.772,0
79,7,0,12,0,0,0,0,0,112519,317.132,29.4,7.304,13593.877,243.964,10.71,0.772,0
79,8,0,12,0,0,0,0,0,112519,317.132,29.4,7.304,13593.877,243.964,10.71,0.772,0
79,9,0,12,0,0,0,0,0,112519,317.132,29.4,7.304,13593.877,243.964,10.71,0.772,0
79,10,0,12,0,0,0,0,0,112519,317.132,29.4,7.304,13593.877,243.964,10.71,0.772,0
79,11,2,14,0,0,0,0,0,112519,317.132,29.4,7.304,13593.877,243.964,10.71,0.772,0
79,12,0,14,0,0,0,0,0,112519,317.132,29.4,7.304,13593.877,243.964,10.71,0.772,0
79,13,0,14,0,0,0,0,0,112519,317.132,29.4,7.304,13593.877,243.964,10.71,0.772,0
79,14,0,14,0,0,0,0,0,112519,317.132,29.4,7.304,13593.877,243.964,10.71,0.772,0
79,15,0,14,0,0,0,0,0,112519,317.132,29.4,7.304,13593.877,243.964,10.71,0.772,0
79,16,0,14,0,0,0,0,0,112519,317.132,29.4,7.304,13593.877,243.964,10.71,0.772,0
79,17,0,14,0,0,0,0,0,112519,317.132,29.4,7.304,13593.877,243.964,10.71,0.772,0
79,18,0,14,0,0,0,0,0,112519,317.132,29.4,7.304,13593.877,243.964,10.71,0.772,0
79,19,0,14,0,0,0,0,0,112519,317.132,29.4,7.304,13593.877,243.964,10.71,0.772,0
79,20,0,14,0,0,0,0,0,112519,317.132,29.4,7.304,13593.877,243.964,10.71,0.772,0
79,21,0,14,0,0,0,0,0,112519,317.132,29.4,7.304,13593.877,243.964,10.71,0.772,0
79,22,0,14,0,0,0,0,0,112519,317.132,29.4,7.304,13593.877,243.964,10.71,0.772,0
79,23,1,15,0,0,0,0,0,112519,317.132,29.4,7.304,13593.877,243.964,10.71,0.772,0
79,24,0,15,0,0,0,0,0,112519,317.132,29.4,7.304,13593.877,243.964,10.71,0.772,0
79,25,0,15,0,0,0,0,0,112519,317.132,29.4,7.304,13593.877,243.964,10.71,0.772,0
79,26,3,18,0,0,0,0,0,112519,317.132,29.4,7.304,13593.877,243.964,10.71,0.772,0
79,27,0,18,0,0,0,0,0,112519,317.132,29.4,7.304,13593.877,243.964,10.71,0.772,0
79,28,0,18,0,0,0,0,0,112519,317.132,29.4,7.304,13593.877,243.964,10.71,0.772,0
79,29,0,18,0,0,0,0,0,112519,317.132,29.4,7.304,13593.877,243.964,10.71,0.772,0
79,30,2,20,0,0,0,0,0,112519,317.132,29.4,7.304,13593.877,243.964,10.71,0.772,0
79,31,0,20,0,0,0,0,0,112519,317.132,29.4,7.304,13593.877,243.964,10.71,0.772,0
79,32,0,20,0,0,0,0,0,112519,317.132,29.4,7.304,13593.877,243.964,10.71,0.772,0
79,33,1,21,0,0,0,0,0,112519,317.132,29.4,7.304,13593.877,243.964,10.71,0.772,0
79,34,0,21,0,0,0,0,0,112519,317.132,29.4,7.304,13593.877,243.964,10.71,0.772,0
79,35,0,21,0,0,0,0,0,112519,317.132,29.4,7.304,13593.877,243.964,10.71,0.772,0
79,36,0,21,0,0,0,0,0,112519,317.132,29.4,7.304,13593.877,243.964,10.71,0.772,0
79,37,0,21,0,0,0,0,0,112519,317.132,29.4,7.304,13593.877,243.964,10.71,0.772,0
79,38,0,21,0,0,0,0,0,112519,317.132,29.4,7.304,13593.877,243.964,10.71,0.772,0
79,39,0,21,0,0,0,0,0,112519,317.132,29.4,7.304,13593.877,243.964,10.71,0.772,0
79,40,0,21,0,0,0,0,0,112519,317.132,29.4,7.304,13593.877,243.964,10.71,0.772,0
79,41,0,21,0,0,0,0,0,112519,317.132,29.4,7.304,13593.877,243.964,10.71,0.772,0
79,42,0,21,0,0,0,0,0,112519,317.132,29.4,7.304,13593.877,243.964,10.71,0.772,0
79,43,0,21,0,0,0,0,0,112519,317.132,29.4,7.304,13593.877,243.964,10.71,0.772,0
79,44,0,21,0,0,0,0,0,112519,317.132,29.4,7.304,13593.877,243.964,10.71,0.772,0
79,45,0,21,0,0,0,0,0,112519,317.132,29.4,7.304,13593.877,243.964,10.71,0.772,0
79,46,1,22,0,0,0,0,0,112519,317.132,29.4,7.304,13593.877,243.964,10.71,0.772,0
79,47,0,22,0,0,0,0,0,112519,317.132,29.4,7.304,13593.877,243.964,10.71,0.772,0
79,48,0,22,0,0,0,0,0,112519,317.132,29.4,7.304,13593.877,243.964,10.71,0.772,0
79,49,0,22,0,0,0,0,0,112519,317.132,29.4,7.304,13593.877,243.964,10.71,0.772,0
79,50,0,22,0,0,0,0,0,112519,317.132,29.4,7.304,13593.877,243.964,10.71,0.772,0
79,51,0,22,0,0,0,0,0,112519,317.132,29.4,7.304,13593.877,243.964,10.71,0.772,0
79,52,0,22,0,0,0,0,0,112519,317.132,29.4,7.304,13593.877,243.964,10.71,0.772,0
79,53,0,22,0,0,0,0,0,112519,317.132,29.4,7.304,13593.877,243.964,10.71,0.772,0
79,54,0,22,0,0,0,0,0,112519,317.132,29.4,7.304,13593.877,243.964,10.71,0.772,0
79,55,0,22,0,0,0,0,0,112519,317.132,29.4,7.304,13593.877,243.964,10.71,0.772,0
79,56,1,23,0,0,0,0,0,112519,317.132,29.4,7.304,13593.877,243.964,10.71,0.772,0
79,57,0,23,0,0,0,0,0,112519,317.132,29.4,7.304,13593.877,243.964,10.71,0.772,0
79,58,0,23,0,0,0,0,0,112519,317.132,29.4,7.304,13593.877,243.964,10.71,0.772,0
79,59,0,23,0,0,0,0,0,112519,317.132,29.4,7.304,13593.877,243.964,10.71,0.772,0
79,60,0,23,0,0,0,0,0,112519,317.132,29.4,7.304,13593.877,243.964,10.71,0.772,0
79,61,0,23,0,0,0,0,0,112519,317.132,29.4,7.304,13593.877,243.964,10.71,0.772,0
79,62,0,23,0,0,0,0,0,112519,317.132,29.4,7.304,13593.877,243.964,10.71,0.772,0
79,63,0,23,0,0,0,0,0,112519,317.132,29.4,7.304,13593.877,243.964,10.71,0.772,0
79,64,0,23,0,0,0,0,0,112519,317.132,29.4,7.304,13593.877,243.964,10.71,0.772,0
79,65,0,23,0,0,0,0,0,112519,317.132,29.4,7.304,13593.877,243.964,10.71,0.772,0
79,66,0,23,0,0,0,0,0,112519,317.132,29.4,7.304,13593.877,243.964,10.71,0.772,0
79,67,0,23,0,0,0,0,0,112519,317.132,29.4,7.304,13593.877,243.964,10.71,0.772,0
79,68,0,23,0,0,0,0,0,112519,317.132,29.4,7.304,13593.877,243.964,10.71,0.772,0
79,69,0,23,0,0,0,0,0,112519,317.132,29.4,7.304,13593.877,243.964,10.71,0.772,0
79,70,0,23,0,0,0,0,0,112519,317.132,29.4,7.304,13593.877,243.964,10.71,0.772,0
79,71,0,23,0,0,0,0,0,112519,317.132,29.4,7.304,13593.877,243.964,10.71,0.772,0
79,72,0,23,0,0,0,0,0,112519,317.132,29.4,7.304,13593.877,243.964,10.71,0.772,0
79,73,0,23,0,0,0,0,0,112519,317.132,29.4,7.304,13593.877,243.964,10.71,0.772,0
79,74,0,23,0,0,0,0,0,112519,317.132,29.4,7.304,13593.877,243.964,10.71,0.772,0
79,75,0,23,0,0,0,0,0,112519,317.132,29.4,7.304,13593.877,243.964,10.71,0.772,0
79,76,0,23,0,0,0,0,0,112519,317.132,29.4,7.304,13593.877,243.964,10.71,0.772,0
79,77,0,23,0,0,0,0,0,112519,317.132,29.4,7.304,13593.877,243.964,10.71,0.772,0
79,78,0,23,0,0,0,0,0,112519,317.132,29.4,7.304,13593.877,243.964,10.71,0.772,0
79,79,0,23,0,0,0,0,0,112519,317.132,29.4,7.304,13593.877,243.964,10.71,0.772,0
79,80,0,23,0,0,0,0,0,112519,317.132,29.4,7.304,13593.877,243.964,10.71,0.772,0
79,81,0,23,0,0,0,0,0,112519,317.132,29.4,7.304,13593.877,243.964,10.71,0.772,0
79,82,0,23,0,0,0,0,0,112519,317.132,29.4,7.304,13593.877,243.964,10.71,0.772,0
79,83,0,23,0,0,0,0,0,112519,317.132,29.4,7.304,13593.877,243.964,10.71,0.772,0
79,84,0,23,0,0,0,0,0,112519,317.132,29.4,7.304,13593.877,243.964,10.71,0.772,0
79,85,0,23,0,0,0,0,0,112519,317.132,29.4,7.304,13593.877,243.964,10.71,0.772,0
79,86,0,23,0,0,0,0,0,112519,317.132,29.4,7.304,13593.877,243.964,10.71,0.772,0
79,87,0,23,0,0,0,0,0,112519,317.132,29.4,7.304,13593.877,243.964,10.71,0.772,0
79,88,0,23,0,0,0,0,0,112519,317.132,29.4,7.304,13593.877,243.964,10.71,0.772,0
79,89,0,23,0,0,0,0,0,112519,317.132,29.4,7.304,13593.877,243.964,10.71,0.772,0
79,90,0,23,0,0,0,0,0,112519,317.132,29.4,7.304,13593.877,243.964,10.71,0.772,0
79,91,0,23,0,0,0,0,0,112519,317.132,29.4,7.304,13593.877,243.964,10.71,0.772,0
79,92,0,23,0,0,0,0,0,112519,317.132,29.4,7.304,13593.877,243.964,10.71,0.772,0
79,93,0,23,0,0,0,0,0,112519,317.132,29.4,7.304,13593.877,243.964,10.71,0.772,0
79,94,0,23,0,0,0,0,0,112519,317.132,29.4,7.304,13593.877,243.964,10.71,0.772,0
79,95,0,23,0,0,0,0,0,112519,317.132,29.4,7.304,13593.877,243.964,10.71,0.772,0
79,96,0,23,0,0,0,0,0,112519,317.132,29.4,7.304,13593.877,243.964,10.71,0.772,0
79,97,0,23,0,0,0,0,0,112519,317.132,29.4,7.304,13593.877,243.964,10.71,0.772,0
79,98,0,23,0,0,0,0,0,112519,317.132,29.4,7.304,13593.877,243.964,10.71,0.772,0
79,99,0,23,0,0,0,0,0,112519,317.132,29.4,7.304,13593.877,243.964,10.71,0.772,0
79,100,0,23,0,0,0,0,0,112519,317.132,29.4,7.304,13593.877,243.964,10.71,0.772,0
79,101,0,23,0,0,0,0,0,112519,317.132,29.4,7.304,13593.877,243.964,10.71,0.772,0
79,102,0,23,0,0,0,0,0,112519,317.132,29.4,7.304,13593.877,243.964,10.71,0.772,0
79,103,0,23,0,0,0,0,0,112519,317.132,29.4,7.304,13593.877,243.964,10.71,0.772,0
79,104,0,23,0,0,0,0,0,112519,317.132,29.4,7.304,13593.877,243.964,10.71,0.772,0
79,105,0,23,0,0,0,0,0,112519,317.132,29.4,7.304,13593.877,243.964,10.71,0.772,0
79,106,0,23,0,0,0,0,0,112519,317.132,29.4,7.304,13593.877,243.964,10.71,0.772,0
79,107,0,23,0,0,0,0,0,112519,317.132,29.4,7.304,13593.877,243.964,10.71,0.772,0
79,108,0,23,0,0,0,0,0,112519,317.132,29.4,7.304,13593.877,243.964,10.71,0.772,0
79,109,0,23,0,0,0,0,0,112519,317.132,29.4,7.304,13593.877,243.964,10.71,0.772,0
79,110,0,23,0,0,0,0,0,112519,317.132,29.4,7.304,13593.877,243.964,10.71,0.772,0
79,111,0,23,0,0,0,0,0,112519,317.132,29.4,7.304,13593.877,243.964,10.71,0.772,0
79,112,0,23,0,0,0,0,0,112519,317.132,29.4,7.304,13593.877,243.964,10.71,0.772,0
79,113,0,23,0,0,0,0,0,112519,317.132,29.4,7.304,13593.877,243.964,10.71,0.772,0
79,114,0,23,0,0,0,0,0,112519,317.132,29.4,7.304,13593.877,243.964,10.71,0.772,0
79,115,0,23,0,0,0,0,0,112519,317.132,29.4,7.304,13593.877,243.964,10.71,0.772,0
79,116,0,23,0,0,0,0,0,112519,317.132,29.4,7.304,13593.877,243.964,10.71,0.772,0
79,117,0,23,0,0,0,0,0,112519,317.132,29.4,7.304,13593.877,243.964,10.71,0.772,0
79,118,0,23,0,0,0,0,0,112519,317.132,29.4,7.304,13593.877,243.964,10.71,0.772,0
79,119,0,23,0,0,0,0,0,112519,317.132,29.4,7.304,13593.877,243.964,10.71,0.772,0
79,120,0,23,0,0,0,0,0,112519,317.132,29.4,7.304,13593.877,243.964,10.71,0.772,0
79,121,1,24,0,0,0,0,0,112519,317.132,29.4,7.304,13593.877,243.964,10.71,0.772,0
79,122,0,24,0,0,0,0,0,112519,317.132,29.4,7.304,13593.877,243.964,10.71,0.772,0
79,123,0,24,0,0,0,0,0,112519,317.132,29.4,7.304,13593.877,243.964,10.71,0.772,0
79,124,0,24,0,0,0,0,0,112519,317.132,29.4,7.304,13593.877,243.964,10.71,0.772,0
79,125,0,24,0,0,0,0,0,112519,317.132,29.4,7.304,13593.877,243.964,10.71,0.772,0
79,126,0,24,0,0,0,0,0,112519,317.132,29.4,7.304,13593.877,243.964,10.71,0.772,0
79,127,0,24,0,0,0,0,0,112519,317.132,29.4,7.304,13593.877,243.964,10.71,0.772,0
79,128,0,24,0,0,0,0,0,112519,317.132,29.4,7.304,13593.877,243.964,10.71,0.772,0
79,129,0,24,0,0,0,0,0,112519,317.132,29.4,7.304,13593.877,243.964,10.71,0.772,0
79,130,0,24,0,0,0,0,0,112519,317.132,29.4,7.304,13593.877,243.964,10.71,0.772,0
79,131,0,24,0,0,0,0,0,112519,317.132,29.4,7.304,13593.877,243.964,10.71,0.772,0
79,132,0,24,0,0,0,0,0,112519,317.132,29.4,7.304,13593.877,243.964,10.71,0.772,0
79,133,0,24,0,0,0,0,0,112519,317.132,29.4,7.304,13593.877,243.964,10.71,0.772,0
79,134,0,24,0,0,0,0,0,112519,317.132,29.4,7.304,13593.877,243.964,10.71,0.772,0
79,135,0,24,0,0,0,0,0,112519,317.132,29.4,7.304,13593.877,243.964,10.71,0.772,0
79,136,0,24,0,0,0,0,0,112519,317.132,29.4,7.304,13593.877,243.964,10.71,0.772,0
79,137,0,24,0,0,0,0,0,112519,317.132,29.4,7.304,13593.877,243.964,10.71,0.772,0
79,138,0,24,0,0,0,0,0,112519,317.132,29.4,7.304,13593.877,243.964,10.71,0.772,0
79,139,0,24,0,0,0,0,0,112519,317.132,29.4,7.304,13593.877,243.964,10.71,0.772,0
79,140,0,24,0,0,0,0,0,112519,317.132,29.4,7.304,13593.877,243.964,10.71,0.772,0
79,141,0,24,0,0,0,0,0,112519,317.132,29.4,7.304,13593.877,243.964,10.71,0.772,0
79,142,0,24,0,0,0,0,0,112519,317.132,29.4,7.304,13593.877,243.964,10.71,0.772,0
79,143,0,24,0,0,0,0,0,112519,317.132,29.4,7.304,13593.877,243.964,10.71,0.772,0
79,144,0,24,0,0,0,0,0,112519,317.132,29.4,7.304,13593.877,243.964,10.71,0.772,0
79,145,0,24,0,0,0,0,0,112519,317.132,29.4,7.304,13593.877,243.964,10.71,0.772,0
79,146,0,24,0,0,0,0,0,112519,317.132,29.4,7.304,13593.877,243.964,10.71,0.772,0
79,147,0,24,0,0,0,0,0,112519,317.132,29.4,7.304,13593.877,243.964,10.71,0.772,0
79,148,0,24,0,0,0,0,0,112519,317.132,29.4,7.304,13593.877,243.964,10.71,0.772,0
79,149,0,24,0,0,0,0,0,112519,317.132,29.4,7.304,13593.877,243.964,10.71,0.772,0
79,150,0,24,0,0,0,0,0,112519,317.132,29.4,7.304,13593.877,243.964,10.71,0.772,0
79,151,0,24,0,0,0,0,0,112519,317.132,29.4,7.304,13593.877,243.964,10.71,0.772,0
79,152,0,24,0,0,0,0,0,112519,317.132,29.4,7.304,13593.877,243.964,10.71,0.772,0
79,153,0,24,0,0,0,0,0,112519,317.132,29.4,7.304,13593.877,243.964,10.71,0.772,0
79,154,0,24,0,0,0,0,0,112519,317.132,29.4,7.304,13593.877,243.964,10.71,0.772,0
79,155,0,24,0,0,0,0,0,112519,317.132,29.4,7.304,13593.877,243.964,10.71,0.772,0
79,156,0,24,0,0,0,0,0,112519,317.132,29.4,7.304,13593.877,243.964,10.71,0.772,0
79,157,0,24,0,0,0,0,0,112519,317.132,29.4,7.304,13593.877,243.964,10.71,0.772,0
79,158,0,24,0,0,0,0,0,112519,317.132,29.4,7.304,13593.877,243.964,10.71,0.772,0
79,159,0,24,0,0,0,0,0,112519,317.132,29.4,7.304,13593.877,243.964,10.71,0.772,0
79,160,0,24,0,0,0,0,0,112519,317.132,29.4,7.304,13593.877,243.964,10.71,0.772,0
79,161,0,24,0,0,0,0,0,112519,317.132,29.4,7.304,13593.877,243.964,10.71,0.772,0
79,162,0,24,0,0,0,0,0,112519,317.132,29.4,7.304,13593.877,243.964,10.71,0.772,0
79,163,0,24,0,0,0,0,0,112519,317.132,29.4,7.304,13593.877,243.964,10.71,0.772,0
79,164,0,24,0,0,0,0,0,112519,317.132,29.4,7.304,13593.877,243.964,10.71,0.772,0
79,165,0,24,0,0,0,0,0,112519,317.132,29.4,7.304,13593.877,243.964,10.71,0.772,0
79,166,0,24,0,0,0,0,0,112519,317.132,29.4,7.304,13593.877,243.964,10.71,0.772,0
79,167,0,24,0,0,0,0,0,112519,317.132,29.4,7.304,13593.877,243.964,10.71,0.772,0
79,168,0,24,0,0,0,0,0,112519,317.132,29.4,7.304,13593.877,243.964,10.71,0.772,0
79,169,0,24,0,0,0,0,0,112519,317.132,29.4,7.304,13593.877,243.964,10.71,0.772,0
79,170,0,24,0,0,0,0,0,112519,317.132,29.4,7.304,13593.877,243.964,10.71,0.772,0
79,171,0,24,0,0,0,0,0,112519,317.132,29.4,7.304,13593.877,243.964,10.71,0.772,0
79,172,0,24,0,0,0,0,0,112519,317.132,29.4,7.304,13593.877,243.964,10.71,0.772,0
79,173,0,24,0,0,0,0,0,112519,317.132,29.4,7.304,13593.877,243.964,10.71,0.772,0
79,174,0,24,0,0,0,0,0,112519,317.132,29.4,7.304,13593.877,243.964,10.71,0.772,0
79,175,0,24,0,0,0,0,0,112519,317.132,29.4,7.304,13593.877,243.964,10.71,0.772,0
79,176,0,24,0,0,0,0,0,112519,317.132,29.4,7.304,13593.877,243.964,10.71,0.772,0
79,177,0,24,0,0,0,0,0,112519,317.132,29.4,7.304,13593.877,243.964,10.71,0.772,0
79,178,0,24,0,0,0,0,0,112519,317.132,29.4,7.304,13593.877,243.964,10.71,0.772,0
79,179,0,24,0,0,0,0,0,112519,317.132,29.4,7.304,13593.877,243.964,10.71,0.772,0
79,180,0,24,0,0,0,0,0,112519,317.132,29.4,7.304,13593.877,243.964,10.71,0.772,0
79,181,0,24,0,0,0,0,0,112519,317.132,29.4,7.304,13593.877,243.964,10.71,0.772,0
79,182,0,24,0,0,0,0,0,112519,317.132,29.4,7.304,13593.877,243.964,10.71,0.772,0
79,183,0,24,0,0,0,0,0,112519,317.132,29.4,7.304,13593.877,243.964,10.71,0.772,0
79,184,0,24,0,0,0,0,0,112519,317.132,29.4,7.304,13593.877,243.964,10.71,0.772,0
79,185,0,24,0,0,0,0,0,112519,317.132,29.4,7.304,13593.877,243.964,10.71,0.772,0
79,186,0,24,0,0,0,0,0,112519,317.132,29.4,7.304,13593.877,243.964,10.71,0.772,0
79,187,0,24,0,0,0,0,0,112519,317.132,29.4,7.304,13593.877,243.964,10.71,0.772,0
79,188,0,24,0,0,0,0,0,112519,317.132,29.4,7.304,13593.877,243.964,10.71,0.772,0
79,189,0,24,0,0,0,0,0,112519,317.132,29.4,7.304,13593.877,243.964,10.71,0.772,0
79,190,0,24,0,0,0,0,0,112519,317.132,29.4,7.304,13593.877,243.964,10.71,0.772,0
79,191,0,24,0,0,0,0,0,112519,317.132,29.4,7.304,13593.877,243.964,10.71,0.772,0
79,192,0,24,0,0,0,0,0,112519,317.132,29.4,7.304,13593.877,243.964,10.71,0.772,0
79,193,0,24,0,0,0,0,0,112519,317.132,29.4,7.304,13593.877,243.964,10.71,0.772,0
79,194,0,24,0,0,0,0,0,112519,317.132,29.4,7.304,13593.877,243.964,10.71,0.772,0
79,195,0,24,0,0,0,0,0,112519,317.132,29.4,7.304,13593.877,243.964,10.71,0.772,0
79,196,1,25,0,0,0,0,0,112519,317.132,29.4,7.304,13593.877,243.964,10.71,0.772,0
79,197,0,25,0,0,0,0,0,112519,317.132,29.4,7.304,13593.877,243.964,10.71,0.772,0
79,198,0,25,0,0,0,0,0,112519,317.132,29.4,7.304,13593.877,243.964,10.71,0.772,0
79,199,0,25,0,0,0,0,0,112519,317.132,29.4,7.304,13593.877,243.964,10.71,0.772,0
79,200,0,25,0,0,0,0,0,112519,317.132,29.4,7.304,13593.877,243.964,10.71,0.772,0
79,201,2,27,0,0,0,0,0,112519,317.132,29.4,7.304,13593.877,243.964,10.71,0.772,0
79,202,0,27,0,0,0,0,0,112519,317.132,29.4,7.304,13593.877,243.964,10.71,0.772,0
79,203,0,27,0,0,0,0,0,112519,317.132,29.4,7.304,13593.877,243.964,10.71,0.772,0
79,204,0,27,0,0,0,0,0,112519,317.132,29.4,7.304,13593.877,243.964,10.71,0.772,0
81,1,2,38,0,1,40,934,93.52,17915567,157.834,22.9,4.694,7423.808,155.898,10.18,0.65,0
81,2,8,46,0,1,46,980,93.52,17915567,157.834,22.9,4.694,7423.808,155.898,10.18,0.65,0
81,3,1,47,0,1,73,1053,93.52,17915567,157.834,22.9,4.694,7423.808,155.898,10.18,0.65,0
81,4,3,50,0,1,21,1074,93.52,17915567,157.834,22.9,4.694,7423.808,155.898,10.18,0.65,0
81,5,11,61,1,2,55,1129,93.52,17915567,157.834,22.9,4.694,7423.808,155.898,10.18,0.65,0
81,6,9,70,1,3,66,1195,93.52,17915567,157.834,22.9,4.694,7423.808,155.898,10.18,0.65,0
81,7,4,74,0,3,64,1259,93.52,17915567,157.834,22.9,4.694,7423.808,155.898,10.18,0.65,0
81,8,6,80,0,3,178,1437,93.52,17915567,157.834,22.9,4.694,7423.808,155.898,10.18,0.65,0
81,9,7,87,0,3,48,1485,93.52,17915567,157.834,22.9,4.694,7423.808,155.898,10.18,0.65,0
81,10,39,126,0,3,39,1524,93.52,17915567,157.834,22.9,4.694,7423.808,155.898,10.18,0.65,0
81,11,11,137,0,3,271,1795,93.52,17915567,157.834,22.9,4.694,7423.808,155.898,10.18,0.65,0
81,12,16,153,0,3,87,1882,93.52,17915567,157.834,22.9,4.694,7423.808,155.898,10.18,0.65,0
81,13,3,156,2,5,80,1962,93.52,17915567,157.834,22.9,4.694,7423.808,155.898,10.18,0.65,0
81,14,11,167,0,5,51,2013,93.52,17915567,157.834,22.9,4.694,7423.808,155.898,10.18,0.65,0
81,15,13,180,0,5,275,2288,93.52,17915567,157.834,22.9,4.694,7423.808,155.898,10.18,0.65,0
81,16,16,196,0,5,269,2557,93.52,17915567,157.834,22.9,4.694,7423.808,155.898,10.18,0.65,0
81,17,18,214,2,7,78,2635,93.52,17915567,157.834,22.9,4.694,7423.808,155.898,10.18,0.65,0
81,18,21,235,0,7,131,2766,96.3,17915567,157.834,22.9,4.694,7423.808,155.898,10.18,0.65,0
81,19,22,257,0,7,249,3015,96.3,17915567,157.834,22.9,4.694,7423.808,155.898,10.18,0.65,0
81,20,32,289,0,7,101,3116,96.3,17915567,157.834,22.9,4.694,7423.808,155.898,10.18,0.65,0
81,21,5,294,0,7,424,3540,96.3,17915567,157.834,22.9,4.694,7423.808,155.898,10.18,0.65,0
81,22,22,316,1,8,137,3677,96.3,17915567,157.834,22.9,4.694,7423.808,155.898,10.18,0.65,0
81,23,26,342,2,10,345,4022,96.3,17915567,157.834,22.9,4.694,7423.808,155.898,10.18,0.65,0
81,24,42,384,1,11,79,4101,96.3,17915567,157.834,22.9,4.694,7423.808,155.898,10.18,0.65,0
81,25,46,430,0,11,416,4517,96.3,17915567,157.834,22.9,4.694,7423.808,155.898,10.18,0.65,0
81,26,43,473,2,13,146,4663,96.3,17915567,157.834,22.9,4.694,7423.808,155.898,10.18,0.65,0
81,27,27,500,2,15,214,4877,96.3,17915567,157.834,22.9,4.694,7423.808,155.898,10.18,0.65,0
81,28,30,530,0,15,266,5143,96.3,17915567,157.834,22.9,4.694,7423.808,155.898,10.18,0.65,0
81,29,27,557,1,16,254,5397,96.3,17915567,157.834,22.9,4.694,7423.808,155.898,10.18,0.65,0
81,30,28,585,0,16,199,5596,96.3,17915567,157.834,22.9,4.694,7423.808,155.898,10.18,0.65,0
81,31,14,599,0,16,392,5988,96.3,17915567,157.834,22.9,4.694,7423.808,155.898,10.18,0.65,0
81,32,45,644,0,16,90,6078,96.3,17915567,157.834,22.9,4.694,7423.808,155.898,10.18,0.65,0
81,33,44,688,1,17,96,6174,96.3,17915567,157.834,22.9,4.694,7423.808,155.898,10.18,0.65,0
81,34,15,703,0,17,219,6393,96.3,17915567,157.834,22.9,4.694,7423.808,155.898,10.18,0.65,0
81,35,27,730,2,19,270,6663,96.3,17915567,157.834,22.9,4.694,7423.808,155.898,10.18,0.65,0
81,36,33,763,0,19,292,6955,96.3,17915567,157.834,22.9,4.694,7423.808,155.898,10.18,0.65,0
81,37,35,798,2,21,470,7425,96.3,17915567,157.834,22.9,4.694,7423.808,155.898,10.18,0.65,0
81,38,34,832,2,23,410,7835,96.3,17915567,157.834,22.9,4.694,7423.808,155.898,10.18,0.65,0
81,39,68,900,1,24,660,8495,96.3,17915567,157.834,22.9,4.694,7423.808,155.898,10.18,0.65,0
81,40,67,967,0,24,252,8747,96.3,17915567,157.834,22.9,4.694,7423.808,155.898,10.18,0.65,0
81,41,85,1052,2,26,209,8956,96.3,17915567,157.834,22.9,4.694,7423.808,155.898,10.18,0.65,0
81,42,62,1114,0,26,396,9352,96.3,17915567,157.834,22.9,4.694,7423.808,155.898,10.18,0.65,0
81,43,85,1199,1,27,634,9986,96.3,17915567,157.834,22.9,4.694,7423.808,155.898,10.18,0.65,0
81,44,143,1342,2,29,600,10586,96.3,17915567,157.834,22.9,4.694,7423.808,155.898,10.18,0.65,0
81,45,176,1518,0,29,762,11348,96.3,17915567,157.834,22.9,4.694,7423.808,155.898,10.18,0.65,0
81,46,125,1643,1,30,593,11941,96.3,17915567,157.834,22.9,4.694,7423.808,155.898,10.18,0.65,0
81,47,120,1763,3,33,340,12281,96.3,17915567,157.834,22.9,4.694,7423.808,155.898,10.18,0.65,0
81,48,149,1912,2,35,851,13132,96.3,17915567,157.834,22.9,4.694,7423.808,155.898,10.18,0.65,0
81,49,89,2001,3,38,694,13826,96.3,17915567,157.834,22.9,4.694,7423.808,155.898,10.18,0.65,0
81,50,132,2133,5,43,641,14467,96.3,17915567,157.834,22.9,4.694,7423.808,155.898,10.18,0.65,0
81,51,132,2265,2,45,1141,15608,96.3,17915567,157.834,22.9,4.694,7423.808,155.898,10.18,0.65,0
81,52,247,2512,3,48,1002,16610,96.3,17915567,157.834,22.9,4.694,7423.808,155.898,10.18,0.65,0
81,53,231,2743,3,51,959,17569,96.3,17915567,157.834,22.9,4.694,7423.808,155.898,10.18,0.65,0
81,54,311,3054,4,55,608,18177,96.3,17915567,157.834,22.9,4.694,7423.808,155.898,10.18,0.65,0
81,55,370,3424,3,58,675,18852,96.3,17915567,157.834,22.9,4.694,7423.808,155.898,10.18,0.65,0
81,56,336,3760,1,59,1001,19853,96.3,17915567,157.834,22.9,4.694,7423.808,155.898,10.18,0.65,0
81,57,194,3954,4,63,1071,20924,96.3,17915567,157.834,22.9,4.694,7423.808,155.898,10.18,0.65,0
81,58,191,4145,5,68,776,21700,96.3,17915567,157.834,22.9,4.694,7423.808,155.898,10.18,0.65,0
81,59,203,4348,12,80,712,22412,96.3,17915567,157.834,22.9,4.694,7423.808,155.898,10.18,0.65,0
81,60,259,4607,10,90,568,22980,96.3,17915567,157.834,22.9,4.694,7423.808,155.898,10.18,0.65,0
81,61,132,4739,12,102,459,23439,96.3,17915567,157.834,22.9,4.694,7423.808,155.898,10.18,0.65,0
81,62,348,5087,6,108,755,24194,96.3,17915567,157.834,22.9,4.694,7423.808,155.898,10.18,0.65,0
81,63,249,5336,8,116,548,24742,96.3,17915567,157.834,22.9,4.694,7423.808,155.898,10.18,0.65,0
81,64,250,5586,7,123,640,25382,96.3,17915567,157.834,22.9,4.694,7423.808,155.898,10.18,0.65,0
81,65,174,5760,20,143,888,26270,96.3,17915567,157.834,22.9,4.694,7423.808,155.898,10.18,0.65,0
81,66,394,6154,15,158,935,27205,96.3,17915567,157.834,22.9,4.694,7423.808,155.898,10.18,0.65,0
81,67,331,6485,58,216,557,27762,96.3,17915567,157.834,22.9,4.694,7423.808,155.898,10.18,0.65,0
81,68,307,6792,14,230,726,28488,96.3,17915567,157.834,22.9,4.694,7423.808,155.898,10.18,0.65,0
81,69,263,7055,22,252,1141,29629,96.3,17915567,157.834,22.9,4.694,7423.808,155.898,10.18,0.65,0
81,70,447,7502,15,267,730,30359,96.3,17915567,157.834,22.9,4.694,7423.808,155.898,10.18,0.65,0
81,71,364,7866,22,289,873,31232,96.3,17915567,157.834,22.9,4.694,7423.808,155.898,10.18,0.65,0
81,72,355,8221,27,316,466,31698,96.3,17915567,157.834,22.9,4.694,7423.808,155.898,10.18,0.65,0
81,73,340,8561,18,334,922,32620,96.3,17915567,157.834,22.9,4.694,7423.808,155.898,10.18,0.65,0
81,74,421,8982,17,351,409,33029,96.3,17915567,157.834,22.9,4.694,7423.808,155.898,10.18,0.65,0
81,75,509,9491,16,367,716,33745,96.3,17915567,157.834,22.9,4.694,7423.808,155.898,10.18,0.65,0
81,76,354,9845,17,384,1626,35371,96.3,17915567,157.834,22.9,4.694,7423.808,155.898,10.18,0.65,0
81,77,427,10272,15,399,1434,36805,96.3,17915567,157.834,22.9,4.694,7423.808,155.898,10.18,0.65,0
81,78,434,10706,19,418,1543,38348,96.3,17915567,157.834,22.9,4.694,7423.808,155.898,10.18,0.65,0
81,79,545,11251,14,432,1904,40252,96.3,17915567,157.834,22.9,4.694,7423.808,155.898,10.18,0.65,0
81,80,617,11868,17,449,1328,41580,96.3,17915567,157.834,22.9,4.694,7423.808,155.898,10.18,0.65,0
81,81,641,12509,34,483,591,42171,96.3,17915567,157.834,22.9,4.694,7423.808,155.898,10.18,0.65,0
81,82,246,12755,31,514,884,43055,96.3,17915567,157.834,22.9,4.694,7423.808,155.898,10.18,0.65,0
81,83,390,13145,17,531,1651,44706,96.3,17915567,157.834,22.9,4.694,7423.808,155.898,10.18,0.65,0
81,84,624,13769,16,547,1732,46438,96.3,17915567,157.834,22.9,4.694,7423.808,155.898,10.18,0.65,0
81,85,771,14540,35,582,1011,47449,96.3,17915567,157.834,22.9,4.694,7423.808,155.898,10.18,0.65,0
81,86,279,14819,19,601,2272,49721,96.3,17915567,157.834,22.9,4.694,7423.808,155.898,10.18,0.65,0
81,87,800,15619,22,623,1945,51666,96.3,17915567,157.834,22.9,4.694,7423.808,155.898,10.18,0.65,0
81,88,209,15828,49,672,1400,53066,96.3,17915567,157.834,22.9,4.694,7423.808,155.898,10.18,0.65,0
81,89,569,16397,34,706,795,53861,96.3,17915567,157.834,22.9,4.694,7423.808,155.898,10.18,0.65,0
81,90,533,16930,21,727,1655,55516,96.3,17915567,157.834,22.9,4.694,7423.808,155.898,10.18,0.65,0
81,91,479,17409,19,746,2750,58266,96.3,17915567,157.834,22.9,4.694,7423.808,155.898,10.18,0.65,0
81,92,687,18096,27,773,2792,61058,96.3,17915567,157.834,22.9,4.694,7423.808,155.898,10.18,0.65,0
81,93,915,19011,44,817,3298,64356,96.3,17915567,157.834,22.9,4.694,7423.808,155.898,10.18,0.65,0
81,94,1061,20072,26,843,3634,67990,96.3,17915567,157.834,22.9,4.694,7423.808,155.898,10.18,0.65,0
81,95,1221,21293,37,880,2906,70896,96.3,17915567,157.834,22.9,4.694,7423.808,155.898,10.18,0.65,0
81,96,1208,22501,40,920,2265,73161,96.3,17915567,157.834,22.9,4.694,7423.808,155.898,10.18,0.65,0
81,97,747,23248,27,947,2909,76070,96.3,17915567,157.834,22.9,4.694,7423.808,155.898,10.18,0.65,0
81,98,724,23972,34,981,1760,77830,96.3,17915567,157.834,22.9,4.694,7423.808,155.898,10.18,0.65,0
81,99,815,24787,23,1004,3331,81161,96.3,17915567,157.834,22.9,4.694,7423.808,155.898,10.18,0.65,0
81,100,624,25411,49,1053,2946,84107,96.3,17915567,157.834,22.9,4.694,7423.808,155.898,10.18,0.65,0
81,101,1247,26658,39,1092,2908,87015,96.3,17915567,157.834,22.9,4.694,7423.808,155.898,10.18,0.65,0
81,102,961,27619,47,1139,1802,88817,96.3,17915567,157.834,22.9,4.694,7423.808,155.898,10.18,0.65,0
81,103,979,28598,33,1172,1166,89983,96.3,17915567,157.834,22.9,4.694,7423.808,155.898,10.18,0.65,0
81,104,757,29355,47,1219,3200,93183,96.3,17915567,157.834,22.9,4.694,7423.808,155.898,10.18,0.65,0
81,105,387,29742,25,1244,3200,96383,96.3,17915567,157.834,22.9,4.694,7423.808,155.898,10.18,0.65,0
81,106,1130,30872,58,1302,3246,99629,96.3,17915567,157.834,22.9,4.694,7423.808,155.898,10.18,0.65,0
81,107,1202,32074,48,1350,3383,103012,96.3,17915567,157.834,22.9,4.694,7423.808,155.898,10.18,0.65,0
81,108,865,32939,54,1404,3461,106473,96.3,17915567,157.834,22.9,4.694,7423.808,155.898,10.18,0.65,0
81,109,870,33809,39,1443,1983,108456,96.3,17915567,157.834,22.9,4.694,7423.808,155.898,10.18,0.65,0
81,110,4233,38042,6,1449,1109,109565,96.3,17915567,157.834,22.9,4.694,7423.808,155.898,10.18,0.65,0
81,111,635,38677,36,1485,3891,113456,96.3,17915567,157.834,22.9,4.694,7423.808,155.898,10.18,0.65,0
81,112,362,39039,17,1502,4097,117553,96.3,17915567,157.834,22.9,4.694,7423.808,155.898,10.18,0.65,0
81,113,1190,40229,29,1531,3445,120998,96.3,17915567,157.834,22.9,4.694,7423.808,155.898,10.18,0.65,0
81,114,906,41135,42,1573,3164,124162,96.3,17915567,157.834,22.9,4.694,7423.808,155.898,10.18,0.65,0
81,115,1057,42192,59,1632,3877,128039,96.3,17915567,157.834,22.9,4.694,7423.808,155.898,10.18,0.65,0
81,116,1091,43283,37,1669,1886,129925,96.3,17915567,157.834,22.9,4.694,7423.808,155.898,10.18,0.65,0
81,117,1209,44492,0,1669,545,130470,96.3,17915567,157.834,22.9,4.694,7423.808,155.898,10.18,0.65,0
81,118,561,45053,65,1734,3832,134302,87.04,17915567,157.834,22.9,4.694,7423.808,155.898,10.18,0.65,0
81,119,0,45053,0,1734,3844,138146,87.04,17915567,157.834,22.9,4.694,7423.808,155.898,10.18,0.65,0
81,120,6,45059,27,1761,4287,142433,87.04,17915567,157.834,22.9,4.694,7423.808,155.898,10.18,0.65,0
81,121,2546,47605,74,1835,4117,146550,87.04,17915567,157.834,22.9,4.694,7423.808,155.898,10.18,0.65,0
81,122,1221,48826,32,1867,3856,150406,87.04,17915567,157.834,22.9,4.694,7423.808,155.898,10.18,0.65,0
81,123,963,49789,57,1924,1477,151883,87.04,17915567,157.834,22.9,4.694,7423.808,155.898,10.18,0.65,0
81,124,1190,50979,35,1959,574,152457,87.04,17915567,157.834,22.9,4.694,7423.808,155.898,10.18,0.65,0
81,125,327,51306,36,1995,3209,155666,87.04,17915567,157.834,22.9,4.694,7423.808,155.898,10.18,0.65,0
81,126,236,51542,18,2013,3931,159597,87.04,17915567,157.834,22.9,4.694,7423.808,155.898,10.18,0.65,0
81,127,823,52365,24,2037,3419,163016,87.04,17915567,157.834,22.9,4.694,7423.808,155.898,10.18,0.65,0
81,128,1144,53509,35,2072,3529,166545,87.04,17915567,157.834,22.9,4.694,7423.808,155.898,10.18,0.65,0
81,129,830,54339,47,2119,3406,169951,87.04,17915567,157.834,22.9,4.694,7423.808,155.898,10.18,0.65,0
81,130,931,55270,49,2168,1763,171714,87.04,17915567,157.834,22.9,4.694,7423.808,155.898,10.18,0.65,0
81,131,919,56189,29,2197,830,172544,87.04,17915567,157.834,22.9,4.694,7423.808,155.898,10.18,0.65,0
81,132,416,56605,14,2211,3817,176361,87.04,17915567,157.834,22.9,4.694,7423.808,155.898,10.18,0.65,0
81,133,382,56987,11,2222,4463,180824,87.04,17915567,157.834,22.9,4.694,7423.808,155.898,10.18,0.65,0
81,134,979,57966,11,2233,4245,185069,87.04,17915567,157.834,22.9,4.694,7423.808,155.898,10.18,0.65,0
81,135,1123,59089,34,2267,4400,189469,87.04,17915567,157.834,22.9,4.694,7423.808,155.898,10.18,0.65,0
81,136,1195,60284,29,2296,3913,193382,87.04,17915567,157.834,22.9,4.694,7423.808,155.898,10.18,0.65,0
81,137,1144,61428,45,2341,937,194319,87.04,17915567,157.834,22.9,4.694,7423.808,155.898,10.18,0.65,0
81,138,885,62313,14,2355,763,195082,87.04,17915567,157.834,22.9,4.694,7423.808,155.898,10.18,0.65,0
81,139,249,62562,24,2379,3921,199003,87.04,17915567,157.834,22.9,4.694,7423.808,155.898,10.18,0.65,0
81,140,382,62944,10,2389,4250,203253,87.04,17915567,157.834,22.9,4.694,7423.808,155.898,10.18,0.65,0
81,141,903,63847,30,2419,4382,207635,87.04,17915567,157.834,22.9,4.694,7423.808,155.898,10.18,0.65,0
81,142,1034,64881,48,2467,3919,211554,87.04,17915567,157.834,22.9,4.694,7423.808,155.898,10.18,0.65,0
81,143,1102,65983,39,2506,3464,215018,87.04,17915567,157.834,22.9,4.694,7423.808,155.898,10.18,0.65,0
81,144,958,66941,26,2532,1121,216139,87.04,17915567,157.834,22.9,4.694,7423.808,155.898,10.18,0.65,0
81,145,915,67856,48,2580,871,217010,87.04,17915567,157.834,22.9,4.694,7423.808,155.898,10.18,0.65,0
81,146,332,68188,14,2594,4557,221567,87.04,17915567,157.834,22.9,4.694,7423.808,155.898,10.18,0.65,0
81,147,345,68533,17,2611,4294,225861,87.04,17915567,157.834,22.9,4.694,7423.808,155.898,10.18,0.65,0
81,148,1118,69651,19,2630,4159,230020,87.04,17915567,157.834,22.9,4.694,7423.808,155.898,10.18,0.65,0
81,149,1063,70714,32,2662,3946,233966,87.04,17915567,157.834,22.9,4.694,7423.808,155.898,10.18,0.65,0
81,150,1142,71856,23,2685,3430,237396,87.04,17915567,157.834,22.9,4.694,7423.808,155.898,10.18,0.65,0
81,151,1065,72921,24,2709,1265,238661,87.04,17915567,157.834,22.9,4.694,7423.808,155.898,10.18,0.65,0
81,152,758,73679,19,2728,788,239449,87.04,17915567,157.834,22.9,4.694,7423.808,155.898,10.18,0.65,0
81,153,233,73912,12,2740,3469,242918,87.04,17915567,157.834,22.9,4.694,7423.808,155.898,10.18,0.65,0
81,154,162,74074,20,2760,3441,246359,87.04,17915567,157.834,22.9,4.694,7423.808,155.898,10.18,0.65,0
81,155,819,74893,18,2778,3347,249706,87.04,17915567,157.834,22.9,4.694,7423.808,155.898,10.18,0.65,0
81,156,771,75664,12,2790,3020,252726,87.04,17915567,157.834,22.9,4.694,7423.808,155.898,10.18,0.65,0
81,157,694,76358,14,2804,2404,255130,87.04,17915567,157.834,22.9,4.694,7423.808,155.898,10.18,0.65,0
81,158,682,77040,21,2825,1019,256149,87.04,17915567,157.834,22.9,4.694,7423.808,155.898,10.18,0.65,0
81,159,441,77481,20,2845,600,256749,87.04,17915567,157.834,22.9,4.694,7423.808,155.898,10.18,0.65,0
81,160,202,77683,7,2852,3234,259983,87.04,17915567,157.834,22.9,4.694,7423.808,155.898,10.18,0.65,0
81,161,145,77828,10,2862,3432,263415,87.04,17915567,157.834,22.9,4.694,7423.808,155.898,10.18,0.65,0
81,162,893,78721,28,2890,3222,266637,87.04,17915567,157.834,22.9,4.694,7423.808,155.898,10.18,0.65,0
81,163,901,79622,7,2897,3072,269709,87.04,17915567,157.834,22.9,4.694,7423.808,155.898,10.18,0.65,0
81,164,684,80306,21,2918,2687,272396,87.04,17915567,157.834,22.9,4.694,7423.808,155.898,10.18,0.65,0
81,165,703,81009,11,2929,1053,273449,87.04,17915567,157.834,22.9,4.694,7423.808,155.898,10.18,0.65,0
81,166,649,81658,20,2949,859,274308,87.04,17915567,157.834,22.9,4.694,7423.808,155.898,10.18,0.65,0
81,167,251,81909,8,2957,2447,276755,87.04,17915567,157.834,22.9,4.694,7423.808,155.898,10.18,0.65,0
81,168,263,82172,15,2972,724,277479,87.04,17915567,157.834,22.9,4.694,7423.808,155.898,10.18,0.65,0
81,169,512,82684,12,2984,2835,280314,87.04,17915567,157.834,22.9,4.694,7423.808,155.898,10.18,0.65,0
81,170,240,82924,25,3009,3148,283462,87.04,17915567,157.834,22.9,4.694,7423.808,155.898,10.18,0.65,0
81,171,740,83664,27,3036,3115,286577,67.59,17915567,157.834,22.9,4.694,7423.808,155.898,10.18,0.65,0
81,172,680,84344,40,3076,1381,287958,67.59,17915567,157.834,22.9,4.694,7423.808,155.898,10.18,0.65,0
81,173,808,85152,29,3105,1373,289331,67.59,17915567,157.834,22.9,4.694,7423.808,155.898,10.18,0.65,0
81,174,292,85444,14,3119,3935,293266,67.59,17915567,157.834,22.9,4.694,7423.808,155.898,10.18,0.65,0
81,175,237,85681,5,3124,3780,297046,67.59,17915567,157.834,22.9,4.694,7423.808,155.898,10.18,0.65,0
81,176,942,86623,13,3137,2646,299692,67.59,17915567,157.834,22.9,4.694,7423.808,155.898,10.18,0.65,0
81,177,819,87442,17,3154,4507,304199,67.59,17915567,157.834,22.9,4.694,7423.808,155.898,10.18,0.65,0
81,178,491,87933,16,3170,4566,308765,67.59,17915567,157.834,22.9,4.694,7423.808,155.898,10.18,0.65,0
81,179,945,88878,16,3186,1895,310660,67.59,17915567,157.834,22.9,4.694,7423.808,155.898,10.18,0.65,0
81,180,824,89702,27,3213,860,311520,67.59,17915567,157.834,22.9,4.694,7423.808,155.898,10.18,0.65,0
81,181,390,90092,16,3229,3994,315514,67.59,17915567,157.834,22.9,4.694,7423.808,155.898,10.18,0.65,0
81,182,171,90263,5,3234,4679,320193,67.59,17915567,157.834,22.9,4.694,7423.808,155.898,10.18,0.65,0
81,183,705,90968,4,3238,4269,324462,67.59,17915567,157.834,22.9,4.694,7423.808,155.898,10.18,0.65,0
81,184,778,91746,8,3246,4626,329088,42.13,17915567,157.834,22.9,4.694,7423.808,155.898,10.18,0.65,0
81,185,663,92409,15,3261,3931,333019,42.13,17915567,157.834,22.9,4.694,7423.808,155.898,10.18,0.65,0
81,186,681,93090,6,3267,1383,334402,42.13,17915567,157.834,22.9,4.694,7423.808,155.898,10.18,0.65,0
81,187,658,93748,18,3285,779,335181,42.13,17915567,157.834,22.9,4.694,7423.808,155.898,10.18,0.65,0
81,188,215,93963,8,3293,3986,339167,42.13,17915567,157.834,22.9,4.694,7423.808,155.898,10.18,0.65,0
81,189,219,94182,9,3302,4692,343859,42.13,17915567,157.834,22.9,4.694,7423.808,155.898,10.18,0.65,0
81,190,688,94870,8,3310,5715,349574,42.13,17915567,157.834,22.9,4.694,7423.808,155.898,10.18,0.65,0
81,191,834,95704,25,3335,2929,352503,42.13,17915567,157.834,22.9,4.694,7423.808,155.898,10.18,0.65,0
81,192,776,96480,12,3347,4810,357313,42.13,17915567,157.834,22.9,4.694,7423.808,155.898,10.18,0.65,0
81,193,455,96935,9,3356,1967,359280,42.13,17915567,157.834,22.9,4.694,7423.808,155.898,10.18,0.65,0
81,194,609,97544,9,3365,864,360144,42.13,17915567,157.834,22.9,4.694,7423.808,155.898,10.18,0.65,0
81,195,171,97715,19,3384,4325,364469,42.13,17915567,157.834,22.9,4.694,7423.808,155.898,10.18,0.65,0
81,196,111,97826,3,3387,4601,369070,42.13,17915567,157.834,22.9,4.694,7423.808,155.898,10.18,0.65,0
81,197,554,98380,23,3410,5042,374112,42.13,17915567,157.834,22.9,4.694,7423.808,155.898,10.18,0.65,0
81,198,714,99094,20,3430,4650,378762,42.13,17915567,157.834,22.9,4.694,7423.808,155.898,10.18,0.65,0
81,199,671,99765,23,3453,4669,383431,42.13,17915567,157.834,22.9,4.694,7423.808,155.898,10.18,0.65,0
81,200,666,100431,25,3478,1592,385023,42.13,17915567,157.834,22.9,4.694,7423.808,155.898,10.18,0.65,0
81,201,597,101028,37,3515,1538,386561,42.13,17915567,157.834,22.9,4.694,7423.808,155.898,10.18,0.65,0
81,202,332,101360,15,3530,0,386561,42.13,17915567,157.834,22.9,4.694,7423.808,155.898,10.18,0.65,0
81,203,239,101599,11,3541,0,386561,42.13,17915567,157.834,22.9,4.694,7423.808,155.898,10.18,0.65,0
81,204,620,102219,5,3546,0,386561,42.13,17915567,157.834,22.9,4.694,7423.808,155.898,10.18,0.65,0
83,1,0,16,0,0,0,0,78.7,13132792,51.755,19,3.135,1998.926,336.717,2.42,0.459,0
83,2,14,30,0,0,0,0,78.7,13132792,51.755,19,3.135,1998.926,336.717,2.42,0.459,0
83,3,22,52,0,0,0,0,78.7,13132792,51.755,19,3.135,1998.926,336.717,2.42,0.459,0
83,4,0,52,0,0,0,0,78.7,13132792,51.755,19,3.135,1998.926,336.717,2.42,0.459,0
83,5,59,111,0,0,0,0,78.7,13132792,51.755,19,3.135,1998.926,336.717,2.42,0.459,0
83,6,10,121,0,0,0,0,78.7,13132792,51.755,19,3.135,1998.926,336.717,2.42,0.459,0
83,7,7,128,0,0,0,0,78.7,13132792,51.755,19,3.135,1998.926,336.717,2.42,0.459,0
83,8,16,144,0,0,0,0,78.7,13132792,51.755,19,3.135,1998.926,336.717,2.42,0.459,0
83,9,20,164,0,0,0,0,78.7,13132792,51.755,19,3.135,1998.926,336.717,2.42,0.459,0
83,10,30,194,0,0,0,0,78.7,13132792,51.755,19,3.135,1998.926,336.717,2.42,0.459,0
83,11,18,212,0,0,0,0,78.7,13132792,51.755,19,3.135,1998.926,336.717,2.42,0.459,0
83,12,38,250,0,0,0,0,78.7,13132792,51.755,19,3.135,1998.926,336.717,2.42,0.459,0
83,13,0,250,0,0,0,0,78.7,13132792,51.755,19,3.135,1998.926,336.717,2.42,0.459,0
83,14,69,319,0,0,0,0,78.7,13132792,51.755,19,3.135,1998.926,336.717,2.42,0.459,0
83,15,44,363,0,0,0,0,78.7,13132792,51.755,19,3.135,1998.926,336.717,2.42,0.459,0
83,16,41,404,1,1,0,0,78.7,13132792,51.755,19,3.135,1998.926,336.717,2.42,0.459,0
83,17,34,438,0,1,0,0,78.7,13132792,51.755,19,3.135,1998.926,336.717,2.42,0.459,0
83,18,39,477,2,3,0,0,78.7,13132792,51.755,19,3.135,1998.926,336.717,2.42,0.459,0
83,19,0,477,0,3,0,0,78.7,13132792,51.755,19,3.135,1998.926,336.717,2.42,0.459,0
83,20,102,579,2,5,0,0,78.7,13132792,51.755,19,3.135,1998.926,336.717,2.42,0.459,0
83,21,43,622,0,5,0,0,78.7,13132792,51.755,19,3.135,1998.926,336.717,2.42,0.459,0
83,22,66,688,1,6,0,0,78.7,13132792,51.755,19,3.135,1998.926,336.717,2.42,0.459,0
83,23,73,761,0,6,0,0,78.7,13132792,51.755,19,3.135,1998.926,336.717,2.42,0.459,0
83,24,101,862,0,6,0,0,78.7,13132792,51.755,19,3.135,1998.926,336.717,2.42,0.459,0
83,25,92,954,0,6,0,0,78.7,13132792,51.755,19,3.135,1998.926,336.717,2.42,0.459,0
83,26,42,996,1,7,0,0,78.7,13132792,51.755,19,3.135,1998.926,336.717,2.42,0.459,0
83,27,98,1094,0,7,0,0,78.7,13132792,51.755,19,3.135,1998.926,336.717,2.42,0.459,0
83,28,69,1163,0,7,0,0,78.7,13132792,51.755,19,3.135,1998.926,336.717,2.42,0.459,0
83,29,77,1240,0,7,0,0,78.7,13132792,51.755,19,3.135,1998.926,336.717,2.42,0.459,0
83,30,111,1351,0,7,0,0,78.7,13132792,51.755,19,3.135,1998.926,336.717,2.42,0.459,0
83,31,144,1495,0,7,0,0,78.7,13132792,51.755,19,3.135,1998.926,336.717,2.42,0.459,0
83,32,42,1537,0,7,0,0,78.7,13132792,51.755,19,3.135,1998.926,336.717,2.42,0.459,0
83,33,49,1586,0,7,0,0,78.7,13132792,51.755,19,3.135,1998.926,336.717,2.42,0.459,0
83,34,0,1586,0,7,0,0,78.7,13132792,51.755,19,3.135,1998.926,336.717,2.42,0.459,0
83,35,124,1710,2,9,0,0,78.7,13132792,51.755,19,3.135,1998.926,336.717,2.42,0.459,0
83,36,101,1811,1,10,0,0,78.7,13132792,51.755,19,3.135,1998.926,336.717,2.42,0.459,0
83,37,45,1856,1,11,0,0,78.7,13132792,51.755,19,3.135,1998.926,336.717,2.42,0.459,0
83,38,71,1927,0,11,0,0,78.7,13132792,51.755,19,3.135,1998.926,336.717,2.42,0.459,0
83,39,82,2009,0,11,0,0,78.7,13132792,51.755,19,3.135,1998.926,336.717,2.42,0.459,0
83,40,33,2042,0,11,0,0,78.7,13132792,51.755,19,3.135,1998.926,336.717,2.42,0.459,0
83,41,104,2146,0,11,0,0,78.7,13132792,51.755,19,3.135,1998.926,336.717,2.42,0.459,0
83,42,67,2213,0,11,0,0,78.7,13132792,51.755,19,3.135,1998.926,336.717,2.42,0.459,0
83,43,0,2213,0,11,0,0,78.7,13132792,51.755,19,3.135,1998.926,336.717,2.42,0.459,0
83,44,161,2374,3,14,0,0,78.7,13132792,51.755,19,3.135,1998.926,336.717,2.42,0.459,0
83,45,99,2473,0,14,0,0,78.7,13132792,51.755,19,3.135,1998.926,336.717,2.42,0.459,0
83,46,58,2531,1,15,0,0,78.7,13132792,51.755,19,3.135,1998.926,336.717,2.42,0.459,0
83,47,127,2658,1,16,0,0,78.7,13132792,51.755,19,3.135,1998.926,336.717,2.42,0.459,0
83,48,0,2658,0,16,0,0,78.7,13132792,51.755,19,3.135,1998.926,336.717,2.42,0.459,0
83,49,138,2796,0,16,0,0,78.7,13132792,51.755,19,3.135,1998.926,336.717,2.42,0.459,0
83,50,67,2863,2,18,0,0,78.7,13132792,51.755,19,3.135,1998.926,336.717,2.42,0.459,0
83,51,0,2863,0,18,0,0,78.7,13132792,51.755,19,3.135,1998.926,336.717,2.42,0.459,0
83,52,204,3067,1,19,0,0,78.7,13132792,51.755,19,3.135,1998.926,336.717,2.42,0.459,0
83,53,0,3067,0,19,0,0,78.7,13132792,51.755,19,3.135,1998.926,336.717,2.42,0.459,0
83,54,109,3176,1,20,0,0,78.7,13132792,51.755,19,3.135,1998.926,336.717,2.42,0.459,0
83,55,99,3275,0,20,0,0,78.7,13132792,51.755,19,3.135,1998.926,336.717,2.42,0.459,0
83,56,0,3275,0,20,0,0,78.7,13132792,51.755,19,3.135,1998.926,336.717,2.42,0.459,0
83,57,83,3358,0,20,0,0,78.7,13132792,51.755,19,3.135,1998.926,336.717,2.42,0.459,0
83,58,88,3446,1,21,0,0,78.7,13132792,51.755,19,3.135,1998.926,336.717,2.42,0.459,0
83,59,107,3553,1,22,0,0,78.7,13132792,51.755,19,3.135,1998.926,336.717,2.42,0.459,0
83,60,103,3656,0,22,0,0,78.7,13132792,51.755,19,3.135,1998.926,336.717,2.42,0.459,0
83,61,50,3706,1,23,0,0,78.7,13132792,51.755,19,3.135,1998.926,336.717,2.42,0.459,0
83,62,65,3771,0,23,0,0,78.7,13132792,51.755,19,3.135,1998.926,336.717,2.42,0.459,0
83,63,73,3844,0,23,0,0,78.7,13132792,51.755,19,3.135,1998.926,336.717,2.42,0.459,0
83,64,0,3844,0,23,0,0,78.7,13132792,51.755,19,3.135,1998.926,336.717,2.42,0.459,0
83,65,42,3886,0,23,0,0,78.7,13132792,51.755,19,3.135,1998.926,336.717,2.42,0.459,0
83,66,105,3991,0,23,0,0,78.7,13132792,51.755,19,3.135,1998.926,336.717,2.42,0.459,0
83,67,69,4060,0,23,0,0,78.7,13132792,51.755,19,3.135,1998.926,336.717,2.42,0.459,0
83,68,57,4117,0,23,0,0,78.7,13132792,51.755,19,3.135,1998.926,336.717,2.42,0.459,0
83,69,48,4165,0,23,0,0,78.7,13132792,51.755,19,3.135,1998.926,336.717,2.42,0.459,0
83,70,51,4216,0,23,0,0,78.7,13132792,51.755,19,3.135,1998.926,336.717,2.42,0.459,0
83,71,42,4258,0,23,0,0,78.7,13132792,51.755,19,3.135,1998.926,336.717,2.42,0.459,0
83,72,0,4258,0,23,0,0,78.7,13132792,51.755,19,3.135,1998.926,336.717,2.42,0.459,0
83,73,114,4372,0,23,0,0,78.7,13132792,51.755,19,3.135,1998.926,336.717,2.42,0.459,0
83,74,54,4426,1,24,0,0,78.7,13132792,51.755,19,3.135,1998.926,336.717,2.42,0.459,0
83,75,58,4484,1,25,0,0,78.7,13132792,51.755,19,3.135,1998.926,336.717,2.42,0.459,0
83,76,48,4532,0,25,0,0,54.63,13132792,51.755,19,3.135,1998.926,336.717,2.42,0.459,0
83,77,40,4572,1,26,0,0,54.63,13132792,51.755,19,3.135,1998.926,336.717,2.42,0.459,0
83,78,67,4639,0,26,0,0,54.63,13132792,51.755,19,3.135,1998.926,336.717,2.42,0.459,0
83,79,29,4668,0,26,0,0,54.63,13132792,51.755,19,3.135,1998.926,336.717,2.42,0.459,0
83,80,173,4841,0,26,0,0,54.63,13132792,51.755,19,3.135,1998.926,336.717,2.42,0.459,0
83,81,63,4904,1,27,0,0,54.63,13132792,51.755,19,3.135,1998.926,336.717,2.42,0.459,0
83,82,56,4960,0,27,0,0,54.63,13132792,51.755,19,3.135,1998.926,336.717,2.42,0.459,0
83,83,28,4988,0,27,0,0,54.63,13132792,51.755,19,3.135,1998.926,336.717,2.42,0.459,0
83,84,0,4988,0,27,0,0,54.63,13132792,51.755,19,3.135,1998.926,336.717,2.42,0.459,0
83,85,116,5104,2,29,0,0,54.63,13132792,51.755,19,3.135,1998.926,336.717,2.42,0.459,0
83,86,70,5174,0,29,0,0,54.63,13132792,51.755,19,3.135,1998.926,336.717,2.42,0.459,0
83,87,37,5211,0,29,0,0,54.63,13132792,51.755,19,3.135,1998.926,336.717,2.42,0.459,0
83,88,49,5260,0,29,0,0,54.63,13132792,51.755,19,3.135,1998.926,336.717,2.42,0.459,0
83,89,31,5291,1,30,0,0,54.63,13132792,51.755,19,3.135,1998.926,336.717,2.42,0.459,0
83,90,51,5342,1,31,0,0,54.63,13132792,51.755,19,3.135,1998.926,336.717,2.42,0.459,0
83,91,9,5351,0,31,0,0,54.63,13132792,51.755,19,3.135,1998.926,336.717,2.42,0.459,0
83,92,40,5391,2,33,0,0,54.63,13132792,51.755,19,3.135,1998.926,336.717,2.42,0.459,0
83,93,13,5404,0,33,0,0,54.63,13132792,51.755,19,3.135,1998.926,336.717,2.42,0.459,0
83,94,46,5450,0,33,0,0,54.63,13132792,51.755,19,3.135,1998.926,336.717,2.42,0.459,0
83,95,71,5521,0,33,0,0,54.63,13132792,51.755,19,3.135,1998.926,336.717,2.42,0.459,0
83,96,49,5570,1,34,0,0,54.63,13132792,51.755,19,3.135,1998.926,336.717,2.42,0.459,0
83,97,40,5610,0,34,0,0,54.63,13132792,51.755,19,3.135,1998.926,336.717,2.42,0.459,0
83,98,26,5636,0,34,0,0,54.63,13132792,51.755,19,3.135,1998.926,336.717,2.42,0.459,0
83,99,61,5697,0,34,0,0,54.63,13132792,51.755,19,3.135,1998.926,336.717,2.42,0.459,0
83,100,0,5697,0,34,0,0,54.63,13132792,51.755,19,3.135,1998.926,336.717,2.42,0.459,0
83,101,184,5881,2,36,0,0,54.63,13132792,51.755,19,3.135,1998.926,336.717,2.42,0.459,0
83,102,88,5969,1,37,0,0,54.63,13132792,51.755,19,3.135,1998.926,336.717,2.42,0.459,0
83,103,75,6044,0,37,0,0,54.63,13132792,51.755,19,3.135,1998.926,336.717,2.42,0.459,0
83,104,97,6141,0,37,0,0,54.63,13132792,51.755,19,3.135,1998.926,336.717,2.42,0.459,0
83,105,0,6141,0,37,0,0,54.63,13132792,51.755,19,3.135,1998.926,336.717,2.42,0.459,0
83,106,0,6141,0,37,0,0,60.19,13132792,51.755,19,3.135,1998.926,336.717,2.42,0.459,0
83,107,135,6276,1,38,0,0,60.19,13132792,51.755,19,3.135,1998.926,336.717,2.42,0.459,0
83,108,0,6276,0,38,0,0,57.41,13132792,51.755,19,3.135,1998.926,336.717,2.42,0.459,0
83,109,154,6430,1,39,0,0,57.41,13132792,51.755,19,3.135,1998.926,336.717,2.42,0.459,0
83,110,61,6491,0,39,0,0,57.41,13132792,51.755,19,3.135,1998.926,336.717,2.42,0.459,0
83,111,53,6544,0,39,0,0,69.44,13132792,51.755,19,3.135,1998.926,336.717,2.42,0.459,0
83,112,46,6590,1,40,0,0,69.44,13132792,51.755,19,3.135,1998.926,336.717,2.42,0.459,0
83,113,62,6652,1,41,0,0,69.44,13132792,51.755,19,3.135,1998.926,336.717,2.42,0.459,0
83,114,95,6747,0,41,0,0,69.44,13132792,51.755,19,3.135,1998.926,336.717,2.42,0.459,0
83,115,59,6806,1,42,0,0,69.44,13132792,51.755,19,3.135,1998.926,336.717,2.42,0.459,0
83,116,61,6867,0,42,0,0,69.44,13132792,51.755,19,3.135,1998.926,336.717,2.42,0.459,0
83,117,60,6927,0,42,0,0,69.44,13132792,51.755,19,3.135,1998.926,336.717,2.42,0.459,0
83,118,81,7008,1,43,0,0,69.44,13132792,51.755,19,3.135,1998.926,336.717,2.42,0.459,0
83,119,47,7055,2,45,0,0,69.44,13132792,51.755,19,3.135,1998.926,336.717,2.42,0.459,0
83,120,71,7126,1,46,0,0,69.44,13132792,51.755,19,3.135,1998.926,336.717,2.42,0.459,0
83,121,57,7183,0,46,0,0,69.44,13132792,51.755,19,3.135,1998.926,336.717,2.42,0.459,0
83,122,59,7242,0,46,0,0,69.44,13132792,51.755,19,3.135,1998.926,336.717,2.42,0.459,0
83,123,66,7308,0,46,0,0,69.44,13132792,51.755,19,3.135,1998.926,336.717,2.42,0.459,0
83,124,9,7317,0,46,0,0,69.44,13132792,51.755,19,3.135,1998.926,336.717,2.42,0.459,0
83,125,47,7364,0,46,0,0,68.06,13132792,51.755,19,3.135,1998.926,336.717,2.42,0.459,0
83,126,0,7364,0,46,0,0,68.06,13132792,51.755,19,3.135,1998.926,336.717,2.42,0.459,0
83,127,125,7489,2,48,0,0,68.06,13132792,51.755,19,3.135,1998.926,336.717,2.42,0.459,0
83,128,86,7575,1,49,0,0,68.06,13132792,51.755,19,3.135,1998.926,336.717,2.42,0.459,0
83,129,89,7664,0,49,0,0,68.06,13132792,51.755,19,3.135,1998.926,336.717,2.42,0.459,0
83,130,113,7777,1,50,0,0,68.06,13132792,51.755,19,3.135,1998.926,336.717,2.42,0.459,0
83,131,98,7875,0,50,0,0,68.06,13132792,51.755,19,3.135,1998.926,336.717,2.42,0.459,0
83,132,55,7930,0,50,0,0,68.06,13132792,51.755,19,3.135,1998.926,336.717,2.42,0.459,0
83,133,0,7930,0,50,0,0,68.06,13132792,51.755,19,3.135,1998.926,336.717,2.42,0.459,0
83,134,88,8018,0,50,0,0,68.06,13132792,51.755,19,3.135,1998.926,336.717,2.42,0.459,0
83,135,98,8116,0,50,0,0,68.06,13132792,51.755,19,3.135,1998.926,336.717,2.42,0.459,0
83,136,82,8198,0,50,0,0,68.06,13132792,51.755,19,3.135,1998.926,336.717,2.42,0.459,0
83,137,62,8260,0,50,0,0,68.06,13132792,51.755,19,3.135,1998.926,336.717,2.42,0.459,0
83,138,83,8343,0,50,0,0,68.06,13132792,51.755,19,3.135,1998.926,336.717,2.42,0.459,0
83,139,139,8482,1,51,0,0,68.06,13132792,51.755,19,3.135,1998.926,336.717,2.42,0.459,0
83,140,138,8620,0,51,0,0,68.06,13132792,51.755,19,3.135,1998.926,336.717,2.42,0.459,0
83,141,95,8715,1,52,0,0,68.06,13132792,51.755,19,3.135,1998.926,336.717,2.42,0.459,0
83,142,77,8792,1,53,0,0,68.06,13132792,51.755,19,3.135,1998.926,336.717,2.42,0.459,0
83,143,84,8876,0,53,0,0,68.06,13132792,51.755,19,3.135,1998.926,336.717,2.42,0.459,0
83,144,56,8932,0,53,0,0,68.06,13132792,51.755,19,3.135,1998.926,336.717,2.42,0.459,0
83,145,0,8932,0,53,0,0,68.06,13132792,51.755,19,3.135,1998.926,336.717,2.42,0.459,0
83,146,35,8967,0,53,0,0,68.06,13132792,51.755,19,3.135,1998.926,336.717,2.42,0.459,0
83,147,46,9013,1,54,0,0,68.06,13132792,51.755,19,3.135,1998.926,336.717,2.42,0.459,0
83,148,115,9128,3,57,0,0,68.06,13132792,51.755,19,3.135,1998.926,336.717,2.42,0.459,0
83,149,39,9167,0,57,0,0,68.06,13132792,51.755,19,3.135,1998.926,336.717,2.42,0.459,0
83,150,46,9213,1,58,0,0,68.06,13132792,51.755,19,3.135,1998.926,336.717,2.42,0.459,0
83,151,38,9251,1,59,0,0,68.06,13132792,51.755,19,3.135,1998.926,336.717,2.42,0.459,0
83,152,0,9251,0,59,0,0,68.06,13132792,51.755,19,3.135,1998.926,336.717,2.42,0.459,0
83,153,120,9371,0,59,0,0,68.06,13132792,51.755,19,3.135,1998.926,336.717,2.42,0.459,0
83,154,38,9409,0,59,0,0,58.8,13132792,51.755,19,3.135,1998.926,336.717,2.42,0.459,0
83,155,70,9479,0,59,0,0,58.8,13132792,51.755,19,3.135,1998.926,336.717,2.42,0.459,0
83,156,0,9479,0,59,0,0,58.8,13132792,51.755,19,3.135,1998.926,336.717,2.42,0.459,0
83,157,47,9526,1,60,0,0,58.8,13132792,51.755,19,3.135,1998.926,336.717,2.42,0.459,0
83,158,53,9579,1,61,0,0,58.8,13132792,51.755,19,3.135,1998.926,336.717,2.42,0.459,0
83,159,70,9649,0,61,0,0,58.8,13132792,51.755,19,3.135,1998.926,336.717,2.42,0.459,0
83,160,73,9722,0,61,0,0,58.8,13132792,51.755,19,3.135,1998.926,336.717,2.42,0.459,0
83,161,76,9798,0,61,0,0,58.8,13132792,51.755,19,3.135,1998.926,336.717,2.42,0.459,0
83,162,50,9848,2,63,0,0,58.8,13132792,51.755,19,3.135,1998.926,336.717,2.42,0.459,0
83,163,37,9885,0,63,0,0,58.8,13132792,51.755,19,3.135,1998.926,336.717,2.42,0.459,0
83,164,61,9946,0,63,0,0,58.8,13132792,51.755,19,3.135,1998.926,336.717,2.42,0.459,0
83,165,33,9979,0,63,0,0,58.8,13132792,51.755,19,3.135,1998.926,336.717,2.42,0.459,0
83,166,41,10020,0,63,0,0,58.8,13132792,51.755,19,3.135,1998.926,336.717,2.42,0.459,0
83,167,0,10020,0,63,0,0,58.8,13132792,51.755,19,3.135,1998.926,336.717,2.42,0.459,0
83,168,41,10061,0,63,0,0,58.8,13132792,51.755,19,3.135,1998.926,336.717,2.42,0.459,0
83,169,50,10111,0,63,0,0,58.8,13132792,51.755,19,3.135,1998.926,336.717,2.42,0.459,0
83,170,43,10154,0,63,0,0,58.8,13132792,51.755,19,3.135,1998.926,336.717,2.42,0.459,0
83,171,0,10154,0,63,0,0,58.8,13132792,51.755,19,3.135,1998.926,336.717,2.42,0.459,0
83,172,77,10231,0,63,0,0,58.8,13132792,51.755,19,3.135,1998.926,336.717,2.42,0.459,0
83,173,55,10286,0,63,0,0,58.8,13132792,51.755,19,3.135,1998.926,336.717,2.42,0.459,0
83,174,39,10325,1,64,0,0,58.8,13132792,51.755,19,3.135,1998.926,336.717,2.42,0.459,0
83,175,19,10344,1,65,0,0,55.09,13132792,51.755,19,3.135,1998.926,336.717,2.42,0.459,0
83,176,43,10387,0,65,0,0,55.09,13132792,51.755,19,3.135,1998.926,336.717,2.42,0.459,0
83,177,47,10434,0,65,0,0,55.09,13132792,51.755,19,3.135,1998.926,336.717,2.42,0.459,0
83,178,44,10478,0,65,0,0,55.09,13132792,51.755,19,3.135,1998.926,336.717,2.42,0.459,0
83,179,0,10478,0,65,0,0,55.09,13132792,51.755,19,3.135,1998.926,336.717,2.42,0.459,0
83,180,70,10548,1,66,0,0,55.09,13132792,51.755,19,3.135,1998.926,336.717,2.42,0.459,0
83,181,32,10580,0,66,0,0,55.09,13132792,51.755,19,3.135,1998.926,336.717,2.42,0.459,0
83,182,18,10598,0,66,0,0,55.09,13132792,51.755,19,3.135,1998.926,336.717,2.42,0.459,0
83,183,36,10634,0,66,0,0,55.09,13132792,51.755,19,3.135,1998.926,336.717,2.42,0.459,0
83,184,18,10652,0,66,0,0,48.15,13132792,51.755,19,3.135,1998.926,336.717,2.42,0.459,0
83,185,0,10652,0,66,0,0,48.15,13132792,51.755,19,3.135,1998.926,336.717,2.42,0.459,0
83,186,83,10735,0,66,0,0,48.15,13132792,51.755,19,3.135,1998.926,336.717,2.42,0.459,0
83,187,0,10735,0,66,0,0,48.15,13132792,51.755,19,3.135,1998.926,336.717,2.42,0.459,0
83,188,19,10754,0,66,0,0,48.15,13132792,51.755,19,3.135,1998.926,336.717,2.42,0.459,0
83,189,46,10800,1,67,0,0,48.15,13132792,51.755,19,3.135,1998.926,336.717,2.42,0.459,0
83,190,63,10863,1,68,0,0,48.15,13132792,51.755,19,3.135,1998.926,336.717,2.42,0.459,0
83,191,0,10863,0,68,0,0,48.15,13132792,51.755,19,3.135,1998.926,336.717,2.42,0.459,0
83,192,38,10901,0,68,0,0,48.15,13132792,51.755,19,3.135,1998.926,336.717,2.42,0.459,0
83,193,53,10954,0,68,0,0,48.15,13132792,51.755,19,3.135,1998.926,336.717,2.42,0.459,0
83,194,42,10996,1,69,0,0,48.15,13132792,51.755,19,3.135,1998.926,336.717,2.42,0.459,0
83,195,26,11022,0,69,0,0,48.15,13132792,51.755,19,3.135,1998.926,336.717,2.42,0.459,0
83,196,40,11062,1,70,0,0,48.15,13132792,51.755,19,3.135,1998.926,336.717,2.42,0.459,0
83,197,72,11134,0,70,0,0,48.15,13132792,51.755,19,3.135,1998.926,336.717,2.42,0.459,0
83,198,54,11188,0,70,0,0,48.15,13132792,51.755,19,3.135,1998.926,336.717,2.42,0.459,0
83,199,67,11255,0,70,0,0,48.15,13132792,51.755,19,3.135,1998.926,336.717,2.42,0.459,0
83,200,107,11362,0,70,0,0,48.15,13132792,51.755,19,3.135,1998.926,336.717,2.42,0.459,0
83,201,116,11478,0,70,0,0,48.15,13132792,51.755,19,3.135,1998.926,336.717,2.42,0.459,0
83,202,40,11518,0,70,0,0,48.15,13132792,51.755,19,3.135,1998.926,336.717,2.42,0.459,0
83,203,0,11518,0,70,0,0,48.15,13132792,51.755,19,3.135,1998.926,336.717,2.42,0.459,0
83,204,20,11538,0,70,0,0,48.15,13132792,51.755,19,3.135,1998.926,336.717,2.42,0.459,0
84,1,6,8,0,0,0,0,0,1967998,66.191,19.4,3.002,1548.675,382.474,2.42,0.455,0
84,2,1,9,0,0,0,0,0,1967998,66.191,19.4,3.002,1548.675,382.474,2.42,0.455,0
84,3,0,9,0,0,0,0,0,1967998,66.191,19.4,3.002,1548.675,382.474,2.42,0.455,0
84,4,6,15,0,0,0,0,0,1967998,66.191,19.4,3.002,1548.675,382.474,2.42,0.455,0
84,5,3,18,0,0,0,0,0,1967998,66.191,19.4,3.002,1548.675,382.474,2.42,0.455,0
84,6,0,18,0,0,0,0,0,1967998,66.191,19.4,3.002,1548.675,382.474,2.42,0.455,0
84,7,15,33,0,0,0,0,0,1967998,66.191,19.4,3.002,1548.675,382.474,2.42,0.455,0
84,8,0,33,0,0,0,0,0,1967998,66.191,19.4,3.002,1548.675,382.474,2.42,0.455,0
84,9,0,33,0,0,0,0,0,1967998,66.191,19.4,3.002,1548.675,382.474,2.42,0.455,0
84,10,2,35,0,0,0,0,0,1967998,66.191,19.4,3.002,1548.675,382.474,2.42,0.455,0
84,11,0,35,0,0,0,0,0,1967998,66.191,19.4,3.002,1548.675,382.474,2.42,0.455,0
84,12,3,38,0,0,0,0,0,1967998,66.191,19.4,3.002,1548.675,382.474,2.42,0.455,0
84,13,1,39,0,0,0,0,0,1967998,66.191,19.4,3.002,1548.675,382.474,2.42,0.455,0
84,14,0,39,0,0,0,0,0,1967998,66.191,19.4,3.002,1548.675,382.474,2.42,0.455,0
84,15,1,40,0,0,0,0,0,1967998,66.191,19.4,3.002,1548.675,382.474,2.42,0.455,0
84,16,3,43,0,0,0,0,0,1967998,66.191,19.4,3.002,1548.675,382.474,2.42,0.455,0
84,17,3,46,0,0,0,0,0,1967998,66.191,19.4,3.002,1548.675,382.474,2.42,0.455,0
84,18,4,50,0,0,0,0,0,1967998,66.191,19.4,3.002,1548.675,382.474,2.42,0.455,0
84,19,0,50,0,0,0,0,0,1967998,66.191,19.4,3.002,1548.675,382.474,2.42,0.455,0
84,20,0,50,0,0,0,0,0,1967998,66.191,19.4,3.002,1548.675,382.474,2.42,0.455,0
84,21,0,50,0,0,0,0,0,1967998,66.191,19.4,3.002,1548.675,382.474,2.42,0.455,0
84,22,0,50,0,0,0,0,0,1967998,66.191,19.4,3.002,1548.675,382.474,2.42,0.455,0
84,23,0,50,0,0,0,0,0,1967998,66.191,19.4,3.002,1548.675,382.474,2.42,0.455,0
84,24,2,52,0,0,0,0,0,1967998,66.191,19.4,3.002,1548.675,382.474,2.42,0.455,0
84,25,0,52,0,0,0,0,0,1967998,66.191,19.4,3.002,1548.675,382.474,2.42,0.455,0
84,26,0,52,0,0,0,0,0,1967998,66.191,19.4,3.002,1548.675,382.474,2.42,0.455,0
84,27,1,53,1,1,0,0,0,1967998,66.191,19.4,3.002,1548.675,382.474,2.42,0.455,0
84,28,20,73,0,1,0,0,0,1967998,66.191,19.4,3.002,1548.675,382.474,2.42,0.455,0
84,29,0,73,0,1,0,0,0,1967998,66.191,19.4,3.002,1548.675,382.474,2.42,0.455,0
84,30,4,77,0,1,0,0,0,1967998,66.191,19.4,3.002,1548.675,382.474,2.42,0.455,0
84,31,128,205,0,1,0,0,0,1967998,66.191,19.4,3.002,1548.675,382.474,2.42,0.455,0
84,32,52,257,0,1,0,0,0,1967998,66.191,19.4,3.002,1548.675,382.474,2.42,0.455,0
84,33,0,257,0,1,0,0,0,1967998,66.191,19.4,3.002,1548.675,382.474,2.42,0.455,0
84,34,35,292,1,2,0,0,0,1967998,66.191,19.4,3.002,1548.675,382.474,2.42,0.455,0
84,35,121,413,0,2,0,0,0,1967998,66.191,19.4,3.002,1548.675,382.474,2.42,0.455,0
84,36,62,475,0,2,0,0,0,1967998,66.191,19.4,3.002,1548.675,382.474,2.42,0.455,0
84,37,0,475,0,2,0,0,0,1967998,66.191,19.4,3.002,1548.675,382.474,2.42,0.455,0
84,38,89,564,0,2,0,0,0,1967998,66.191,19.4,3.002,1548.675,382.474,2.42,0.455,0
84,39,30,594,0,2,0,0,0,1967998,66.191,19.4,3.002,1548.675,382.474,2.42,0.455,0
84,40,47,641,1,3,0,0,0,1967998,66.191,19.4,3.002,1548.675,382.474,2.42,0.455,0
84,41,85,726,0,3,0,0,0,1967998,66.191,19.4,3.002,1548.675,382.474,2.42,0.455,0
84,42,35,761,0,3,0,0,0,1967998,66.191,19.4,3.002,1548.675,382.474,2.42,0.455,0
84,43,59,820,0,3,0,0,0,1967998,66.191,19.4,3.002,1548.675,382.474,2.42,0.455,0
84,44,0,820,0,3,0,0,0,1967998,66.191,19.4,3.002,1548.675,382.474,2.42,0.455,0
84,45,93,913,0,3,0,0,0,1967998,66.191,19.4,3.002,1548.675,382.474,2.42,0.455,0
84,46,0,913,0,3,0,0,0,1967998,66.191,19.4,3.002,1548.675,382.474,2.42,0.455,0
84,47,0,913,0,3,0,0,0,1967998,66.191,19.4,3.002,1548.675,382.474,2.42,0.455,0
84,48,77,990,1,4,0,0,0,1967998,66.191,19.4,3.002,1548.675,382.474,2.42,0.455,0
84,49,0,990,0,4,0,0,0,1967998,66.191,19.4,3.002,1548.675,382.474,2.42,0.455,0
84,50,48,1038,2,6,0,0,0,1967998,66.191,19.4,3.002,1548.675,382.474,2.42,0.455,0
84,51,0,1038,0,6,0,0,0,1967998,66.191,19.4,3.002,1548.675,382.474,2.42,0.455,0
84,52,51,1089,0,6,0,0,0,1967998,66.191,19.4,3.002,1548.675,382.474,2.42,0.455,0
84,53,0,1089,0,6,0,0,0,1967998,66.191,19.4,3.002,1548.675,382.474,2.42,0.455,0
84,54,25,1114,0,6,0,0,0,1967998,66.191,19.4,3.002,1548.675,382.474,2.42,0.455,0
84,55,59,1173,0,6,0,0,0,1967998,66.191,19.4,3.002,1548.675,382.474,2.42,0.455,0
84,56,0,1173,0,6,0,0,0,1967998,66.191,19.4,3.002,1548.675,382.474,2.42,0.455,0
84,57,0,1173,0,6,0,0,0,1967998,66.191,19.4,3.002,1548.675,382.474,2.42,0.455,0
84,58,5,1178,1,7,0,0,0,1967998,66.191,19.4,3.002,1548.675,382.474,2.42,0.455,0
84,59,0,1178,0,7,0,0,0,1967998,66.191,19.4,3.002,1548.675,382.474,2.42,0.455,0
84,60,78,1256,1,8,0,0,0,1967998,66.191,19.4,3.002,1548.675,382.474,2.42,0.455,0
84,61,0,1256,0,8,0,0,0,1967998,66.191,19.4,3.002,1548.675,382.474,2.42,0.455,0
84,62,66,1322,0,8,0,0,0,1967998,66.191,19.4,3.002,1548.675,382.474,2.42,0.455,0
84,63,17,1339,0,8,0,0,0,1967998,66.191,19.4,3.002,1548.675,382.474,2.42,0.455,0
84,64,0,1339,0,8,0,0,0,1967998,66.191,19.4,3.002,1548.675,382.474,2.42,0.455,0
84,65,0,1339,0,8,0,0,0,1967998,66.191,19.4,3.002,1548.675,382.474,2.42,0.455,0
84,66,7,1346,1,9,0,0,0,1967998,66.191,19.4,3.002,1548.675,382.474,2.42,0.455,0
84,67,22,1368,3,12,0,0,0,1967998,66.191,19.4,3.002,1548.675,382.474,2.42,0.455,0
84,68,0,1368,0,12,0,0,0,1967998,66.191,19.4,3.002,1548.675,382.474,2.42,0.455,0
84,69,0,1368,0,12,0,0,0,1967998,66.191,19.4,3.002,1548.675,382.474,2.42,0.455,0
84,70,21,1389,0,12,0,0,0,1967998,66.191,19.4,3.002,1548.675,382.474,2.42,0.455,0
84,71,0,1389,0,12,0,0,0,1967998,66.191,19.4,3.002,1548.675,382.474,2.42,0.455,0
84,72,0,1389,0,12,0,0,0,1967998,66.191,19.4,3.002,1548.675,382.474,2.42,0.455,0
84,73,0,1389,0,12,0,0,0,1967998,66.191,19.4,3.002,1548.675,382.474,2.42,0.455,0
84,74,0,1389,0,12,0,0,0,1967998,66.191,19.4,3.002,1548.675,382.474,2.42,0.455,0
84,75,71,1460,3,15,0,0,0,1967998,66.191,19.4,3.002,1548.675,382.474,2.42,0.455,0
84,76,0,1460,0,15,0,0,0,1967998,66.191,19.4,3.002,1548.675,382.474,2.42,0.455,0
84,77,0,1460,0,15,0,0,0,1967998,66.191,19.4,3.002,1548.675,382.474,2.42,0.455,0
84,78,32,1492,0,15,0,0,0,1967998,66.191,19.4,3.002,1548.675,382.474,2.42,0.455,0
84,79,0,1492,0,15,0,0,0,1967998,66.191,19.4,3.002,1548.675,382.474,2.42,0.455,0
84,80,20,1512,0,15,0,0,0,1967998,66.191,19.4,3.002,1548.675,382.474,2.42,0.455,0
84,81,0,1512,0,15,0,0,0,1967998,66.191,19.4,3.002,1548.675,382.474,2.42,0.455,0
84,82,29,1541,2,17,0,0,0,1967998,66.191,19.4,3.002,1548.675,382.474,2.42,0.455,0
84,83,0,1541,0,17,0,0,0,1967998,66.191,19.4,3.002,1548.675,382.474,2.42,0.455,0
84,84,15,1556,2,19,0,0,0,1967998,66.191,19.4,3.002,1548.675,382.474,2.42,0.455,0
84,85,0,1556,0,19,0,0,0,1967998,66.191,19.4,3.002,1548.675,382.474,2.42,0.455,0
84,86,0,1556,0,19,0,0,0,1967998,66.191,19.4,3.002,1548.675,382.474,2.42,0.455,0
84,87,0,1556,0,19,0,0,0,1967998,66.191,19.4,3.002,1548.675,382.474,2.42,0.455,0
84,88,0,1556,0,19,0,0,0,1967998,66.191,19.4,3.002,1548.675,382.474,2.42,0.455,0
84,89,58,1614,2,21,0,0,0,1967998,66.191,19.4,3.002,1548.675,382.474,2.42,0.455,0
84,90,0,1614,0,21,0,0,0,1967998,66.191,19.4,3.002,1548.675,382.474,2.42,0.455,0
84,91,0,1614,0,21,0,0,0,1967998,66.191,19.4,3.002,1548.675,382.474,2.42,0.455,0
84,92,40,1654,3,24,0,0,0,1967998,66.191,19.4,3.002,1548.675,382.474,2.42,0.455,0
84,93,0,1654,0,24,0,0,0,1967998,66.191,19.4,3.002,1548.675,382.474,2.42,0.455,0
84,94,0,1654,0,24,0,0,0,1967998,66.191,19.4,3.002,1548.675,382.474,2.42,0.455,0
84,95,56,1710,0,24,0,0,0,1967998,66.191,19.4,3.002,1548.675,382.474,2.42,0.455,0
84,96,55,1765,1,25,0,0,0,1967998,66.191,19.4,3.002,1548.675,382.474,2.42,0.455,0
84,97,0,1765,0,25,0,0,0,1967998,66.191,19.4,3.002,1548.675,382.474,2.42,0.455,0
84,98,0,1765,0,25,0,0,0,1967998,66.191,19.4,3.002,1548.675,382.474,2.42,0.455,0
84,99,25,1790,0,25,0,0,0,1967998,66.191,19.4,3.002,1548.675,382.474,2.42,0.455,0
84,100,0,1790,0,25,0,0,0,1967998,66.191,19.4,3.002,1548.675,382.474,2.42,0.455,0
84,101,0,1790,0,25,0,0,0,1967998,66.191,19.4,3.002,1548.675,382.474,2.42,0.455,0
84,102,0,1790,0,25,0,0,0,1967998,66.191,19.4,3.002,1548.675,382.474,2.42,0.455,0
84,103,52,1842,0,25,0,0,0,1967998,66.191,19.4,3.002,1548.675,382.474,2.42,0.455,0
84,104,0,1842,0,25,0,0,0,1967998,66.191,19.4,3.002,1548.675,382.474,2.42,0.455,0
84,105,0,1842,0,25,0,0,0,1967998,66.191,19.4,3.002,1548.675,382.474,2.42,0.455,0
84,106,60,1902,1,26,0,0,0,1967998,66.191,19.4,3.002,1548.675,382.474,2.42,0.455,0
84,107,0,1902,0,26,0,0,0,1967998,66.191,19.4,3.002,1548.675,382.474,2.42,0.455,0
84,108,25,1927,0,26,0,0,0,1967998,66.191,19.4,3.002,1548.675,382.474,2.42,0.455,0
84,109,0,1927,0,26,0,0,0,1967998,66.191,19.4,3.002,1548.675,382.474,2.42,0.455,0
84,110,0,1927,0,26,0,0,0,1967998,66.191,19.4,3.002,1548.675,382.474,2.42,0.455,0
84,111,0,1927,0,26,0,0,0,1967998,66.191,19.4,3.002,1548.675,382.474,2.42,0.455,0
84,112,23,1950,0,26,0,0,0,1967998,66.191,19.4,3.002,1548.675,382.474,2.42,0.455,0
84,113,4,1954,0,26,0,0,0,1967998,66.191,19.4,3.002,1548.675,382.474,2.42,0.455,0
84,114,0,1954,0,26,0,0,0,1967998,66.191,19.4,3.002,1548.675,382.474,2.42,0.455,0
84,115,0,1954,0,26,0,0,0,1967998,66.191,19.4,3.002,1548.675,382.474,2.42,0.455,0
84,116,0,1954,0,26,0,0,0,1967998,66.191,19.4,3.002,1548.675,382.474,2.42,0.455,0
84,117,0,1954,0,26,0,0,0,1967998,66.191,19.4,3.002,1548.675,382.474,2.42,0.455,0
84,118,0,1954,0,26,0,0,0,1967998,66.191,19.4,3.002,1548.675,382.474,2.42,0.455,0
84,119,0,1954,0,26,0,0,0,1967998,66.191,19.4,3.002,1548.675,382.474,2.42,0.455,0
84,120,0,1954,0,26,0,0,0,1967998,66.191,19.4,3.002,1548.675,382.474,2.42,0.455,0
84,121,0,1954,0,26,0,0,0,1967998,66.191,19.4,3.002,1548.675,382.474,2.42,0.455,0
84,122,27,1981,0,26,0,0,0,1967998,66.191,19.4,3.002,1548.675,382.474,2.42,0.455,0
84,123,0,1981,0,26,0,0,0,1967998,66.191,19.4,3.002,1548.675,382.474,2.42,0.455,0
84,124,0,1981,0,26,0,0,0,1967998,66.191,19.4,3.002,1548.675,382.474,2.42,0.455,0
84,125,0,1981,0,26,0,0,0,1967998,66.191,19.4,3.002,1548.675,382.474,2.42,0.455,0
84,126,0,1981,1,27,0,0,0,1967998,66.191,19.4,3.002,1548.675,382.474,2.42,0.455,0
84,127,51,2032,0,27,0,0,0,1967998,66.191,19.4,3.002,1548.675,382.474,2.42,0.455,0
84,128,0,2032,0,27,0,0,0,1967998,66.191,19.4,3.002,1548.675,382.474,2.42,0.455,0
84,129,0,2032,0,27,0,0,0,1967998,66.191,19.4,3.002,1548.675,382.474,2.42,0.455,0
84,130,0,2032,0,27,0,0,0,1967998,66.191,19.4,3.002,1548.675,382.474,2.42,0.455,0
84,131,20,2052,2,29,0,0,0,1967998,66.191,19.4,3.002,1548.675,382.474,2.42,0.455,0
84,132,0,2052,0,29,0,0,0,1967998,66.191,19.4,3.002,1548.675,382.474,2.42,0.455,0
84,133,0,2052,0,29,0,0,0,1967998,66.191,19.4,3.002,1548.675,382.474,2.42,0.455,0
84,134,0,2052,0,29,0,0,0,1967998,66.191,19.4,3.002,1548.675,382.474,2.42,0.455,0
84,135,0,2052,0,29,0,0,0,1967998,66.191,19.4,3.002,1548.675,382.474,2.42,0.455,0
84,136,65,2117,4,33,0,0,0,1967998,66.191,19.4,3.002,1548.675,382.474,2.42,0.455,0
84,137,0,2117,0,33,0,0,0,1967998,66.191,19.4,3.002,1548.675,382.474,2.42,0.455,0
84,138,0,2117,0,33,0,0,0,1967998,66.191,19.4,3.002,1548.675,382.474,2.42,0.455,0
84,139,0,2117,0,33,0,0,0,1967998,66.191,19.4,3.002,1548.675,382.474,2.42,0.455,0
84,140,0,2117,0,33,0,0,0,1967998,66.191,19.4,3.002,1548.675,382.474,2.42,0.455,0
84,141,0,2117,0,33,0,0,0,1967998,66.191,19.4,3.002,1548.675,382.474,2.42,0.455,0
84,142,0,2117,0,33,0,0,0,1967998,66.191,19.4,3.002,1548.675,382.474,2.42,0.455,0
84,143,0,2117,0,33,0,0,0,1967998,66.191,19.4,3.002,1548.675,382.474,2.42,0.455,0
84,144,32,2149,0,33,0,0,0,1967998,66.191,19.4,3.002,1548.675,382.474,2.42,0.455,0
84,145,0,2149,0,33,0,0,0,1967998,66.191,19.4,3.002,1548.675,382.474,2.42,0.455,0
84,146,0,2149,0,33,0,0,0,1967998,66.191,19.4,3.002,1548.675,382.474,2.42,0.455,0
84,147,0,2149,0,33,0,0,0,1967998,66.191,19.4,3.002,1548.675,382.474,2.42,0.455,0
84,148,0,2149,0,33,0,0,0,1967998,66.191,19.4,3.002,1548.675,382.474,2.42,0.455,0
84,149,0,2149,0,33,0,0,0,1967998,66.191,19.4,3.002,1548.675,382.474,2.42,0.455,0
84,150,0,2149,0,33,0,0,0,1967998,66.191,19.4,3.002,1548.675,382.474,2.42,0.455,0
84,151,0,2149,0,33,0,0,0,1967998,66.191,19.4,3.002,1548.675,382.474,2.42,0.455,0
84,152,56,2205,0,33,0,0,0,1967998,66.191,19.4,3.002,1548.675,382.474,2.42,0.455,0
84,153,0,2205,1,34,0,0,0,1967998,66.191,19.4,3.002,1548.675,382.474,2.42,0.455,0
84,154,0,2205,0,34,0,0,0,1967998,66.191,19.4,3.002,1548.675,382.474,2.42,0.455,0
84,155,0,2205,0,34,0,0,0,1967998,66.191,19.4,3.002,1548.675,382.474,2.42,0.455,0
84,156,0,2205,0,34,0,0,0,1967998,66.191,19.4,3.002,1548.675,382.474,2.42,0.455,0
84,157,0,2205,0,34,0,0,0,1967998,66.191,19.4,3.002,1548.675,382.474,2.42,0.455,0
84,158,40,2245,4,38,0,0,0,1967998,66.191,19.4,3.002,1548.675,382.474,2.42,0.455,0
84,159,0,2245,0,38,0,0,0,1967998,66.191,19.4,3.002,1548.675,382.474,2.42,0.455,0
84,160,0,2245,0,38,0,0,0,1967998,66.191,19.4,3.002,1548.675,382.474,2.42,0.455,0
84,161,0,2245,0,38,0,0,0,1967998,66.191,19.4,3.002,1548.675,382.474,2.42,0.455,0
84,162,0,2245,0,38,0,0,0,1967998,66.191,19.4,3.002,1548.675,382.474,2.42,0.455,0
84,163,0,2245,0,38,0,0,0,1967998,66.191,19.4,3.002,1548.675,382.474,2.42,0.455,0
84,164,0,2245,0,38,0,0,0,1967998,66.191,19.4,3.002,1548.675,382.474,2.42,0.455,0
84,165,30,2275,1,39,0,0,0,1967998,66.191,19.4,3.002,1548.675,382.474,2.42,0.455,0
84,166,0,2275,0,39,0,0,0,1967998,66.191,19.4,3.002,1548.675,382.474,2.42,0.455,0
84,167,0,2275,0,39,0,0,0,1967998,66.191,19.4,3.002,1548.675,382.474,2.42,0.455,0
84,168,0,2275,0,39,0,0,0,1967998,66.191,19.4,3.002,1548.675,382.474,2.42,0.455,0
84,169,0,2275,0,39,0,0,0,1967998,66.191,19.4,3.002,1548.675,382.474,2.42,0.455,0
84,170,0,2275,0,39,0,0,0,1967998,66.191,19.4,3.002,1548.675,382.474,2.42,0.455,0
84,171,0,2275,0,39,0,0,0,1967998,66.191,19.4,3.002,1548.675,382.474,2.42,0.455,0
84,172,28,2303,0,39,0,0,0,1967998,66.191,19.4,3.002,1548.675,382.474,2.42,0.455,0
84,173,0,2303,0,39,0,0,0,1967998,66.191,19.4,3.002,1548.675,382.474,2.42,0.455,0
84,174,0,2303,0,39,0,0,0,1967998,66.191,19.4,3.002,1548.675,382.474,2.42,0.455,0
84,175,0,2303,0,39,0,0,0,1967998,66.191,19.4,3.002,1548.675,382.474,2.42,0.455,0
84,176,0,2303,0,39,0,0,0,1967998,66.191,19.4,3.002,1548.675,382.474,2.42,0.455,0
84,177,0,2303,0,39,0,0,0,1967998,66.191,19.4,3.002,1548.675,382.474,2.42,0.455,0
84,178,0,2303,0,39,0,0,0,1967998,66.191,19.4,3.002,1548.675,382.474,2.42,0.455,0
84,179,21,2324,0,39,0,0,0,1967998,66.191,19.4,3.002,1548.675,382.474,2.42,0.455,0
84,180,0,2324,0,39,0,0,0,1967998,66.191,19.4,3.002,1548.675,382.474,2.42,0.455,0
84,181,0,2324,0,39,0,0,0,1967998,66.191,19.4,3.002,1548.675,382.474,2.42,0.455,0
84,182,0,2324,0,39,0,0,0,1967998,66.191,19.4,3.002,1548.675,382.474,2.42,0.455,0
84,183,0,2324,0,39,0,0,0,1967998,66.191,19.4,3.002,1548.675,382.474,2.42,0.455,0
84,184,0,2324,0,39,0,0,0,1967998,66.191,19.4,3.002,1548.675,382.474,2.42,0.455,0
84,185,0,2324,0,39,0,0,0,1967998,66.191,19.4,3.002,1548.675,382.474,2.42,0.455,0
84,186,38,2362,0,39,0,0,0,1967998,66.191,19.4,3.002,1548.675,382.474,2.42,0.455,0
84,187,0,2362,0,39,0,0,0,1967998,66.191,19.4,3.002,1548.675,382.474,2.42,0.455,0
84,188,0,2362,0,39,0,0,0,1967998,66.191,19.4,3.002,1548.675,382.474,2.42,0.455,0
84,189,0,2362,0,39,0,0,0,1967998,66.191,19.4,3.002,1548.675,382.474,2.42,0.455,0
84,190,0,2362,0,39,0,0,0,1967998,66.191,19.4,3.002,1548.675,382.474,2.42,0.455,0
84,191,0,2362,0,39,0,0,0,1967998,66.191,19.4,3.002,1548.675,382.474,2.42,0.455,0
84,192,0,2362,0,39,0,0,0,1967998,66.191,19.4,3.002,1548.675,382.474,2.42,0.455,0
84,193,0,2362,0,39,0,0,0,1967998,66.191,19.4,3.002,1548.675,382.474,2.42,0.455,0
84,194,0,2362,0,39,0,0,0,1967998,66.191,19.4,3.002,1548.675,382.474,2.42,0.455,0
84,195,23,2385,1,40,0,0,0,1967998,66.191,19.4,3.002,1548.675,382.474,2.42,0.455,0
84,196,0,2385,0,40,0,0,0,1967998,66.191,19.4,3.002,1548.675,382.474,2.42,0.455,0
84,197,0,2385,0,40,0,0,0,1967998,66.191,19.4,3.002,1548.675,382.474,2.42,0.455,0
84,198,0,2385,0,40,0,0,0,1967998,66.191,19.4,3.002,1548.675,382.474,2.42,0.455,0
84,199,0,2385,0,40,0,0,0,1967998,66.191,19.4,3.002,1548.675,382.474,2.42,0.455,0
84,200,4,2389,1,41,0,0,0,1967998,66.191,19.4,3.002,1548.675,382.474,2.42,0.455,0
84,201,0,2389,0,41,0,0,0,1967998,66.191,19.4,3.002,1548.675,382.474,2.42,0.455,0
84,202,0,2389,0,41,0,0,0,1967998,66.191,19.4,3.002,1548.675,382.474,2.42,0.455,0
84,203,0,2389,0,41,0,0,0,1967998,66.191,19.4,3.002,1548.675,382.474,2.42,0.455,0
84,204,14,2403,0,41,0,0,0,1967998,66.191,19.4,3.002,1548.675,382.474,2.42,0.455,0
85,1,4,12,1,2,0,0,57.41,786559,3.952,26.3,5.305,7435.047,373.159,11.62,0.654,0
85,2,7,19,2,4,0,0,57.41,786559,3.952,26.3,5.305,7435.047,373.159,11.62,0.654,0
85,3,0,19,0,4,0,0,85.19,786559,3.952,26.3,5.305,7435.047,373.159,11.62,0.654,0
85,4,4,23,0,4,0,0,85.19,786559,3.952,26.3,5.305,7435.047,373.159,11.62,0.654,0
85,5,1,24,0,4,0,0,85.19,786559,3.952,26.3,5.305,7435.047,373.159,11.62,0.654,0
85,6,5,29,0,4,0,0,85.19,786559,3.952,26.3,5.305,7435.047,373.159,11.62,0.654,0
85,7,2,31,1,5,0,0,85.19,786559,3.952,26.3,5.305,7435.047,373.159,11.62,0.654,0
85,8,2,33,0,5,0,0,85.19,786559,3.952,26.3,5.305,7435.047,373.159,11.62,0.654,0
85,9,4,37,1,6,0,0,87.04,786559,3.952,26.3,5.305,7435.047,373.159,11.62,0.654,0
85,10,0,37,0,6,0,0,87.04,786559,3.952,26.3,5.305,7435.047,373.159,11.62,0.654,0
85,11,3,40,0,6,0,0,87.04,786559,3.952,26.3,5.305,7435.047,373.159,11.62,0.654,0
85,12,5,45,0,6,0,0,87.04,786559,3.952,26.3,5.305,7435.047,373.159,11.62,0.654,0
85,13,0,45,0,6,0,0,87.04,786559,3.952,26.3,5.305,7435.047,373.159,11.62,0.654,0
85,14,2,47,0,6,0,0,87.04,786559,3.952,26.3,5.305,7435.047,373.159,11.62,0.654,0
85,15,1,48,0,6,0,0,87.04,786559,3.952,26.3,5.305,7435.047,373.159,11.62,0.654,0
85,16,7,55,0,6,0,0,87.04,786559,3.952,26.3,5.305,7435.047,373.159,11.62,0.654,0
85,17,2,57,0,6,0,0,87.04,786559,3.952,26.3,5.305,7435.047,373.159,11.62,0.654,0
85,18,6,63,0,6,0,0,87.04,786559,3.952,26.3,5.305,7435.047,373.159,11.62,0.654,0
85,19,0,63,1,7,0,0,87.04,786559,3.952,26.3,5.305,7435.047,373.159,11.62,0.654,0
85,20,2,65,0,7,0,0,87.04,786559,3.952,26.3,5.305,7435.047,373.159,11.62,0.654,0
85,21,1,66,0,7,0,0,87.04,786559,3.952,26.3,5.305,7435.047,373.159,11.62,0.654,0
85,22,1,67,0,7,0,0,87.04,786559,3.952,26.3,5.305,7435.047,373.159,11.62,0.654,0
85,23,0,67,0,7,0,0,87.04,786559,3.952,26.3,5.305,7435.047,373.159,11.62,0.654,0
85,24,3,70,0,7,0,0,87.04,786559,3.952,26.3,5.305,7435.047,373.159,11.62,0.654,0
85,25,3,73,1,8,0,0,87.04,786559,3.952,26.3,5.305,7435.047,373.159,11.62,0.654,0
85,26,1,74,0,8,0,0,87.04,786559,3.952,26.3,5.305,7435.047,373.159,11.62,0.654,0
85,27,0,74,0,8,0,0,87.04,786559,3.952,26.3,5.305,7435.047,373.159,11.62,0.654,0
85,28,0,74,0,8,0,0,87.04,786559,3.952,26.3,5.305,7435.047,373.159,11.62,0.654,0
85,29,1,75,0,8,0,0,87.04,786559,3.952,26.3,5.305,7435.047,373.159,11.62,0.654,0
85,30,3,78,0,8,0,0,87.04,786559,3.952,26.3,5.305,7435.047,373.159,11.62,0.654,0
85,31,4,82,1,9,0,0,87.04,786559,3.952,26.3,5.305,7435.047,373.159,11.62,0.654,0
85,32,0,82,0,9,0,0,87.04,786559,3.952,26.3,5.305,7435.047,373.159,11.62,0.654,0
85,33,0,82,0,9,0,0,87.04,786559,3.952,26.3,5.305,7435.047,373.159,11.62,0.654,0
85,34,0,82,0,9,0,0,87.04,786559,3.952,26.3,5.305,7435.047,373.159,11.62,0.654,0
85,35,10,92,0,9,0,0,87.04,786559,3.952,26.3,5.305,7435.047,373.159,11.62,0.654,0
85,36,1,93,1,10,0,0,87.04,786559,3.952,26.3,5.305,7435.047,373.159,11.62,0.654,0
85,37,0,93,0,10,0,0,87.04,786559,3.952,26.3,5.305,7435.047,373.159,11.62,0.654,0
85,38,0,93,0,10,0,0,87.04,786559,3.952,26.3,5.305,7435.047,373.159,11.62,0.654,0
85,39,1,94,0,10,0,0,87.04,786559,3.952,26.3,5.305,7435.047,373.159,11.62,0.654,0
85,40,3,97,0,10,0,0,87.04,786559,3.952,26.3,5.305,7435.047,373.159,11.62,0.654,0
85,41,7,104,0,10,0,0,87.04,786559,3.952,26.3,5.305,7435.047,373.159,11.62,0.654,0
85,42,5,109,0,10,0,0,87.04,786559,3.952,26.3,5.305,7435.047,373.159,11.62,0.654,0
85,43,4,113,0,10,0,0,87.04,786559,3.952,26.3,5.305,7435.047,373.159,11.62,0.654,0
85,44,0,113,0,10,0,0,87.04,786559,3.952,26.3,5.305,7435.047,373.159,11.62,0.654,0
85,45,0,113,0,10,0,0,87.04,786559,3.952,26.3,5.305,7435.047,373.159,11.62,0.654,0
85,46,3,116,0,10,0,0,87.04,786559,3.952,26.3,5.305,7435.047,373.159,11.62,0.654,0
85,47,1,117,0,10,0,0,87.04,786559,3.952,26.3,5.305,7435.047,373.159,11.62,0.654,0
85,48,0,117,0,10,0,0,87.04,786559,3.952,26.3,5.305,7435.047,373.159,11.62,0.654,0
85,49,7,124,0,10,0,0,87.04,786559,3.952,26.3,5.305,7435.047,373.159,11.62,0.654,0
85,50,1,125,0,10,0,0,87.04,786559,3.952,26.3,5.305,7435.047,373.159,11.62,0.654,0
85,51,0,125,0,10,0,0,87.04,786559,3.952,26.3,5.305,7435.047,373.159,11.62,0.654,0
85,52,2,127,0,10,0,0,87.04,786559,3.952,26.3,5.305,7435.047,373.159,11.62,0.654,0
85,53,0,127,0,10,0,0,87.04,786559,3.952,26.3,5.305,7435.047,373.159,11.62,0.654,0
85,54,0,127,0,10,0,0,87.04,786559,3.952,26.3,5.305,7435.047,373.159,11.62,0.654,0
85,55,8,135,0,10,0,0,87.04,786559,3.952,26.3,5.305,7435.047,373.159,11.62,0.654,0
85,56,2,137,1,11,0,0,87.04,786559,3.952,26.3,5.305,7435.047,373.159,11.62,0.654,0
85,57,2,139,0,11,0,0,87.04,786559,3.952,26.3,5.305,7435.047,373.159,11.62,0.654,0
85,58,0,139,0,11,0,0,87.04,786559,3.952,26.3,5.305,7435.047,373.159,11.62,0.654,0
85,59,11,150,0,11,0,0,87.04,786559,3.952,26.3,5.305,7435.047,373.159,11.62,0.654,0
85,60,0,150,0,11,0,0,87.04,786559,3.952,26.3,5.305,7435.047,373.159,11.62,0.654,0
85,61,2,152,1,12,0,0,87.04,786559,3.952,26.3,5.305,7435.047,373.159,11.62,0.654,0
85,62,1,153,0,12,0,0,87.04,786559,3.952,26.3,5.305,7435.047,373.159,11.62,0.654,0
85,63,0,153,0,12,0,0,87.04,786559,3.952,26.3,5.305,7435.047,373.159,11.62,0.654,0
85,64,0,153,0,12,0,0,87.04,786559,3.952,26.3,5.305,7435.047,373.159,11.62,0.654,0
85,65,0,153,0,12,0,0,87.04,786559,3.952,26.3,5.305,7435.047,373.159,11.62,0.654,0
85,66,0,153,0,12,0,0,87.04,786559,3.952,26.3,5.305,7435.047,373.159,11.62,0.654,0
85,67,0,153,0,12,0,0,87.04,786559,3.952,26.3,5.305,7435.047,373.159,11.62,0.654,0
85,68,1,154,0,12,0,0,87.04,786559,3.952,26.3,5.305,7435.047,373.159,11.62,0.654,0
85,69,0,154,0,12,0,0,83.33,786559,3.952,26.3,5.305,7435.047,373.159,11.62,0.654,0
85,70,0,154,0,12,0,0,83.33,786559,3.952,26.3,5.305,7435.047,373.159,11.62,0.654,0
85,71,2,156,0,12,0,0,83.33,786559,3.952,26.3,5.305,7435.047,373.159,11.62,0.654,0
85,72,0,156,0,12,0,0,83.33,786559,3.952,26.3,5.305,7435.047,373.159,11.62,0.654,0
85,73,2,158,0,12,0,0,83.33,786559,3.952,26.3,5.305,7435.047,373.159,11.62,0.654,0
85,74,1,159,0,12,0,0,83.33,786559,3.952,26.3,5.305,7435.047,373.159,11.62,0.654,0
85,75,0,159,0,12,0,0,83.33,786559,3.952,26.3,5.305,7435.047,373.159,11.62,0.654,0
85,76,0,159,0,12,0,0,83.33,786559,3.952,26.3,5.305,7435.047,373.159,11.62,0.654,0
85,77,0,159,0,12,0,0,83.33,786559,3.952,26.3,5.305,7435.047,373.159,11.62,0.654,0
85,78,12,171,0,12,0,0,79.63,786559,3.952,26.3,5.305,7435.047,373.159,11.62,0.654,0
85,79,0,171,0,12,0,0,79.63,786559,3.952,26.3,5.305,7435.047,373.159,11.62,0.654,0
85,80,12,183,0,12,0,0,79.63,786559,3.952,26.3,5.305,7435.047,373.159,11.62,0.654,0
85,81,0,183,0,12,0,0,79.63,786559,3.952,26.3,5.305,7435.047,373.159,11.62,0.654,0
85,82,0,183,0,12,0,0,79.63,786559,3.952,26.3,5.305,7435.047,373.159,11.62,0.654,0
85,83,1,184,0,12,0,0,79.63,786559,3.952,26.3,5.305,7435.047,373.159,11.62,0.654,0
85,84,21,205,0,12,0,0,79.63,786559,3.952,26.3,5.305,7435.047,373.159,11.62,0.654,0
85,85,1,206,0,12,0,0,79.63,786559,3.952,26.3,5.305,7435.047,373.159,11.62,0.654,0
85,86,3,209,0,12,0,0,79.63,786559,3.952,26.3,5.305,7435.047,373.159,11.62,0.654,0
85,87,6,215,0,12,0,0,79.63,786559,3.952,26.3,5.305,7435.047,373.159,11.62,0.654,0
85,88,15,230,0,12,0,0,79.63,786559,3.952,26.3,5.305,7435.047,373.159,11.62,0.654,0
85,89,0,230,0,12,0,0,79.63,786559,3.952,26.3,5.305,7435.047,373.159,11.62,0.654,0
85,90,0,230,0,12,0,0,79.63,786559,3.952,26.3,5.305,7435.047,373.159,11.62,0.654,0
85,91,5,235,0,12,0,0,79.63,786559,3.952,26.3,5.305,7435.047,373.159,11.62,0.654,0
85,92,10,245,0,12,0,0,79.63,786559,3.952,26.3,5.305,7435.047,373.159,11.62,0.654,0
85,93,3,248,1,13,0,0,79.63,786559,3.952,26.3,5.305,7435.047,373.159,11.62,0.654,0
85,94,2,250,1,14,0,0,77.31,786559,3.952,26.3,5.305,7435.047,373.159,11.62,0.654,0
85,95,6,256,0,14,0,0,77.31,786559,3.952,26.3,5.305,7435.047,373.159,11.62,0.654,0
85,96,16,272,0,14,0,0,77.31,786559,3.952,26.3,5.305,7435.047,373.159,11.62,0.654,0
85,97,1,273,1,15,0,0,77.31,786559,3.952,26.3,5.305,7435.047,373.159,11.62,0.654,0
85,98,5,278,1,16,0,0,77.31,786559,3.952,26.3,5.305,7435.047,373.159,11.62,0.654,0
85,99,7,285,0,16,0,0,77.31,786559,3.952,26.3,5.305,7435.047,373.159,11.62,0.654,0
85,100,0,285,0,16,0,0,77.31,786559,3.952,26.3,5.305,7435.047,373.159,11.62,0.654,0
85,101,1,286,0,16,0,0,77.31,786559,3.952,26.3,5.305,7435.047,373.159,11.62,0.654,0
85,102,4,290,0,16,0,0,77.31,786559,3.952,26.3,5.305,7435.047,373.159,11.62,0.654,0
85,103,1,291,1,17,0,0,77.31,786559,3.952,26.3,5.305,7435.047,373.159,11.62,0.654,0
85,104,6,297,0,17,0,0,77.31,786559,3.952,26.3,5.305,7435.047,373.159,11.62,0.654,0
85,105,3,300,0,17,0,0,77.31,786559,3.952,26.3,5.305,7435.047,373.159,11.62,0.654,0
85,106,8,308,0,17,0,0,77.31,786559,3.952,26.3,5.305,7435.047,373.159,11.62,0.654,0
85,107,5,313,1,18,0,0,77.31,786559,3.952,26.3,5.305,7435.047,373.159,11.62,0.654,0
85,108,1,314,1,19,0,0,77.31,786559,3.952,26.3,5.305,7435.047,373.159,11.62,0.654,0
85,109,1,315,0,19,0,0,77.31,786559,3.952,26.3,5.305,7435.047,373.159,11.62,0.654,0
85,110,12,327,0,19,0,0,77.31,786559,3.952,26.3,5.305,7435.047,373.159,11.62,0.654,0
85,111,9,336,0,19,0,0,77.31,786559,3.952,26.3,5.305,7435.047,373.159,11.62,0.654,0
85,112,1,337,0,19,0,0,77.31,786559,3.952,26.3,5.305,7435.047,373.159,11.62,0.654,0
85,113,2,339,0,19,0,0,77.31,786559,3.952,26.3,5.305,7435.047,373.159,11.62,0.654,0
85,114,11,350,0,19,0,0,77.31,786559,3.952,26.3,5.305,7435.047,373.159,11.62,0.654,0
85,115,1,351,0,19,0,0,77.31,786559,3.952,26.3,5.305,7435.047,373.159,11.62,0.654,0
85,116,1,352,1,20,0,0,77.31,786559,3.952,26.3,5.305,7435.047,373.159,11.62,0.654,0
85,117,8,360,0,20,0,0,77.31,786559,3.952,26.3,5.305,7435.047,373.159,11.62,0.654,0
85,118,10,370,0,20,0,0,77.31,786559,3.952,26.3,5.305,7435.047,373.159,11.62,0.654,0
85,119,19,389,0,20,0,0,77.31,786559,3.952,26.3,5.305,7435.047,373.159,11.62,0.654,0
85,120,7,396,0,20,0,0,77.31,786559,3.952,26.3,5.305,7435.047,373.159,11.62,0.654,0
85,121,2,398,0,20,0,0,77.31,786559,3.952,26.3,5.305,7435.047,373.159,11.62,0.654,0
85,122,3,401,0,20,0,0,77.31,786559,3.952,26.3,5.305,7435.047,373.159,11.62,0.654,0
85,123,12,413,0,20,0,0,75.93,786559,3.952,26.3,5.305,7435.047,373.159,11.62,0.654,0
85,124,17,430,0,20,0,0,75.93,786559,3.952,26.3,5.305,7435.047,373.159,11.62,0.654,0
85,125,44,474,1,21,0,0,75.93,786559,3.952,26.3,5.305,7435.047,373.159,11.62,0.654,0
85,126,0,474,0,21,0,0,75.93,786559,3.952,26.3,5.305,7435.047,373.159,11.62,0.654,0
85,127,23,497,1,22,0,0,75.93,786559,3.952,26.3,5.305,7435.047,373.159,11.62,0.654,0
85,128,12,509,0,22,0,0,75.93,786559,3.952,26.3,5.305,7435.047,373.159,11.62,0.654,0
85,129,29,538,0,22,0,0,75.93,786559,3.952,26.3,5.305,7435.047,373.159,11.62,0.654,0
85,130,0,538,0,22,0,0,75.93,786559,3.952,26.3,5.305,7435.047,373.159,11.62,0.654,0
85,131,16,554,0,22,0,0,75.93,786559,3.952,26.3,5.305,7435.047,373.159,11.62,0.654,0
85,132,14,568,0,22,0,0,75.93,786559,3.952,26.3,5.305,7435.047,373.159,11.62,0.654,0
85,133,0,568,0,22,0,0,75.93,786559,3.952,26.3,5.305,7435.047,373.159,11.62,0.654,0
85,134,0,568,0,22,0,0,75.93,786559,3.952,26.3,5.305,7435.047,373.159,11.62,0.654,0
85,135,55,623,0,22,0,0,75.93,786559,3.952,26.3,5.305,7435.047,373.159,11.62,0.654,0
85,136,8,631,0,22,0,0,73.15,786559,3.952,26.3,5.305,7435.047,373.159,11.62,0.654,0
85,137,18,649,0,22,0,0,73.15,786559,3.952,26.3,5.305,7435.047,373.159,11.62,0.654,0
85,138,25,674,0,22,0,0,73.15,786559,3.952,26.3,5.305,7435.047,373.159,11.62,0.654,0
85,139,35,709,1,23,0,0,73.15,786559,3.952,26.3,5.305,7435.047,373.159,11.62,0.654,0
85,140,0,709,0,23,0,0,73.15,786559,3.952,26.3,5.305,7435.047,373.159,11.62,0.654,0
85,141,28,737,2,25,0,0,73.15,786559,3.952,26.3,5.305,7435.047,373.159,11.62,0.654,0
85,142,39,776,2,27,0,0,73.15,786559,3.952,26.3,5.305,7435.047,373.159,11.62,0.654,0
85,143,70,846,2,29,0,0,73.15,786559,3.952,26.3,5.305,7435.047,373.159,11.62,0.654,0
85,144,35,881,1,30,0,0,73.15,786559,3.952,26.3,5.305,7435.047,373.159,11.62,0.654,0
85,145,44,925,1,31,0,0,73.15,786559,3.952,26.3,5.305,7435.047,373.159,11.62,0.654,0
85,146,30,955,0,31,0,0,73.15,786559,3.952,26.3,5.305,7435.047,373.159,11.62,0.654,0
85,147,0,955,0,31,0,0,73.15,786559,3.952,26.3,5.305,7435.047,373.159,11.62,0.654,0
85,148,105,1060,0,31,0,0,73.15,786559,3.952,26.3,5.305,7435.047,373.159,11.62,0.654,0
85,149,33,1093,0,31,0,0,73.15,786559,3.952,26.3,5.305,7435.047,373.159,11.62,0.654,0
85,150,47,1140,1,32,0,0,73.15,786559,3.952,26.3,5.305,7435.047,373.159,11.62,0.654,0
85,151,40,1180,3,35,0,0,73.15,786559,3.952,26.3,5.305,7435.047,373.159,11.62,0.654,0
85,152,4,1184,0,35,0,0,73.15,786559,3.952,26.3,5.305,7435.047,373.159,11.62,0.654,0
85,153,50,1234,2,37,0,0,73.15,786559,3.952,26.3,5.305,7435.047,373.159,11.62,0.654,0
85,154,72,1306,2,39,0,0,73.15,786559,3.952,26.3,5.305,7435.047,373.159,11.62,0.654,0
85,155,67,1373,2,41,0,0,73.15,786559,3.952,26.3,5.305,7435.047,373.159,11.62,0.654,0
85,156,9,1382,0,41,0,0,73.15,786559,3.952,26.3,5.305,7435.047,373.159,11.62,0.654,0
85,157,19,1401,3,44,0,0,73.15,786559,3.952,26.3,5.305,7435.047,373.159,11.62,0.654,0
85,158,15,1416,0,44,0,0,73.15,786559,3.952,26.3,5.305,7435.047,373.159,11.62,0.654,0
85,159,43,1459,2,46,0,0,73.15,786559,3.952,26.3,5.305,7435.047,373.159,11.62,0.654,0
85,160,9,1468,0,46,0,0,73.15,786559,3.952,26.3,5.305,7435.047,373.159,11.62,0.654,0
85,161,92,1560,1,47,0,0,73.15,786559,3.952,26.3,5.305,7435.047,373.159,11.62,0.654,0
85,162,53,1613,1,48,0,0,75,786559,3.952,26.3,5.305,7435.047,373.159,11.62,0.654,0
85,163,90,1703,0,48,0,0,75,786559,3.952,26.3,5.305,7435.047,373.159,11.62,0.654,0
85,164,47,1750,1,49,0,0,75,786559,3.952,26.3,5.305,7435.047,373.159,11.62,0.654,0
85,165,13,1763,3,52,0,0,75,786559,3.952,26.3,5.305,7435.047,373.159,11.62,0.654,0
85,166,49,1812,2,54,0,0,75,786559,3.952,26.3,5.305,7435.047,373.159,11.62,0.654,0
85,167,41,1853,2,56,0,0,75,786559,3.952,26.3,5.305,7435.047,373.159,11.62,0.654,0
85,168,31,1884,0,56,0,0,75,786559,3.952,26.3,5.305,7435.047,373.159,11.62,0.654,0
85,169,74,1958,2,58,0,0,75,786559,3.952,26.3,5.305,7435.047,373.159,11.62,0.654,0
85,170,0,1958,0,58,0,0,75,786559,3.952,26.3,5.305,7435.047,373.159,11.62,0.654,0
85,171,69,2027,2,60,0,0,75,786559,3.952,26.3,5.305,7435.047,373.159,11.62,0.654,0
85,172,75,2102,2,62,0,0,75,786559,3.952,26.3,5.305,7435.047,373.159,11.62,0.654,0
85,173,66,2168,2,64,0,0,75,786559,3.952,26.3,5.305,7435.047,373.159,11.62,0.654,0
85,174,101,2269,0,64,0,0,75,786559,3.952,26.3,5.305,7435.047,373.159,11.62,0.654,0
85,175,133,2402,1,65,0,0,79.17,786559,3.952,26.3,5.305,7435.047,373.159,11.62,0.654,0
85,176,35,2437,2,67,0,0,79.17,786559,3.952,26.3,5.305,7435.047,373.159,11.62,0.654,0
85,177,98,2535,2,69,0,0,79.17,786559,3.952,26.3,5.305,7435.047,373.159,11.62,0.654,0
85,178,44,2579,2,71,0,0,79.17,786559,3.952,26.3,5.305,7435.047,373.159,11.62,0.654,0
85,179,130,2709,2,73,0,0,79.17,786559,3.952,26.3,5.305,7435.047,373.159,11.62,0.654,0
85,180,16,2725,1,74,0,0,79.17,786559,3.952,26.3,5.305,7435.047,373.159,11.62,0.654,0
85,181,47,2772,2,76,0,0,79.17,786559,3.952,26.3,5.305,7435.047,373.159,11.62,0.654,0
85,182,15,2787,2,78,0,0,79.17,786559,3.952,26.3,5.305,7435.047,373.159,11.62,0.654,0
85,183,59,2846,0,78,0,0,79.17,786559,3.952,26.3,5.305,7435.047,373.159,11.62,0.654,0
85,184,48,2894,2,80,0,0,79.17,786559,3.952,26.3,5.305,7435.047,373.159,11.62,0.654,0
85,185,35,2929,2,82,0,0,79.17,786559,3.952,26.3,5.305,7435.047,373.159,11.62,0.654,0
85,186,39,2968,3,85,0,0,79.17,786559,3.952,26.3,5.305,7435.047,373.159,11.62,0.654,0
85,187,37,3005,0,85,0,0,79.17,786559,3.952,26.3,5.305,7435.047,373.159,11.62,0.654,0
85,188,88,3093,2,87,0,0,79.17,786559,3.952,26.3,5.305,7435.047,373.159,11.62,0.654,0
85,189,95,3188,3,90,0,0,79.17,786559,3.952,26.3,5.305,7435.047,373.159,11.62,0.654,0
85,190,0,3188,2,92,0,0,79.17,786559,3.952,26.3,5.305,7435.047,373.159,11.62,0.654,0
85,191,104,3292,3,95,0,0,79.17,786559,3.952,26.3,5.305,7435.047,373.159,11.62,0.654,0
85,192,37,3329,3,98,0,0,79.17,786559,3.952,26.3,5.305,7435.047,373.159,11.62,0.654,0
85,193,29,3358,2,100,0,0,79.17,786559,3.952,26.3,5.305,7435.047,373.159,11.62,0.654,0
85,194,47,3405,2,102,0,0,79.17,786559,3.952,26.3,5.305,7435.047,373.159,11.62,0.654,0
85,195,64,3469,1,103,0,0,79.17,786559,3.952,26.3,5.305,7435.047,373.159,11.62,0.654,0
85,196,52,3521,1,104,0,0,79.17,786559,3.952,26.3,5.305,7435.047,373.159,11.62,0.654,0
85,197,44,3565,2,106,0,0,79.17,786559,3.952,26.3,5.305,7435.047,373.159,11.62,0.654,0
85,198,24,3589,0,106,0,0,79.17,786559,3.952,26.3,5.305,7435.047,373.159,11.62,0.654,0
85,199,31,3620,1,107,0,0,79.17,786559,3.952,26.3,5.305,7435.047,373.159,11.62,0.654,0
85,200,52,3672,0,107,0,0,79.17,786559,3.952,26.3,5.305,7435.047,373.159,11.62,0.654,0
85,201,38,3710,2,109,0,0,79.17,786559,3.952,26.3,5.305,7435.047,373.159,11.62,0.654,0
85,202,24,3734,0,109,0,0,79.17,786559,3.952,26.3,5.305,7435.047,373.159,11.62,0.654,0
85,203,31,3765,2,111,0,0,79.17,786559,3.952,26.3,5.305,7435.047,373.159,11.62,0.654,0
85,204,31,3796,3,114,0,0,79.17,786559,3.952,26.3,5.305,7435.047,373.159,11.62,0.654,0
86,1,0,15,0,0,0,0,82.41,11402533,398.448,24.3,4.8,1653.173,430.548,6.65,0.498,0
86,2,1,16,0,0,0,0,82.41,11402533,398.448,24.3,4.8,1653.173,430.548,6.65,0.498,0
86,3,2,18,0,0,0,0,82.41,11402533,398.448,24.3,4.8,1653.173,430.548,6.65,0.498,0
86,4,0,18,0,0,0,0,82.41,11402533,398.448,24.3,4.8,1653.173,430.548,6.65,0.498,0
86,5,3,21,0,0,0,0,82.41,11402533,398.448,24.3,4.8,1653.173,430.548,6.65,0.498,0
86,6,0,21,0,0,0,0,90.74,11402533,398.448,24.3,4.8,1653.173,430.548,6.65,0.498,0
86,7,3,24,1,1,0,0,90.74,11402533,398.448,24.3,4.8,1653.173,430.548,6.65,0.498,0
86,8,1,25,0,1,0,0,90.74,11402533,398.448,24.3,4.8,1653.173,430.548,6.65,0.498,0
86,9,2,27,0,1,0,0,90.74,11402533,398.448,24.3,4.8,1653.173,430.548,6.65,0.498,0
86,10,3,30,1,2,0,0,90.74,11402533,398.448,24.3,4.8,1653.173,430.548,6.65,0.498,0
86,11,1,31,0,2,0,0,90.74,11402533,398.448,24.3,4.8,1653.173,430.548,6.65,0.498,0
86,12,2,33,0,2,0,0,90.74,11402533,398.448,24.3,4.8,1653.173,430.548,6.65,0.498,0
86,13,0,33,1,3,0,0,90.74,11402533,398.448,24.3,4.8,1653.173,430.548,6.65,0.498,0
86,14,7,40,0,3,0,0,90.74,11402533,398.448,24.3,4.8,1653.173,430.548,6.65,0.498,0
86,15,0,40,0,3,0,0,90.74,11402533,398.448,24.3,4.8,1653.173,430.548,6.65,0.498,0
86,16,1,41,0,3,0,0,90.74,11402533,398.448,24.3,4.8,1653.173,430.548,6.65,0.498,0
86,17,2,43,0,3,0,0,90.74,11402533,398.448,24.3,4.8,1653.173,430.548,6.65,0.498,0
86,18,1,44,0,3,0,0,90.74,11402533,398.448,24.3,4.8,1653.173,430.548,6.65,0.498,0
86,19,0,44,0,3,0,0,93.52,11402533,398.448,24.3,4.8,1653.173,430.548,6.65,0.498,0
86,20,3,47,0,3,0,0,89.81,11402533,398.448,24.3,4.8,1653.173,430.548,6.65,0.498,0
86,21,10,57,0,3,0,0,89.81,11402533,398.448,24.3,4.8,1653.173,430.548,6.65,0.498,0
86,22,1,58,1,4,0,0,89.81,11402533,398.448,24.3,4.8,1653.173,430.548,6.65,0.498,0
86,23,4,62,0,4,0,0,89.81,11402533,398.448,24.3,4.8,1653.173,430.548,6.65,0.498,0
86,24,10,72,1,5,0,0,89.81,11402533,398.448,24.3,4.8,1653.173,430.548,6.65,0.498,0
86,25,0,72,0,5,0,0,89.81,11402533,398.448,24.3,4.8,1653.173,430.548,6.65,0.498,0
86,26,0,72,1,6,0,0,89.81,11402533,398.448,24.3,4.8,1653.173,430.548,6.65,0.498,0
86,27,0,72,0,6,0,0,89.81,11402533,398.448,24.3,4.8,1653.173,430.548,6.65,0.498,0
86,28,4,76,0,6,0,0,89.81,11402533,398.448,24.3,4.8,1653.173,430.548,6.65,0.498,0
86,29,0,76,0,6,0,0,89.81,11402533,398.448,24.3,4.8,1653.173,430.548,6.65,0.498,0
86,30,0,76,0,6,0,0,89.81,11402533,398.448,24.3,4.8,1653.173,430.548,6.65,0.498,0
86,31,5,81,2,8,0,0,89.81,11402533,398.448,24.3,4.8,1653.173,430.548,6.65,0.498,0
86,32,4,85,0,8,0,0,89.81,11402533,398.448,24.3,4.8,1653.173,430.548,6.65,0.498,0
86,33,0,85,0,8,0,0,89.81,11402533,398.448,24.3,4.8,1653.173,430.548,6.65,0.498,0
86,34,0,85,0,8,0,0,89.81,11402533,398.448,24.3,4.8,1653.173,430.548,6.65,0.498,0
86,35,15,100,3,11,0,0,89.81,11402533,398.448,24.3,4.8,1653.173,430.548,6.65,0.498,0
86,36,1,101,1,12,0,0,89.81,11402533,398.448,24.3,4.8,1653.173,430.548,6.65,0.498,0
86,37,7,108,0,12,0,0,89.81,11402533,398.448,24.3,4.8,1653.173,430.548,6.65,0.498,0
86,38,21,129,0,12,0,0,89.81,11402533,398.448,24.3,4.8,1653.173,430.548,6.65,0.498,0
86,39,17,146,0,12,0,0,89.81,11402533,398.448,24.3,4.8,1653.173,430.548,6.65,0.498,0
86,40,5,151,0,12,0,0,89.81,11402533,398.448,24.3,4.8,1653.173,430.548,6.65,0.498,0
86,41,31,182,3,15,0,0,89.81,11402533,398.448,24.3,4.8,1653.173,430.548,6.65,0.498,0
86,42,27,209,1,16,0,0,89.81,11402533,398.448,24.3,4.8,1653.173,430.548,6.65,0.498,0
86,43,10,219,2,18,0,0,89.81,11402533,398.448,24.3,4.8,1653.173,430.548,6.65,0.498,0
86,44,15,234,0,18,0,0,89.81,11402533,398.448,24.3,4.8,1653.173,430.548,6.65,0.498,0
86,45,39,273,2,20,0,0,89.81,11402533,398.448,24.3,4.8,1653.173,430.548,6.65,0.498,0
86,46,37,310,0,20,0,0,89.81,11402533,398.448,24.3,4.8,1653.173,430.548,6.65,0.498,0
86,47,48,358,0,20,0,0,89.81,11402533,398.448,24.3,4.8,1653.173,430.548,6.65,0.498,0
86,48,98,456,0,20,0,0,89.81,11402533,398.448,24.3,4.8,1653.173,430.548,6.65,0.498,0
86,49,77,533,1,21,0,0,89.81,11402533,398.448,24.3,4.8,1653.173,430.548,6.65,0.498,0
86,50,63,596,1,22,0,0,89.81,11402533,398.448,24.3,4.8,1653.173,430.548,6.65,0.498,0
86,51,0,596,0,22,0,0,89.81,11402533,398.448,24.3,4.8,1653.173,430.548,6.65,0.498,0
86,52,138,734,3,25,0,0,89.81,11402533,398.448,24.3,4.8,1653.173,430.548,6.65,0.498,0
86,53,78,812,0,25,0,0,89.81,11402533,398.448,24.3,4.8,1653.173,430.548,6.65,0.498,0
86,54,53,865,1,26,0,0,89.81,11402533,398.448,24.3,4.8,1653.173,430.548,6.65,0.498,0
86,55,93,958,1,27,0,0,89.81,11402533,398.448,24.3,4.8,1653.173,430.548,6.65,0.498,0
86,56,105,1063,4,31,0,0,89.81,11402533,398.448,24.3,4.8,1653.173,430.548,6.65,0.498,0
86,57,111,1174,2,33,0,0,89.81,11402533,398.448,24.3,4.8,1653.173,430.548,6.65,0.498,0
86,58,146,1320,1,34,0,0,89.81,11402533,398.448,24.3,4.8,1653.173,430.548,6.65,0.498,0
86,59,123,1443,1,35,0,0,89.81,11402533,398.448,24.3,4.8,1653.173,430.548,6.65,0.498,0
86,60,141,1584,0,35,0,0,89.81,11402533,398.448,24.3,4.8,1653.173,430.548,6.65,0.498,0
86,61,281,1865,6,41,0,0,89.81,11402533,398.448,24.3,4.8,1653.173,430.548,6.65,0.498,0
86,62,259,2124,3,44,0,0,89.81,11402533,398.448,24.3,4.8,1653.173,430.548,6.65,0.498,0
86,63,102,2226,1,45,0,0,80.56,11402533,398.448,24.3,4.8,1653.173,430.548,6.65,0.498,0
86,64,281,2507,3,48,0,0,80.56,11402533,398.448,24.3,4.8,1653.173,430.548,6.65,0.498,0
86,65,133,2640,2,50,0,0,80.56,11402533,398.448,24.3,4.8,1653.173,430.548,6.65,0.498,0
86,66,0,2640,0,50,0,0,80.56,11402533,398.448,24.3,4.8,1653.173,430.548,6.65,0.498,0
86,67,284,2924,0,50,0,0,80.56,11402533,398.448,24.3,4.8,1653.173,430.548,6.65,0.498,0
86,68,148,3072,0,50,0,0,80.56,11402533,398.448,24.3,4.8,1653.173,430.548,6.65,0.498,0
86,69,262,3334,1,51,0,0,80.56,11402533,398.448,24.3,4.8,1653.173,430.548,6.65,0.498,0
86,70,204,3538,3,54,0,0,80.56,11402533,398.448,24.3,4.8,1653.173,430.548,6.65,0.498,0
86,71,124,3662,2,56,0,0,80.56,11402533,398.448,24.3,4.8,1653.173,430.548,6.65,0.498,0
86,72,134,3796,2,58,0,0,80.56,11402533,398.448,24.3,4.8,1653.173,430.548,6.65,0.498,0
86,73,145,3941,6,64,0,0,80.56,11402533,398.448,24.3,4.8,1653.173,430.548,6.65,0.498,0
86,74,0,3941,0,64,0,0,80.56,11402533,398.448,24.3,4.8,1653.173,430.548,6.65,0.498,0
86,75,224,4165,6,70,0,0,80.56,11402533,398.448,24.3,4.8,1653.173,430.548,6.65,0.498,0
86,76,144,4309,3,73,0,0,80.56,11402533,398.448,24.3,4.8,1653.173,430.548,6.65,0.498,0
86,77,132,4441,3,76,0,0,80.56,11402533,398.448,24.3,4.8,1653.173,430.548,6.65,0.498,0
86,78,106,4547,4,80,0,0,80.56,11402533,398.448,24.3,4.8,1653.173,430.548,6.65,0.498,0
86,79,141,4688,2,82,0,0,80.56,11402533,398.448,24.3,4.8,1653.173,430.548,6.65,0.498,0
86,80,228,4916,2,84,0,0,80.56,11402533,398.448,24.3,4.8,1653.173,430.548,6.65,0.498,0
86,81,64,4980,3,87,0,0,80.56,11402533,398.448,24.3,4.8,1653.173,430.548,6.65,0.498,0
86,82,97,5077,1,88,0,0,80.56,11402533,398.448,24.3,4.8,1653.173,430.548,6.65,0.498,0
86,83,134,5211,0,88,0,0,80.56,11402533,398.448,24.3,4.8,1653.173,430.548,6.65,0.498,0
86,84,0,5211,0,88,0,0,77.78,11402533,398.448,24.3,4.8,1653.173,430.548,6.65,0.498,0
86,85,113,5324,1,89,0,0,77.78,11402533,398.448,24.3,4.8,1653.173,430.548,6.65,0.498,0
86,86,105,5429,3,92,0,0,77.78,11402533,398.448,24.3,4.8,1653.173,430.548,6.65,0.498,0
86,87,114,5543,4,96,0,0,77.78,11402533,398.448,24.3,4.8,1653.173,430.548,6.65,0.498,0
86,88,179,5722,2,98,0,0,77.78,11402533,398.448,24.3,4.8,1653.173,430.548,6.65,0.498,0
86,89,55,5777,2,100,0,0,77.78,11402533,398.448,24.3,4.8,1653.173,430.548,6.65,0.498,0
86,90,70,5847,4,104,0,0,77.78,11402533,398.448,24.3,4.8,1653.173,430.548,6.65,0.498,0
86,91,86,5933,1,105,0,0,72.22,11402533,398.448,24.3,4.8,1653.173,430.548,6.65,0.498,0
86,92,42,5975,0,105,0,0,72.22,11402533,398.448,24.3,4.8,1653.173,430.548,6.65,0.498,0
86,93,65,6040,2,107,0,0,72.22,11402533,398.448,24.3,4.8,1653.173,430.548,6.65,0.498,0
86,94,61,6101,3,110,0,0,72.22,11402533,398.448,24.3,4.8,1653.173,430.548,6.65,0.498,0
86,95,129,6230,0,110,0,0,72.22,11402533,398.448,24.3,4.8,1653.173,430.548,6.65,0.498,0
86,96,64,6294,3,113,0,0,72.22,11402533,398.448,24.3,4.8,1653.173,430.548,6.65,0.498,0
86,97,39,6333,0,113,0,0,72.22,11402533,398.448,24.3,4.8,1653.173,430.548,6.65,0.498,0
86,98,38,6371,0,113,0,0,72.22,11402533,398.448,24.3,4.8,1653.173,430.548,6.65,0.498,0
86,99,61,6432,4,117,0,0,72.22,11402533,398.448,24.3,4.8,1653.173,430.548,6.65,0.498,0
86,100,54,6486,6,123,0,0,72.22,11402533,398.448,24.3,4.8,1653.173,430.548,6.65,0.498,0
86,101,0,6486,0,123,0,0,72.22,11402533,398.448,24.3,4.8,1653.173,430.548,6.65,0.498,0
86,102,131,6617,12,135,0,0,72.22,11402533,398.448,24.3,4.8,1653.173,430.548,6.65,0.498,0
86,103,73,6690,4,139,0,0,72.22,11402533,398.448,24.3,4.8,1653.173,430.548,6.65,0.498,0
86,104,37,6727,0,139,0,0,72.22,11402533,398.448,24.3,4.8,1653.173,430.548,6.65,0.498,0
86,105,0,6727,2,141,0,0,72.22,11402533,398.448,24.3,4.8,1653.173,430.548,6.65,0.498,0
86,106,104,6831,2,143,0,0,69.44,11402533,398.448,24.3,4.8,1653.173,430.548,6.65,0.498,0
86,107,71,6902,2,145,0,0,69.44,11402533,398.448,24.3,4.8,1653.173,430.548,6.65,0.498,0
86,108,46,6948,0,145,0,0,69.44,11402533,398.448,24.3,4.8,1653.173,430.548,6.65,0.498,0
86,109,27,6975,1,146,0,0,69.44,11402533,398.448,24.3,4.8,1653.173,430.548,6.65,0.498,0
86,110,78,7053,0,146,0,0,69.44,11402533,398.448,24.3,4.8,1653.173,430.548,6.65,0.498,0
86,111,0,7053,0,146,0,0,28.7,11402533,398.448,24.3,4.8,1653.173,430.548,6.65,0.498,0
86,112,10,7063,0,146,0,0,28.7,11402533,398.448,24.3,4.8,1653.173,430.548,6.65,0.498,0
86,113,83,7146,8,154,0,0,28.7,11402533,398.448,24.3,4.8,1653.173,430.548,6.65,0.498,0
86,114,21,7167,0,154,0,0,28.7,11402533,398.448,24.3,4.8,1653.173,430.548,6.65,0.498,0
86,115,30,7197,0,154,0,0,28.7,11402533,398.448,24.3,4.8,1653.173,430.548,6.65,0.498,0
86,116,63,7260,2,156,0,0,28.7,11402533,398.448,24.3,4.8,1653.173,430.548,6.65,0.498,0
86,117,37,7297,0,156,0,0,28.7,11402533,398.448,24.3,4.8,1653.173,430.548,6.65,0.498,0
86,118,18,7315,1,157,0,0,28.7,11402533,398.448,24.3,4.8,1653.173,430.548,6.65,0.498,0
86,119,25,7340,1,158,0,0,28.7,11402533,398.448,24.3,4.8,1653.173,430.548,6.65,0.498,0
86,120,31,7371,0,158,0,0,28.7,11402533,398.448,24.3,4.8,1653.173,430.548,6.65,0.498,0
86,121,7,7378,1,159,0,0,28.7,11402533,398.448,24.3,4.8,1653.173,430.548,6.65,0.498,0
86,122,34,7412,2,161,0,0,28.7,11402533,398.448,24.3,4.8,1653.173,430.548,6.65,0.498,0
86,123,12,7424,0,161,0,0,28.7,11402533,398.448,24.3,4.8,1653.173,430.548,6.65,0.498,0
86,124,44,7468,4,165,0,0,28.7,11402533,398.448,24.3,4.8,1653.173,430.548,6.65,0.498,0
86,125,8,7476,0,165,0,0,28.7,11402533,398.448,24.3,4.8,1653.173,430.548,6.65,0.498,0
86,126,35,7511,1,166,0,0,28.7,11402533,398.448,24.3,4.8,1653.173,430.548,6.65,0.498,0
86,127,21,7532,5,171,0,0,28.7,11402533,398.448,24.3,4.8,1653.173,430.548,6.65,0.498,0
86,128,12,7544,0,171,0,0,28.7,11402533,398.448,24.3,4.8,1653.173,430.548,6.65,0.498,0
86,129,38,7582,0,171,0,0,28.7,11402533,398.448,24.3,4.8,1653.173,430.548,6.65,0.498,0
86,130,17,7599,6,177,0,0,28.7,11402533,398.448,24.3,4.8,1653.173,430.548,6.65,0.498,0
86,131,12,7611,5,182,0,0,28.7,11402533,398.448,24.3,4.8,1653.173,430.548,6.65,0.498,0
86,132,23,7634,1,183,0,0,25,11402533,398.448,24.3,4.8,1653.173,430.548,6.65,0.498,0
86,133,15,7649,0,183,0,0,25,11402533,398.448,24.3,4.8,1653.173,430.548,6.65,0.498,0
86,134,0,7649,0,183,0,0,25,11402533,398.448,24.3,4.8,1653.173,430.548,6.65,0.498,0
86,135,94,7743,4,187,0,0,25,11402533,398.448,24.3,4.8,1653.173,430.548,6.65,0.498,0
86,136,67,7810,5,192,0,0,25,11402533,398.448,24.3,4.8,1653.173,430.548,6.65,0.498,0
86,137,21,7831,4,196,0,0,25,11402533,398.448,24.3,4.8,1653.173,430.548,6.65,0.498,0
86,138,0,7831,0,196,0,0,25,11402533,398.448,24.3,4.8,1653.173,430.548,6.65,0.498,0
86,139,48,7879,0,196,0,0,17.59,11402533,398.448,24.3,4.8,1653.173,430.548,6.65,0.498,0
86,140,18,7897,0,196,0,0,17.59,11402533,398.448,24.3,4.8,1653.173,430.548,6.65,0.498,0
86,141,24,7921,0,196,0,0,17.59,11402533,398.448,24.3,4.8,1653.173,430.548,6.65,0.498,0
86,142,28,7949,0,196,0,0,17.59,11402533,398.448,24.3,4.8,1653.173,430.548,6.65,0.498,0
86,143,48,7997,0,196,0,0,17.59,11402533,398.448,24.3,4.8,1653.173,430.548,6.65,0.498,0
86,144,19,8016,0,196,0,0,17.59,11402533,398.448,24.3,4.8,1653.173,430.548,6.65,0.498,0
86,145,34,8050,0,196,0,0,17.59,11402533,398.448,24.3,4.8,1653.173,430.548,6.65,0.498,0
86,146,32,8082,0,196,0,0,17.59,11402533,398.448,24.3,4.8,1653.173,430.548,6.65,0.498,0
86,147,28,8110,0,196,0,0,17.59,11402533,398.448,24.3,4.8,1653.173,430.548,6.65,0.498,0
86,148,2,8112,0,196,0,0,17.59,11402533,398.448,24.3,4.8,1653.173,430.548,6.65,0.498,0
86,149,39,8151,4,200,0,0,17.59,11402533,398.448,24.3,4.8,1653.173,430.548,6.65,0.498,0
86,150,0,8151,0,200,0,0,17.59,11402533,398.448,24.3,4.8,1653.173,430.548,6.65,0.498,0
86,151,10,8161,1,201,0,0,17.59,11402533,398.448,24.3,4.8,1653.173,430.548,6.65,0.498,0
86,152,48,8209,0,201,0,0,17.59,11402533,398.448,24.3,4.8,1653.173,430.548,6.65,0.498,0
86,153,0,8209,0,201,0,0,17.59,11402533,398.448,24.3,4.8,1653.173,430.548,6.65,0.498,0
86,154,15,8224,0,201,0,0,17.59,11402533,398.448,24.3,4.8,1653.173,430.548,6.65,0.498,0
86,155,34,8258,5,206,0,0,17.59,11402533,398.448,24.3,4.8,1653.173,430.548,6.65,0.498,0
86,156,0,8258,0,206,0,0,17.59,11402533,398.448,24.3,4.8,1653.173,430.548,6.65,0.498,0
86,157,43,8301,4,210,0,0,17.59,11402533,398.448,24.3,4.8,1653.173,430.548,6.65,0.498,0
86,158,25,8326,2,212,0,0,17.59,11402533,398.448,24.3,4.8,1653.173,430.548,6.65,0.498,0
86,159,10,8336,0,212,0,0,17.59,11402533,398.448,24.3,4.8,1653.173,430.548,6.65,0.498,0
86,160,24,8360,2,214,0,0,17.59,11402533,398.448,24.3,4.8,1653.173,430.548,6.65,0.498,0
86,161,2,8362,0,214,0,0,17.59,11402533,398.448,24.3,4.8,1653.173,430.548,6.65,0.498,0
86,162,14,8376,0,214,0,0,17.59,11402533,398.448,24.3,4.8,1653.173,430.548,6.65,0.498,0
86,163,8,8384,0,214,0,0,17.59,11402533,398.448,24.3,4.8,1653.173,430.548,6.65,0.498,0
86,164,45,8429,1,215,0,0,17.59,11402533,398.448,24.3,4.8,1653.173,430.548,6.65,0.498,0
86,165,28,8457,1,216,0,0,17.59,11402533,398.448,24.3,4.8,1653.173,430.548,6.65,0.498,0
86,166,21,8478,3,219,0,0,17.59,11402533,398.448,24.3,4.8,1653.173,430.548,6.65,0.498,0
86,167,15,8493,0,219,0,0,17.59,11402533,398.448,24.3,4.8,1653.173,430.548,6.65,0.498,0
86,168,6,8499,0,219,0,0,17.59,11402533,398.448,24.3,4.8,1653.173,430.548,6.65,0.498,0
86,169,31,8530,1,220,0,0,17.59,11402533,398.448,24.3,4.8,1653.173,430.548,6.65,0.498,0
86,170,11,8541,0,220,0,0,17.59,11402533,398.448,24.3,4.8,1653.173,430.548,6.65,0.498,0
86,171,15,8556,0,220,0,0,17.59,11402533,398.448,24.3,4.8,1653.173,430.548,6.65,0.498,0
86,172,44,8600,1,221,0,0,17.59,11402533,398.448,24.3,4.8,1653.173,430.548,6.65,0.498,0
86,173,15,8615,0,221,0,0,17.59,11402533,398.448,24.3,4.8,1653.173,430.548,6.65,0.498,0
86,174,4,8619,0,221,0,0,43.52,11402533,398.448,24.3,4.8,1653.173,430.548,6.65,0.498,0
86,175,5,8624,0,221,0,0,43.52,11402533,398.448,24.3,4.8,1653.173,430.548,6.65,0.498,0
86,176,9,8633,2,223,0,0,43.52,11402533,398.448,24.3,4.8,1653.173,430.548,6.65,0.498,0
86,177,13,8646,2,225,0,0,43.52,11402533,398.448,24.3,4.8,1653.173,430.548,6.65,0.498,0
86,178,0,8646,0,225,0,0,43.52,11402533,398.448,24.3,4.8,1653.173,430.548,6.65,0.498,0
86,179,38,8684,2,227,0,0,43.52,11402533,398.448,24.3,4.8,1653.173,430.548,6.65,0.498,0
86,180,39,8723,0,227,0,0,43.52,11402533,398.448,24.3,4.8,1653.173,430.548,6.65,0.498,0
86,181,0,8723,0,227,0,0,43.52,11402533,398.448,24.3,4.8,1653.173,430.548,6.65,0.498,0
86,182,17,8740,0,227,0,0,43.52,11402533,398.448,24.3,4.8,1653.173,430.548,6.65,0.498,0
86,183,7,8747,2,229,0,0,43.52,11402533,398.448,24.3,4.8,1653.173,430.548,6.65,0.498,0
86,184,19,8766,0,229,0,0,43.52,11402533,398.448,24.3,4.8,1653.173,430.548,6.65,0.498,0
86,185,0,8766,0,229,0,0,43.52,11402533,398.448,24.3,4.8,1653.173,430.548,6.65,0.498,0
86,186,26,8792,0,229,0,0,43.52,11402533,398.448,24.3,4.8,1653.173,430.548,6.65,0.498,0
86,187,19,8811,0,229,0,0,43.52,11402533,398.448,24.3,4.8,1653.173,430.548,6.65,0.498,0
86,188,8,8819,0,229,0,0,43.52,11402533,398.448,24.3,4.8,1653.173,430.548,6.65,0.498,0
86,189,0,8819,0,229,0,0,43.52,11402533,398.448,24.3,4.8,1653.173,430.548,6.65,0.498,0
86,190,19,8838,0,229,0,0,43.52,11402533,398.448,24.3,4.8,1653.173,430.548,6.65,0.498,0
86,191,0,8838,0,229,0,0,43.52,11402533,398.448,24.3,4.8,1653.173,430.548,6.65,0.498,0
86,192,16,8854,1,230,0,0,43.52,11402533,398.448,24.3,4.8,1653.173,430.548,6.65,0.498,0
86,193,0,8854,0,230,0,0,43.52,11402533,398.448,24.3,4.8,1653.173,430.548,6.65,0.498,0
86,194,6,8860,0,230,0,0,43.52,11402533,398.448,24.3,4.8,1653.173,430.548,6.65,0.498,0
86,195,22,8882,0,230,0,0,43.52,11402533,398.448,24.3,4.8,1653.173,430.548,6.65,0.498,0
86,196,0,8882,0,230,0,0,43.52,11402533,398.448,24.3,4.8,1653.173,430.548,6.65,0.498,0
86,197,5,8887,0,230,0,0,43.52,11402533,398.448,24.3,4.8,1653.173,430.548,6.65,0.498,0
86,198,21,8908,1,231,0,0,43.52,11402533,398.448,24.3,4.8,1653.173,430.548,6.65,0.498,0
86,199,17,8925,0,231,0,0,43.52,11402533,398.448,24.3,4.8,1653.173,430.548,6.65,0.498,0
86,200,0,8925,0,231,0,0,43.52,11402533,398.448,24.3,4.8,1653.173,430.548,6.65,0.498,0
86,201,0,8925,0,231,0,0,43.52,11402533,398.448,24.3,4.8,1653.173,430.548,6.65,0.498,0
86,202,0,8925,0,231,0,0,43.52,11402533,398.448,24.3,4.8,1653.173,430.548,6.65,0.498,0
86,203,51,8976,0,231,0,0,43.52,11402533,398.448,24.3,4.8,1653.173,430.548,6.65,0.498,0
86,204,0,8976,0,231,0,0,43.52,11402533,398.448,24.3,4.8,1653.173,430.548,6.65,0.498,0
87,1,31,172,3,10,0,0,100,9904608,82.805,24.9,4.652,4541.795,240.208,7.21,0.617,0
87,2,47,219,4,14,0,0,100,9904608,82.805,24.9,4.652,4541.795,240.208,7.21,0.617,0
87,3,3,222,1,15,0,0,100,9904608,82.805,24.9,4.652,4541.795,240.208,7.21,0.617,0
87,4,42,264,0,15,0,0,100,9904608,82.805,24.9,4.652,4541.795,240.208,7.21,0.617,0
87,5,4,268,7,22,0,0,100,9904608,82.805,24.9,4.652,4541.795,240.208,7.21,0.617,0
87,6,30,298,0,22,0,0,100,9904608,82.805,24.9,4.652,4541.795,240.208,7.21,0.617,0
87,7,7,305,0,22,0,0,100,9904608,82.805,24.9,4.652,4541.795,240.208,7.21,0.617,0
87,8,7,312,0,22,0,0,100,9904608,82.805,24.9,4.652,4541.795,240.208,7.21,0.617,0
87,9,31,343,1,23,0,0,100,9904608,82.805,24.9,4.652,4541.795,240.208,7.21,0.617,0
87,10,39,382,0,23,0,0,100,9904608,82.805,24.9,4.652,4541.795,240.208,7.21,0.617,0
87,11,10,392,1,24,0,0,100,9904608,82.805,24.9,4.652,4541.795,240.208,7.21,0.617,0
87,12,1,393,1,25,0,0,100,9904608,82.805,24.9,4.652,4541.795,240.208,7.21,0.617,0
87,13,4,397,0,25,0,0,100,9904608,82.805,24.9,4.652,4541.795,240.208,7.21,0.617,0
87,14,10,407,1,26,0,0,100,9904608,82.805,24.9,4.652,4541.795,240.208,7.21,0.617,0
87,15,12,419,5,31,0,0,100,9904608,82.805,24.9,4.652,4541.795,240.208,7.21,0.617,0
87,16,7,426,4,35,0,0,100,9904608,82.805,24.9,4.652,4541.795,240.208,7.21,0.617,0
87,17,16,442,6,41,0,0,100,9904608,82.805,24.9,4.652,4541.795,240.208,7.21,0.617,0
87,18,15,457,5,46,0,0,100,9904608,82.805,24.9,4.652,4541.795,240.208,7.21,0.617,0
87,19,15,472,0,46,0,0,100,9904608,82.805,24.9,4.652,4541.795,240.208,7.21,0.617,0
87,20,5,477,0,46,0,0,100,9904608,82.805,24.9,4.652,4541.795,240.208,7.21,0.617,0
87,21,17,494,0,46,0,0,100,9904608,82.805,24.9,4.652,4541.795,240.208,7.21,0.617,0
87,22,16,510,0,46,0,0,100,9904608,82.805,24.9,4.652,4541.795,240.208,7.21,0.617,0
87,23,9,519,1,47,0,0,100,9904608,82.805,24.9,4.652,4541.795,240.208,7.21,0.617,0
87,24,0,519,0,47,0,0,100,9904608,82.805,24.9,4.652,4541.795,240.208,7.21,0.617,0
87,25,72,591,0,47,0,0,100,9904608,82.805,24.9,4.652,4541.795,240.208,7.21,0.617,0
87,26,36,627,12,59,0,0,100,9904608,82.805,24.9,4.652,4541.795,240.208,7.21,0.617,0
87,27,34,661,2,61,0,0,100,9904608,82.805,24.9,4.652,4541.795,240.208,7.21,0.617,0
87,28,32,693,0,61,0,0,100,9904608,82.805,24.9,4.652,4541.795,240.208,7.21,0.617,0
87,29,45,738,5,66,0,0,100,9904608,82.805,24.9,4.652,4541.795,240.208,7.21,0.617,0
87,30,33,771,5,71,0,0,100,9904608,82.805,24.9,4.652,4541.795,240.208,7.21,0.617,0
87,31,33,804,4,75,0,0,100,9904608,82.805,24.9,4.652,4541.795,240.208,7.21,0.617,0
87,32,95,899,0,75,0,0,100,9904608,82.805,24.9,4.652,4541.795,240.208,7.21,0.617,0
87,33,111,1010,1,76,0,0,100,9904608,82.805,24.9,4.652,4541.795,240.208,7.21,0.617,0
87,34,45,1055,6,82,0,0,100,9904608,82.805,24.9,4.652,4541.795,240.208,7.21,0.617,0
87,35,123,1178,0,82,0,0,100,9904608,82.805,24.9,4.652,4541.795,240.208,7.21,0.617,0
87,36,92,1270,11,93,0,0,100,9904608,82.805,24.9,4.652,4541.795,240.208,7.21,0.617,0
87,37,191,1461,6,99,0,0,100,9904608,82.805,24.9,4.652,4541.795,240.208,7.21,0.617,0
87,38,224,1685,6,105,0,0,100,9904608,82.805,24.9,4.652,4541.795,240.208,7.21,0.617,0
87,39,86,1771,2,107,0,0,100,9904608,82.805,24.9,4.652,4541.795,240.208,7.21,0.617,0
87,40,59,1830,1,108,0,0,100,9904608,82.805,24.9,4.652,4541.795,240.208,7.21,0.617,0
87,41,142,1972,0,108,0,0,100,9904608,82.805,24.9,4.652,4541.795,240.208,7.21,0.617,0
87,42,34,2006,8,116,0,0,100,9904608,82.805,24.9,4.652,4541.795,240.208,7.21,0.617,0
87,43,74,2080,5,121,0,0,100,9904608,82.805,24.9,4.652,4541.795,240.208,7.21,0.617,0
87,44,175,2255,2,123,0,0,100,9904608,82.805,24.9,4.652,4541.795,240.208,7.21,0.617,0
87,45,63,2318,10,133,0,0,100,9904608,82.805,24.9,4.652,4541.795,240.208,7.21,0.617,0
87,46,142,2460,1,134,0,0,100,9904608,82.805,24.9,4.652,4541.795,240.208,7.21,0.617,0
87,47,105,2565,4,138,0,0,100,9904608,82.805,24.9,4.652,4541.795,240.208,7.21,0.617,0
87,48,81,2646,4,142,0,0,100,9904608,82.805,24.9,4.652,4541.795,240.208,7.21,0.617,0
87,49,152,2798,4,146,0,0,100,9904608,82.805,24.9,4.652,4541.795,240.208,7.21,0.617,0
87,50,157,2955,1,147,0,0,100,9904608,82.805,24.9,4.652,4541.795,240.208,7.21,0.617,0
87,51,145,3100,4,151,0,0,100,9904608,82.805,24.9,4.652,4541.795,240.208,7.21,0.617,0
87,52,104,3204,5,156,0,0,100,9904608,82.805,24.9,4.652,4541.795,240.208,7.21,0.617,0
87,53,273,3477,11,167,0,0,100,9904608,82.805,24.9,4.652,4541.795,240.208,7.21,0.617,0
87,54,266,3743,7,174,0,0,100,9904608,82.805,24.9,4.652,4541.795,240.208,7.21,0.617,0
87,55,207,3950,6,180,0,0,100,9904608,82.805,24.9,4.652,4541.795,240.208,7.21,0.617,0
87,56,239,4189,2,182,0,0,100,9904608,82.805,24.9,4.652,4541.795,240.208,7.21,0.617,0
87,57,212,4401,6,188,0,0,100,9904608,82.805,24.9,4.652,4541.795,240.208,7.21,0.617,0
87,58,239,4640,6,194,0,0,100,9904608,82.805,24.9,4.652,4541.795,240.208,7.21,0.617,0
87,59,112,4752,2,196,0,0,100,9904608,82.805,24.9,4.652,4541.795,240.208,7.21,0.617,0
87,60,134,4886,3,199,0,0,100,9904608,82.805,24.9,4.652,4541.795,240.208,7.21,0.617,0
87,61,208,5094,2,201,0,0,100,9904608,82.805,24.9,4.652,4541.795,240.208,7.21,0.617,0
87,62,108,5202,11,212,0,0,100,9904608,82.805,24.9,4.652,4541.795,240.208,7.21,0.617,0
87,63,160,5362,5,217,0,0,100,9904608,82.805,24.9,4.652,4541.795,240.208,7.21,0.617,0
87,64,165,5527,8,225,0,0,100,9904608,82.805,24.9,4.652,4541.795,240.208,7.21,0.617,0
87,65,163,5690,9,234,0,0,100,9904608,82.805,24.9,4.652,4541.795,240.208,7.21,0.617,0
87,66,190,5880,9,243,0,0,100,9904608,82.805,24.9,4.652,4541.795,240.208,7.21,0.617,0
87,67,91,5971,5,248,0,0,100,9904608,82.805,24.9,4.652,4541.795,240.208,7.21,0.617,0
87,68,184,6155,2,250,0,0,100,9904608,82.805,24.9,4.652,4541.795,240.208,7.21,0.617,0
87,69,172,6327,8,258,0,0,96.3,9904608,82.805,24.9,4.652,4541.795,240.208,7.21,0.617,0
87,70,123,6450,4,262,0,0,96.3,9904608,82.805,24.9,4.652,4541.795,240.208,7.21,0.617,0
87,71,485,6935,9,271,0,0,96.3,9904608,82.805,24.9,4.652,4541.795,240.208,7.21,0.617,0
87,72,425,7360,19,290,0,0,96.3,9904608,82.805,24.9,4.652,4541.795,240.208,7.21,0.617,0
87,73,309,7669,4,294,0,0,96.3,9904608,82.805,24.9,4.652,4541.795,240.208,7.21,0.617,0
87,74,463,8132,12,306,0,0,96.3,9904608,82.805,24.9,4.652,4541.795,240.208,7.21,0.617,0
87,75,323,8455,4,310,0,0,96.3,9904608,82.805,24.9,4.652,4541.795,240.208,7.21,0.617,0
87,76,403,8858,2,312,0,0,96.3,9904608,82.805,24.9,4.652,4541.795,240.208,7.21,0.617,0
87,77,320,9178,10,322,0,0,96.3,9904608,82.805,24.9,4.652,4541.795,240.208,7.21,0.617,0
87,78,478,9656,8,330,0,0,96.3,9904608,82.805,24.9,4.652,4541.795,240.208,7.21,0.617,0
87,79,643,10299,6,336,0,0,96.3,9904608,82.805,24.9,4.652,4541.795,240.208,7.21,0.617,0
87,80,440,10739,7,343,0,0,96.3,9904608,82.805,24.9,4.652,4541.795,240.208,7.21,0.617,0
87,81,519,11258,6,349,0,0,96.3,9904608,82.805,24.9,4.652,4541.795,240.208,7.21,0.617,0
87,82,992,12250,9,358,0,0,96.3,9904608,82.805,24.9,4.652,4541.795,240.208,7.21,0.617,0
87,83,519,12769,5,363,0,0,96.3,9904608,82.805,24.9,4.652,4541.795,240.208,7.21,0.617,0
87,84,587,13356,32,395,0,0,96.3,9904608,82.805,24.9,4.652,4541.795,240.208,7.21,0.617,0
87,85,587,13943,10,405,0,0,96.3,9904608,82.805,24.9,4.652,4541.795,240.208,7.21,0.617,0
87,86,628,14571,12,417,0,0,96.3,9904608,82.805,24.9,4.652,4541.795,240.208,7.21,0.617,0
87,87,795,15366,9,426,0,0,96.3,9904608,82.805,24.9,4.652,4541.795,240.208,7.21,0.617,0
87,88,628,15994,45,471,0,0,96.3,9904608,82.805,24.9,4.652,4541.795,240.208,7.21,0.617,0
87,89,1013,17007,8,479,0,0,96.3,9904608,82.805,24.9,4.652,4541.795,240.208,7.21,0.617,0
87,90,1075,18082,0,479,0,0,96.3,9904608,82.805,24.9,4.652,4541.795,240.208,7.21,0.617,0
87,91,736,18818,6,485,0,0,96.3,9904608,82.805,24.9,4.652,4541.795,240.208,7.21,0.617,0
87,92,740,19558,12,497,0,0,96.3,9904608,82.805,24.9,4.652,4541.795,240.208,7.21,0.617,0
87,93,704,20262,45,542,0,0,96.3,9904608,82.805,24.9,4.652,4541.795,240.208,7.21,0.617,0
87,94,858,21120,49,591,0,0,96.3,9904608,82.805,24.9,4.652,4541.795,240.208,7.21,0.617,0
87,95,996,22116,14,605,0,0,96.3,9904608,82.805,24.9,4.652,4541.795,240.208,7.21,0.617,0
87,96,805,22921,24,629,0,0,96.3,9904608,82.805,24.9,4.652,4541.795,240.208,7.21,0.617,0
87,97,1022,23943,10,639,0,0,96.3,9904608,82.805,24.9,4.652,4541.795,240.208,7.21,0.617,0
87,98,722,24665,17,656,0,0,96.3,9904608,82.805,24.9,4.652,4541.795,240.208,7.21,0.617,0
87,99,763,25428,21,677,0,0,96.3,9904608,82.805,24.9,4.652,4541.795,240.208,7.21,0.617,0
87,100,550,25978,17,694,0,0,96.3,9904608,82.805,24.9,4.652,4541.795,240.208,7.21,0.617,0
87,101,406,26384,10,704,0,0,96.3,9904608,82.805,24.9,4.652,4541.795,240.208,7.21,0.617,0
87,102,669,27053,46,750,0,0,96.3,9904608,82.805,24.9,4.652,4541.795,240.208,7.21,0.617,0
87,103,530,27583,21,771,0,0,96.3,9904608,82.805,24.9,4.652,4541.795,240.208,7.21,0.617,0
87,104,507,28090,3,774,0,0,96.3,9904608,82.805,24.9,4.652,4541.795,240.208,7.21,0.617,0
87,105,489,28579,15,789,0,0,96.3,9904608,82.805,24.9,4.652,4541.795,240.208,7.21,0.617,0
87,106,527,29106,18,807,0,0,96.3,9904608,82.805,24.9,4.652,4541.795,240.208,7.21,0.617,0
87,107,930,30036,18,825,0,0,96.3,9904608,82.805,24.9,4.652,4541.795,240.208,7.21,0.617,0
87,108,831,30867,10,835,0,0,96.3,9904608,82.805,24.9,4.652,4541.795,240.208,7.21,0.617,0
87,109,878,31745,22,857,0,0,96.3,9904608,82.805,24.9,4.652,4541.795,240.208,7.21,0.617,0
87,110,1048,32793,34,891,0,0,96.3,9904608,82.805,24.9,4.652,4541.795,240.208,7.21,0.617,0
87,111,1042,33835,9,900,0,0,96.3,9904608,82.805,24.9,4.652,4541.795,240.208,7.21,0.617,0
87,112,776,34611,35,935,0,0,96.3,9904608,82.805,24.9,4.652,4541.795,240.208,7.21,0.617,0
87,113,734,35345,53,988,0,0,96.3,9904608,82.805,24.9,4.652,4541.795,240.208,7.21,0.617,0
87,114,757,36102,18,1006,0,0,96.3,9904608,82.805,24.9,4.652,4541.795,240.208,7.21,0.617,0
87,115,800,36902,5,1011,0,0,96.3,9904608,82.805,24.9,4.652,4541.795,240.208,7.21,0.617,0
87,116,657,37559,50,1061,0,0,96.3,9904608,82.805,24.9,4.652,4541.795,240.208,7.21,0.617,0
87,117,879,38438,37,1098,0,0,96.3,9904608,82.805,24.9,4.652,4541.795,240.208,7.21,0.617,0
87,118,838,39276,18,1116,0,0,96.3,9904608,82.805,24.9,4.652,4541.795,240.208,7.21,0.617,0
87,119,465,39741,50,1166,0,0,96.3,9904608,82.805,24.9,4.652,4541.795,240.208,7.21,0.617,0
87,120,719,40460,48,1214,0,0,96.3,9904608,82.805,24.9,4.652,4541.795,240.208,7.21,0.617,0
87,121,484,40944,45,1259,0,0,96.3,9904608,82.805,24.9,4.652,4541.795,240.208,7.21,0.617,0
87,122,482,41426,53,1312,0,0,96.3,9904608,82.805,24.9,4.652,4541.795,240.208,7.21,0.617,0
87,123,976,42402,25,1337,0,0,96.3,9904608,82.805,24.9,4.652,4541.795,240.208,7.21,0.617,0
87,124,283,42685,31,1368,0,0,96.3,9904608,82.805,24.9,4.652,4541.795,240.208,7.21,0.617,0
87,125,512,43197,9,1377,0,0,96.3,9904608,82.805,24.9,4.652,4541.795,240.208,7.21,0.617,0
87,126,597,43794,7,1384,0,0,96.3,9904608,82.805,24.9,4.652,4541.795,240.208,7.21,0.617,0
87,127,505,44299,16,1400,0,0,96.3,9904608,82.805,24.9,4.652,4541.795,240.208,7.21,0.617,0
87,128,799,45098,23,1423,0,0,96.3,9904608,82.805,24.9,4.652,4541.795,240.208,7.21,0.617,0
87,129,657,45755,23,1446,0,0,96.3,9904608,82.805,24.9,4.652,4541.795,240.208,7.21,0.617,0
87,130,610,46365,19,1465,0,0,96.3,9904608,82.805,24.9,4.652,4541.795,240.208,7.21,0.617,0
87,131,611,46976,11,1476,0,0,96.3,9904608,82.805,24.9,4.652,4541.795,240.208,7.21,0.617,0
87,132,478,47454,19,1495,0,0,96.3,9904608,82.805,24.9,4.652,4541.795,240.208,7.21,0.617,0
87,133,418,47872,11,1506,0,0,96.3,9904608,82.805,24.9,4.652,4541.795,240.208,7.21,0.617,0
87,134,531,48403,9,1515,0,0,96.3,9904608,82.805,24.9,4.652,4541.795,240.208,7.21,0.617,0
87,135,254,48657,18,1533,0,0,96.3,9904608,82.805,24.9,4.652,4541.795,240.208,7.21,0.617,0
87,136,385,49042,9,1542,0,0,96.3,9904608,82.805,24.9,4.652,4541.795,240.208,7.21,0.617,0
87,137,425,49467,6,1548,0,0,96.3,9904608,82.805,24.9,4.652,4541.795,240.208,7.21,0.617,0
87,138,512,49979,19,1567,0,0,96.3,9904608,82.805,24.9,4.652,4541.795,240.208,7.21,0.617,0
87,139,523,50502,8,1575,0,0,87.96,9904608,82.805,24.9,4.652,4541.795,240.208,7.21,0.617,0
87,140,493,50995,8,1583,0,0,87.96,9904608,82.805,24.9,4.652,4541.795,240.208,7.21,0.617,0
87,141,675,51670,10,1593,0,0,87.96,9904608,82.805,24.9,4.652,4541.795,240.208,7.21,0.617,0
87,142,626,52296,15,1608,0,0,87.96,9904608,82.805,24.9,4.652,4541.795,240.208,7.21,0.617,0
87,143,523,52819,11,1619,0,0,87.96,9904608,82.805,24.9,4.652,4541.795,240.208,7.21,0.617,0
87,144,562,53381,13,1632,0,0,82.41,9904608,82.805,24.9,4.652,4541.795,240.208,7.21,0.617,0
87,145,602,53983,11,1643,0,0,82.41,9904608,82.805,24.9,4.652,4541.795,240.208,7.21,0.617,0
87,146,528,54511,11,1654,0,0,82.41,9904608,82.805,24.9,4.652,4541.795,240.208,7.21,0.617,0
87,147,968,55479,29,1683,0,0,82.41,9904608,82.805,24.9,4.652,4541.795,240.208,7.21,0.617,0
87,148,0,55479,0,1683,0,0,82.41,9904608,82.805,24.9,4.652,4541.795,240.208,7.21,0.617,0
87,149,1170,56649,64,1747,0,0,82.41,9904608,82.805,24.9,4.652,4541.795,240.208,7.21,0.617,0
87,150,1020,57669,56,1803,0,0,82.41,9904608,82.805,24.9,4.652,4541.795,240.208,7.21,0.617,0
87,151,1141,58810,24,1827,0,0,82.41,9904608,82.805,24.9,4.652,4541.795,240.208,7.21,0.617,0
87,152,835,59645,15,1842,0,0,82.41,9904608,82.805,24.9,4.652,4541.795,240.208,7.21,0.617,0
87,153,529,60174,16,1858,0,0,82.41,9904608,82.805,24.9,4.652,4541.795,240.208,7.21,0.617,0
87,154,840,61014,15,1873,0,0,82.41,9904608,82.805,24.9,4.652,4541.795,240.208,7.21,0.617,0
87,155,755,61769,15,1888,0,0,82.41,9904608,82.805,24.9,4.652,4541.795,240.208,7.21,0.617,0
87,156,757,62526,36,1924,0,0,82.41,9904608,82.805,24.9,4.652,4541.795,240.208,7.21,0.617,0
87,157,632,63158,30,1954,0,0,82.41,9904608,82.805,24.9,4.652,4541.795,240.208,7.21,0.617,0
87,158,640,63798,30,1984,0,0,82.41,9904608,82.805,24.9,4.652,4541.795,240.208,7.21,0.617,0
87,159,554,64352,22,2006,0,0,82.41,9904608,82.805,24.9,4.652,4541.795,240.208,7.21,0.617,0
87,160,412,64764,1,2007,0,0,82.41,9904608,82.805,24.9,4.652,4541.795,240.208,7.21,0.617,0
87,161,50,64814,16,2023,0,0,82.41,9904608,82.805,24.9,4.652,4541.795,240.208,7.21,0.617,0
87,162,404,65218,11,2034,0,0,82.41,9904608,82.805,24.9,4.652,4541.795,240.208,7.21,0.617,0
87,163,379,65597,10,2044,0,0,82.41,9904608,82.805,24.9,4.652,4541.795,240.208,7.21,0.617,0
87,164,205,65802,5,2049,0,0,82.41,9904608,82.805,24.9,4.652,4541.795,240.208,7.21,0.617,0
87,165,247,66049,9,2058,0,0,82.41,9904608,82.805,24.9,4.652,4541.795,240.208,7.21,0.617,0
87,166,1087,67136,7,2065,0,0,82.41,9904608,82.805,24.9,4.652,4541.795,240.208,7.21,0.617,0
87,167,653,67789,14,2079,0,0,82.41,9904608,82.805,24.9,4.652,4541.795,240.208,7.21,0.617,0
87,168,831,68620,8,2087,0,0,82.41,9904608,82.805,24.9,4.652,4541.795,240.208,7.21,0.617,0
87,169,0,68620,0,2087,0,0,82.41,9904608,82.805,24.9,4.652,4541.795,240.208,7.21,0.617,0
87,170,1040,69660,15,2102,0,0,82.41,9904608,82.805,24.9,4.652,4541.795,240.208,7.21,0.617,0
87,171,460,70120,20,2122,0,0,82.41,9904608,82.805,24.9,4.652,4541.795,240.208,7.21,0.617,0
87,172,491,70611,24,2146,0,0,82.41,9904608,82.805,24.9,4.652,4541.795,240.208,7.21,0.617,0
87,173,532,71143,20,2166,0,0,84.26,9904608,82.805,24.9,4.652,4541.795,240.208,7.21,0.617,0
87,174,473,71616,18,2184,0,0,84.26,9904608,82.805,24.9,4.652,4541.795,240.208,7.21,0.617,0
87,175,459,72075,20,2204,0,0,84.26,9904608,82.805,24.9,4.652,4541.795,240.208,7.21,0.617,0
87,176,231,72306,2,2206,0,0,84.26,9904608,82.805,24.9,4.652,4541.795,240.208,7.21,0.617,0
87,177,369,72675,16,2222,0,0,84.26,9904608,82.805,24.9,4.652,4541.795,240.208,7.21,0.617,0
87,178,518,73193,27,2249,0,0,84.26,9904608,82.805,24.9,4.652,4541.795,240.208,7.21,0.617,0
87,179,647,73840,22,2271,0,0,84.26,9904608,82.805,24.9,4.652,4541.795,240.208,7.21,0.617,0
87,180,708,74548,17,2288,0,0,84.26,9904608,82.805,24.9,4.652,4541.795,240.208,7.21,0.617,0
87,181,561,75109,1,2289,0,0,84.26,9904608,82.805,24.9,4.652,4541.795,240.208,7.21,0.617,0
87,182,428,75537,12,2301,0,0,84.26,9904608,82.805,24.9,4.652,4541.795,240.208,7.21,0.617,0
87,183,561,76098,22,2323,0,0,84.26,9904608,82.805,24.9,4.652,4541.795,240.208,7.21,0.617,0
87,184,802,76900,30,2353,0,0,84.26,9904608,82.805,24.9,4.652,4541.795,240.208,7.21,0.617,0
87,185,698,77598,27,2380,0,0,84.26,9904608,82.805,24.9,4.652,4541.795,240.208,7.21,0.617,0
87,186,671,78269,6,2386,0,0,84.26,9904608,82.805,24.9,4.652,4541.795,240.208,7.21,0.617,0
87,187,519,78788,13,2399,0,0,84.26,9904608,82.805,24.9,4.652,4541.795,240.208,7.21,0.617,0
87,188,841,79629,23,2422,0,0,84.26,9904608,82.805,24.9,4.652,4541.795,240.208,7.21,0.617,0
87,189,391,80020,11,2433,0,0,84.26,9904608,82.805,24.9,4.652,4541.795,240.208,7.21,0.617,0
87,190,642,80662,14,2447,0,0,84.26,9904608,82.805,24.9,4.652,4541.795,240.208,7.21,0.617,0
87,191,354,81016,19,2466,0,0,84.26,9904608,82.805,24.9,4.652,4541.795,240.208,7.21,0.617,0
87,192,656,81672,11,2477,0,0,84.26,9904608,82.805,24.9,4.652,4541.795,240.208,7.21,0.617,0
87,193,880,82552,15,2492,0,0,84.26,9904608,82.805,24.9,4.652,4541.795,240.208,7.21,0.617,0
87,194,594,83146,12,2504,0,0,84.26,9904608,82.805,24.9,4.652,4541.795,240.208,7.21,0.617,0
87,195,935,84081,8,2512,0,0,84.26,9904608,82.805,24.9,4.652,4541.795,240.208,7.21,0.617,0
87,196,332,84413,9,2521,0,0,84.26,9904608,82.805,24.9,4.652,4541.795,240.208,7.21,0.617,0
87,197,439,84852,7,2528,0,0,84.26,9904608,82.805,24.9,4.652,4541.795,240.208,7.21,0.617,0
87,198,606,85458,5,2533,0,0,84.26,9904608,82.805,24.9,4.652,4541.795,240.208,7.21,0.617,0
87,199,631,86089,19,2552,0,0,84.26,9904608,82.805,24.9,4.652,4541.795,240.208,7.21,0.617,0
87,200,602,86691,4,2556,0,0,84.26,9904608,82.805,24.9,4.652,4541.795,240.208,7.21,0.617,0
87,201,903,87594,7,2563,0,0,84.26,9904608,82.805,24.9,4.652,4541.795,240.208,7.21,0.617,0
87,202,831,88425,5,2568,0,0,84.26,9904608,82.805,24.9,4.652,4541.795,240.208,7.21,0.617,0
87,203,956,89381,8,2576,0,0,84.26,9904608,82.805,24.9,4.652,4541.795,240.208,7.21,0.617,0
87,204,851,90232,6,2582,0,0,84.26,9904608,82.805,24.9,4.652,4541.795,240.208,7.21,0.617,0
89,1,33,525,4,20,1062,15208,76.85,9660350,108.043,43.4,18.577,26777.561,278.296,7.55,0.838,0
89,2,60,585,1,21,1193,16401,76.85,9660350,108.043,43.4,18.577,26777.561,278.296,7.55,0.838,0
89,3,38,623,5,26,1368,17769,76.85,9660350,108.043,43.4,18.577,26777.561,278.296,7.55,0.838,0
89,4,55,678,6,32,1655,19424,76.85,9660350,108.043,43.4,18.577,26777.561,278.296,7.55,0.838,0
89,5,55,733,2,34,1826,21250,76.85,9660350,108.043,43.4,18.577,26777.561,278.296,7.55,0.838,0
89,6,11,744,4,38,1032,22282,76.85,9660350,108.043,43.4,18.577,26777.561,278.296,7.55,0.838,0
89,7,73,817,9,47,1464,23746,76.85,9660350,108.043,43.4,18.577,26777.561,278.296,7.55,0.838,0
89,8,78,895,11,58,2002,25748,76.85,9660350,108.043,43.4,18.577,26777.561,278.296,7.55,0.838,0
89,9,85,980,8,66,2078,27826,76.85,9660350,108.043,43.4,18.577,26777.561,278.296,7.55,0.838,0
89,10,210,1190,11,77,2122,29948,76.85,9660350,108.043,43.4,18.577,26777.561,278.296,7.55,0.838,0
89,11,120,1310,8,85,2013,31961,76.85,9660350,108.043,43.4,18.577,26777.561,278.296,7.55,0.838,0
89,12,100,1410,14,99,1571,33532,76.85,9660350,108.043,43.4,18.577,26777.561,278.296,7.55,0.838,0
89,13,48,1458,10,109,1287,34819,76.85,9660350,108.043,43.4,18.577,26777.561,278.296,7.55,0.838,0
89,14,54,1512,13,122,1006,35825,76.85,9660350,108.043,43.4,18.577,26777.561,278.296,7.55,0.838,0
89,15,67,1579,12,134,1501,37326,76.85,9660350,108.043,43.4,18.577,26777.561,278.296,7.55,0.838,0
89,16,73,1652,8,142,1163,38489,76.85,9660350,108.043,43.4,18.577,26777.561,278.296,7.55,0.838,0
89,17,111,1763,14,156,3101,41590,76.85,9660350,108.043,43.4,18.577,26777.561,278.296,7.55,0.838,0
89,18,71,1834,16,172,2311,43901,76.85,9660350,108.043,43.4,18.577,26777.561,278.296,7.55,0.838,0
89,19,82,1916,17,189,2452,46353,76.85,9660350,108.043,43.4,18.577,26777.561,278.296,7.55,0.838,0
89,20,68,1984,10,199,1704,48057,76.85,9660350,108.043,43.4,18.577,26777.561,278.296,7.55,0.838,0
89,21,114,2098,14,213,1995,50052,76.85,9660350,108.043,43.4,18.577,26777.561,278.296,7.55,0.838,0
89,22,70,2168,12,225,2650,52702,76.85,9660350,108.043,43.4,18.577,26777.561,278.296,7.55,0.838,0
89,23,116,2284,0,225,2688,55390,76.85,9660350,108.043,43.4,18.577,26777.561,278.296,7.55,0.838,0
89,24,99,2383,25,250,2861,58251,76.85,9660350,108.043,43.4,18.577,26777.561,278.296,7.55,0.838,0
89,25,60,2443,12,262,2550,60801,76.85,9660350,108.043,43.4,18.577,26777.561,278.296,7.55,0.838,0
89,26,57,2500,10,272,2704,63505,76.85,9660350,108.043,43.4,18.577,26777.561,278.296,7.55,0.838,0
89,27,83,2583,8,280,2120,65625,76.85,9660350,108.043,43.4,18.577,26777.561,278.296,7.55,0.838,0
89,28,66,2649,11,291,1547,67172,76.85,9660350,108.043,43.4,18.577,26777.561,278.296,7.55,0.838,0
89,29,78,2727,9,300,3128,70300,76.85,9660350,108.043,43.4,18.577,26777.561,278.296,7.55,0.838,0
89,30,48,2775,12,312,2651,72951,76.85,9660350,108.043,43.4,18.577,26777.561,278.296,7.55,0.838,0
89,31,88,2863,11,323,3380,76331,76.85,9660350,108.043,43.4,18.577,26777.561,278.296,7.55,0.838,0
89,32,79,2942,12,335,3220,79551,76.85,9660350,108.043,43.4,18.577,26777.561,278.296,7.55,0.838,0
89,33,56,2998,5,340,2459,82010,76.85,9660350,108.043,43.4,18.577,26777.561,278.296,7.55,0.838,0
89,34,37,3035,11,351,1948,83958,62.96,9660350,108.043,43.4,18.577,26777.561,278.296,7.55,0.838,0
89,35,30,3065,12,363,1599,85557,62.96,9660350,108.043,43.4,18.577,26777.561,278.296,7.55,0.838,0
89,36,46,3111,10,373,3178,88735,62.96,9660350,108.043,43.4,18.577,26777.561,278.296,7.55,0.838,0
89,37,39,3150,10,383,5301,94036,62.96,9660350,108.043,43.4,18.577,26777.561,278.296,7.55,0.838,0
89,38,28,3178,9,392,5022,99058,62.96,9660350,108.043,43.4,18.577,26777.561,278.296,7.55,0.838,0
89,39,35,3213,13,405,4200,103258,62.96,9660350,108.043,43.4,18.577,26777.561,278.296,7.55,0.838,0
89,40,50,3263,8,413,4999,108257,62.96,9660350,108.043,43.4,18.577,26777.561,278.296,7.55,0.838,0
89,41,21,3284,8,421,3908,112165,62.96,9660350,108.043,43.4,18.577,26777.561,278.296,7.55,0.838,0
89,42,29,3313,4,425,2554,114719,62.96,9660350,108.043,43.4,18.577,26777.561,278.296,7.55,0.838,0
89,43,28,3341,5,430,3781,118500,62.96,9660350,108.043,43.4,18.577,26777.561,278.296,7.55,0.838,0
89,44,39,3380,6,436,4758,123258,62.96,9660350,108.043,43.4,18.577,26777.561,278.296,7.55,0.838,0
89,45,37,3417,6,442,3979,127237,62.96,9660350,108.043,43.4,18.577,26777.561,278.296,7.55,0.838,0
89,46,56,3473,6,448,4192,131429,62.96,9660350,108.043,43.4,18.577,26777.561,278.296,7.55,0.838,0
89,47,36,3509,3,451,3708,135137,62.96,9660350,108.043,43.4,18.577,26777.561,278.296,7.55,0.838,0
89,48,26,3535,11,462,2106,137243,62.96,9660350,108.043,43.4,18.577,26777.561,278.296,7.55,0.838,0
89,49,21,3556,5,467,1454,138697,62.96,9660350,108.043,43.4,18.577,26777.561,278.296,7.55,0.838,0
89,50,42,3598,3,470,4032,142729,62.96,9660350,108.043,43.4,18.577,26777.561,278.296,7.55,0.838,0
89,51,43,3641,3,473,4782,147511,62.96,9660350,108.043,43.4,18.577,26777.561,278.296,7.55,0.838,0
89,52,37,3678,3,476,8290,155801,62.96,9660350,108.043,43.4,18.577,26777.561,278.296,7.55,0.838,0
89,53,35,3713,6,482,3459,159260,62.96,9660350,108.043,43.4,18.577,26777.561,278.296,7.55,0.838,0
89,54,28,3741,4,486,3665,162925,62.96,9660350,108.043,43.4,18.577,26777.561,278.296,7.55,0.838,0
89,55,15,3756,5,491,1694,164619,62.96,9660350,108.043,43.4,18.577,26777.561,278.296,7.55,0.838,0
89,56,15,3771,8,499,1644,166263,62.96,9660350,108.043,43.4,18.577,26777.561,278.296,7.55,0.838,0
89,57,22,3793,6,505,3697,169960,62.96,9660350,108.043,43.4,18.577,26777.561,278.296,7.55,0.838,0
89,58,23,3816,4,509,4051,174011,62.96,9660350,108.043,43.4,18.577,26777.561,278.296,7.55,0.838,0
89,59,25,3841,8,517,6141,180152,62.96,9660350,108.043,43.4,18.577,26777.561,278.296,7.55,0.838,0
89,60,0,3841,0,517,3410,183562,62.96,9660350,108.043,43.4,18.577,26777.561,278.296,7.55,0.838,0
89,61,26,3867,7,524,2418,185980,62.96,9660350,108.043,43.4,18.577,26777.561,278.296,7.55,0.838,0
89,62,9,3876,2,526,1985,187965,62.96,9660350,108.043,43.4,18.577,26777.561,278.296,7.55,0.838,0
89,63,45,3921,6,532,2004,189969,62.96,9660350,108.043,43.4,18.577,26777.561,278.296,7.55,0.838,0
89,64,10,3931,2,534,1603,191572,62.96,9660350,108.043,43.4,18.577,26777.561,278.296,7.55,0.838,0
89,65,0,3931,0,534,4322,195894,62.96,9660350,108.043,43.4,18.577,26777.561,278.296,7.55,0.838,0
89,66,23,3954,5,539,6712,202606,62.96,9660350,108.043,43.4,18.577,26777.561,278.296,7.55,0.838,0
89,67,16,3970,3,542,4247,206853,62.96,9660350,108.043,43.4,18.577,26777.561,278.296,7.55,0.838,0
89,68,0,3970,0,542,3349,210202,62.96,9660350,108.043,43.4,18.577,26777.561,278.296,7.55,0.838,0
89,69,0,3970,0,542,547,210749,62.96,9660350,108.043,43.4,18.577,26777.561,278.296,7.55,0.838,0
89,70,44,4014,6,548,3719,214468,62.96,9660350,108.043,43.4,18.577,26777.561,278.296,7.55,0.838,0
89,71,3,4017,2,550,3221,217689,62.96,9660350,108.043,43.4,18.577,26777.561,278.296,7.55,0.838,0
89,72,10,4027,1,551,4558,222247,62.96,9660350,108.043,43.4,18.577,26777.561,278.296,7.55,0.838,0
89,73,12,4039,2,553,4422,226669,62.96,9660350,108.043,43.4,18.577,26777.561,278.296,7.55,0.838,0
89,74,14,4053,2,555,3500,230169,62.96,9660350,108.043,43.4,18.577,26777.561,278.296,7.55,0.838,0
89,75,11,4064,4,559,3573,233742,62.96,9660350,108.043,43.4,18.577,26777.561,278.296,7.55,0.838,0
89,76,12,4076,4,563,1635,235377,62.96,9660350,108.043,43.4,18.577,26777.561,278.296,7.55,0.838,0
89,77,1,4077,2,565,1451,236828,62.96,9660350,108.043,43.4,18.577,26777.561,278.296,7.55,0.838,0
89,78,1,4078,2,567,5311,242139,62.96,9660350,108.043,43.4,18.577,26777.561,278.296,7.55,0.838,0
89,79,1,4079,1,568,3459,245598,62.96,9660350,108.043,43.4,18.577,26777.561,278.296,7.55,0.838,0
89,80,2,4081,0,568,3793,249391,52.78,9660350,108.043,43.4,18.577,26777.561,278.296,7.55,0.838,0
89,81,5,4086,2,570,3709,253100,52.78,9660350,108.043,43.4,18.577,26777.561,278.296,7.55,0.838,0
89,82,8,4094,0,570,3226,256326,52.78,9660350,108.043,43.4,18.577,26777.561,278.296,7.55,0.838,0
89,83,8,4102,2,572,1789,258115,52.78,9660350,108.043,43.4,18.577,26777.561,278.296,7.55,0.838,0
89,84,5,4107,1,573,746,258861,52.78,9660350,108.043,43.4,18.577,26777.561,278.296,7.55,0.838,0
89,85,0,4107,0,573,2559,261420,52.78,9660350,108.043,43.4,18.577,26777.561,278.296,7.55,0.838,0
89,86,7,4114,3,576,3709,265129,52.78,9660350,108.043,43.4,18.577,26777.561,278.296,7.55,0.838,0
89,87,9,4123,1,577,1927,267056,52.78,9660350,108.043,43.4,18.577,26777.561,278.296,7.55,0.838,0
89,88,4,4127,1,578,3207,270263,52.78,9660350,108.043,43.4,18.577,26777.561,278.296,7.55,0.838,0
89,89,11,4138,0,578,931,271194,52.78,9660350,108.043,43.4,18.577,26777.561,278.296,7.55,0.838,0
89,90,4,4142,3,581,2685,273879,52.78,9660350,108.043,43.4,18.577,26777.561,278.296,7.55,0.838,0
89,91,3,4145,4,585,1066,274945,52.78,9660350,108.043,43.4,18.577,26777.561,278.296,7.55,0.838,0
89,92,10,4155,0,585,2805,277750,52.78,9660350,108.043,43.4,18.577,26777.561,278.296,7.55,0.838,0
89,93,2,4157,1,586,1940,279690,52.78,9660350,108.043,43.4,18.577,26777.561,278.296,7.55,0.838,0
89,94,9,4166,1,587,1938,281628,52.78,9660350,108.043,43.4,18.577,26777.561,278.296,7.55,0.838,0
89,95,6,4172,1,588,1880,283508,52.78,9660350,108.043,43.4,18.577,26777.561,278.296,7.55,0.838,0
89,96,11,4183,1,589,2082,285590,52.78,9660350,108.043,43.4,18.577,26777.561,278.296,7.55,0.838,0
89,97,0,4183,0,589,493,286083,52.78,9660350,108.043,43.4,18.577,26777.561,278.296,7.55,0.838,0
89,98,6,4189,0,589,900,286983,52.78,9660350,108.043,43.4,18.577,26777.561,278.296,7.55,0.838,0
89,99,16,4205,0,589,1710,288693,52.78,9660350,108.043,43.4,18.577,26777.561,278.296,7.55,0.838,0
89,100,5,4210,0,589,909,289602,52.78,9660350,108.043,43.4,18.577,26777.561,278.296,7.55,0.838,0
89,101,10,4220,2,591,2435,292037,52.78,9660350,108.043,43.4,18.577,26777.561,278.296,7.55,0.838,0
89,102,3,4223,2,593,1183,293220,52.78,9660350,108.043,43.4,18.577,26777.561,278.296,7.55,0.838,0
89,103,6,4229,2,595,1205,294425,52.78,9660350,108.043,43.4,18.577,26777.561,278.296,7.55,0.838,0
89,104,5,4234,0,595,1136,295561,52.78,9660350,108.043,43.4,18.577,26777.561,278.296,7.55,0.838,0
89,105,13,4247,0,595,797,296358,52.78,9660350,108.043,43.4,18.577,26777.561,278.296,7.55,0.838,0
89,106,16,4263,0,595,2827,299185,52.78,9660350,108.043,43.4,18.577,26777.561,278.296,7.55,0.838,0
89,107,0,4263,0,595,1447,300632,52.78,9660350,108.043,43.4,18.577,26777.561,278.296,7.55,0.838,0
89,108,16,4279,0,595,2117,302749,52.78,9660350,108.043,43.4,18.577,26777.561,278.296,7.55,0.838,0
89,109,14,4293,0,595,2384,305133,52.78,9660350,108.043,43.4,18.577,26777.561,278.296,7.55,0.838,0
89,110,22,4315,1,596,2713,307846,52.78,9660350,108.043,43.4,18.577,26777.561,278.296,7.55,0.838,0
89,111,18,4333,0,596,2224,310070,52.78,9660350,108.043,43.4,18.577,26777.561,278.296,7.55,0.838,0
89,112,14,4347,0,596,760,310830,52.78,9660350,108.043,43.4,18.577,26777.561,278.296,7.55,0.838,0
89,113,19,4366,0,596,2158,312988,52.78,9660350,108.043,43.4,18.577,26777.561,278.296,7.55,0.838,0
89,114,14,4380,0,596,3132,316120,52.78,9660350,108.043,43.4,18.577,26777.561,278.296,7.55,0.838,0
89,115,18,4398,0,596,3734,319854,52.78,9660350,108.043,43.4,18.577,26777.561,278.296,7.55,0.838,0
89,116,26,4424,0,596,3819,323673,52.78,9660350,108.043,43.4,18.577,26777.561,278.296,7.55,0.838,0
89,117,11,4435,0,596,2881,326554,52.78,9660350,108.043,43.4,18.577,26777.561,278.296,7.55,0.838,0
89,118,13,4448,0,596,2029,328583,52.78,9660350,108.043,43.4,18.577,26777.561,278.296,7.55,0.838,0
89,119,8,4456,0,596,1656,330239,52.78,9660350,108.043,43.4,18.577,26777.561,278.296,7.55,0.838,0
89,120,9,4465,0,596,3207,333446,52.78,9660350,108.043,43.4,18.577,26777.561,278.296,7.55,0.838,0
89,121,19,4484,0,596,3015,336461,52.78,9660350,108.043,43.4,18.577,26777.561,278.296,7.55,0.838,0
89,122,21,4505,0,596,2702,339163,52.78,9660350,108.043,43.4,18.577,26777.561,278.296,7.55,0.838,0
89,123,0,4505,0,596,3724,342887,52.78,9660350,108.043,43.4,18.577,26777.561,278.296,7.55,0.838,0
89,124,21,4526,1,597,2110,344997,52.78,9660350,108.043,43.4,18.577,26777.561,278.296,7.55,0.838,0
89,125,9,4535,0,597,1965,346962,52.78,9660350,108.043,43.4,18.577,26777.561,278.296,7.55,0.838,0
89,126,9,4544,0,597,1170,348132,52.78,9660350,108.043,43.4,18.577,26777.561,278.296,7.55,0.838,0
89,127,9,4553,1,598,1976,350108,52.78,9660350,108.043,43.4,18.577,26777.561,278.296,7.55,0.838,0
89,128,11,4564,1,599,2438,352546,52.78,9660350,108.043,43.4,18.577,26777.561,278.296,7.55,0.838,0
89,129,33,4597,1,600,2921,355467,52.78,9660350,108.043,43.4,18.577,26777.561,278.296,7.55,0.838,0
89,130,24,4621,2,602,2970,358437,52.78,9660350,108.043,43.4,18.577,26777.561,278.296,7.55,0.838,0
89,131,32,4653,0,602,2335,360772,52.78,9660350,108.043,43.4,18.577,26777.561,278.296,7.55,0.838,0
89,132,43,4696,0,602,1888,362660,52.78,9660350,108.043,43.4,18.577,26777.561,278.296,7.55,0.838,0
89,133,35,4731,3,605,799,363459,49.07,9660350,108.043,43.4,18.577,26777.561,278.296,7.55,0.838,0
89,134,15,4746,0,605,2897,366356,49.07,9660350,108.043,43.4,18.577,26777.561,278.296,7.55,0.838,0
89,135,22,4768,0,605,3189,369545,49.07,9660350,108.043,43.4,18.577,26777.561,278.296,7.55,0.838,0
89,136,45,4813,2,607,3142,372687,49.07,9660350,108.043,43.4,18.577,26777.561,278.296,7.55,0.838,0
89,137,40,4853,0,607,2998,375685,49.07,9660350,108.043,43.4,18.577,26777.561,278.296,7.55,0.838,0
89,138,24,4877,0,607,2923,378608,49.07,9660350,108.043,43.4,18.577,26777.561,278.296,7.55,0.838,0
89,139,39,4916,1,608,2324,380932,49.07,9660350,108.043,43.4,18.577,26777.561,278.296,7.55,0.838,0
89,140,54,4970,1,609,2479,383411,49.07,9660350,108.043,43.4,18.577,26777.561,278.296,7.55,0.838,0
89,141,0,4970,0,609,3700,387111,49.07,9660350,108.043,43.4,18.577,26777.561,278.296,7.55,0.838,0
89,142,32,5002,0,609,2968,390079,49.07,9660350,108.043,43.4,18.577,26777.561,278.296,7.55,0.838,0
89,143,44,5046,0,609,3352,393431,49.07,9660350,108.043,43.4,18.577,26777.561,278.296,7.55,0.838,0
89,144,52,5098,2,611,1480,394911,49.07,9660350,108.043,43.4,18.577,26777.561,278.296,7.55,0.838,0
89,145,35,5133,0,611,2181,397092,49.07,9660350,108.043,43.4,18.577,26777.561,278.296,7.55,0.838,0
89,146,22,5155,2,613,1458,398550,49.07,9660350,108.043,43.4,18.577,26777.561,278.296,7.55,0.838,0
89,147,36,5191,0,613,1892,400442,49.07,9660350,108.043,43.4,18.577,26777.561,278.296,7.55,0.838,0
89,148,24,5215,1,614,4625,405067,49.07,9660350,108.043,43.4,18.577,26777.561,278.296,7.55,0.838,0
89,149,73,5288,0,614,3732,408799,49.07,9660350,108.043,43.4,18.577,26777.561,278.296,7.55,0.838,0
89,150,91,5379,0,614,5846,414645,49.07,9660350,108.043,43.4,18.577,26777.561,278.296,7.55,0.838,0
89,151,132,5511,0,614,3245,417890,49.07,9660350,108.043,43.4,18.577,26777.561,278.296,7.55,0.838,0
89,152,158,5669,0,614,6380,424270,49.07,9660350,108.043,43.4,18.577,26777.561,278.296,7.55,0.838,0
89,153,292,5961,0,614,3880,428150,49.07,9660350,108.043,43.4,18.577,26777.561,278.296,7.55,0.838,0
89,154,178,6139,1,615,1792,429942,51.85,9660350,108.043,43.4,18.577,26777.561,278.296,7.55,0.838,0
89,155,118,6257,1,616,7589,437531,51.85,9660350,108.043,43.4,18.577,26777.561,278.296,7.55,0.838,0
89,156,365,6622,3,619,7516,445047,51.85,9660350,108.043,43.4,18.577,26777.561,278.296,7.55,0.838,0
89,157,301,6923,1,620,7091,452138,51.85,9660350,108.043,43.4,18.577,26777.561,278.296,7.55,0.838,0
89,158,459,7382,1,621,8097,460235,51.85,9660350,108.043,43.4,18.577,26777.561,278.296,7.55,0.838,0
89,159,510,7892,3,624,9765,470000,51.85,9660350,108.043,43.4,18.577,26777.561,278.296,7.55,0.838,0
89,160,495,8387,0,624,11424,481424,51.85,9660350,108.043,43.4,18.577,26777.561,278.296,7.55,0.838,0
89,161,576,8963,1,625,5722,487146,51.85,9660350,108.043,43.4,18.577,26777.561,278.296,7.55,0.838,0
89,162,341,9304,1,626,8335,495481,51.85,9660350,108.043,43.4,18.577,26777.561,278.296,7.55,0.838,0
89,163,411,9715,2,628,10104,505585,51.85,9660350,108.043,43.4,18.577,26777.561,278.296,7.55,0.838,0
89,164,476,10191,2,630,11637,517222,40.74,9660350,108.043,43.4,18.577,26777.561,278.296,7.55,0.838,0
89,165,718,10909,1,631,11841,529063,40.74,9660350,108.043,43.4,18.577,26777.561,278.296,7.55,0.838,0
89,166,916,11825,2,633,8834,537897,40.74,9660350,108.043,43.4,18.577,26777.561,278.296,7.55,0.838,0
89,167,484,12309,4,637,11314,549211,40.74,9660350,108.043,43.4,18.577,26777.561,278.296,7.55,0.838,0
89,168,844,13153,5,642,8653,557864,40.74,9660350,108.043,43.4,18.577,26777.561,278.296,7.55,0.838,0
89,169,1307,14460,12,654,9827,567691,40.74,9660350,108.043,43.4,18.577,26777.561,278.296,7.55,0.838,0
89,170,710,15170,9,663,12381,580072,40.74,9660350,108.043,43.4,18.577,26777.561,278.296,7.55,0.838,0
89,171,941,16111,6,669,11546,591618,40.74,9660350,108.043,43.4,18.577,26777.561,278.296,7.55,0.838,0
89,172,809,16920,6,675,12504,604122,40.74,9660350,108.043,43.4,18.577,26777.561,278.296,7.55,0.838,0
89,173,1070,17990,8,683,11877,615999,40.74,9660350,108.043,43.4,18.577,26777.561,278.296,7.55,0.838,0
89,174,876,18866,3,686,10022,626021,40.74,9660350,108.043,43.4,18.577,26777.561,278.296,7.55,0.838,0
89,175,633,19499,8,694,6010,632031,40.74,9660350,108.043,43.4,18.577,26777.561,278.296,7.55,0.838,0
89,176,951,20450,8,702,13461,645492,40.74,9660350,108.043,43.4,18.577,26777.561,278.296,7.55,0.838,0
89,177,750,21200,7,709,11945,657437,40.74,9660350,108.043,43.4,18.577,26777.561,278.296,7.55,0.838,0
89,178,927,22127,9,718,11116,668553,40.74,9660350,108.043,43.4,18.577,26777.561,278.296,7.55,0.838,0
89,179,950,23077,12,730,11782,680335,40.74,9660350,108.043,43.4,18.577,26777.561,278.296,7.55,0.838,0
89,180,937,24014,6,736,10073,690408,40.74,9660350,108.043,43.4,18.577,26777.561,278.296,7.55,0.838,0
89,181,702,24716,13,749,7065,697473,40.74,9660350,108.043,43.4,18.577,26777.561,278.296,7.55,0.838,0
89,182,851,25567,8,757,7037,704510,40.74,9660350,108.043,43.4,18.577,26777.561,278.296,7.55,0.838,0
89,183,894,26461,8,765,11167,715677,40.74,9660350,108.043,43.4,18.577,26777.561,278.296,7.55,0.838,0
89,184,848,27309,16,781,11972,727649,40.74,9660350,108.043,43.4,18.577,26777.561,278.296,7.55,0.838,0
89,185,1322,28631,17,798,12394,740043,40.74,9660350,108.043,43.4,18.577,26777.561,278.296,7.55,0.838,0
89,186,1086,29717,14,812,11174,751217,40.74,9660350,108.043,43.4,18.577,26777.561,278.296,7.55,0.838,0
89,187,858,30575,10,822,7957,759174,40.74,9660350,108.043,43.4,18.577,26777.561,278.296,7.55,0.838,0
89,188,905,31480,11,833,6424,765598,40.74,9660350,108.043,43.4,18.577,26777.561,278.296,7.55,0.838,0
89,189,818,32298,20,853,5699,771297,40.74,9660350,108.043,43.4,18.577,26777.561,278.296,7.55,0.838,0
89,190,816,33114,24,877,9726,781023,40.74,9660350,108.043,43.4,18.577,26777.561,278.296,7.55,0.838,0
89,191,932,34046,21,898,11462,792485,40.74,9660350,108.043,43.4,18.577,26777.561,278.296,7.55,0.838,0
89,192,1176,35222,15,913,11163,803648,40.74,9660350,108.043,43.4,18.577,26777.561,278.296,7.55,0.838,0
89,193,1374,36596,20,933,11719,815367,40.74,9660350,108.043,43.4,18.577,26777.561,278.296,7.55,0.838,0
89,194,1068,37664,21,954,10203,825570,40.74,9660350,108.043,43.4,18.577,26777.561,278.296,7.55,0.838,0
89,195,913,38577,14,968,8527,834097,40.74,9660350,108.043,43.4,18.577,26777.561,278.296,7.55,0.838,0
89,196,1285,39862,28,996,7123,841220,40.74,9660350,108.043,43.4,18.577,26777.561,278.296,7.55,0.838,0
89,197,920,40782,27,1023,9658,850878,40.74,9660350,108.043,43.4,18.577,26777.561,278.296,7.55,0.838,0
89,198,950,41732,29,1052,10742,861620,40.74,9660350,108.043,43.4,18.577,26777.561,278.296,7.55,0.838,0
89,199,1293,43025,33,1085,9797,871417,40.74,9660350,108.043,43.4,18.577,26777.561,278.296,7.55,0.838,0
89,200,1791,44816,24,1109,12971,884388,40.74,9660350,108.043,43.4,18.577,26777.561,278.296,7.55,0.838,0
89,201,1474,46290,33,1142,9997,894385,40.74,9660350,108.043,43.4,18.577,26777.561,278.296,7.55,0.838,0
89,202,1478,47768,31,1173,9651,904036,40.74,9660350,108.043,43.4,18.577,26777.561,278.296,7.55,0.838,0
89,203,989,48757,38,1211,6332,910368,40.74,9660350,108.043,43.4,18.577,26777.561,278.296,7.55,0.838,0
89,204,1423,50180,48,1259,0,910368,40.74,9660350,108.043,43.4,18.577,26777.561,278.296,7.55,0.838,0
90,1,49,1135,0,2,1414,20889,53.7,341250,3.404,37.3,14.431,46482.958,117.992,5.31,0.935,0
90,2,85,1220,0,2,1265,22154,53.7,341250,3.404,37.3,14.431,46482.958,117.992,5.31,0.935,0
90,3,99,1319,2,4,1445,23599,53.7,341250,3.404,37.3,14.431,46482.958,117.992,5.31,0.935,0
90,4,45,1364,0,4,1754,25353,53.7,341250,3.404,37.3,14.431,46482.958,117.992,5.31,0.935,0
90,5,53,1417,0,4,2486,27839,53.7,341250,3.404,37.3,14.431,46482.958,117.992,5.31,0.935,0
90,6,69,1486,0,4,1112,28951,53.7,341250,3.404,37.3,14.431,46482.958,117.992,5.31,0.935,0
90,7,76,1562,2,6,1955,30906,53.7,341250,3.404,37.3,14.431,46482.958,117.992,5.31,0.935,0
90,8,24,1586,0,6,1676,32582,53.7,341250,3.404,37.3,14.431,46482.958,117.992,5.31,0.935,0
90,9,30,1616,0,6,1502,34084,53.7,341250,3.404,37.3,14.431,46482.958,117.992,5.31,0.935,0
90,10,32,1648,0,6,510,34594,53.7,341250,3.404,37.3,14.431,46482.958,117.992,5.31,0.935,0
90,11,27,1675,1,7,618,35212,53.7,341250,3.404,37.3,14.431,46482.958,117.992,5.31,0.935,0
90,12,14,1689,1,8,235,35447,53.7,341250,3.404,37.3,14.431,46482.958,117.992,5.31,0.935,0
90,13,12,1701,0,8,851,36298,53.7,341250,3.404,37.3,14.431,46482.958,117.992,5.31,0.935,0
90,14,10,1711,0,8,1047,37345,53.7,341250,3.404,37.3,14.431,46482.958,117.992,5.31,0.935,0
90,15,9,1720,0,8,818,38163,53.7,341250,3.404,37.3,14.431,46482.958,117.992,5.31,0.935,0
90,16,7,1727,0,8,1332,39495,53.7,341250,3.404,37.3,14.431,46482.958,117.992,5.31,0.935,0
90,17,12,1739,0,8,1555,41050,53.7,341250,3.404,37.3,14.431,46482.958,117.992,5.31,0.935,0
90,18,15,1754,0,8,1671,42721,53.7,341250,3.404,37.3,14.431,46482.958,117.992,5.31,0.935,0
90,19,6,1760,1,9,381,43102,53.7,341250,3.404,37.3,14.431,46482.958,117.992,5.31,0.935,0
90,20,11,1771,0,9,688,43790,53.7,341250,3.404,37.3,14.431,46482.958,117.992,5.31,0.935,0
90,21,2,1773,1,10,637,44427,53.7,341250,3.404,37.3,14.431,46482.958,117.992,5.31,0.935,0
90,22,5,1778,0,10,625,45052,53.7,341250,3.404,37.3,14.431,46482.958,117.992,5.31,0.935,0
90,23,7,1785,0,10,193,45245,53.7,341250,3.404,37.3,14.431,46482.958,117.992,5.31,0.935,0
90,24,4,1789,0,10,685,45930,53.7,341250,3.404,37.3,14.431,46482.958,117.992,5.31,0.935,0
90,25,0,1789,0,10,381,46311,53.7,341250,3.404,37.3,14.431,46482.958,117.992,5.31,0.935,0
90,26,1,1790,0,10,25,46336,53.7,341250,3.404,37.3,14.431,46482.958,117.992,5.31,0.935,0
90,27,2,1792,0,10,688,47024,53.7,341250,3.404,37.3,14.431,46482.958,117.992,5.31,0.935,0
90,28,0,1792,0,10,508,47532,53.7,341250,3.404,37.3,14.431,46482.958,117.992,5.31,0.935,0
90,29,3,1795,0,10,840,48372,53.7,341250,3.404,37.3,14.431,46482.958,117.992,5.31,0.935,0
90,30,2,1797,0,10,722,49094,53.7,341250,3.404,37.3,14.431,46482.958,117.992,5.31,0.935,0
90,31,0,1797,0,10,867,49961,53.7,341250,3.404,37.3,14.431,46482.958,117.992,5.31,0.935,0
90,32,1,1798,0,10,404,50365,53.7,341250,3.404,37.3,14.431,46482.958,117.992,5.31,0.935,0
90,33,0,1798,0,10,71,50436,53.7,341250,3.404,37.3,14.431,46482.958,117.992,5.31,0.935,0
90,34,1,1799,0,10,868,51304,46.3,341250,3.404,37.3,14.431,46482.958,117.992,5.31,0.935,0
90,35,0,1799,0,10,318,51622,46.3,341250,3.404,37.3,14.431,46482.958,117.992,5.31,0.935,0
90,36,0,1799,0,10,620,52242,46.3,341250,3.404,37.3,14.431,46482.958,117.992,5.31,0.935,0
90,37,0,1799,0,10,462,52704,46.3,341250,3.404,37.3,14.431,46482.958,117.992,5.31,0.935,0
90,38,2,1801,0,10,515,53219,46.3,341250,3.404,37.3,14.431,46482.958,117.992,5.31,0.935,0
90,39,0,1801,0,10,935,54154,46.3,341250,3.404,37.3,14.431,46482.958,117.992,5.31,0.935,0
90,40,0,1801,0,10,18,54172,46.3,341250,3.404,37.3,14.431,46482.958,117.992,5.31,0.935,0
90,41,0,1801,0,10,578,54750,46.3,341250,3.404,37.3,14.431,46482.958,117.992,5.31,0.935,0
90,42,0,1801,0,10,284,55034,46.3,341250,3.404,37.3,14.431,46482.958,117.992,5.31,0.935,0
90,43,0,1801,0,10,551,55585,46.3,341250,3.404,37.3,14.431,46482.958,117.992,5.31,0.935,0
90,44,1,1802,0,10,593,56178,46.3,341250,3.404,37.3,14.431,46482.958,117.992,5.31,0.935,0
90,45,0,1802,0,10,523,56701,46.3,341250,3.404,37.3,14.431,46482.958,117.992,5.31,0.935,0
90,46,0,1802,0,10,133,56834,46.3,341250,3.404,37.3,14.431,46482.958,117.992,5.31,0.935,0
90,47,0,1802,0,10,7,56841,46.3,341250,3.404,37.3,14.431,46482.958,117.992,5.31,0.935,0
90,48,0,1802,0,10,305,57146,46.3,341250,3.404,37.3,14.431,46482.958,117.992,5.31,0.935,0
90,49,0,1802,0,10,441,57587,46.3,341250,3.404,37.3,14.431,46482.958,117.992,5.31,0.935,0
90,50,0,1802,0,10,597,58184,46.3,341250,3.404,37.3,14.431,46482.958,117.992,5.31,0.935,0
90,51,1,1803,0,10,70,58254,46.3,341250,3.404,37.3,14.431,46482.958,117.992,5.31,0.935,0
90,52,0,1803,0,10,491,58745,46.3,341250,3.404,37.3,14.431,46482.958,117.992,5.31,0.935,0
90,53,0,1803,0,10,58,58803,46.3,341250,3.404,37.3,14.431,46482.958,117.992,5.31,0.935,0
90,54,1,1804,0,10,12,58815,46.3,341250,3.404,37.3,14.431,46482.958,117.992,5.31,0.935,0
90,55,0,1804,0,10,231,59046,36.11,341250,3.404,37.3,14.431,46482.958,117.992,5.31,0.935,0
90,56,0,1804,0,10,526,59572,36.11,341250,3.404,37.3,14.431,46482.958,117.992,5.31,0.935,0
90,57,0,1804,0,10,528,60100,36.11,341250,3.404,37.3,14.431,46482.958,117.992,5.31,0.935,0
90,58,1,1805,0,10,350,60450,36.11,341250,3.404,37.3,14.431,46482.958,117.992,5.31,0.935,0
90,59,0,1805,0,10,534,60984,36.11,341250,3.404,37.3,14.431,46482.958,117.992,5.31,0.935,0
90,60,0,1805,0,10,97,61081,36.11,341250,3.404,37.3,14.431,46482.958,117.992,5.31,0.935,0
90,61,1,1806,0,10,16,61097,36.11,341250,3.404,37.3,14.431,46482.958,117.992,5.31,0.935,0
90,62,0,1806,0,10,18,61115,36.11,341250,3.404,37.3,14.431,46482.958,117.992,5.31,0.935,0
90,63,0,1806,0,10,199,61314,36.11,341250,3.404,37.3,14.431,46482.958,117.992,5.31,0.935,0
90,64,0,1806,0,10,325,61639,36.11,341250,3.404,37.3,14.431,46482.958,117.992,5.31,0.935,0
90,65,0,1806,0,10,550,62189,36.11,341250,3.404,37.3,14.431,46482.958,117.992,5.31,0.935,0
90,66,0,1806,0,10,538,62727,36.11,341250,3.404,37.3,14.431,46482.958,117.992,5.31,0.935,0
90,67,0,1806,0,10,27,62754,36.11,341250,3.404,37.3,14.431,46482.958,117.992,5.31,0.935,0
90,68,0,1806,0,10,7,62761,36.11,341250,3.404,37.3,14.431,46482.958,117.992,5.31,0.935,0
90,69,1,1807,0,10,68,62829,36.11,341250,3.404,37.3,14.431,46482.958,117.992,5.31,0.935,0
90,70,0,1807,0,10,41,62870,36.11,341250,3.404,37.3,14.431,46482.958,117.992,5.31,0.935,0
90,71,0,1807,0,10,65,62935,36.11,341250,3.404,37.3,14.431,46482.958,117.992,5.31,0.935,0
90,72,0,1807,0,10,69,63004,36.11,341250,3.404,37.3,14.431,46482.958,117.992,5.31,0.935,0
90,73,0,1807,0,10,79,63083,36.11,341250,3.404,37.3,14.431,46482.958,117.992,5.31,0.935,0
90,74,1,1808,0,10,60,63143,36.11,341250,3.404,37.3,14.431,46482.958,117.992,5.31,0.935,0
90,75,2,1810,0,10,14,63157,36.11,341250,3.404,37.3,14.431,46482.958,117.992,5.31,0.935,0
90,76,0,1810,0,10,27,63184,33.33,341250,3.404,37.3,14.431,46482.958,117.992,5.31,0.935,0
90,77,1,1811,0,10,176,63360,33.33,341250,3.404,37.3,14.431,46482.958,117.992,5.31,0.935,0
90,78,1,1812,0,10,68,63428,33.33,341250,3.404,37.3,14.431,46482.958,117.992,5.31,0.935,0
90,79,0,1812,0,10,39,63467,33.33,341250,3.404,37.3,14.431,46482.958,117.992,5.31,0.935,0
90,80,2,1814,0,10,109,63576,33.33,341250,3.404,37.3,14.431,46482.958,117.992,5.31,0.935,0
90,81,1,1815,0,10,64,63640,33.33,341250,3.404,37.3,14.431,46482.958,117.992,5.31,0.935,0
90,82,0,1815,0,10,17,63657,33.33,341250,3.404,37.3,14.431,46482.958,117.992,5.31,0.935,0
90,83,0,1815,0,10,44,63701,33.33,341250,3.404,37.3,14.431,46482.958,117.992,5.31,0.935,0
90,84,0,1815,0,10,86,63787,33.33,341250,3.404,37.3,14.431,46482.958,117.992,5.31,0.935,0
90,85,0,1815,0,10,47,63834,33.33,341250,3.404,37.3,14.431,46482.958,117.992,5.31,0.935,0
90,86,2,1817,0,10,136,63970,33.33,341250,3.404,37.3,14.431,46482.958,117.992,5.31,0.935,0
90,87,1,1818,0,10,251,64221,33.33,341250,3.404,37.3,14.431,46482.958,117.992,5.31,0.935,0
90,88,2,1820,0,10,171,64392,33.33,341250,3.404,37.3,14.431,46482.958,117.992,5.31,0.935,0
90,89,0,1820,0,10,250,64642,33.33,341250,3.404,37.3,14.431,46482.958,117.992,5.31,0.935,0
90,90,1,1821,0,10,464,65106,33.33,341250,3.404,37.3,14.431,46482.958,117.992,5.31,0.935,0
90,91,1,1822,0,10,728,65834,33.33,341250,3.404,37.3,14.431,46482.958,117.992,5.31,0.935,0
90,92,2,1824,0,10,270,66104,33.33,341250,3.404,37.3,14.431,46482.958,117.992,5.31,0.935,0
90,93,1,1825,0,10,161,66265,33.33,341250,3.404,37.3,14.431,46482.958,117.992,5.31,0.935,0
90,94,5,1830,0,10,397,66662,33.33,341250,3.404,37.3,14.431,46482.958,117.992,5.31,0.935,0
90,95,0,1830,0,10,152,66814,33.33,341250,3.404,37.3,14.431,46482.958,117.992,5.31,0.935,0
90,96,0,1830,0,10,23,66837,33.33,341250,3.404,37.3,14.431,46482.958,117.992,5.31,0.935,0
90,97,0,1830,0,10,185,67022,33.33,341250,3.404,37.3,14.431,46482.958,117.992,5.31,0.935,0
90,98,2,1832,0,10,224,67246,33.33,341250,3.404,37.3,14.431,46482.958,117.992,5.31,0.935,0
90,99,1,1833,0,10,131,67377,33.33,341250,3.404,37.3,14.431,46482.958,117.992,5.31,0.935,0
90,100,0,1833,0,10,141,67518,33.33,341250,3.404,37.3,14.431,46482.958,117.992,5.31,0.935,0
90,101,0,1833,0,10,211,67729,33.33,341250,3.404,37.3,14.431,46482.958,117.992,5.31,0.935,0
90,102,0,1833,0,10,63,67792,33.33,341250,3.404,37.3,14.431,46482.958,117.992,5.31,0.935,0
90,103,0,1833,0,10,31,67823,33.33,341250,3.404,37.3,14.431,46482.958,117.992,5.31,0.935,0
90,104,0,1833,0,10,89,67912,33.33,341250,3.404,37.3,14.431,46482.958,117.992,5.31,0.935,0
90,105,0,1833,0,10,152,68064,33.33,341250,3.404,37.3,14.431,46482.958,117.992,5.31,0.935,0
90,106,2,1835,0,10,137,68201,33.33,341250,3.404,37.3,14.431,46482.958,117.992,5.31,0.935,0
90,107,0,1835,0,10,121,68322,33.33,341250,3.404,37.3,14.431,46482.958,117.992,5.31,0.935,0
90,108,1,1836,0,10,189,68511,33.33,341250,3.404,37.3,14.431,46482.958,117.992,5.31,0.935,0
90,109,0,1836,0,10,64,68575,33.33,341250,3.404,37.3,14.431,46482.958,117.992,5.31,0.935,0
90,110,2,1838,0,10,39,68614,33.33,341250,3.404,37.3,14.431,46482.958,117.992,5.31,0.935,0
90,111,1,1839,0,10,26,68640,33.33,341250,3.404,37.3,14.431,46482.958,117.992,5.31,0.935,0
90,112,0,1839,0,10,66,68706,33.33,341250,3.404,37.3,14.431,46482.958,117.992,5.31,0.935,0
90,113,0,1839,0,10,49,68755,33.33,341250,3.404,37.3,14.431,46482.958,117.992,5.31,0.935,0
90,114,1,1840,0,10,67,68822,33.33,341250,3.404,37.3,14.431,46482.958,117.992,5.31,0.935,0
90,115,1,1841,0,10,69,68891,33.33,341250,3.404,37.3,14.431,46482.958,117.992,5.31,0.935,0
90,116,2,1843,0,10,46,68937,33.33,341250,3.404,37.3,14.431,46482.958,117.992,5.31,0.935,0
90,117,0,1843,0,10,18,68955,33.33,341250,3.404,37.3,14.431,46482.958,117.992,5.31,0.935,0
90,118,4,1847,0,10,37,68992,33.33,341250,3.404,37.3,14.431,46482.958,117.992,5.31,0.935,0
90,119,7,1854,0,10,124,69116,33.33,341250,3.404,37.3,14.431,46482.958,117.992,5.31,0.935,0
90,120,3,1857,0,10,352,69468,33.33,341250,3.404,37.3,14.431,46482.958,117.992,5.31,0.935,0
90,121,4,1861,0,10,1138,70606,33.33,341250,3.404,37.3,14.431,46482.958,117.992,5.31,0.935,0
90,122,11,1872,0,10,1324,71930,39.81,341250,3.404,37.3,14.431,46482.958,117.992,5.31,0.935,0
90,123,13,1885,0,10,826,72756,39.81,341250,3.404,37.3,14.431,46482.958,117.992,5.31,0.935,0
90,124,8,1893,0,10,1205,73961,39.81,341250,3.404,37.3,14.431,46482.958,117.992,5.31,0.935,0
90,125,14,1907,0,10,767,74728,39.81,341250,3.404,37.3,14.431,46482.958,117.992,5.31,0.935,0
90,126,8,1915,0,10,615,75343,39.81,341250,3.404,37.3,14.431,46482.958,117.992,5.31,0.935,0
90,127,3,1918,0,10,825,76168,39.81,341250,3.404,37.3,14.431,46482.958,117.992,5.31,0.935,0
90,128,8,1926,0,10,1077,77245,39.81,341250,3.404,37.3,14.431,46482.958,117.992,5.31,0.935,0
90,129,6,1932,0,10,594,77839,39.81,341250,3.404,37.3,14.431,46482.958,117.992,5.31,0.935,0
90,130,20,1952,0,10,396,78235,39.81,341250,3.404,37.3,14.431,46482.958,117.992,5.31,0.935,0
90,131,3,1955,0,10,232,78467,39.81,341250,3.404,37.3,14.431,46482.958,117.992,5.31,0.935,0
90,132,3,1958,0,10,345,78812,39.81,341250,3.404,37.3,14.431,46482.958,117.992,5.31,0.935,0
90,133,4,1962,0,10,1190,80002,39.81,341250,3.404,37.3,14.431,46482.958,117.992,5.31,0.935,0
90,134,6,1968,0,10,722,80724,39.81,341250,3.404,37.3,14.431,46482.958,117.992,5.31,0.935,0
90,135,4,1972,0,10,328,81052,39.81,341250,3.404,37.3,14.431,46482.958,117.992,5.31,0.935,0
90,136,4,1976,0,10,537,81589,39.81,341250,3.404,37.3,14.431,46482.958,117.992,5.31,0.935,0
90,137,7,1983,0,10,347,81936,39.81,341250,3.404,37.3,14.431,46482.958,117.992,5.31,0.935,0
90,138,16,1999,0,10,158,82094,39.81,341250,3.404,37.3,14.431,46482.958,117.992,5.31,0.935,0
90,139,12,2011,0,10,408,82502,39.81,341250,3.404,37.3,14.431,46482.958,117.992,5.31,0.935,0
90,140,3,2014,0,10,504,83006,39.81,341250,3.404,37.3,14.431,46482.958,117.992,5.31,0.935,0
90,141,13,2027,0,10,455,83461,39.81,341250,3.404,37.3,14.431,46482.958,117.992,5.31,0.935,0
90,142,8,2035,0,10,591,84052,39.81,341250,3.404,37.3,14.431,46482.958,117.992,5.31,0.935,0
90,143,5,2040,0,10,588,84640,39.81,341250,3.404,37.3,14.431,46482.958,117.992,5.31,0.935,0
90,144,10,2050,0,10,272,84912,39.81,341250,3.404,37.3,14.431,46482.958,117.992,5.31,0.935,0
90,145,8,2058,0,10,291,85203,39.81,341250,3.404,37.3,14.431,46482.958,117.992,5.31,0.935,0
90,146,6,2064,0,10,602,85805,39.81,341250,3.404,37.3,14.431,46482.958,117.992,5.31,0.935,0
90,147,9,2073,0,10,871,86676,39.81,341250,3.404,37.3,14.431,46482.958,117.992,5.31,0.935,0
90,148,4,2077,0,10,767,87443,39.81,341250,3.404,37.3,14.431,46482.958,117.992,5.31,0.935,0
90,149,5,2082,0,10,723,88166,39.81,341250,3.404,37.3,14.431,46482.958,117.992,5.31,0.935,0
90,150,5,2087,0,10,663,88829,39.81,341250,3.404,37.3,14.431,46482.958,117.992,5.31,0.935,0
90,151,5,2092,0,10,360,89189,39.81,341250,3.404,37.3,14.431,46482.958,117.992,5.31,0.935,0
90,152,8,2100,0,10,217,89406,39.81,341250,3.404,37.3,14.431,46482.958,117.992,5.31,0.935,0
90,153,5,2105,0,10,675,90081,39.81,341250,3.404,37.3,14.431,46482.958,117.992,5.31,0.935,0
90,154,2,2107,0,10,593,90674,39.81,341250,3.404,37.3,14.431,46482.958,117.992,5.31,0.935,0
90,155,9,2116,0,10,609,91283,39.81,341250,3.404,37.3,14.431,46482.958,117.992,5.31,0.935,0
90,156,5,2121,0,10,557,91840,39.81,341250,3.404,37.3,14.431,46482.958,117.992,5.31,0.935,0
90,157,7,2128,0,10,659,92499,39.81,341250,3.404,37.3,14.431,46482.958,117.992,5.31,0.935,0
90,158,7,2135,0,10,349,92848,39.81,341250,3.404,37.3,14.431,46482.958,117.992,5.31,0.935,0
90,159,1,2136,0,10,123,92971,39.81,341250,3.404,37.3,14.431,46482.958,117.992,5.31,0.935,0
90,160,5,2141,0,10,726,93697,31.48,341250,3.404,37.3,14.431,46482.958,117.992,5.31,0.935,0
90,161,2,2143,0,10,702,94399,31.48,341250,3.404,37.3,14.431,46482.958,117.992,5.31,0.935,0
90,162,7,2150,0,10,524,94923,31.48,341250,3.404,37.3,14.431,46482.958,117.992,5.31,0.935,0
90,163,3,2153,0,10,562,95485,31.48,341250,3.404,37.3,14.431,46482.958,117.992,5.31,0.935,0
90,164,4,2157,0,10,589,96074,31.48,341250,3.404,37.3,14.431,46482.958,117.992,5.31,0.935,0
90,165,4,2161,0,10,334,96408,31.48,341250,3.404,37.3,14.431,46482.958,117.992,5.31,0.935,0
90,166,1,2162,0,10,148,96556,31.48,341250,3.404,37.3,14.431,46482.958,117.992,5.31,0.935,0
90,167,3,2165,0,10,479,97035,31.48,341250,3.404,37.3,14.431,46482.958,117.992,5.31,0.935,0
90,168,3,2168,0,10,774,97809,31.48,341250,3.404,37.3,14.431,46482.958,117.992,5.31,0.935,0
90,169,6,2174,0,10,1247,99056,31.48,341250,3.404,37.3,14.431,46482.958,117.992,5.31,0.935,0
90,170,15,2189,0,10,3104,102160,31.48,341250,3.404,37.3,14.431,46482.958,117.992,5.31,0.935,0
90,171,17,2206,0,10,3264,105424,31.48,341250,3.404,37.3,14.431,46482.958,117.992,5.31,0.935,0
90,172,24,2230,0,10,1404,106828,31.48,341250,3.404,37.3,14.431,46482.958,117.992,5.31,0.935,0
90,173,77,2307,0,10,1512,108340,31.48,341250,3.404,37.3,14.431,46482.958,117.992,5.31,0.935,0
90,174,39,2346,0,10,3846,112186,31.48,341250,3.404,37.3,14.431,46482.958,117.992,5.31,0.935,0
90,175,31,2377,0,10,4525,116711,31.48,341250,3.404,37.3,14.431,46482.958,117.992,5.31,0.935,0
90,176,42,2419,0,10,2073,118784,31.48,341250,3.404,37.3,14.431,46482.958,117.992,5.31,0.935,0
90,177,57,2476,0,10,2230,121014,31.48,341250,3.404,37.3,14.431,46482.958,117.992,5.31,0.935,0
90,178,36,2512,0,10,2237,123251,31.48,341250,3.404,37.3,14.431,46482.958,117.992,5.31,0.935,0
90,179,49,2561,0,10,974,124225,31.48,341250,3.404,37.3,14.431,46482.958,117.992,5.31,0.935,0
90,180,40,2601,0,10,765,124990,31.48,341250,3.404,37.3,14.431,46482.958,117.992,5.31,0.935,0
90,181,22,2623,0,10,1764,126754,31.48,341250,3.404,37.3,14.431,46482.958,117.992,5.31,0.935,0
90,182,40,2663,0,10,1703,128457,31.48,341250,3.404,37.3,14.431,46482.958,117.992,5.31,0.935,0
90,183,32,2695,0,10,1427,129884,31.48,341250,3.404,37.3,14.431,46482.958,117.992,5.31,0.935,0
90,184,33,2728,0,10,1269,131153,31.48,341250,3.404,37.3,14.431,46482.958,117.992,5.31,0.935,0
90,185,41,2769,0,10,1456,132609,31.48,341250,3.404,37.3,14.431,46482.958,117.992,5.31,0.935,0
90,186,40,2809,0,10,1128,133737,31.48,341250,3.404,37.3,14.431,46482.958,117.992,5.31,0.935,0
90,187,63,2872,0,10,1088,134825,31.48,341250,3.404,37.3,14.431,46482.958,117.992,5.31,0.935,0
90,188,49,2921,0,10,2535,137360,34.26,341250,3.404,37.3,14.431,46482.958,117.992,5.31,0.935,0
90,189,59,2980,0,10,2386,139746,34.26,341250,3.404,37.3,14.431,46482.958,117.992,5.31,0.935,0
90,190,101,3081,0,10,2591,142337,34.26,341250,3.404,37.3,14.431,46482.958,117.992,5.31,0.935,0
90,191,91,3172,0,10,3479,145816,34.26,341250,3.404,37.3,14.431,46482.958,117.992,5.31,0.935,0
90,192,95,3267,0,10,3213,149029,34.26,341250,3.404,37.3,14.431,46482.958,117.992,5.31,0.935,0
90,193,106,3373,0,10,1608,150637,34.26,341250,3.404,37.3,14.431,46482.958,117.992,5.31,0.935,0
90,194,87,3460,0,10,1055,151692,34.26,341250,3.404,37.3,14.431,46482.958,117.992,5.31,0.935,0
90,195,66,3526,0,10,3129,154821,34.26,341250,3.404,37.3,14.431,46482.958,117.992,5.31,0.935,0
90,196,56,3582,0,10,1815,156636,34.26,341250,3.404,37.3,14.431,46482.958,117.992,5.31,0.935,0
90,197,86,3668,0,10,2219,158855,34.26,341250,3.404,37.3,14.431,46482.958,117.992,5.31,0.935,0
90,198,89,3757,0,10,2175,161030,34.26,341250,3.404,37.3,14.431,46482.958,117.992,5.31,0.935,0
90,199,80,3837,0,10,1807,162837,34.26,341250,3.404,37.3,14.431,46482.958,117.992,5.31,0.935,0
90,200,92,3929,1,11,1285,164122,34.26,341250,3.404,37.3,14.431,46482.958,117.992,5.31,0.935,0
90,201,69,3998,0,11,823,164945,34.26,341250,3.404,37.3,14.431,46482.958,117.992,5.31,0.935,0
90,202,57,4055,0,11,0,164945,34.26,341250,3.404,37.3,14.431,46482.958,117.992,5.31,0.935,0
90,203,46,4101,0,11,0,164945,34.26,341250,3.404,37.3,14.431,46482.958,117.992,5.31,0.935,0
90,204,92,4193,0,11,0,164945,34.26,341250,3.404,37.3,14.431,46482.958,117.992,5.31,0.935,0
91,1,146,1397,3,35,0,0,100,1380004385,450.419,28.2,5.989,6426.674,282.28,10.39,0.64,1
91,2,568,1965,15,50,0,47951,100,1380004385,450.419,28.2,5.989,6426.674,282.28,10.39,0.64,1
91,3,336,2301,6,56,21294,69245,100,1380004385,450.419,28.2,5.989,6426.674,282.28,10.39,0.64,1
91,4,601,2902,12,68,10705,79950,100,1380004385,450.419,28.2,5.989,6426.674,282.28,10.39,0.64,1
91,5,472,3374,9,77,9584,89534,100,1380004385,450.419,28.2,5.989,6426.674,282.28,10.39,0.64,1
91,6,693,4067,32,109,11534,101068,100,1380004385,450.419,28.2,5.989,6426.674,282.28,10.39,0.64,1
91,7,354,4421,5,114,12947,114015,100,1380004385,450.419,28.2,5.989,6426.674,282.28,10.39,0.64,1
91,8,773,5194,35,149,13904,127919,100,1380004385,450.419,28.2,5.989,6426.674,282.28,10.39,0.64,1
91,9,540,5734,17,166,16991,144910,100,1380004385,450.419,28.2,5.989,6426.674,282.28,10.39,0.64,1
91,10,678,6412,33,199,16420,161330,100,1380004385,450.419,28.2,5.989,6426.674,282.28,10.39,0.64,1
91,11,1035,7447,40,239,18044,179374,100,1380004385,450.419,28.2,5.989,6426.674,282.28,10.39,0.64,1
91,12,909,8356,34,273,16374,195748,100,1380004385,450.419,28.2,5.989,6426.674,282.28,10.39,0.64,1
91,13,796,9152,35,308,21806,217554,100,1380004385,450.419,28.2,5.989,6426.674,282.28,10.39,0.64,1
91,14,1211,10363,31,339,27339,244893,100,1380004385,450.419,28.2,5.989,6426.674,282.28,10.39,0.64,1
91,15,1075,11438,38,377,29706,274599,100,1380004385,450.419,28.2,5.989,6426.674,282.28,10.39,0.64,1
91,16,942,12380,37,414,28357,302956,100,1380004385,450.419,28.2,5.989,6426.674,282.28,10.39,0.64,1
91,17,1007,13387,23,437,32167,335123,100,1380004385,450.419,28.2,5.989,6426.674,282.28,10.39,0.64,1
91,18,991,14378,43,480,37000,372123,100,1380004385,450.419,28.2,5.989,6426.674,282.28,10.39,0.64,1
91,19,1334,15712,27,507,29463,401586,100,1380004385,450.419,28.2,5.989,6426.674,282.28,10.39,0.64,1
91,20,1553,17265,36,543,0,401586,96.3,1380004385,450.419,28.2,5.989,6426.674,282.28,10.39,0.64,1
91,21,1335,18600,47,590,0,462621,96.3,1380004385,450.419,28.2,5.989,6426.674,282.28,10.39,0.64,1
91,22,1384,19984,50,640,0,462621,96.3,1380004385,450.419,28.2,5.989,6426.674,282.28,10.39,0.64,1
91,23,1409,21393,41,681,0,500542,96.3,1380004385,450.419,28.2,5.989,6426.674,282.28,10.39,0.64,1
91,24,1684,23077,37,718,41247,541789,96.3,1380004385,450.419,28.2,5.989,6426.674,282.28,10.39,0.64,1
91,25,1429,24506,57,775,38168,579957,96.3,1380004385,450.419,28.2,5.989,6426.674,282.28,10.39,0.64,1
91,26,1990,26496,49,824,45352,625309,96.3,1380004385,450.419,28.2,5.989,6426.674,282.28,10.39,0.64,1
91,27,1396,27892,48,872,40510,665819,96.3,1380004385,450.419,28.2,5.989,6426.674,282.28,10.39,0.64,1
91,28,1543,29435,62,934,50914,716733,96.3,1380004385,450.419,28.2,5.989,6426.674,282.28,10.39,0.64,1
91,29,1897,31332,73,1007,54031,770764,96.3,1380004385,450.419,28.2,5.989,6426.674,282.28,10.39,0.64,1
91,30,1718,33050,67,1074,59437,830201,96.3,1380004385,450.419,28.2,5.989,6426.674,282.28,10.39,0.64,1
91,31,1993,35043,73,1147,72453,902654,96.3,1380004385,450.419,28.2,5.989,6426.674,282.28,10.39,0.64,1
91,32,2293,37336,71,1218,73709,976363,96.3,1380004385,450.419,28.2,5.989,6426.674,282.28,10.39,0.64,1
91,33,2644,39980,83,1301,70087,1046450,96.3,1380004385,450.419,28.2,5.989,6426.674,282.28,10.39,0.64,1
91,34,2553,42533,72,1373,60783,1107233,81.94,1380004385,450.419,28.2,5.989,6426.674,282.28,10.39,0.64,1
91,35,3900,46433,195,1568,84713,1191946,81.94,1380004385,450.419,28.2,5.989,6426.674,282.28,10.39,0.64,1
91,36,2958,49391,126,1694,84835,1276781,81.94,1380004385,450.419,28.2,5.989,6426.674,282.28,10.39,0.64,1
91,37,3561,52952,89,1783,80632,1357413,81.94,1380004385,450.419,28.2,5.989,6426.674,282.28,10.39,0.64,1
91,38,3390,56342,103,1886,80375,1437788,81.94,1380004385,450.419,28.2,5.989,6426.674,282.28,10.39,0.64,1
91,39,3320,59662,95,1981,85425,1523213,81.94,1380004385,450.419,28.2,5.989,6426.674,282.28,10.39,0.64,1
91,40,3277,62939,128,2109,85824,1609037,81.94,1380004385,450.419,28.2,5.989,6426.674,282.28,10.39,0.64,1
91,41,4213,67152,97,2206,64651,1673688,81.94,1380004385,450.419,28.2,5.989,6426.674,282.28,10.39,0.64,1
91,42,3604,70756,87,2293,85891,1759579,81.94,1380004385,450.419,28.2,5.989,6426.674,282.28,10.39,0.64,1
91,43,3525,74281,122,2415,94671,1854250,81.94,1380004385,450.419,28.2,5.989,6426.674,282.28,10.39,0.64,1
91,44,3722,78003,134,2549,92791,1947041,81.94,1380004385,450.419,28.2,5.989,6426.674,282.28,10.39,0.64,1
91,45,3967,81970,100,2649,92911,2039952,81.94,1380004385,450.419,28.2,5.989,6426.674,282.28,10.39,0.64,1
91,46,3970,85940,103,2752,94325,2134277,81.94,1380004385,450.419,28.2,5.989,6426.674,282.28,10.39,0.64,1
91,47,4987,90927,120,2872,93365,2227642,81.94,1380004385,450.419,28.2,5.989,6426.674,282.28,10.39,0.64,1
91,48,5242,96169,157,3029,75150,2302792,79.17,1380004385,450.419,28.2,5.989,6426.674,282.28,10.39,0.64,1
91,49,4970,101139,134,3163,101475,2404267,79.17,1380004385,450.419,28.2,5.989,6426.674,282.28,10.39,0.64,1
91,50,5611,106750,140,3303,108121,2512388,79.17,1380004385,450.419,28.2,5.989,6426.674,282.28,10.39,0.64,1
91,51,5609,112359,132,3435,103532,2615920,79.17,1380004385,450.419,28.2,5.989,6426.674,282.28,10.39,0.64,1
91,52,6088,118447,148,3583,103514,2719434,79.17,1380004385,450.419,28.2,5.989,6426.674,282.28,10.39,0.64,1
91,53,6654,125101,137,3720,115364,2834798,79.17,1380004385,450.419,28.2,5.989,6426.674,282.28,10.39,0.64,1
91,54,6767,131868,147,3867,108623,2943421,79.17,1380004385,450.419,28.2,5.989,6426.674,282.28,10.39,0.64,1
91,55,6977,138845,154,4021,90170,3033591,79.17,1380004385,450.419,28.2,5.989,6426.674,282.28,10.39,0.64,1
91,56,6535,145380,146,4167,92528,3126119,79.17,1380004385,450.419,28.2,5.989,6426.674,282.28,10.39,0.64,1
91,57,6387,151767,170,4337,116041,3242160,79.17,1380004385,450.419,28.2,5.989,6426.674,282.28,10.39,0.64,1
91,58,6566,158333,194,4531,119976,3362136,79.17,1380004385,450.419,28.2,5.989,6426.674,282.28,10.39,0.64,1
91,59,7466,165799,175,4706,121702,3483838,79.17,1380004385,450.419,28.2,5.989,6426.674,282.28,10.39,0.64,1
91,60,7964,173763,265,4971,127761,3611599,79.17,1380004385,450.419,28.2,5.989,6426.674,282.28,10.39,0.64,1
91,61,8380,182143,193,5164,125428,3737027,79.17,1380004385,450.419,28.2,5.989,6426.674,282.28,10.39,0.64,1
91,62,8392,190535,230,5394,100180,3837207,75.46,1380004385,450.419,28.2,5.989,6426.674,282.28,10.39,0.64,1
91,63,8171,198706,204,5598,128868,3966075,75.46,1380004385,450.419,28.2,5.989,6426.674,282.28,10.39,0.64,1
91,64,8909,207615,217,5815,137158,4103233,75.46,1380004385,450.419,28.2,5.989,6426.674,282.28,10.39,0.64,1
91,65,9304,216919,260,6075,139485,4242718,75.46,1380004385,450.419,28.2,5.989,6426.674,282.28,10.39,0.64,1
91,66,9851,226770,273,6348,143661,4386379,75.46,1380004385,450.419,28.2,5.989,6426.674,282.28,10.39,0.64,1
91,67,9887,236657,294,6642,137938,4524317,75.46,1380004385,450.419,28.2,5.989,6426.674,282.28,10.39,0.64,1
91,68,9971,246628,287,6929,142069,4666386,75.46,1380004385,450.419,28.2,5.989,6426.674,282.28,10.39,0.64,1
91,69,9983,256611,206,7135,108048,4774434,75.46,1380004385,450.419,28.2,5.989,6426.674,282.28,10.39,0.64,1
91,70,9987,266598,331,7466,141682,4916116,76.85,1380004385,450.419,28.2,5.989,6426.674,282.28,10.39,0.64,1
91,71,9985,276583,279,7745,145216,5061332,76.85,1380004385,450.419,28.2,5.989,6426.674,282.28,10.39,0.64,1
91,72,9996,286579,357,8102,151808,5213140,76.85,1380004385,450.419,28.2,5.989,6426.674,282.28,10.39,0.64,1
91,73,10956,297535,396,8498,150305,5363445,76.85,1380004385,450.419,28.2,5.989,6426.674,282.28,10.39,0.64,1
91,74,11458,308993,386,8884,143737,5507182,76.85,1380004385,450.419,28.2,5.989,6426.674,282.28,10.39,0.64,1
91,75,11929,320922,311,9195,151432,5658614,76.85,1380004385,450.419,28.2,5.989,6426.674,282.28,10.39,0.64,1
91,76,11502,332424,325,9520,115519,5774133,76.85,1380004385,450.419,28.2,5.989,6426.674,282.28,10.39,0.64,1
91,77,10667,343091,380,9900,146936,5921069,76.85,1380004385,450.419,28.2,5.989,6426.674,282.28,10.39,0.64,1
91,78,10974,354065,2003,11903,163187,6084256,76.85,1380004385,450.419,28.2,5.989,6426.674,282.28,10.39,0.64,1
91,79,12881,366946,334,12237,165412,6249668,76.39,1380004385,450.419,28.2,5.989,6426.674,282.28,10.39,0.64,1
91,80,13586,380532,336,12573,176959,6426627,76.39,1380004385,450.419,28.2,5.989,6426.674,282.28,10.39,0.64,1
91,81,14516,395048,375,12948,189869,6616496,76.39,1380004385,450.419,28.2,5.989,6426.674,282.28,10.39,0.64,1
91,82,15413,410461,306,13254,190730,6807226,76.39,1380004385,450.419,28.2,5.989,6426.674,282.28,10.39,0.64,1
91,83,14821,425282,445,13699,143267,6950493,76.39,1380004385,450.419,28.2,5.989,6426.674,282.28,10.39,0.64,1
91,84,14933,440215,312,14011,187223,7137716,76.39,1380004385,450.419,28.2,5.989,6426.674,282.28,10.39,0.64,1
91,85,15968,456183,465,14476,215195,7352911,76.39,1380004385,450.419,28.2,5.989,6426.674,282.28,10.39,0.64,1
91,86,16922,473105,418,14894,207871,7560782,76.39,1380004385,450.419,28.2,5.989,6426.674,282.28,10.39,0.64,1
91,87,17296,490401,407,15301,215446,7776228,76.39,1380004385,450.419,28.2,5.989,6426.674,282.28,10.39,0.64,1
91,88,18552,508953,384,15685,220479,7996707,76.39,1380004385,450.419,28.2,5.989,6426.674,282.28,10.39,0.64,1
91,89,19906,528859,410,16095,231095,8227802,76.39,1380004385,450.419,28.2,5.989,6426.674,282.28,10.39,0.64,1
91,90,19459,548318,380,16475,170560,8398362,76.39,1380004385,450.419,28.2,5.989,6426.674,282.28,10.39,0.64,1
91,91,18522,566840,418,16893,210292,8608654,76.39,1380004385,450.419,28.2,5.989,6426.674,282.28,10.39,0.64,1
91,92,18653,585493,507,17400,217931,8826585,74.07,1380004385,450.419,28.2,5.989,6426.674,282.28,10.39,0.64,1
91,93,19148,604641,434,17834,229588,9056173,74.07,1380004385,450.419,28.2,5.989,6426.674,282.28,10.39,0.64,1
91,94,20903,625544,379,18213,241576,9297749,74.07,1380004385,450.419,28.2,5.989,6426.674,282.28,10.39,0.64,1
91,95,22771,648315,442,18655,242383,9540132,74.07,1380004385,450.419,28.2,5.989,6426.674,282.28,10.39,0.64,1
91,96,24850,673165,613,19268,248934,9789066,74.07,1380004385,450.419,28.2,5.989,6426.674,282.28,10.39,0.64,1
91,97,24248,697413,425,19693,180596,9969662,74.07,1380004385,450.419,28.2,5.989,6426.674,282.28,10.39,0.64,1
91,98,22252,719665,467,20160,241430,10211092,74.07,1380004385,450.419,28.2,5.989,6426.674,282.28,10.39,0.64,1
91,99,22752,742417,482,20642,262679,10473771,74.07,1380004385,450.419,28.2,5.989,6426.674,282.28,10.39,0.64,1
91,100,24879,767296,487,21129,267061,10740832,74.07,1380004385,450.419,28.2,5.989,6426.674,282.28,10.39,0.64,1
91,101,26506,793802,475,21604,283659,11024491,77.78,1380004385,450.419,28.2,5.989,6426.674,282.28,10.39,0.64,1
91,102,27114,820916,519,22123,282511,11307002,77.78,1380004385,450.419,28.2,5.989,6426.674,282.28,10.39,0.64,1
91,103,28637,849553,551,22674,280151,11587153,77.78,1380004385,450.419,28.2,5.989,6426.674,282.28,10.39,0.64,1
91,104,28701,878254,500,23174,219103,11806256,77.78,1380004385,450.419,28.2,5.989,6426.674,282.28,10.39,0.64,1
91,105,28498,906752,553,23727,286247,12092503,77.78,1380004385,450.419,28.2,5.989,6426.674,282.28,10.39,0.64,1
91,106,29429,936181,582,24309,320161,12412664,77.78,1380004385,450.419,28.2,5.989,6426.674,282.28,10.39,0.64,1
91,107,32695,968876,606,24915,326826,12739490,77.78,1380004385,450.419,28.2,5.989,6426.674,282.28,10.39,0.64,1
91,108,34956,1003832,687,25602,333228,13072718,77.78,1380004385,450.419,28.2,5.989,6426.674,282.28,10.39,0.64,1
91,109,34884,1038716,671,26273,361024,13433742,77.78,1380004385,450.419,28.2,5.989,6426.674,282.28,10.39,0.64,1
91,110,38902,1077618,543,26816,358127,13791869,77.78,1380004385,450.419,28.2,5.989,6426.674,282.28,10.39,0.64,1
91,111,40425,1118043,681,27497,256039,14047908,77.78,1380004385,450.419,28.2,5.989,6426.674,282.28,10.39,0.64,1
91,112,37148,1155191,587,28084,333395,14381303,77.78,1380004385,450.419,28.2,5.989,6426.674,282.28,10.39,0.64,1
91,113,37724,1192915,648,28732,343243,14724546,77.78,1380004385,450.419,28.2,5.989,6426.674,282.28,10.39,0.64,1
91,114,45720,1238635,1129,29861,350823,15075369,77.78,1380004385,450.419,28.2,5.989,6426.674,282.28,10.39,0.64,1
91,115,49310,1287945,740,30601,352801,15428170,77.78,1380004385,450.419,28.2,5.989,6426.674,282.28,10.39,0.64,1
91,116,48916,1336861,757,31358,420898,15849068,77.78,1380004385,450.419,28.2,5.989,6426.674,282.28,10.39,0.64,1
91,117,48661,1385522,705,32063,442263,16291331,77.78,1380004385,450.419,28.2,5.989,6426.674,282.28,10.39,0.64,1
91,118,49931,1435453,708,32771,515472,16806803,77.78,1380004385,450.419,28.2,5.989,6426.674,282.28,10.39,0.64,1
91,119,47703,1483156,654,33425,528082,17334885,77.78,1380004385,450.419,28.2,5.989,6426.674,282.28,10.39,0.64,1
91,120,48513,1531669,768,34193,408855,17743740,77.78,1380004385,450.419,28.2,5.989,6426.674,282.28,10.39,0.64,1
91,121,52123,1583792,775,34968,446642,18190382,77.78,1380004385,450.419,28.2,5.989,6426.674,282.28,10.39,0.64,1
91,122,55078,1638870,779,35747,642588,18832970,77.78,1380004385,450.419,28.2,5.989,6426.674,282.28,10.39,0.64,1
91,123,57118,1695988,764,36511,525689,19358659,79.63,1380004385,450.419,28.2,5.989,6426.674,282.28,10.39,0.64,1
91,124,54735,1750723,853,37364,463172,19821831,79.63,1380004385,450.419,28.2,5.989,6426.674,282.28,10.39,0.64,1
91,125,52972,1803695,771,38135,381027,20202858,79.63,1380004385,450.419,28.2,5.989,6426.674,282.28,10.39,0.64,1
91,126,52050,1855745,803,38938,661892,20864750,79.63,1380004385,450.419,28.2,5.989,6426.674,282.28,10.39,0.64,1
91,127,52509,1908254,857,39795,619652,21484402,79.63,1380004385,450.419,28.2,5.989,6426.674,282.28,10.39,0.64,1
91,128,56282,1964536,904,40699,664949,22149351,79.63,1380004385,450.419,28.2,5.989,6426.674,282.28,10.39,0.64,1
91,129,62538,2027074,886,41585,639042,22788393,79.63,1380004385,450.419,28.2,5.989,6426.674,282.28,10.39,0.64,1
91,130,61537,2088611,933,42518,598778,23387171,79.63,1380004385,450.419,28.2,5.989,6426.674,282.28,10.39,0.64,1
91,131,64399,2153010,861,43379,719364,24106535,79.63,1380004385,450.419,28.2,5.989,6426.674,282.28,10.39,0.64,1
91,132,62064,2215074,1007,44386,477023,24583558,79.63,1380004385,450.419,28.2,5.989,6426.674,282.28,10.39,0.64,1
91,133,53601,2268675,871,45257,698290,25281848,79.63,1380004385,450.419,28.2,5.989,6426.674,282.28,10.39,0.64,1
91,134,60963,2329638,834,46091,733449,26015297,79.63,1380004385,450.419,28.2,5.989,6426.674,282.28,10.39,0.64,1
91,135,66999,2396637,942,47033,830391,26845688,79.63,1380004385,450.419,28.2,5.989,6426.674,282.28,10.39,0.64,1
91,136,64553,2461190,1007,48040,848728,27694416,79.63,1380004385,450.419,28.2,5.989,6426.674,282.28,10.39,0.64,1
91,137,65002,2526192,996,49036,868679,28563095,79.63,1380004385,450.419,28.2,5.989,6426.674,282.28,10.39,0.64,1
91,138,63490,2589682,944,49980,746608,29309703,79.63,1380004385,450.419,28.2,5.989,6426.674,282.28,10.39,0.64,1
91,139,57981,2647663,941,50921,731697,30041400,79.63,1380004385,450.419,28.2,5.989,6426.674,282.28,10.39,0.64,1
91,140,55079,2702742,876,51797,899864,30941264,79.63,1380004385,450.419,28.2,5.989,6426.674,282.28,10.39,0.64,1
91,141,64531,2767273,1092,52889,801518,31742782,79.63,1380004385,450.419,28.2,5.989,6426.674,282.28,10.39,0.64,1
91,142,69652,2836925,977,53866,918470,32661252,79.63,1380004385,450.419,28.2,5.989,6426.674,282.28,10.39,0.64,1
91,143,68898,2905823,983,54849,805985,33467237,79.63,1380004385,450.419,28.2,5.989,6426.674,282.28,10.39,0.64,1
91,144,69878,2975701,945,55794,1023836,34491073,79.63,1380004385,450.419,28.2,5.989,6426.674,282.28,10.39,0.64,1
91,145,69239,3044940,912,56706,801147,35292220,79.63,1380004385,450.419,28.2,5.989,6426.674,282.28,10.39,0.64,1
91,146,61408,3106348,836,57542,609917,35902137,79.63,1380004385,450.419,28.2,5.989,6426.674,282.28,10.39,0.64,1
91,147,60975,3167323,848,58390,925383,36827520,79.63,1380004385,450.419,28.2,5.989,6426.674,282.28,10.39,0.64,1
91,148,67151,3234474,1059,59449,823992,37651512,79.63,1380004385,450.419,28.2,5.989,6426.674,282.28,10.39,0.64,1
91,149,75760,3310234,1023,60472,924998,38576510,79.63,1380004385,450.419,28.2,5.989,6426.674,282.28,10.39,0.64,1
91,150,77266,3387500,1057,61529,901338,39477848,79.63,1380004385,450.419,28.2,5.989,6426.674,282.28,10.39,0.64,1
91,151,76472,3463972,1021,62550,928761,40406609,81.02,1380004385,450.419,28.2,5.989,6426.674,282.28,10.39,0.64,1
91,152,78761,3542733,948,63498,1055027,41461636,81.02,1380004385,450.419,28.2,5.989,6426.674,282.28,10.39,0.64,1
91,153,78512,3621245,971,64469,846278,42307914,81.02,1380004385,450.419,28.2,5.989,6426.674,282.28,10.39,0.64,1
91,154,69921,3691166,759,65228,1016920,43324834,81.02,1380004385,450.419,28.2,5.989,6426.674,282.28,10.39,0.64,1
91,155,78357,3769523,1105,66333,1012367,44337201,81.02,1380004385,450.419,28.2,5.989,6426.674,282.28,10.39,0.64,1
91,156,83883,3853406,1043,67376,1172179,45509380,81.02,1380004385,450.419,28.2,5.989,6426.674,282.28,10.39,0.64,1
91,157,83341,3936747,1096,68472,1169765,46679145,81.02,1380004385,450.419,28.2,5.989,6426.674,282.28,10.39,0.64,1
91,158,86432,4023179,1089,69561,1059346,47738491,81.02,1380004385,450.419,28.2,5.989,6426.674,282.28,10.39,0.64,1
91,159,90632,4113811,1065,70626,1092654,48831145,81.02,1380004385,450.419,28.2,5.989,6426.674,282.28,10.39,0.64,1
91,160,90802,4204613,1016,71642,720362,49551507,81.02,1380004385,450.419,28.2,5.989,6426.674,282.28,10.39,0.64,1
91,161,75809,4280422,1133,72775,1098621,50650128,81.02,1380004385,450.419,28.2,5.989,6426.674,282.28,10.39,0.64,1
91,162,89706,4370128,1115,73890,1154549,51804677,81.02,1380004385,450.419,28.2,5.989,6426.674,282.28,10.39,0.64,1
91,163,95735,4465863,1172,75062,1129756,52934433,81.02,1380004385,450.419,28.2,5.989,6426.674,282.28,10.39,0.64,1
91,164,96551,4562414,1209,76271,1163542,54097975,81.02,1380004385,450.419,28.2,5.989,6426.674,282.28,10.39,0.64,1
91,165,97570,4659984,1201,77472,1091251,55189226,81.02,1380004385,450.419,28.2,5.989,6426.674,282.28,10.39,0.64,1
91,166,94372,4754356,1114,78586,1071702,56260928,81.02,1380004385,450.419,28.2,5.989,6426.674,282.28,10.39,0.64,1
91,167,92071,4846427,1136,79722,978500,57239428,81.02,1380004385,450.419,28.2,5.989,6426.674,282.28,10.39,0.64,1
91,168,83809,4930236,1054,80776,1072845,58312273,81.02,1380004385,450.419,28.2,5.989,6426.674,282.28,10.39,0.64,1
91,169,90123,5020359,1290,82066,1116842,59429115,81.02,1380004385,450.419,28.2,5.989,6426.674,282.28,10.39,0.64,1
91,170,97894,5118253,1132,83198,1136613,60565728,81.02,1380004385,450.419,28.2,5.989,6426.674,282.28,10.39,0.64,1
91,171,96424,5214677,1174,84372,1006615,61572343,81.02,1380004385,450.419,28.2,5.989,6426.674,282.28,10.39,0.64,1
91,172,93337,5308014,1247,85619,881911,62454254,81.02,1380004385,450.419,28.2,5.989,6426.674,282.28,10.39,0.64,1
91,173,92605,5400619,1133,86752,1206806,63661060,81.02,1380004385,450.419,28.2,5.989,6426.674,282.28,10.39,0.64,1
91,174,86961,5487580,1130,87882,731534,64392594,75.46,1380004385,450.419,28.2,5.989,6426.674,282.28,10.39,0.64,1
91,175,75083,5562663,1053,88935,933185,65325779,75.46,1380004385,450.419,28.2,5.989,6426.674,282.28,10.39,0.64,1
91,176,83347,5646010,1085,90020,953683,66279462,75.46,1380004385,450.419,28.2,5.989,6426.674,282.28,10.39,0.64,1
91,177,86508,5732518,1129,91149,1156569,67436031,75.46,1380004385,450.419,28.2,5.989,6426.674,282.28,10.39,0.64,1
91,178,86052,5818570,1141,92290,1492409,68928440,75.46,1380004385,450.419,28.2,5.989,6426.674,282.28,10.39,0.64,1
91,179,85362,5903932,1089,93379,1341535,70269975,75.46,1380004385,450.419,28.2,5.989,6426.674,282.28,10.39,0.64,1
91,180,88600,5992532,1124,94503,987861,71257836,75.46,1380004385,450.419,28.2,5.989,6426.674,282.28,10.39,0.64,1
91,181,82170,6074702,1039,95542,709394,71967230,75.46,1380004385,450.419,28.2,5.989,6426.674,282.28,10.39,0.64,1
91,182,70589,6145291,776,96318,1142811,73110041,75.46,1380004385,450.419,28.2,5.989,6426.674,282.28,10.39,0.64,1
91,183,80472,6225763,1179,97497,1086688,74196729,73.61,1380004385,450.419,28.2,5.989,6426.674,282.28,10.39,0.64,1
91,184,86821,6312584,1181,98678,1423052,75619781,73.61,1380004385,450.419,28.2,5.989,6426.674,282.28,10.39,0.64,1
91,185,81484,6394068,1095,99773,1097947,76717728,73.61,1380004385,450.419,28.2,5.989,6426.674,282.28,10.39,0.64,1
91,186,79476,6473544,1069,100842,1132675,77850403,73.61,1380004385,450.419,28.2,5.989,6426.674,282.28,10.39,0.64,1
91,187,75829,6549373,940,101782,1142131,78992534,73.61,1380004385,450.419,28.2,5.989,6426.674,282.28,10.39,0.64,1
91,188,74442,6623815,903,102685,989860,79982394,73.61,1380004385,450.419,28.2,5.989,6426.674,282.28,10.39,0.64,1
91,189,61267,6685082,884,103569,1089403,81071797,73.61,1380004385,450.419,28.2,5.989,6426.674,282.28,10.39,0.64,1
91,190,72049,6757131,986,104555,1199857,82271654,73.61,1380004385,450.419,28.2,5.989,6426.674,282.28,10.39,0.64,1
91,191,78524,6835655,971,105526,1194321,83465975,73.61,1380004385,450.419,28.2,5.989,6426.674,282.28,10.39,0.64,1
91,192,70496,6906151,964,106490,1168705,84634680,73.61,1380004385,450.419,28.2,5.989,6426.674,282.28,10.39,0.64,1
91,193,73272,6979423,926,107416,1164018,85798698,73.61,1380004385,450.419,28.2,5.989,6426.674,282.28,10.39,0.64,1
91,194,74383,7053806,918,108334,1078544,86877242,73.61,1380004385,450.419,28.2,5.989,6426.674,282.28,10.39,0.64,1
91,195,66732,7120538,816,109150,994851,87872093,73.61,1380004385,450.419,28.2,5.989,6426.674,282.28,10.39,0.64,1
91,196,55342,7175880,706,109856,1073014,88945107,73.61,1380004385,450.419,28.2,5.989,6426.674,282.28,10.39,0.64,1
91,197,63509,7239389,730,110586,1145015,90090122,73.61,1380004385,450.419,28.2,5.989,6426.674,282.28,10.39,0.64,1
91,198,67708,7307097,680,111266,1136183,91226305,73.61,1380004385,450.419,28.2,5.989,6426.674,282.28,10.39,0.64,1
91,199,63371,7370468,895,112161,1028622,92254927,73.61,1380004385,450.419,28.2,5.989,6426.674,282.28,10.39,0.64,1
91,200,62212,7432680,837,112998,999090,93254017,73.61,1380004385,450.419,28.2,5.989,6426.674,282.28,10.39,0.64,1
91,201,61871,7494551,1033,114031,970173,94224190,73.61,1380004385,450.419,28.2,5.989,6426.674,282.28,10.39,0.64,1
91,202,55722,7550273,579,114610,859786,95083976,73.61,1380004385,450.419,28.2,5.989,6426.674,282.28,10.39,0.64,1
91,203,46790,7597063,587,115197,1032795,96116771,73.61,1380004385,450.419,28.2,5.989,6426.674,282.28,10.39,0.64,1
91,204,54044,7651107,717,115914,0,96116771,73.61,1380004385,450.419,28.2,5.989,6426.674,282.28,10.39,0.64,1
92,1,114,1528,14,136,114,6777,50.93,273523621,145.725,29.3,5.319,11188.744,342.864,6.32,0.694,2
92,2,149,1677,21,157,416,7193,50.93,273523621,145.725,29.3,5.319,11188.744,342.864,6.32,0.694,2
92,3,113,1790,13,170,428,7621,50.93,273523621,145.725,29.3,5.319,11188.744,342.864,6.32,0.694,2
92,4,196,1986,11,181,365,7986,50.93,273523621,145.725,29.3,5.319,11188.744,342.864,6.32,0.694,2
92,5,106,2092,10,191,0,7986,50.93,273523621,145.725,29.3,5.319,11188.744,342.864,6.32,0.694,2
92,6,181,2273,7,198,0,11460,50.93,273523621,145.725,29.3,5.319,11188.744,342.864,6.32,0.694,2
92,7,218,2491,11,209,1973,13433,60.65,273523621,145.725,29.3,5.319,11188.744,342.864,6.32,0.694,2
92,8,247,2738,12,221,1138,14571,60.65,273523621,145.725,29.3,5.319,11188.744,342.864,6.32,0.694,2
92,9,218,2956,19,240,2277,16848,60.65,273523621,145.725,29.3,5.319,11188.744,342.864,6.32,0.694,2
92,10,337,3293,40,280,2604,19452,71.76,273523621,145.725,29.3,5.319,11188.744,342.864,6.32,0.694,2
92,11,219,3512,26,306,330,19782,71.76,273523621,145.725,29.3,5.319,11188.744,342.864,6.32,0.694,2
92,12,330,3842,21,327,7293,27075,71.76,273523621,145.725,29.3,5.319,11188.744,342.864,6.32,0.694,2
92,13,399,4241,46,373,316,27391,71.76,273523621,145.725,29.3,5.319,11188.744,342.864,6.32,0.694,2
92,14,316,4557,26,399,4237,31628,71.76,273523621,145.725,29.3,5.319,11188.744,342.864,6.32,0.694,2
92,15,282,4839,60,459,1373,33001,71.76,273523621,145.725,29.3,5.319,11188.744,342.864,6.32,0.694,2
92,16,297,5136,10,469,1974,34975,71.76,273523621,145.725,29.3,5.319,11188.744,342.864,6.32,0.694,2
92,17,380,5516,27,496,2159,37134,71.76,273523621,145.725,29.3,5.319,11188.744,342.864,6.32,0.694,2
92,18,407,5923,24,520,2288,39422,71.76,273523621,145.725,29.3,5.319,11188.744,342.864,6.32,0.694,2
92,19,325,6248,15,535,2797,42219,71.76,273523621,145.725,29.3,5.319,11188.744,342.864,6.32,0.694,2
92,20,327,6575,47,582,1530,43749,71.76,273523621,145.725,29.3,5.319,11188.744,342.864,6.32,0.694,2
92,21,185,6760,8,590,2424,46173,71.76,273523621,145.725,29.3,5.319,11188.744,342.864,6.32,0.694,2
92,22,375,7135,26,616,1188,47361,71.76,273523621,145.725,29.3,5.319,11188.744,342.864,6.32,0.694,2
92,23,283,7418,19,635,1286,48647,71.76,273523621,145.725,29.3,5.319,11188.744,342.864,6.32,0.694,2
92,24,357,7775,12,647,1916,50563,80.09,273523621,145.725,29.3,5.319,11188.744,342.864,6.32,0.694,2
92,25,436,8211,42,689,1978,52541,80.09,273523621,145.725,29.3,5.319,11188.744,342.864,6.32,0.694,2
92,26,396,8607,31,720,4433,56974,80.09,273523621,145.725,29.3,5.319,11188.744,342.864,6.32,0.694,2
92,27,275,8882,23,743,2435,59409,80.09,273523621,145.725,29.3,5.319,11188.744,342.864,6.32,0.694,2
92,28,214,9096,22,765,3135,62544,80.09,273523621,145.725,29.3,5.319,11188.744,342.864,6.32,0.694,2
92,29,415,9511,8,773,5240,67784,80.09,273523621,145.725,29.3,5.319,11188.744,342.864,6.32,0.694,2
92,30,260,9771,11,784,4567,72351,80.09,273523621,145.725,29.3,5.319,11188.744,342.864,6.32,0.694,2
92,31,347,10118,8,792,4187,76538,80.09,273523621,145.725,29.3,5.319,11188.744,342.864,6.32,0.694,2
92,32,433,10551,8,800,3330,79868,80.09,273523621,145.725,29.3,5.319,11188.744,342.864,6.32,0.694,2
92,33,292,10843,31,831,3144,83012,74.54,273523621,145.725,29.3,5.319,11188.744,342.864,6.32,0.694,2
92,34,349,11192,14,845,3049,86061,74.54,273523621,145.725,29.3,5.319,11188.744,342.864,6.32,0.694,2
92,35,395,11587,19,864,2863,88924,74.54,273523621,145.725,29.3,5.319,11188.744,342.864,6.32,0.694,2
92,36,484,12071,8,872,4052,92976,74.54,273523621,145.725,29.3,5.319,11188.744,342.864,6.32,0.694,2
92,37,367,12438,23,895,3741,96717,74.54,273523621,145.725,29.3,5.319,11188.744,342.864,6.32,0.694,2
92,38,338,12776,35,930,6644,103361,74.54,273523621,145.725,29.3,5.319,11188.744,342.864,6.32,0.694,2
92,39,336,13112,13,943,5338,108699,74.54,273523621,145.725,29.3,5.319,11188.744,342.864,6.32,0.694,2
92,40,533,13645,16,959,4753,113452,74.54,273523621,145.725,29.3,5.319,11188.744,342.864,6.32,0.694,2
92,41,387,14032,14,973,2906,116358,74.54,273523621,145.725,29.3,5.319,11188.744,342.864,6.32,0.694,2
92,42,233,14265,18,991,3370,119728,74.54,273523621,145.725,29.3,5.319,11188.744,342.864,6.32,0.694,2
92,43,484,14749,16,1007,3844,123572,74.54,273523621,145.725,29.3,5.319,11188.744,342.864,6.32,0.694,2
92,44,689,15438,21,1028,4241,127813,74.54,273523621,145.725,29.3,5.319,11188.744,342.864,6.32,0.694,2
92,45,568,16006,15,1043,4247,132060,74.54,273523621,145.725,29.3,5.319,11188.744,342.864,6.32,0.694,2
92,46,490,16496,33,1076,3666,135726,74.54,273523621,145.725,29.3,5.319,11188.744,342.864,6.32,0.694,2
92,47,529,17025,13,1089,4753,140479,74.54,273523621,145.725,29.3,5.319,11188.744,342.864,6.32,0.694,2
92,48,489,17514,59,1148,2556,143035,74.54,273523621,145.725,29.3,5.319,11188.744,342.864,6.32,0.694,2
92,49,496,18010,43,1191,4764,147799,74.54,273523621,145.725,29.3,5.319,11188.744,342.864,6.32,0.694,2
92,50,486,18496,30,1221,6340,154139,71.76,273523621,145.725,29.3,5.319,11188.744,342.864,6.32,0.694,2
92,51,693,19189,21,1242,0,154139,71.76,273523621,145.725,29.3,5.319,11188.744,342.864,6.32,0.694,2
92,52,973,20162,36,1278,0,168969,71.76,273523621,145.725,29.3,5.319,11188.744,342.864,6.32,0.694,2
92,53,634,20796,48,1326,7066,176035,71.76,273523621,145.725,29.3,5.319,11188.744,342.864,6.32,0.694,2
92,54,949,21745,25,1351,3829,179864,71.76,273523621,145.725,29.3,5.319,11188.744,342.864,6.32,0.694,2
92,55,526,22271,21,1372,3328,183192,71.76,273523621,145.725,29.3,5.319,11188.744,342.864,6.32,0.694,2
92,56,479,22750,19,1391,5110,188302,71.76,273523621,145.725,29.3,5.319,11188.744,342.864,6.32,0.694,2
92,57,415,23165,27,1418,7216,195518,71.76,273523621,145.725,29.3,5.319,11188.744,342.864,6.32,0.694,2
92,58,686,23851,55,1473,5793,201311,71.76,273523621,145.725,29.3,5.319,11188.744,342.864,6.32,0.694,2
92,59,687,24538,23,1496,3939,205250,71.76,273523621,145.725,29.3,5.319,11188.744,342.864,6.32,0.694,2
92,60,678,25216,24,1520,11519,216769,71.76,273523621,145.725,29.3,5.319,11188.744,342.864,6.32,0.694,2
92,61,557,25773,53,1573,6855,223624,71.76,273523621,145.725,29.3,5.319,11188.744,342.864,6.32,0.694,2
92,62,700,26473,40,1613,8489,232113,71.76,273523621,145.725,29.3,5.319,11188.744,342.864,6.32,0.694,2
92,63,467,26940,28,1641,5834,237947,71.76,273523621,145.725,29.3,5.319,11188.744,342.864,6.32,0.694,2
92,64,609,27549,22,1663,8486,246433,71.76,273523621,145.725,29.3,5.319,11188.744,342.864,6.32,0.694,2
92,65,684,28233,35,1698,5303,251736,71.76,273523621,145.725,29.3,5.319,11188.744,342.864,6.32,0.694,2
92,66,585,28818,23,1721,5074,256810,71.76,273523621,145.725,29.3,5.319,11188.744,342.864,6.32,0.694,2
92,67,703,29521,49,1770,7930,264740,71.76,273523621,145.725,29.3,5.319,11188.744,342.864,6.32,0.694,2
92,68,993,30514,31,1801,4406,269146,71.76,273523621,145.725,29.3,5.319,11188.744,342.864,6.32,0.694,2
92,69,672,31186,50,1851,5284,274430,68.06,273523621,145.725,29.3,5.319,11188.744,342.864,6.32,0.694,2
92,70,847,32033,32,1883,7223,281653,68.06,273523621,145.725,29.3,5.319,11188.744,342.864,6.32,0.694,2
92,71,1043,33076,40,1923,5825,287478,68.06,273523621,145.725,29.3,5.319,11188.744,342.864,6.32,0.694,2
92,72,1240,34316,36,1959,7193,294671,68.06,273523621,145.725,29.3,5.319,11188.744,342.864,6.32,0.694,2
92,73,979,35295,41,2000,7476,302147,68.06,273523621,145.725,29.3,5.319,11188.744,342.864,6.32,0.694,2
92,74,1111,36406,48,2048,11128,313275,68.06,273523621,145.725,29.3,5.319,11188.744,342.864,6.32,0.694,2
92,75,1014,37420,43,2091,0,313275,68.06,273523621,145.725,29.3,5.319,11188.744,342.864,6.32,0.694,2
92,76,857,38277,43,2134,0,329190,68.06,273523621,145.725,29.3,5.319,11188.744,342.864,6.32,0.694,2
92,77,1017,39294,64,2198,10119,339309,68.06,273523621,145.725,29.3,5.319,11188.744,342.864,6.32,0.694,2
92,78,1106,40400,33,2231,8969,348278,68.06,273523621,145.725,29.3,5.319,11188.744,342.864,6.32,0.694,2
92,79,1031,41431,45,2276,10381,358659,68.06,273523621,145.725,29.3,5.319,11188.744,342.864,6.32,0.694,2
92,80,1331,42762,63,2339,7922,366581,68.06,273523621,145.725,29.3,5.319,11188.744,342.864,6.32,0.694,2
92,81,1041,43803,34,2373,9937,376518,68.06,273523621,145.725,29.3,5.319,11188.744,342.864,6.32,0.694,2
92,82,1226,45029,56,2429,6587,383105,68.06,273523621,145.725,29.3,5.319,11188.744,342.864,6.32,0.694,2
92,83,862,45891,36,2465,10012,393117,68.06,273523621,145.725,29.3,5.319,11188.744,342.864,6.32,0.694,2
92,84,954,46845,35,2500,8564,401681,59.72,273523621,145.725,29.3,5.319,11188.744,342.864,6.32,0.694,2
92,85,1051,47896,35,2535,12238,413919,59.72,273523621,145.725,29.3,5.319,11188.744,342.864,6.32,0.694,2
92,86,1113,49009,38,2573,13239,427158,59.72,273523621,145.725,29.3,5.319,11188.744,342.864,6.32,0.694,2
92,87,1178,50187,47,2620,0,427158,59.72,273523621,145.725,29.3,5.319,11188.744,342.864,6.32,0.694,2
92,88,1240,51427,63,2683,0,449569,59.72,273523621,145.725,29.3,5.319,11188.744,342.864,6.32,0.694,2
92,89,1385,52812,37,2720,7067,456636,59.72,273523621,145.725,29.3,5.319,11188.744,342.864,6.32,0.694,2
92,90,1198,54010,34,2754,9047,465683,59.72,273523621,145.725,29.3,5.319,11188.744,342.864,6.32,0.694,2
92,91,1082,55092,51,2805,11635,477318,54.17,273523621,145.725,29.3,5.319,11188.744,342.864,6.32,0.694,2
92,92,1293,56385,71,2876,15000,492318,54.17,273523621,145.725,29.3,5.319,11188.744,342.864,6.32,0.694,2
92,93,1385,57770,58,2934,0,492318,54.17,273523621,145.725,29.3,5.319,11188.744,342.864,6.32,0.694,2
92,94,1624,59394,53,2987,0,492318,54.17,273523621,145.725,29.3,5.319,11188.744,342.864,6.32,0.694,2
92,95,1301,60695,49,3036,0,529669,54.17,273523621,145.725,29.3,5.319,11188.744,342.864,6.32,0.694,2
92,96,1447,62142,53,3089,0,529669,54.17,273523621,145.725,29.3,5.319,11188.744,342.864,6.32,0.694,2
92,97,1607,63749,82,3171,0,552084,54.17,273523621,145.725,29.3,5.319,11188.744,342.864,6.32,0.694,2
92,98,1209,64958,70,3241,10675,562759,54.17,273523621,145.725,29.3,5.319,11188.744,342.864,6.32,0.694,2
92,99,1268,66226,68,3309,0,562759,54.17,273523621,145.725,29.3,5.319,11188.744,342.864,6.32,0.694,2
92,100,1853,68079,50,3359,0,588080,54.17,273523621,145.725,29.3,5.319,11188.744,342.864,6.32,0.694,2
92,101,2657,70736,58,3417,9388,597468,54.17,273523621,145.725,29.3,5.319,11188.744,342.864,6.32,0.694,2
92,102,1611,72347,52,3469,12625,610093,62.5,273523621,145.725,29.3,5.319,11188.744,342.864,6.32,0.694,2
92,103,1671,74018,66,3535,10994,621087,62.5,273523621,145.725,29.3,5.319,11188.744,342.864,6.32,0.694,2
92,104,1681,75699,71,3606,9062,630149,62.5,273523621,145.725,29.3,5.319,11188.744,342.864,6.32,0.694,2
92,105,1282,76981,50,3656,0,630149,62.5,273523621,145.725,29.3,5.319,11188.744,342.864,6.32,0.694,2
92,106,1591,78572,54,3710,0,657655,62.5,273523621,145.725,29.3,5.319,11188.744,342.864,6.32,0.694,2
92,107,1522,80094,87,3797,12156,669811,62.5,273523621,145.725,29.3,5.319,11188.744,342.864,6.32,0.694,2
92,108,1574,81668,76,3873,13994,683805,62.5,273523621,145.725,29.3,5.319,11188.744,342.864,6.32,0.694,2
92,109,1462,83130,84,3957,13238,697043,62.5,273523621,145.725,29.3,5.319,11188.744,342.864,6.32,0.694,2
92,110,1752,84882,59,4016,10195,707238,62.5,273523621,145.725,29.3,5.319,11188.744,342.864,6.32,0.694,2
92,111,1639,86521,127,4143,13259,720497,62.5,273523621,145.725,29.3,5.319,11188.744,342.864,6.32,0.694,2
92,112,1693,88214,96,4239,17347,737844,62.5,273523621,145.725,29.3,5.319,11188.744,342.864,6.32,0.694,2
92,113,1655,89869,81,4320,11782,749626,62.5,273523621,145.725,29.3,5.319,11188.744,342.864,6.32,0.694,2
92,114,1882,91751,139,4459,13331,762957,62.5,273523621,145.725,29.3,5.319,11188.744,342.864,6.32,0.694,2
92,115,1906,93657,117,4576,14143,777100,62.5,273523621,145.725,29.3,5.319,11188.744,342.864,6.32,0.694,2
92,116,1761,95418,89,4665,12158,789258,62.5,273523621,145.725,29.3,5.319,11188.744,342.864,6.32,0.694,2
92,117,1868,97286,49,4714,7692,796950,62.5,273523621,145.725,29.3,5.319,11188.744,342.864,6.32,0.694,2
92,118,1492,98778,67,4781,0,796950,62.5,273523621,145.725,29.3,5.319,11188.744,342.864,6.32,0.694,2
92,119,1525,100303,57,4838,0,807946,62.5,273523621,145.725,29.3,5.319,11188.744,342.864,6.32,0.694,2
92,120,1748,102051,63,4901,33081,841027,62.5,273523621,145.725,29.3,5.319,11188.744,342.864,6.32,0.694,2
92,121,2381,104432,74,4975,14976,856003,62.5,273523621,145.725,29.3,5.319,11188.744,342.864,6.32,0.694,2
92,122,1904,106336,83,5058,10536,866539,62.5,273523621,145.725,29.3,5.319,11188.744,342.864,6.32,0.694,2
92,123,2040,108376,73,5131,9355,875894,62.5,273523621,145.725,29.3,5.319,11188.744,342.864,6.32,0.694,2
92,124,1560,109936,62,5193,6458,882352,62.5,273523621,145.725,29.3,5.319,11188.744,342.864,6.32,0.694,2
92,125,1519,111455,43,5236,12179,894531,62.5,273523621,145.725,29.3,5.319,11188.744,342.864,6.32,0.694,2
92,126,1679,113134,66,5302,13456,907987,62.5,273523621,145.725,29.3,5.319,11188.744,342.864,6.32,0.694,2
92,127,1922,115056,86,5388,14722,922709,62.5,273523621,145.725,29.3,5.319,11188.744,342.864,6.32,0.694,2
92,128,1815,116871,64,5452,13602,936311,62.5,273523621,145.725,29.3,5.319,11188.744,342.864,6.32,0.694,2
92,129,1882,118753,69,5521,15599,951910,62.5,273523621,145.725,29.3,5.319,11188.744,342.864,6.32,0.694,2
92,130,2473,121226,72,5593,11692,963602,62.5,273523621,145.725,29.3,5.319,11188.744,342.864,6.32,0.694,2
92,131,2277,123503,65,5658,8992,972594,62.5,273523621,145.725,29.3,5.319,11188.744,342.864,6.32,0.694,2
92,132,1893,125396,65,5723,12299,984893,62.5,273523621,145.725,29.3,5.319,11188.744,342.864,6.32,0.694,2
92,133,1687,127083,42,5765,13513,998406,59.72,273523621,145.725,29.3,5.319,11188.744,342.864,6.32,0.694,2
92,134,1693,128776,59,5824,13698,1012104,59.72,273523621,145.725,29.3,5.319,11188.744,342.864,6.32,0.694,2
92,135,1942,130718,79,5903,14850,1026954,59.72,273523621,145.725,29.3,5.319,11188.744,342.864,6.32,0.694,2
92,136,2098,132816,65,5968,12728,1039682,59.72,273523621,145.725,29.3,5.319,11188.744,342.864,6.32,0.694,2
92,137,2307,135123,53,6021,12821,1052503,59.72,273523621,145.725,29.3,5.319,11188.744,342.864,6.32,0.694,2
92,138,2345,137468,50,6071,9218,1061721,59.72,273523621,145.725,29.3,5.319,11188.744,342.864,6.32,0.694,2
92,139,2081,139549,79,6150,7224,1068945,59.72,273523621,145.725,29.3,5.319,11188.744,342.864,6.32,0.694,2
92,140,1821,141370,57,6207,12409,1081354,59.72,273523621,145.725,29.3,5.319,11188.744,342.864,6.32,0.694,2
92,141,1673,143043,70,6277,14940,1096294,59.72,273523621,145.725,29.3,5.319,11188.744,342.864,6.32,0.694,2
92,142,1902,144945,69,6346,0,1096294,59.72,273523621,145.725,29.3,5.319,11188.744,342.864,6.32,0.694,2
92,143,2266,147211,72,6418,0,1096294,59.72,273523621,145.725,29.3,5.319,11188.744,342.864,6.32,0.694,2
92,144,2197,149408,82,6500,0,1096294,59.72,273523621,145.725,29.3,5.319,11188.744,342.864,6.32,0.694,2
92,145,2090,151498,94,6594,0,1096294,59.72,273523621,145.725,29.3,5.319,11188.744,342.864,6.32,0.694,2
92,146,2037,153535,86,6680,0,1096294,59.72,273523621,145.725,29.3,5.319,11188.744,342.864,6.32,0.694,2
92,147,1877,155412,79,6759,0,1191948,59.72,273523621,145.725,29.3,5.319,11188.744,342.864,6.32,0.694,2
92,148,2447,157859,99,6858,0,1191948,59.72,273523621,145.725,29.3,5.319,11188.744,342.864,6.32,0.694,2
92,149,2306,160165,86,6944,0,1212468,59.72,273523621,145.725,29.3,5.319,11188.744,342.864,6.32,0.694,2
92,150,2719,162884,120,7064,21018,1233486,59.72,273523621,145.725,29.3,5.319,11188.744,342.864,6.32,0.694,2
92,151,3003,165887,105,7169,16649,1250135,59.72,273523621,145.725,29.3,5.319,11188.744,342.864,6.32,0.694,2
92,152,3308,169195,92,7261,21166,1271301,59.72,273523621,145.725,29.3,5.319,11188.744,342.864,6.32,0.694,2
92,153,2858,172053,82,7343,11317,1282618,59.72,273523621,145.725,29.3,5.319,11188.744,342.864,6.32,0.694,2
92,154,2743,174796,74,7417,14566,1297184,59.72,273523621,145.725,29.3,5.319,11188.744,342.864,6.32,0.694,2
92,155,2775,177571,88,7505,15293,1312477,59.72,273523621,145.725,29.3,5.319,11188.744,342.864,6.32,0.694,2
92,156,3075,180646,111,7616,40814,1353291,59.72,273523621,145.725,29.3,5.319,11188.744,342.864,6.32,0.694,2
92,157,3622,184268,134,7750,18100,1371391,59.72,273523621,145.725,29.3,5.319,11188.744,342.864,6.32,0.694,2
92,158,3269,187537,82,7832,0,1371391,59.72,273523621,145.725,29.3,5.319,11188.744,342.864,6.32,0.694,2
92,159,3128,190665,108,7940,0,1401513,59.72,273523621,145.725,29.3,5.319,11188.744,342.864,6.32,0.694,2
92,160,3444,194109,85,8025,16181,1417694,59.72,273523621,145.725,29.3,5.319,11188.744,342.864,6.32,0.694,2
92,161,2880,196989,105,8130,0,1417694,59.72,273523621,145.725,29.3,5.319,11188.744,342.864,6.32,0.694,2
92,162,3046,200035,100,8230,0,1434294,59.72,273523621,145.725,29.3,5.319,11188.744,342.864,6.32,0.694,2
92,163,3307,203342,106,8336,15335,1449629,59.72,273523621,145.725,29.3,5.319,11188.744,342.864,6.32,0.694,2
92,164,3861,207203,120,8456,20314,1469943,59.72,273523621,145.725,29.3,5.319,11188.744,342.864,6.32,0.694,2
92,165,3737,210940,88,8544,28349,1498292,59.72,273523621,145.725,29.3,5.319,11188.744,342.864,6.32,0.694,2
92,166,3817,214757,106,8650,24922,1523214,59.72,273523621,145.725,29.3,5.319,11188.744,342.864,6.32,0.694,2
92,167,3625,218382,73,8723,26138,1549352,68.98,273523621,145.725,29.3,5.319,11188.744,342.864,6.32,0.694,2
92,168,3141,221523,118,8841,42704,1592056,68.98,273523621,145.725,29.3,5.319,11188.744,342.864,6.32,0.694,2
92,169,3507,225030,124,8965,0,1592056,68.98,273523621,145.725,29.3,5.319,11188.744,342.864,6.32,0.694,2
92,170,3963,228993,135,9100,0,1622769,68.98,273523621,145.725,29.3,5.319,11188.744,342.864,6.32,0.694,2
92,171,3635,232628,122,9222,29555,1652324,68.98,273523621,145.725,29.3,5.319,11188.744,342.864,6.32,0.694,2
92,172,3891,236519,114,9336,24324,1676648,68.98,273523621,145.725,29.3,5.319,11188.744,342.864,6.32,0.694,2
92,173,4168,240687,112,9448,21554,1698202,68.98,273523621,145.725,29.3,5.319,11188.744,342.864,6.32,0.694,2
92,174,3989,244676,105,9553,19973,1718175,68.98,273523621,145.725,29.3,5.319,11188.744,342.864,6.32,0.694,2
92,175,4176,248852,124,9677,24825,1743000,68.98,273523621,145.725,29.3,5.319,11188.744,342.864,6.32,0.694,2
92,176,4071,252923,160,9837,56563,1799563,68.98,273523621,145.725,29.3,5.319,11188.744,342.864,6.32,0.694,2
92,177,4465,257388,140,9977,34786,1834349,68.98,273523621,145.725,29.3,5.319,11188.744,342.864,6.32,0.694,2
92,178,4634,262022,128,10105,26419,1860768,68.98,273523621,145.725,29.3,5.319,11188.744,342.864,6.32,0.694,2
92,179,4823,266845,113,10218,25658,1886426,68.98,273523621,145.725,29.3,5.319,11188.744,342.864,6.32,0.694,2
92,180,4494,271339,90,10308,20800,1907226,68.98,273523621,145.725,29.3,5.319,11188.744,342.864,6.32,0.694,2
92,181,3874,275213,78,10386,27637,1934863,68.98,273523621,145.725,29.3,5.319,11188.744,342.864,6.32,0.694,2
92,182,3509,278722,87,10473,27891,1962754,68.98,273523621,145.725,29.3,5.319,11188.744,342.864,6.32,0.694,2
92,183,4002,282724,128,10601,30940,1993694,68.98,273523621,145.725,29.3,5.319,11188.744,342.864,6.32,0.694,2
92,184,4284,287008,139,10740,30296,2023990,68.98,273523621,145.725,29.3,5.319,11188.744,342.864,6.32,0.694,2
92,185,4174,291182,116,10856,26831,2050821,68.98,273523621,145.725,29.3,5.319,11188.744,342.864,6.32,0.694,2
92,186,4317,295499,116,10972,0,2050821,68.98,273523621,145.725,29.3,5.319,11188.744,342.864,6.32,0.694,2
92,187,4007,299506,83,11055,0,2096584,68.98,273523621,145.725,29.3,5.319,11188.744,342.864,6.32,0.694,2
92,188,3992,303498,96,11151,22771,2119355,68.98,273523621,145.725,29.3,5.319,11188.744,342.864,6.32,0.694,2
92,189,3622,307120,102,11253,26153,2145508,68.98,273523621,145.725,29.3,5.319,11188.744,342.864,6.32,0.694,2
92,190,4056,311176,121,11374,32167,2177675,68.98,273523621,145.725,29.3,5.319,11188.744,342.864,6.32,0.694,2
92,191,4538,315714,98,11472,32901,2210576,68.98,273523621,145.725,29.3,5.319,11188.744,342.864,6.32,0.694,2
92,192,4850,320564,108,11580,39118,2249694,68.98,273523621,145.725,29.3,5.319,11188.744,342.864,6.32,0.694,2
92,193,4094,324658,97,11677,33675,2283369,68.98,273523621,145.725,29.3,5.319,11188.744,342.864,6.32,0.694,2
92,194,4294,328952,88,11765,22163,2305532,68.98,273523621,145.725,29.3,5.319,11188.744,342.864,6.32,0.694,2
92,195,4497,333449,79,11844,33018,2338550,68.98,273523621,145.725,29.3,5.319,11188.744,342.864,6.32,0.694,2
92,196,3267,336716,91,11935,40012,2378562,68.98,273523621,145.725,29.3,5.319,11188.744,342.864,6.32,0.694,2
92,197,3906,340622,92,12027,37044,2415606,68.98,273523621,145.725,29.3,5.319,11188.744,342.864,6.32,0.694,2
92,198,4127,344749,129,12156,34119,2449725,68.98,273523621,145.725,29.3,5.319,11188.744,342.864,6.32,0.694,2
92,199,4411,349160,112,12268,30197,2479922,68.98,273523621,145.725,29.3,5.319,11188.744,342.864,6.32,0.694,2
92,200,4301,353461,79,12347,25976,2505898,68.98,273523621,145.725,29.3,5.319,11188.744,342.864,6.32,0.694,2
92,201,4301,357762,84,12431,22421,2528319,68.98,273523621,145.725,29.3,5.319,11188.744,342.864,6.32,0.694,2
92,202,4105,361867,80,12511,25202,2553521,68.98,273523621,145.725,29.3,5.319,11188.744,342.864,6.32,0.694,2
92,203,3373,365240,106,12617,29564,2583085,68.98,273523621,145.725,29.3,5.319,11188.744,342.864,6.32,0.694,2
92,204,3602,368842,117,12734,0,2583085,68.98,273523621,145.725,29.3,5.319,11188.744,342.864,6.32,0.694,2
93,1,3111,44606,141,2898,0,0,57.41,83992953,49.831,32.4,5.44,19082.62,270.308,9.59,0.798,3
93,2,2987,47593,138,3036,0,0,57.41,83992953,49.831,32.4,5.44,19082.62,270.308,9.59,0.798,3
93,3,2875,50468,124,3160,0,0,57.41,83992953,49.831,32.4,5.44,19082.62,270.308,9.59,0.798,3
93,4,0,50468,0,3160,0,0,57.41,83992953,49.831,32.4,5.44,19082.62,270.308,9.59,0.798,3
93,5,5275,55743,292,3452,0,189790,59.26,83992953,49.831,32.4,5.44,19082.62,270.308,9.59,0.798,3
93,6,2483,58226,151,3603,0,189790,59.26,83992953,49.831,32.4,5.44,19082.62,270.308,9.59,0.798,3
93,7,2274,60500,136,3739,0,189790,59.26,83992953,49.831,32.4,5.44,19082.62,270.308,9.59,0.798,3
93,8,2089,62589,133,3872,0,220975,59.26,83992953,49.831,32.4,5.44,19082.62,270.308,9.59,0.798,3
93,9,1997,64586,121,3993,10418,231393,59.26,83992953,49.831,32.4,5.44,19082.62,270.308,9.59,0.798,3
93,10,1634,66220,117,4110,11175,242568,59.26,83992953,49.831,32.4,5.44,19082.62,270.308,9.59,0.798,3
93,11,1972,68192,122,4232,9135,251703,50.93,83992953,49.831,32.4,5.44,19082.62,270.308,9.59,0.798,3
93,12,1837,70029,125,4357,11685,263388,50.93,83992953,49.831,32.4,5.44,19082.62,270.308,9.59,0.798,3
93,13,1657,71686,117,4474,0,263388,50.93,83992953,49.831,32.4,5.44,19082.62,270.308,9.59,0.798,3
93,14,1617,73303,111,4585,0,287359,50.93,83992953,49.831,32.4,5.44,19082.62,270.308,9.59,0.798,3
93,15,1574,74877,98,4683,11845,299204,50.93,83992953,49.831,32.4,5.44,19082.62,270.308,9.59,0.798,3
93,16,1512,76389,94,4777,11136,310340,50.93,83992953,49.831,32.4,5.44,19082.62,270.308,9.59,0.798,3
93,17,1606,77995,92,4869,9539,319879,50.93,83992953,49.831,32.4,5.44,19082.62,270.308,9.59,0.798,3
93,18,1499,79494,89,4958,10258,330137,50.93,83992953,49.831,32.4,5.44,19082.62,270.308,9.59,0.798,3
93,19,1374,80868,73,5031,11525,341662,53.7,83992953,49.831,32.4,5.44,19082.62,270.308,9.59,0.798,3
93,20,1343,82211,87,5118,11350,353012,53.7,83992953,49.831,32.4,5.44,19082.62,270.308,9.59,0.798,3
93,21,1294,83505,91,5209,12711,365723,53.7,83992953,49.831,32.4,5.44,19082.62,270.308,9.59,0.798,3
93,22,1297,84802,88,5297,0,365723,53.7,83992953,49.831,32.4,5.44,19082.62,270.308,9.59,0.798,3
93,23,1194,85996,94,5391,0,389507,53.7,83992953,49.831,32.4,5.44,19082.62,270.308,9.59,0.798,3
93,24,1030,87026,90,5481,10420,399927,53.7,83992953,49.831,32.4,5.44,19082.62,270.308,9.59,0.798,3
93,25,1168,88194,93,5574,10148,410075,53.7,83992953,49.831,32.4,5.44,19082.62,270.308,9.59,0.798,3
93,26,1134,89328,76,5650,11238,421313,53.7,83992953,49.831,32.4,5.44,19082.62,270.308,9.59,0.798,3
93,27,1153,90481,60,5710,11016,432329,53.7,83992953,49.831,32.4,5.44,19082.62,270.308,9.59,0.798,3
93,28,991,91472,96,5806,0,432329,53.7,83992953,49.831,32.4,5.44,19082.62,270.308,9.59,0.798,3
93,29,1112,92584,71,5877,0,453386,53.7,83992953,49.831,32.4,5.44,19082.62,270.308,9.59,0.798,3
93,30,1073,93657,80,5957,9909,463295,53.7,83992953,49.831,32.4,5.44,19082.62,270.308,9.59,0.798,3
93,31,983,94640,71,6028,11728,475023,53.7,83992953,49.831,32.4,5.44,19082.62,270.308,9.59,0.798,3
93,32,1006,95646,63,6091,9518,484541,53.7,83992953,49.831,32.4,5.44,19082.62,270.308,9.59,0.798,3
93,33,802,96448,65,6156,11732,496273,53.7,83992953,49.831,32.4,5.44,19082.62,270.308,9.59,0.798,3
93,34,976,97424,47,6203,12015,508288,53.7,83992953,49.831,32.4,5.44,19082.62,270.308,9.59,0.798,3
93,35,1223,98647,74,6277,11255,519543,53.7,83992953,49.831,32.4,5.44,19082.62,270.308,9.59,0.798,3
93,36,1323,99970,63,6340,11732,531275,53.7,83992953,49.831,32.4,5.44,19082.62,270.308,9.59,0.798,3
93,37,1680,101650,78,6418,13517,544792,53.7,83992953,49.831,32.4,5.44,19082.62,270.308,9.59,0.798,3
93,38,1485,103135,68,6486,14107,558899,53.7,83992953,49.831,32.4,5.44,19082.62,270.308,9.59,0.798,3
93,39,1556,104691,55,6541,0,558899,50.93,83992953,49.831,32.4,5.44,19082.62,270.308,9.59,0.798,3
93,40,1529,106220,48,6589,0,586699,50.93,83992953,49.831,32.4,5.44,19082.62,270.308,9.59,0.798,3
93,41,1383,107603,51,6640,0,586699,50.93,83992953,49.831,32.4,5.44,19082.62,270.308,9.59,0.798,3
93,42,1683,109286,45,6685,0,615477,50.93,83992953,49.831,32.4,5.44,19082.62,270.308,9.59,0.798,3
93,43,1481,110767,48,6733,14057,629534,50.93,83992953,49.831,32.4,5.44,19082.62,270.308,9.59,0.798,3
93,44,1958,112725,50,6783,14238,643772,50.93,83992953,49.831,32.4,5.44,19082.62,270.308,9.59,0.798,3
93,45,1808,114533,71,6854,14832,658604,50.93,83992953,49.831,32.4,5.44,19082.62,270.308,9.59,0.798,3
93,46,2102,116635,48,6902,14075,672679,45.37,83992953,49.831,32.4,5.44,19082.62,270.308,9.59,0.798,3
93,47,1757,118392,35,6937,14256,686935,47.22,83992953,49.831,32.4,5.44,19082.62,270.308,9.59,0.798,3
93,48,1806,120198,51,6988,14705,701640,47.22,83992953,49.831,32.4,5.44,19082.62,270.308,9.59,0.798,3
93,49,2294,122492,69,7057,14536,716176,47.22,83992953,49.831,32.4,5.44,19082.62,270.308,9.59,0.798,3
93,50,2111,124603,62,7119,15037,731213,47.22,83992953,49.831,32.4,5.44,19082.62,270.308,9.59,0.798,3
93,51,2346,126949,64,7183,14832,746045,47.22,83992953,49.831,32.4,5.44,19082.62,270.308,9.59,0.798,3
93,52,2392,129341,66,7249,17868,763913,47.22,83992953,49.831,32.4,5.44,19082.62,270.308,9.59,0.798,3
93,53,2311,131652,51,7300,17373,781286,47.22,83992953,49.831,32.4,5.44,19082.62,270.308,9.59,0.798,3
93,54,1869,133521,59,7359,19233,800519,47.22,83992953,49.831,32.4,5.44,19082.62,270.308,9.59,0.798,3
93,55,2180,135701,58,7417,18398,818917,47.22,83992953,49.831,32.4,5.44,19082.62,270.308,9.59,0.798,3
93,56,2023,137724,34,7451,18173,837090,42.59,83992953,49.831,32.4,5.44,19082.62,270.308,9.59,0.798,3
93,57,1787,139511,57,7508,19456,856546,42.59,83992953,49.831,32.4,5.44,19082.62,270.308,9.59,0.798,3
93,58,2080,141591,56,7564,0,856546,42.59,83992953,49.831,32.4,5.44,19082.62,270.308,9.59,0.798,3
93,59,2258,143849,63,7627,0,896571,42.59,83992953,49.831,32.4,5.44,19082.62,270.308,9.59,0.798,3
93,60,2819,146668,50,7677,19427,915998,42.59,83992953,49.831,32.4,5.44,19082.62,270.308,9.59,0.798,3
93,61,2282,148950,57,7734,19896,935894,42.59,83992953,49.831,32.4,5.44,19082.62,270.308,9.59,0.798,3
93,62,2516,151466,63,7797,19971,955865,42.59,83992953,49.831,32.4,5.44,19082.62,270.308,9.59,0.798,3
93,63,2979,154445,81,7878,20071,975936,42.59,83992953,49.831,32.4,5.44,19082.62,270.308,9.59,0.798,3
93,64,3117,157562,64,7942,21073,997009,42.59,83992953,49.831,32.4,5.44,19082.62,270.308,9.59,0.798,3
93,65,3134,160696,70,8012,22353,1019362,42.59,83992953,49.831,32.4,5.44,19082.62,270.308,9.59,0.798,3
93,66,3574,164270,59,8071,20927,1040289,42.59,83992953,49.831,32.4,5.44,19082.62,270.308,9.59,0.798,3
93,67,2886,167156,63,8134,19837,1060126,42.59,83992953,49.831,32.4,5.44,19082.62,270.308,9.59,0.798,3
93,68,2269,169425,75,8209,24731,1084857,42.59,83992953,49.831,32.4,5.44,19082.62,270.308,9.59,0.798,3
93,69,2364,171789,72,8281,0,1084857,42.59,83992953,49.831,32.4,5.44,19082.62,270.308,9.59,0.798,3
93,70,2043,173832,70,8351,0,1128601,42.59,83992953,49.831,32.4,5.44,19082.62,270.308,9.59,0.798,3
93,71,2095,175927,74,8425,22431,1151032,42.59,83992953,49.831,32.4,5.44,19082.62,270.308,9.59,0.798,3
93,72,2011,177938,81,8506,0,1151032,42.59,83992953,49.831,32.4,5.44,19082.62,270.308,9.59,0.798,3
93,73,2238,180176,78,8584,0,1196947,42.59,83992953,49.831,32.4,5.44,19082.62,270.308,9.59,0.798,3
93,74,2369,182545,75,8659,22453,1219400,42.59,83992953,49.831,32.4,5.44,19082.62,270.308,9.59,0.798,3
93,75,2410,184955,71,8730,24674,1244074,42.59,83992953,49.831,32.4,5.44,19082.62,270.308,9.59,0.798,3
93,76,2472,187427,107,8837,25120,1269194,42.59,83992953,49.831,32.4,5.44,19082.62,270.308,9.59,0.798,3
93,77,2449,189876,113,8950,24415,1293609,42.59,83992953,49.831,32.4,5.44,19082.62,270.308,9.59,0.798,3
93,78,2563,192439,115,9065,26311,1319920,42.59,83992953,49.831,32.4,5.44,19082.62,270.308,9.59,0.798,3
93,79,2612,195051,120,9185,24679,1344599,42.59,83992953,49.831,32.4,5.44,19082.62,270.308,9.59,0.798,3
93,80,2596,197647,87,9272,26119,1370718,42.59,83992953,49.831,32.4,5.44,19082.62,270.308,9.59,0.798,3
93,81,2615,200262,120,9392,24957,1395675,42.59,83992953,49.831,32.4,5.44,19082.62,270.308,9.59,0.798,3
93,82,2322,202584,115,9507,26732,1422407,39.81,83992953,49.831,32.4,5.44,19082.62,270.308,9.59,0.798,3
93,83,2368,204952,116,9623,27013,1449420,39.81,83992953,49.831,32.4,5.44,19082.62,270.308,9.59,0.798,3
93,84,2573,207525,119,9742,25911,1475331,39.81,83992953,49.831,32.4,5.44,19082.62,270.308,9.59,0.798,3
93,85,2445,209970,121,9863,27194,1502525,39.81,83992953,49.831,32.4,5.44,19082.62,270.308,9.59,0.798,3
93,86,2531,212501,133,9996,27912,1530437,39.81,83992953,49.831,32.4,5.44,19082.62,270.308,9.59,0.798,3
93,87,2595,215096,134,10130,27435,1557872,39.81,83992953,49.831,32.4,5.44,19082.62,270.308,9.59,0.798,3
93,88,2628,217724,0,10130,25670,1583542,39.81,83992953,49.831,32.4,5.44,19082.62,270.308,9.59,0.798,3
93,89,2456,220180,234,10364,27327,1610869,39.81,83992953,49.831,32.4,5.44,19082.62,270.308,9.59,0.798,3
93,90,2489,222669,144,10508,28209,1639078,39.81,83992953,49.831,32.4,5.44,19082.62,270.308,9.59,0.798,3
93,91,2536,225205,162,10670,0,1639078,39.81,83992953,49.831,32.4,5.44,19082.62,270.308,9.59,0.798,3
93,92,2457,227662,147,10817,0,1693242,39.81,83992953,49.831,32.4,5.44,19082.62,270.308,9.59,0.798,3
93,93,2549,230211,141,10958,0,1693242,39.81,83992953,49.831,32.4,5.44,19082.62,270.308,9.59,0.798,3
93,94,2652,232863,148,11106,0,1744958,39.81,83992953,49.831,32.4,5.44,19082.62,270.308,9.59,0.798,3
93,95,2566,235429,154,11260,24562,1769520,39.81,83992953,49.831,32.4,5.44,19082.62,270.308,9.59,0.798,3
93,96,2449,237878,148,11408,25207,1794727,39.81,83992953,49.831,32.4,5.44,19082.62,270.308,9.59,0.798,3
93,97,2560,240438,163,11571,25276,1820003,39.81,83992953,49.831,32.4,5.44,19082.62,270.308,9.59,0.798,3
93,98,2613,243051,160,11731,26790,1846793,39.81,83992953,49.831,32.4,5.44,19082.62,270.308,9.59,0.798,3
93,99,2637,245688,200,11931,25598,1872391,39.81,83992953,49.831,32.4,5.44,19082.62,270.308,9.59,0.798,3
93,100,2691,248379,153,12084,25412,1897803,39.81,83992953,49.831,32.4,5.44,19082.62,270.308,9.59,0.798,3
93,101,2079,250458,221,12305,24698,1922501,39.81,83992953,49.831,32.4,5.44,19082.62,270.308,9.59,0.798,3
93,102,2262,252720,142,12447,24613,1947114,52.31,83992953,49.831,32.4,5.44,19082.62,270.308,9.59,0.798,3
93,103,2397,255117,188,12635,25093,1972207,52.31,83992953,49.831,32.4,5.44,19082.62,270.308,9.59,0.798,3
93,104,2186,257303,194,12829,25760,1997967,58.8,83992953,49.831,32.4,5.44,19082.62,270.308,9.59,0.798,3
93,105,2349,259652,203,13032,25112,2023079,58.8,83992953,49.831,32.4,5.44,19082.62,270.308,9.59,0.798,3
93,106,2521,262173,179,13211,24970,2048049,58.8,83992953,49.831,32.4,5.44,19082.62,270.308,9.59,0.798,3
93,107,2388,264561,199,13410,25742,2073791,58.8,83992953,49.831,32.4,5.44,19082.62,270.308,9.59,0.798,3
93,108,2500,267061,198,13608,25194,2098985,58.8,83992953,49.831,32.4,5.44,19082.62,270.308,9.59,0.798,3
93,109,2379,269440,183,13791,24533,2123518,58.8,83992953,49.831,32.4,5.44,19082.62,270.308,9.59,0.798,3
93,110,2166,271606,188,13979,25481,2148999,58.8,83992953,49.831,32.4,5.44,19082.62,270.308,9.59,0.798,3
93,111,2182,273788,209,14188,26218,2175217,58.8,83992953,49.831,32.4,5.44,19082.62,270.308,9.59,0.798,3
93,112,2414,276202,217,14405,26741,2201958,58.8,83992953,49.831,32.4,5.44,19082.62,270.308,9.59,0.798,3
93,113,2625,278827,229,14634,26319,2228277,58.8,83992953,49.831,32.4,5.44,19082.62,270.308,9.59,0.798,3
93,114,2586,281413,219,14853,25846,2254123,58.8,83992953,49.831,32.4,5.44,19082.62,270.308,9.59,0.798,3
93,115,2621,284034,221,15074,24261,2278384,58.8,83992953,49.831,32.4,5.44,19082.62,270.308,9.59,0.798,3
93,116,2489,286523,215,15289,0,2278384,58.8,83992953,49.831,32.4,5.44,19082.62,270.308,9.59,0.798,3
93,117,2316,288839,195,15484,0,2278384,58.8,83992953,49.831,32.4,5.44,19082.62,270.308,9.59,0.798,3
93,118,2333,291172,216,15700,0,2278384,58.8,83992953,49.831,32.4,5.44,19082.62,270.308,9.59,0.798,3
93,119,2434,293606,212,15912,0,2380122,58.8,83992953,49.831,32.4,5.44,19082.62,270.308,9.59,0.798,3
93,120,2667,296273,235,16147,25740,2405862,58.8,83992953,49.831,32.4,5.44,19082.62,270.308,9.59,0.798,3
93,121,2636,298909,196,16343,0,2405862,58.8,83992953,49.831,32.4,5.44,19082.62,270.308,9.59,0.798,3
93,122,2621,301530,226,16569,0,2456909,61.57,83992953,49.831,32.4,5.44,19082.62,270.308,9.59,0.798,3
93,123,2674,304204,197,16766,25644,2482553,61.57,83992953,49.831,32.4,5.44,19082.62,270.308,9.59,0.798,3
93,124,2548,306752,216,16982,25865,2508418,61.57,83992953,49.831,32.4,5.44,19082.62,270.308,9.59,0.798,3
93,125,2685,309437,208,17190,26240,2534658,61.57,83992953,49.831,32.4,5.44,19082.62,270.308,9.59,0.798,3
93,126,2598,312035,215,17405,25716,2560374,60.19,83992953,49.831,32.4,5.44,19082.62,270.308,9.59,0.798,3
93,127,2751,314786,212,17617,26709,2587083,60.19,83992953,49.831,32.4,5.44,19082.62,270.308,9.59,0.798,3
93,128,2697,317483,185,17802,0,2587083,60.19,83992953,49.831,32.4,5.44,19082.62,270.308,9.59,0.798,3
93,129,2634,320117,14,17816,0,2637575,60.19,83992953,49.831,32.4,5.44,19082.62,270.308,9.59,0.798,3
93,130,2450,322567,316,18132,24390,2661965,60.19,83992953,49.831,32.4,5.44,19082.62,270.308,9.59,0.798,3
93,131,2125,324692,132,18264,24533,2686498,60.19,83992953,49.831,32.4,5.44,19082.62,270.308,9.59,0.798,3
93,132,2020,326712,163,18427,25319,2711817,60.19,83992953,49.831,32.4,5.44,19082.62,270.308,9.59,0.798,3
93,133,2132,328844,189,18616,24697,2736514,60.19,83992953,49.831,32.4,5.44,19082.62,270.308,9.59,0.798,3
93,134,2345,331189,184,18800,26711,2763225,60.19,83992953,49.831,32.4,5.44,19082.62,270.308,9.59,0.798,3
93,135,2510,333699,188,18988,0,2763225,60.19,83992953,49.831,32.4,5.44,19082.62,270.308,9.59,0.798,3
93,136,2625,336324,174,19162,0,2812488,60.19,83992953,49.831,32.4,5.44,19082.62,270.308,9.59,0.798,3
93,137,2501,338825,169,19331,23764,2836252,60.19,83992953,49.831,32.4,5.44,19082.62,270.308,9.59,0.798,3
93,138,2245,341070,161,19492,25573,2861825,60.19,83992953,49.831,32.4,5.44,19082.62,270.308,9.59,0.798,3
93,139,2133,343203,147,19639,26113,2887938,60.19,83992953,49.831,32.4,5.44,19082.62,270.308,9.59,0.798,3
93,140,2247,345450,165,19804,26111,2914049,60.19,83992953,49.831,32.4,5.44,19082.62,270.308,9.59,0.798,3
93,141,2385,347835,168,19972,25791,2939840,60.19,83992953,49.831,32.4,5.44,19082.62,270.308,9.59,0.798,3
93,142,0,347835,0,19972,23901,2963741,60.19,83992953,49.831,32.4,5.44,19082.62,270.308,9.59,0.798,3
93,143,4723,352558,292,20264,0,2963741,60.19,83992953,49.831,32.4,5.44,19082.62,270.308,9.59,0.798,3
93,144,2206,354764,112,20376,0,3011310,60.19,83992953,49.831,32.4,5.44,19082.62,270.308,9.59,0.798,3
93,145,2028,356792,126,20502,25401,3036711,60.19,83992953,49.831,32.4,5.44,19082.62,270.308,9.59,0.798,3
93,146,2113,358905,141,20643,25711,3062422,60.19,83992953,49.831,32.4,5.44,19082.62,270.308,9.59,0.798,3
93,147,0,358905,0,20643,25891,3088313,60.19,83992953,49.831,32.4,5.44,19082.62,270.308,9.59,0.798,3
93,148,2245,361150,133,20776,25493,3113806,60.19,83992953,49.831,32.4,5.44,19082.62,270.308,9.59,0.798,3
93,149,2213,363363,125,20901,24976,3138782,60.19,83992953,49.831,32.4,5.44,19082.62,270.308,9.59,0.798,3
93,150,4433,367796,236,21137,23112,3161894,60.19,83992953,49.831,32.4,5.44,19082.62,270.308,9.59,0.798,3
93,151,2115,369911,112,21249,0,3161894,60.19,83992953,49.831,32.4,5.44,19082.62,270.308,9.59,0.798,3
93,152,1905,371816,110,21359,0,3207269,60.19,83992953,49.831,32.4,5.44,19082.62,270.308,9.59,0.798,3
93,153,1754,373570,103,21462,23841,3231110,60.19,83992953,49.831,32.4,5.44,19082.62,270.308,9.59,0.798,3
93,154,1642,375212,109,21571,25012,3256122,60.19,83992953,49.831,32.4,5.44,19082.62,270.308,9.59,0.798,3
93,155,1682,376894,101,21672,25839,3281961,60.19,83992953,49.831,32.4,5.44,19082.62,270.308,9.59,0.798,3
93,156,1858,378752,125,21797,25422,3307383,60.19,83992953,49.831,32.4,5.44,19082.62,270.308,9.59,0.798,3
93,157,1994,380746,129,21926,0,3307383,60.19,83992953,49.831,32.4,5.44,19082.62,270.308,9.59,0.798,3
93,158,2026,382772,118,22044,0,3355152,60.19,83992953,49.831,32.4,5.44,19082.62,270.308,9.59,0.798,3
93,159,1894,384666,110,22154,0,3355152,60.19,83992953,49.831,32.4,5.44,19082.62,270.308,9.59,0.798,3
93,160,1992,386658,139,22293,0,3406055,60.19,83992953,49.831,32.4,5.44,19082.62,270.308,9.59,0.798,3
93,161,2152,388810,117,22410,25591,3431646,60.19,83992953,49.831,32.4,5.44,19082.62,270.308,9.59,0.798,3
93,162,2302,391112,132,22542,26097,3457743,60.19,83992953,49.831,32.4,5.44,19082.62,270.308,9.59,0.798,3
93,163,2313,393425,127,22669,0,3457743,60.19,83992953,49.831,32.4,5.44,19082.62,270.308,9.59,0.798,3
93,164,2063,395488,129,22798,0,3507938,60.19,83992953,49.831,32.4,5.44,19082.62,270.308,9.59,0.798,3
93,165,2313,397801,115,22913,24936,3532874,60.19,83992953,49.831,32.4,5.44,19082.62,270.308,9.59,0.798,3
93,166,2139,399940,116,23029,26691,3559565,60.19,83992953,49.831,32.4,5.44,19082.62,270.308,9.59,0.798,3
93,167,2089,402029,128,23157,27283,3586848,60.19,83992953,49.831,32.4,5.44,19082.62,270.308,9.59,0.798,3
93,168,2619,404648,156,23313,0,3586848,54.63,83992953,49.831,32.4,5.44,19082.62,270.308,9.59,0.798,3
93,169,2705,407353,140,23453,0,3641581,54.63,83992953,49.831,32.4,5.44,19082.62,270.308,9.59,0.798,3
93,170,2981,410334,179,23632,0,3641581,54.63,83992953,49.831,32.4,5.44,19082.62,270.308,9.59,0.798,3
93,171,2815,413149,176,23808,0,3641581,54.63,83992953,49.831,32.4,5.44,19082.62,270.308,9.59,0.798,3
93,172,3049,416198,144,23952,0,3719210,54.63,83992953,49.831,32.4,5.44,19082.62,270.308,9.59,0.798,3
93,173,2845,419043,166,24118,0,3719210,54.63,83992953,49.831,32.4,5.44,19082.62,270.308,9.59,0.798,3
93,174,3097,422140,183,24301,0,3773300,54.63,83992953,49.831,32.4,5.44,19082.62,270.308,9.59,0.798,3
93,175,3341,425481,177,24478,27319,3800619,54.63,83992953,49.831,32.4,5.44,19082.62,270.308,9.59,0.798,3
93,176,3712,429193,178,24656,27711,3828330,54.63,83992953,49.831,32.4,5.44,19082.62,270.308,9.59,0.798,3
93,177,3605,432798,184,24840,0,3828330,54.63,83992953,49.831,32.4,5.44,19082.62,270.308,9.59,0.798,3
93,178,3521,436319,175,25015,0,3828330,54.63,83992953,49.831,32.4,5.44,19082.62,270.308,9.59,0.798,3
93,179,3563,439882,207,25222,0,3879640,54.63,83992953,49.831,32.4,5.44,19082.62,270.308,9.59,0.798,3
93,180,3204,443086,172,25394,0,3879640,54.63,83992953,49.831,32.4,5.44,19082.62,270.308,9.59,0.798,3
93,181,3362,446448,195,25589,0,3959783,54.63,83992953,49.831,32.4,5.44,19082.62,270.308,9.59,0.798,3
93,182,3512,449960,190,25779,26937,3986720,54.63,83992953,49.831,32.4,5.44,19082.62,270.308,9.59,0.798,3
93,183,3677,453637,207,25986,28101,4014821,54.63,83992953,49.831,32.4,5.44,19082.62,270.308,9.59,0.798,3
93,184,3582,457219,183,26169,0,4014821,54.63,83992953,49.831,32.4,5.44,19082.62,270.308,9.59,0.798,3
93,185,3825,461044,211,26380,0,4067861,54.63,83992953,49.831,32.4,5.44,19082.62,270.308,9.59,0.798,3
93,186,3552,464596,187,26567,0,4067861,57.41,83992953,49.831,32.4,5.44,19082.62,270.308,9.59,0.798,3
93,187,3523,468119,179,26746,0,4067861,57.41,83992953,49.831,32.4,5.44,19082.62,270.308,9.59,0.798,3
93,188,3653,471772,211,26957,0,4067861,57.41,83992953,49.831,32.4,5.44,19082.62,270.308,9.59,0.798,3
93,189,3902,475674,235,27192,0,4115445,63.89,83992953,49.831,32.4,5.44,19082.62,270.308,9.59,0.798,3
93,190,4151,479825,227,27419,92186,4207631,63.89,83992953,49.831,32.4,5.44,19082.62,270.308,9.59,0.798,3
93,191,4019,483844,239,27658,0,4207631,63.89,83992953,49.831,32.4,5.44,19082.62,270.308,9.59,0.798,3
93,192,4392,488236,230,27888,0,4207631,63.89,83992953,49.831,32.4,5.44,19082.62,270.308,9.59,0.798,3
93,193,4142,492378,210,28098,0,4207631,63.89,83992953,49.831,32.4,5.44,19082.62,270.308,9.59,0.798,3
93,194,3875,496253,195,28293,0,4312514,63.89,83992953,49.831,32.4,5.44,19082.62,270.308,9.59,0.798,3
93,195,3822,500075,251,28544,28317,4340831,63.89,83992953,49.831,32.4,5.44,19082.62,270.308,9.59,0.798,3
93,196,4206,504281,272,28816,28791,4369622,63.89,83992953,49.831,32.4,5.44,19082.62,270.308,9.59,0.798,3
93,197,4108,508389,254,29070,29101,4398723,63.89,83992953,49.831,32.4,5.44,19082.62,270.308,9.59,0.798,3
93,198,4830,513219,279,29349,28056,4426779,63.89,83992953,49.831,32.4,5.44,19082.62,270.308,9.59,0.798,3
93,199,4616,517835,256,29605,0,4426779,63.89,83992953,49.831,32.4,5.44,19082.62,270.308,9.59,0.798,3
93,200,4552,522387,265,29870,0,4426779,63.89,83992953,49.831,32.4,5.44,19082.62,270.308,9.59,0.798,3
93,201,4103,526490,253,30123,0,4511154,63.89,83992953,49.831,32.4,5.44,19082.62,270.308,9.59,0.798,3
93,202,3890,530380,252,30375,29301,4540455,63.89,83992953,49.831,32.4,5.44,19082.62,270.308,9.59,0.798,3
93,203,4251,534631,337,30712,0,4540455,63.89,83992953,49.831,32.4,5.44,19082.62,270.308,9.59,0.798,3
93,204,5039,539670,322,31034,0,4540455,63.89,83992953,49.831,32.4,5.44,19082.62,270.308,9.59,0.798,3
94,1,64,694,4,50,0,0,96.3,40222503,88.125,20,3.186,15663.986,218.612,8.83,0.685,4
94,2,0,694,0,50,0,0,96.3,40222503,88.125,20,3.186,15663.986,218.612,8.83,0.685,4
94,3,78,772,4,54,0,0,96.3,40222503,88.125,20,3.186,15663.986,218.612,8.83,0.685,4
94,4,0,772,0,54,0,0,96.3,40222503,88.125,20,3.186,15663.986,218.612,8.83,0.685,4
94,5,106,878,2,56,0,0,96.3,40222503,88.125,20,3.186,15663.986,218.612,8.83,0.685,4
94,6,83,961,5,61,0,0,96.3,40222503,88.125,20,3.186,15663.986,218.612,8.83,0.685,4
94,7,70,1031,3,64,0,26331,96.3,40222503,88.125,20,3.186,15663.986,218.612,8.83,0.685,4
94,8,0,1031,0,64,2083,28414,96.3,40222503,88.125,20,3.186,15663.986,218.612,8.83,0.685,4
94,9,171,1202,5,69,2052,30466,96.3,40222503,88.125,20,3.186,15663.986,218.612,8.83,0.685,4
94,10,30,1232,0,69,1692,32158,96.3,40222503,88.125,20,3.186,15663.986,218.612,8.83,0.685,4
94,11,47,1279,1,70,1731,33889,96.3,40222503,88.125,20,3.186,15663.986,218.612,8.83,0.685,4
94,12,39,1318,2,72,1526,35415,96.3,40222503,88.125,20,3.186,15663.986,218.612,8.83,0.685,4
94,13,34,1352,4,76,2376,37791,96.3,40222503,88.125,20,3.186,15663.986,218.612,8.83,0.685,4
94,14,26,1378,2,78,7646,45437,96.3,40222503,88.125,20,3.186,15663.986,218.612,8.83,0.685,4
94,15,22,1400,0,78,698,46135,96.3,40222503,88.125,20,3.186,15663.986,218.612,8.83,0.685,4
94,16,15,1415,1,79,3125,49260,96.3,40222503,88.125,20,3.186,15663.986,218.612,8.83,0.685,4
94,17,19,1434,1,80,2477,51737,96.3,40222503,88.125,20,3.186,15663.986,218.612,8.83,0.685,4
94,18,48,1482,1,81,2218,53955,96.3,40222503,88.125,20,3.186,15663.986,218.612,8.83,0.685,4
94,19,0,1482,0,81,2192,56147,96.3,40222503,88.125,20,3.186,15663.986,218.612,8.83,0.685,4
94,20,57,1539,1,82,2908,59055,96.3,40222503,88.125,20,3.186,15663.986,218.612,8.83,0.685,4
94,21,35,1574,0,82,1782,60837,85.19,40222503,88.125,20,3.186,15663.986,218.612,8.83,0.685,4
94,22,28,1602,1,83,2043,62880,85.19,40222503,88.125,20,3.186,15663.986,218.612,8.83,0.685,4
94,23,0,1602,0,83,2002,64882,85.19,40222503,88.125,20,3.186,15663.986,218.612,8.83,0.685,4
94,24,75,1677,0,83,2411,67293,85.19,40222503,88.125,20,3.186,15663.986,218.612,8.83,0.685,4
94,25,31,1708,3,86,931,68224,85.19,40222503,88.125,20,3.186,15663.986,218.612,8.83,0.685,4
94,26,55,1763,0,86,3247,71471,85.19,40222503,88.125,20,3.186,15663.986,218.612,8.83,0.685,4
94,27,57,1820,1,87,2311,73782,85.19,40222503,88.125,20,3.186,15663.986,218.612,8.83,0.685,4
94,28,27,1847,1,88,4648,78430,85.19,40222503,88.125,20,3.186,15663.986,218.612,8.83,0.685,4
94,29,0,1847,0,88,8278,86708,85.19,40222503,88.125,20,3.186,15663.986,218.612,8.83,0.685,4
94,30,156,2003,4,92,5353,92061,85.19,40222503,88.125,20,3.186,15663.986,218.612,8.83,0.685,4
94,31,82,2085,1,93,3338,95399,85.19,40222503,88.125,20,3.186,15663.986,218.612,8.83,0.685,4
94,32,68,2153,1,94,2854,98253,85.19,40222503,88.125,20,3.186,15663.986,218.612,8.83,0.685,4
94,33,66,2219,1,95,0,98253,85.19,40222503,88.125,20,3.186,15663.986,218.612,8.83,0.685,4
94,34,77,2296,2,97,0,107586,85.19,40222503,88.125,20,3.186,15663.986,218.612,8.83,0.685,4
94,35,50,2346,1,98,5898,113484,85.19,40222503,88.125,20,3.186,15663.986,218.612,8.83,0.685,4
94,36,85,2431,4,102,4242,117726,85.19,40222503,88.125,20,3.186,15663.986,218.612,8.83,0.685,4
94,37,49,2480,0,102,2878,120604,85.19,40222503,88.125,20,3.186,15663.986,218.612,8.83,0.685,4
94,38,63,2543,0,102,2337,122941,85.19,40222503,88.125,20,3.186,15663.986,218.612,8.83,0.685,4
94,39,60,2603,2,104,1979,124920,85.19,40222503,88.125,20,3.186,15663.986,218.612,8.83,0.685,4
94,40,76,2679,3,107,2233,127153,85.19,40222503,88.125,20,3.186,15663.986,218.612,8.83,0.685,4
94,41,88,2767,2,109,2548,129701,82.41,40222503,88.125,20,3.186,15663.986,218.612,8.83,0.685,4
94,42,51,2818,1,110,2756,132457,82.41,40222503,88.125,20,3.186,15663.986,218.612,8.83,0.685,4
94,43,95,2913,2,112,4183,136640,82.41,40222503,88.125,20,3.186,15663.986,218.612,8.83,0.685,4
94,44,119,3032,3,115,3933,140573,82.41,40222503,88.125,20,3.186,15663.986,218.612,8.83,0.685,4
94,45,111,3143,0,115,2921,143494,82.41,40222503,88.125,20,3.186,15663.986,218.612,8.83,0.685,4
94,46,50,3193,2,117,3100,146594,82.41,40222503,88.125,20,3.186,15663.986,218.612,8.83,0.685,4
94,47,67,3260,4,121,3107,149701,82.41,40222503,88.125,20,3.186,15663.986,218.612,8.83,0.685,4
94,48,144,3404,2,123,3520,153221,82.41,40222503,88.125,20,3.186,15663.986,218.612,8.83,0.685,4
94,49,150,3554,4,127,4441,157662,82.41,40222503,88.125,20,3.186,15663.986,218.612,8.83,0.685,4
94,50,57,3611,4,131,5947,163609,82.41,40222503,88.125,20,3.186,15663.986,218.612,8.83,0.685,4
94,51,113,3724,3,134,0,163609,82.41,40222503,88.125,20,3.186,15663.986,218.612,8.83,0.685,4
94,52,153,3877,6,140,0,163609,82.41,40222503,88.125,20,3.186,15663.986,218.612,8.83,0.685,4
94,53,87,3964,7,147,0,163609,82.41,40222503,88.125,20,3.186,15663.986,218.612,8.83,0.685,4
94,54,308,4272,5,152,0,163609,82.41,40222503,88.125,20,3.186,15663.986,218.612,8.83,0.685,4
94,55,197,4469,8,160,0,163609,82.41,40222503,88.125,20,3.186,15663.986,218.612,8.83,0.685,4
94,56,163,4632,3,163,0,163609,92.59,40222503,88.125,20,3.186,15663.986,218.612,8.83,0.685,4
94,57,216,4848,6,169,0,163609,92.59,40222503,88.125,20,3.186,15663.986,218.612,8.83,0.685,4
94,58,287,5135,6,175,0,163609,92.59,40222503,88.125,20,3.186,15663.986,218.612,8.83,0.685,4
94,59,322,5457,4,179,0,163609,92.59,40222503,88.125,20,3.186,15663.986,218.612,8.83,0.685,4
94,60,416,5873,6,185,0,163609,92.59,40222503,88.125,20,3.186,15663.986,218.612,8.83,0.685,4
94,61,306,6179,10,195,0,227756,92.59,40222503,88.125,20,3.186,15663.986,218.612,8.83,0.685,4
94,62,260,6439,10,205,10495,238251,92.59,40222503,88.125,20,3.186,15663.986,218.612,8.83,0.685,4
94,63,429,6868,10,215,13463,251714,92.59,40222503,88.125,20,3.186,15663.986,218.612,8.83,0.685,4
94,64,519,7387,20,235,8585,260299,92.59,40222503,88.125,20,3.186,15663.986,218.612,8.83,0.685,4
94,65,781,8168,21,256,11960,272259,92.59,40222503,88.125,20,3.186,15663.986,218.612,8.83,0.685,4
94,66,672,8840,15,271,9642,281901,92.59,40222503,88.125,20,3.186,15663.986,218.612,8.83,0.685,4
94,67,1006,9846,14,285,12543,294444,92.59,40222503,88.125,20,3.186,15663.986,218.612,8.83,0.685,4
94,68,1252,11098,33,318,8609,303053,92.59,40222503,88.125,20,3.186,15663.986,218.612,8.83,0.685,4
94,69,1268,12366,28,346,8927,311980,92.59,40222503,88.125,20,3.186,15663.986,218.612,8.83,0.685,4
94,70,1115,13481,24,370,10711,322691,92.59,40222503,88.125,20,3.186,15663.986,218.612,8.83,0.685,4
94,71,787,14268,22,392,7835,330526,92.59,40222503,88.125,20,3.186,15663.986,218.612,8.83,0.685,4
94,72,1146,15414,34,426,9342,339868,92.59,40222503,88.125,20,3.186,15663.986,218.612,8.83,0.685,4
94,73,1261,16675,31,457,9757,349625,92.59,40222503,88.125,20,3.186,15663.986,218.612,8.83,0.685,4
94,74,1095,17770,39,496,10325,359950,92.59,40222503,88.125,20,3.186,15663.986,218.612,8.83,0.685,4
94,75,1180,18950,53,549,9920,369870,92.59,40222503,88.125,20,3.186,15663.986,218.612,8.83,0.685,4
94,76,1259,20209,58,607,10135,380005,92.59,40222503,88.125,20,3.186,15663.986,218.612,8.83,0.685,4
94,77,1106,21315,45,652,10330,390335,92.59,40222503,88.125,20,3.186,15663.986,218.612,8.83,0.685,4
94,78,1385,22700,60,712,13053,403388,92.59,40222503,88.125,20,3.186,15663.986,218.612,8.83,0.685,4
94,79,1554,24254,61,773,10578,413966,92.59,40222503,88.125,20,3.186,15663.986,218.612,8.83,0.685,4
94,80,1463,25717,83,856,11226,425192,92.59,40222503,88.125,20,3.186,15663.986,218.612,8.83,0.685,4
94,81,1635,27352,69,925,10022,435214,92.59,40222503,88.125,20,3.186,15663.986,218.612,8.83,0.685,4
94,82,1870,29222,88,1013,10027,445241,92.59,40222503,88.125,20,3.186,15663.986,218.612,8.83,0.685,4
94,83,1646,30868,87,1100,10075,455316,92.59,40222503,88.125,20,3.186,15663.986,218.612,8.83,0.685,4
94,84,1808,32676,67,1167,10672,465988,92.59,40222503,88.125,20,3.186,15663.986,218.612,8.83,0.685,4
94,85,1826,34502,84,1251,11445,477433,92.59,40222503,88.125,20,3.186,15663.986,218.612,8.83,0.685,4
94,86,2200,36702,79,1330,11370,488803,92.59,40222503,88.125,20,3.186,15663.986,218.612,8.83,0.685,4
94,87,2437,39139,107,1437,11920,500723,92.59,40222503,88.125,20,3.186,15663.986,218.612,8.83,0.685,4
94,88,2054,41193,122,1559,9630,510353,92.59,40222503,88.125,20,3.186,15663.986,218.612,8.83,0.685,4
94,89,2069,43262,101,1660,10595,520948,92.59,40222503,88.125,20,3.186,15663.986,218.612,8.83,0.685,4
94,90,2140,45402,96,1756,11172,532120,92.59,40222503,88.125,20,3.186,15663.986,218.612,8.83,0.685,4
94,91,1749,47151,83,1839,12425,544545,92.59,40222503,88.125,20,3.186,15663.986,218.612,8.83,0.685,4
94,92,1958,49109,104,1943,11378,555923,92.59,40222503,88.125,20,3.186,15663.986,218.612,8.83,0.685,4
94,93,2415,51524,107,2050,11762,567685,92.59,40222503,88.125,20,3.186,15663.986,218.612,8.83,0.685,4
94,94,2184,53708,110,2160,12176,579861,92.59,40222503,88.125,20,3.186,15663.986,218.612,8.83,0.685,4
94,95,2312,56020,102,2262,9516,589377,92.59,40222503,88.125,20,3.186,15663.986,218.612,8.83,0.685,4
94,96,2334,58354,106,2368,11711,601088,92.59,40222503,88.125,20,3.186,15663.986,218.612,8.83,0.685,4
94,97,2125,60479,105,2473,11519,612607,92.59,40222503,88.125,20,3.186,15663.986,218.612,8.83,0.685,4
94,98,1796,62275,94,2567,11813,624420,92.59,40222503,88.125,20,3.186,15663.986,218.612,8.83,0.685,4
94,99,2426,64701,118,2685,12807,637227,92.59,40222503,88.125,20,3.186,15663.986,218.612,8.83,0.685,4
94,100,2741,67442,94,2779,11809,649036,92.59,40222503,88.125,20,3.186,15663.986,218.612,8.83,0.685,4
94,101,2170,69612,103,2882,12054,661090,92.59,40222503,88.125,20,3.186,15663.986,218.612,8.83,0.685,4
94,102,2848,72460,78,2960,10388,671478,92.59,40222503,88.125,20,3.186,15663.986,218.612,8.83,0.685,4
94,103,2734,75194,95,3055,11154,682632,92.59,40222503,88.125,20,3.186,15663.986,218.612,8.83,0.685,4
94,104,2312,77506,95,3150,15380,698012,92.59,40222503,88.125,20,3.186,15663.986,218.612,8.83,0.685,4
94,105,2229,79735,100,3250,0,698012,92.59,40222503,88.125,20,3.186,15663.986,218.612,8.83,0.685,4
94,106,2022,81757,95,3345,0,698012,92.59,40222503,88.125,20,3.186,15663.986,218.612,8.83,0.685,4
94,107,2110,83867,87,3432,0,698012,92.59,40222503,88.125,20,3.186,15663.986,218.612,8.83,0.685,4
94,108,2281,86148,90,3522,0,762058,92.59,40222503,88.125,20,3.186,15663.986,218.612,8.83,0.685,4
94,109,2023,88171,94,3616,15229,777287,92.59,40222503,88.125,20,3.186,15663.986,218.612,8.83,0.685,4
94,110,2049,90220,75,3691,15737,793024,92.59,40222503,88.125,20,3.186,15663.986,218.612,8.83,0.685,4
94,111,2310,92530,90,3781,16498,809522,92.59,40222503,88.125,20,3.186,15663.986,218.612,8.83,0.685,4
94,112,2163,94693,88,3869,16280,825802,92.59,40222503,88.125,20,3.186,15663.986,218.612,8.83,0.685,4
94,113,2466,97159,81,3950,18416,844218,92.59,40222503,88.125,20,3.186,15663.986,218.612,8.83,0.685,4
94,114,2706,99865,92,4042,16947,861165,92.59,40222503,88.125,20,3.186,15663.986,218.612,8.83,0.685,4
94,115,2361,102226,80,4122,0,861165,92.59,40222503,88.125,20,3.186,15663.986,218.612,8.83,0.685,4
94,116,2485,104711,90,4212,0,861165,92.59,40222503,88.125,20,3.186,15663.986,218.612,8.83,0.685,4
94,117,2862,107573,72,4284,0,912698,92.59,40222503,88.125,20,3.186,15663.986,218.612,8.83,0.685,4
94,118,2459,110032,78,4362,17141,929839,92.59,40222503,88.125,20,3.186,15663.986,218.612,8.83,0.685,4
94,119,2553,112585,96,4458,16922,946761,92.59,40222503,88.125,20,3.186,15663.986,218.612,8.83,0.685,4
94,120,2747,115332,77,4535,18556,965317,92.59,40222503,88.125,20,3.186,15663.986,218.612,8.83,0.685,4
94,121,2968,118300,68,4603,18018,983335,92.59,40222503,88.125,20,3.186,15663.986,218.612,8.83,0.685,4
94,122,2963,121263,68,4671,17634,1000969,92.59,40222503,88.125,20,3.186,15663.986,218.612,8.83,0.685,4
94,123,3346,124609,70,4741,13791,1014760,92.59,40222503,88.125,20,3.186,15663.986,218.612,8.83,0.685,4
94,124,2095,126704,64,4805,14399,1029159,92.59,40222503,88.125,20,3.186,15663.986,218.612,8.83,0.685,4
94,125,2447,129151,63,4868,13647,1042806,92.59,40222503,88.125,20,3.186,15663.986,218.612,8.83,0.685,4
94,126,2735,131886,66,4934,16813,1059619,92.59,40222503,88.125,20,3.186,15663.986,218.612,8.83,0.685,4
94,127,2836,134722,83,5017,16531,1076150,92.59,40222503,88.125,20,3.186,15663.986,218.612,8.83,0.685,4
94,128,2834,137556,77,5094,16591,1092741,92.59,40222503,88.125,20,3.186,15663.986,218.612,8.83,0.685,4
94,129,3047,140603,67,5161,17517,1110258,92.59,40222503,88.125,20,3.186,15663.986,218.612,8.83,0.685,4
94,130,3461,144064,75,5236,17125,1127383,92.59,40222503,88.125,20,3.186,15663.986,218.612,8.83,0.685,4
94,131,3325,147389,74,5310,18003,1145386,92.59,40222503,88.125,20,3.186,15663.986,218.612,8.83,0.685,4
94,132,2726,150115,82,5392,19663,1165049,92.59,40222503,88.125,20,3.186,15663.986,218.612,8.83,0.685,4
94,133,3484,153599,72,5464,18901,1183950,92.59,40222503,88.125,20,3.186,15663.986,218.612,8.83,0.685,4
94,134,3396,156995,67,5531,19933,1203883,92.59,40222503,88.125,20,3.186,15663.986,218.612,8.83,0.685,4
94,135,3441,160436,57,5588,21026,1224909,92.59,40222503,88.125,20,3.186,15663.986,218.612,8.83,0.685,4
94,136,3841,164277,53,5641,20446,1245355,92.59,40222503,88.125,20,3.186,15663.986,218.612,8.83,0.685,4
94,137,4013,168290,68,5709,18295,1263650,92.59,40222503,88.125,20,3.186,15663.986,218.612,8.83,0.685,4
94,138,4293,172583,76,5785,19278,1282928,92.59,40222503,88.125,20,3.186,15663.986,218.612,8.83,0.685,4
94,139,4348,176931,75,5860,21403,1304331,92.59,40222503,88.125,20,3.186,15663.986,218.612,8.83,0.685,4
94,140,3202,180133,94,5954,20772,1325103,92.59,40222503,88.125,20,3.186,15663.986,218.612,8.83,0.685,4
94,141,4576,184709,82,6036,20356,1345459,92.59,40222503,88.125,20,3.186,15663.986,218.612,8.83,0.685,4
94,142,4093,188802,85,6121,0,1345459,92.59,40222503,88.125,20,3.186,15663.986,218.612,8.83,0.685,4
94,143,3995,192797,87,6208,0,1345459,92.59,40222503,88.125,20,3.186,15663.986,218.612,8.83,0.685,4
94,144,4288,197085,75,6283,0,1413947,92.59,40222503,88.125,20,3.186,15663.986,218.612,8.83,0.685,4
94,145,3965,201050,70,6353,19679,1433626,92.59,40222503,88.125,20,3.186,15663.986,218.612,8.83,0.685,4
94,146,3291,204341,75,6428,0,1433626,92.59,40222503,88.125,20,3.186,15663.986,218.612,8.83,0.685,4
94,147,3644,207985,91,6519,0,1482187,92.59,40222503,88.125,20,3.186,15663.986,218.612,8.83,0.685,4
94,148,3962,211947,77,6596,20359,1502546,92.59,40222503,88.125,20,3.186,15663.986,218.612,8.83,0.685,4
94,149,3837,215784,72,6668,0,1502546,84.26,40222503,88.125,20,3.186,15663.986,218.612,8.83,0.685,4
94,150,3651,219435,72,6740,0,1502546,84.26,40222503,88.125,20,3.186,15663.986,218.612,8.83,0.685,4
94,151,4177,223612,74,6814,0,1502546,84.26,40222503,88.125,20,3.186,15663.986,218.612,8.83,0.685,4
94,152,3834,227446,77,6891,0,1587326,84.26,40222503,88.125,20,3.186,15663.986,218.612,8.83,0.685,4
94,153,3731,231177,68,6959,18578,1605904,84.26,40222503,88.125,20,3.186,15663.986,218.612,8.83,0.685,4
94,154,3757,234934,83,7042,18427,1624331,84.26,40222503,88.125,20,3.186,15663.986,218.612,8.83,0.685,4
94,155,3404,238338,81,7123,23123,1647454,84.26,40222503,88.125,20,3.186,15663.986,218.612,8.83,0.685,4
94,156,3946,242284,78,7201,23029,1670483,84.26,40222503,88.125,20,3.186,15663.986,218.612,8.83,0.685,4
94,157,4755,247039,74,7275,0,1670483,84.26,40222503,88.125,20,3.186,15663.986,218.612,8.83,0.685,4
94,158,5036,252075,84,7359,0,1718157,84.26,40222503,88.125,20,3.186,15663.986,218.612,8.83,0.685,4
94,159,4644,256719,63,7422,22772,1740929,84.26,40222503,88.125,20,3.186,15663.986,218.612,8.83,0.685,4
94,160,3651,260370,90,7512,24318,1765247,78.7,40222503,88.125,20,3.186,15663.986,218.612,8.83,0.685,4
94,161,4314,264684,77,7589,0,1765247,78.7,40222503,88.125,20,3.186,15663.986,218.612,8.83,0.685,4
94,162,4894,269578,68,7657,0,1765247,78.7,40222503,88.125,20,3.186,15663.986,218.612,8.83,0.685,4
94,163,4243,273821,75,7732,0,1840913,73.15,40222503,88.125,20,3.186,15663.986,218.612,8.83,0.685,4
94,164,4597,278418,82,7814,23186,1864099,73.15,40222503,88.125,20,3.186,15663.986,218.612,8.83,0.685,4
94,165,4254,282672,67,7881,18949,1883048,73.15,40222503,88.125,20,3.186,15663.986,218.612,8.83,0.685,4
94,166,4106,286778,60,7941,19353,1902401,73.15,40222503,88.125,20,3.186,15663.986,218.612,8.83,0.685,4
94,167,3531,290309,73,8014,23989,1926390,73.15,40222503,88.125,20,3.186,15663.986,218.612,8.83,0.685,4
94,168,4169,294478,72,8086,22141,1948531,73.15,40222503,88.125,20,3.186,15663.986,218.612,8.83,0.685,4
94,169,4224,298702,80,8166,24558,1973089,73.15,40222503,88.125,20,3.186,15663.986,218.612,8.83,0.685,4
94,170,4357,303059,82,8248,25206,1998295,73.15,40222503,88.125,20,3.186,15663.986,218.612,8.83,0.685,4
94,171,4326,307385,84,8332,23291,2021586,73.15,40222503,88.125,20,3.186,15663.986,218.612,8.83,0.685,4
94,172,4305,311690,76,8408,17438,2039024,73.15,40222503,88.125,20,3.186,15663.986,218.612,8.83,0.685,4
94,173,3907,315597,83,8491,18064,2057088,73.15,40222503,88.125,20,3.186,15663.986,218.612,8.83,0.685,4
94,174,3438,319035,64,8555,19756,2076844,73.15,40222503,88.125,20,3.186,15663.986,218.612,8.83,0.685,4
94,175,3821,322856,70,8625,21644,2098488,73.15,40222503,88.125,20,3.186,15663.986,218.612,8.83,0.685,4
94,176,4724,327580,57,8682,22816,2121304,73.15,40222503,88.125,20,3.186,15663.986,218.612,8.83,0.685,4
94,177,5055,332635,72,8754,20581,2141885,73.15,40222503,88.125,20,3.186,15663.986,218.612,8.83,0.685,4
94,178,4471,337106,45,8799,20662,2162547,73.15,40222503,88.125,20,3.186,15663.986,218.612,8.83,0.685,4
94,179,4593,341699,68,8867,17769,2180316,73.15,40222503,88.125,20,3.186,15663.986,218.612,8.83,0.685,4
94,180,4270,345969,68,8935,18543,2198859,73.15,40222503,88.125,20,3.186,15663.986,218.612,8.83,0.685,4
94,181,3481,349450,55,8990,22054,2220913,73.15,40222503,88.125,20,3.186,15663.986,218.612,8.83,0.685,4
94,182,4116,353566,62,9052,23168,2244081,73.15,40222503,88.125,20,3.186,15663.986,218.612,8.83,0.685,4
94,183,4724,358290,70,9122,22274,2266355,73.15,40222503,88.125,20,3.186,15663.986,218.612,8.83,0.685,4
94,184,4691,362981,59,9181,23522,2289877,73.15,40222503,88.125,20,3.186,15663.986,218.612,8.83,0.685,4
94,185,4493,367474,50,9231,22085,2311962,78.7,40222503,88.125,20,3.186,15663.986,218.612,8.83,0.685,4
94,186,4785,372259,67,9298,18424,2330386,78.7,40222503,88.125,20,3.186,15663.986,218.612,8.83,0.685,4
94,187,3672,375931,49,9347,19047,2349433,78.7,40222503,88.125,20,3.186,15663.986,218.612,8.83,0.685,4
94,188,3210,379141,52,9399,21915,2371348,78.7,40222503,88.125,20,3.186,15663.986,218.612,8.83,0.685,4
94,189,3808,382949,65,9464,24039,2395387,78.7,40222503,88.125,20,3.186,15663.986,218.612,8.83,0.685,4
94,190,4172,387121,67,9531,23865,2419252,78.7,40222503,88.125,20,3.186,15663.986,218.612,8.83,0.685,4
94,191,3923,391044,73,9604,20576,2439828,78.7,40222503,88.125,20,3.186,15663.986,218.612,8.83,0.685,4
94,192,3522,394566,79,9683,16954,2456782,78.7,40222503,88.125,20,3.186,15663.986,218.612,8.83,0.685,4
94,193,3214,397780,52,9735,13863,2470645,78.7,40222503,88.125,20,3.186,15663.986,218.612,8.83,0.685,4
94,194,2344,400124,55,9790,16538,2487183,78.7,40222503,88.125,20,3.186,15663.986,218.612,8.83,0.685,4
94,195,2206,402330,62,9852,20368,2507551,78.7,40222503,88.125,20,3.186,15663.986,218.612,8.83,0.685,4
94,196,3107,405437,60,9912,20663,2528214,78.7,40222503,88.125,20,3.186,15663.986,218.612,8.83,0.685,4
94,197,3921,409358,58,9970,20539,2548753,78.7,40222503,88.125,20,3.186,15663.986,218.612,8.83,0.685,4
94,198,3857,413215,51,10021,20023,2568776,78.7,40222503,88.125,20,3.186,15663.986,218.612,8.83,0.685,4
94,199,3587,416802,65,10086,20004,2588780,78.7,40222503,88.125,20,3.186,15663.986,218.612,8.83,0.685,4
94,200,3501,420303,56,10142,16686,2605466,78.7,40222503,88.125,20,3.186,15663.986,218.612,8.83,0.685,4
94,201,3221,423524,56,10198,18885,2624351,78.7,40222503,88.125,20,3.186,15663.986,218.612,8.83,0.685,4
94,202,3110,426634,56,10254,0,2624351,78.7,40222503,88.125,20,3.186,15663.986,218.612,8.83,0.685,4
94,203,4044,430678,63,10317,0,2624351,78.7,40222503,88.125,20,3.186,15663.986,218.612,8.83,0.685,4
94,204,3920,434598,49,10366,0,2624351,78.7,40222503,88.125,20,3.186,15663.986,218.612,8.83,0.685,4
95,1,325,3235,17,71,2009,32809,85.19,4937796,69.874,38.7,13.928,67335.293,126.459,3.28,0.938,0
95,2,212,3447,14,85,1975,34784,85.19,4937796,69.874,38.7,13.928,67335.293,126.459,3.28,0.938,0
95,3,402,3849,13,98,1857,36641,85.19,4937796,69.874,38.7,13.928,67335.293,126.459,3.28,0.938,0
95,4,424,4273,22,120,1849,38490,85.19,4937796,69.874,38.7,13.928,67335.293,126.459,3.28,0.938,0
95,5,331,4604,17,137,2831,41321,85.19,4937796,69.874,38.7,13.928,67335.293,126.459,3.28,0.938,0
95,6,507,5111,21,158,6117,47438,90.74,4937796,69.874,38.7,13.928,67335.293,126.459,3.28,0.938,0
95,7,253,5364,16,174,1853,49291,90.74,4937796,69.874,38.7,13.928,67335.293,126.459,3.28,0.938,0
95,8,345,5709,36,210,3728,53019,90.74,4937796,69.874,38.7,13.928,67335.293,126.459,3.28,0.938,0
95,9,515,6224,25,235,5487,58506,90.74,4937796,69.874,38.7,13.928,67335.293,126.459,3.28,0.938,0
95,10,1169,7393,28,263,6959,65465,90.74,4937796,69.874,38.7,13.928,67335.293,126.459,3.28,0.938,0
95,11,696,8089,24,287,6990,72455,90.74,4937796,69.874,38.7,13.928,67335.293,126.459,3.28,0.938,0
95,12,839,8928,33,320,5722,78177,90.74,4937796,69.874,38.7,13.928,67335.293,126.459,3.28,0.938,0
95,13,727,9655,14,334,8427,86604,90.74,4937796,69.874,38.7,13.928,67335.293,126.459,3.28,0.938,0
95,14,992,10647,31,365,4275,90879,90.74,4937796,69.874,38.7,13.928,67335.293,126.459,3.28,0.938,0
95,15,832,11479,41,406,3036,93915,90.74,4937796,69.874,38.7,13.928,67335.293,126.459,3.28,0.938,0
95,16,1068,12547,38,444,3644,97559,90.74,4937796,69.874,38.7,13.928,67335.293,126.459,3.28,0.938,0
95,17,724,13271,42,486,4355,101914,90.74,4937796,69.874,38.7,13.928,67335.293,126.459,3.28,0.938,0
95,18,709,13980,44,530,2209,104123,90.74,4937796,69.874,38.7,13.928,67335.293,126.459,3.28,0.938,0
95,19,778,14758,41,571,2313,106436,90.74,4937796,69.874,38.7,13.928,67335.293,126.459,3.28,0.938,0
95,20,493,15251,39,610,1626,108062,90.74,4937796,69.874,38.7,13.928,67335.293,126.459,3.28,0.938,0
95,21,401,15652,77,687,3757,111819,90.74,4937796,69.874,38.7,13.928,67335.293,126.459,3.28,0.938,0
95,22,388,16040,43,730,5363,117182,90.74,4937796,69.874,38.7,13.928,67335.293,126.459,3.28,0.938,0
95,23,631,16671,39,769,4871,122053,90.74,4937796,69.874,38.7,13.928,67335.293,126.459,3.28,0.938,0
95,24,936,17607,25,794,5580,127633,90.74,4937796,69.874,38.7,13.928,67335.293,126.459,3.28,0.938,0
95,25,577,18184,35,829,5632,133265,90.74,4937796,69.874,38.7,13.928,67335.293,126.459,3.28,0.938,0
95,26,377,18561,234,1063,8598,141863,90.74,4937796,69.874,38.7,13.928,67335.293,126.459,3.28,0.938,0
95,27,701,19262,24,1087,5100,146963,90.74,4937796,69.874,38.7,13.928,67335.293,126.459,3.28,0.938,0
95,28,386,19648,15,1102,6306,153269,90.74,4937796,69.874,38.7,13.928,67335.293,126.459,3.28,0.938,0
95,29,229,19877,57,1159,8159,161428,90.74,4937796,69.874,38.7,13.928,67335.293,126.459,3.28,0.938,0
95,30,376,20253,31,1190,8218,169646,90.74,4937796,69.874,38.7,13.928,67335.293,126.459,3.28,0.938,0
95,31,359,20612,42,1232,7451,177097,90.74,4937796,69.874,38.7,13.928,67335.293,126.459,3.28,0.938,0
95,32,221,20833,33,1265,12076,189173,90.74,4937796,69.874,38.7,13.928,67335.293,126.459,3.28,0.938,0
95,33,343,21176,0,1265,9799,198972,90.74,4937796,69.874,38.7,13.928,67335.293,126.459,3.28,0.938,0
95,34,330,21506,38,1303,8617,207589,90.74,4937796,69.874,38.7,13.928,67335.293,126.459,3.28,0.938,0
95,35,216,21722,16,1319,7512,215101,90.74,4937796,69.874,38.7,13.928,67335.293,126.459,3.28,0.938,0
95,36,261,21983,20,1339,7815,222916,90.74,4937796,69.874,38.7,13.928,67335.293,126.459,3.28,0.938,0
95,37,265,22248,36,1375,5703,228619,90.74,4937796,69.874,38.7,13.928,67335.293,126.459,3.28,0.938,0
95,38,137,22385,28,1403,4973,233592,90.74,4937796,69.874,38.7,13.928,67335.293,126.459,3.28,0.938,0
95,39,156,22541,26,1429,7657,241249,90.74,4937796,69.874,38.7,13.928,67335.293,126.459,3.28,0.938,0
95,40,219,22760,17,1446,6507,247756,90.74,4937796,69.874,38.7,13.928,67335.293,126.459,3.28,0.938,0
95,41,236,22996,12,1458,5374,253130,90.74,4937796,69.874,38.7,13.928,67335.293,126.459,3.28,0.938,0
95,42,139,23135,9,1467,6138,259268,90.74,4937796,69.874,38.7,13.928,67335.293,126.459,3.28,0.938,0
95,43,107,23242,21,1488,4674,263942,90.74,4937796,69.874,38.7,13.928,67335.293,126.459,3.28,0.938,0
95,44,159,23401,9,1497,6210,270152,90.74,4937796,69.874,38.7,13.928,67335.293,126.459,3.28,0.938,0
95,45,426,23827,9,1506,5699,275851,90.74,4937796,69.874,38.7,13.928,67335.293,126.459,3.28,0.938,0
95,46,129,23956,12,1518,6334,282185,90.74,4937796,69.874,38.7,13.928,67335.293,126.459,3.28,0.938,0
95,47,92,24048,15,1533,6449,288634,90.74,4937796,69.874,38.7,13.928,67335.293,126.459,3.28,0.938,0
95,48,64,24112,10,1543,3964,292598,83.33,4937796,69.874,38.7,13.928,67335.293,126.459,3.28,0.938,0
95,49,88,24200,4,1547,3278,295876,83.33,4937796,69.874,38.7,13.928,67335.293,126.459,3.28,0.938,0
95,50,51,24251,14,1561,4764,300640,83.33,4937796,69.874,38.7,13.928,67335.293,126.459,3.28,0.938,0
95,51,64,24315,10,1571,5274,305914,83.33,4937796,69.874,38.7,13.928,67335.293,126.459,3.28,0.938,0
95,52,76,24391,12,1583,5373,311287,83.33,4937796,69.874,38.7,13.928,67335.293,126.459,3.28,0.938,0
95,53,115,24506,9,1592,4276,315563,83.33,4937796,69.874,38.7,13.928,67335.293,126.459,3.28,0.938,0
95,54,76,24582,12,1604,3509,319072,83.33,4937796,69.874,38.7,13.928,67335.293,126.459,3.28,0.938,0
95,55,57,24639,2,1606,3529,322601,83.33,4937796,69.874,38.7,13.928,67335.293,126.459,3.28,0.938,0
95,56,59,24698,0,1606,3515,326116,83.33,4937796,69.874,38.7,13.928,67335.293,126.459,3.28,0.938,0
95,57,37,24735,9,1615,3437,329553,83.33,4937796,69.874,38.7,13.928,67335.293,126.459,3.28,0.938,0
95,58,68,24803,16,1631,3811,333364,83.33,4937796,69.874,38.7,13.928,67335.293,126.459,3.28,0.938,0
95,59,38,24841,8,1639,4364,337728,83.33,4937796,69.874,38.7,13.928,67335.293,126.459,3.28,0.938,0
95,60,35,24876,6,1645,3423,341151,83.33,4937796,69.874,38.7,13.928,67335.293,126.459,3.28,0.938,0
95,61,53,24929,5,1650,3474,344625,83.33,4937796,69.874,38.7,13.928,67335.293,126.459,3.28,0.938,0
95,62,61,24990,0,1650,2285,346910,83.33,4937796,69.874,38.7,13.928,67335.293,126.459,3.28,0.938,0
95,63,72,25062,0,1650,1827,348737,83.33,4937796,69.874,38.7,13.928,67335.293,126.459,3.28,0.938,0
95,64,4,25066,8,1658,2486,351223,83.33,4937796,69.874,38.7,13.928,67335.293,126.459,3.28,0.938,0
95,65,45,25111,1,1659,3099,354322,83.33,4937796,69.874,38.7,13.928,67335.293,126.459,3.28,0.938,0
95,66,31,25142,5,1664,3234,357556,72.22,4937796,69.874,38.7,13.928,67335.293,126.459,3.28,0.938,0
95,67,21,25163,6,1670,3106,360662,72.22,4937796,69.874,38.7,13.928,67335.293,126.459,3.28,0.938,0
95,68,20,25183,0,1670,2828,363490,72.22,4937796,69.874,38.7,13.928,67335.293,126.459,3.28,0.938,0
95,69,18,25201,9,1679,1960,365450,72.22,4937796,69.874,38.7,13.928,67335.293,126.459,3.28,0.938,0
95,70,6,25207,4,1683,2355,367805,72.22,4937796,69.874,38.7,13.928,67335.293,126.459,3.28,0.938,0
95,71,8,25215,8,1691,2492,370297,72.22,4937796,69.874,38.7,13.928,67335.293,126.459,3.28,0.938,0
95,72,16,25231,4,1695,4240,374537,72.22,4937796,69.874,38.7,13.928,67335.293,126.459,3.28,0.938,0
95,73,7,25238,8,1703,3009,377546,72.22,4937796,69.874,38.7,13.928,67335.293,126.459,3.28,0.938,0
95,74,12,25250,2,1705,2712,380258,72.22,4937796,69.874,38.7,13.928,67335.293,126.459,3.28,0.938,0
95,75,45,25295,0,1705,2512,382770,72.22,4937796,69.874,38.7,13.928,67335.293,126.459,3.28,0.938,0
95,76,8,25303,1,1706,1714,384484,72.22,4937796,69.874,38.7,13.928,67335.293,126.459,3.28,0.938,0
95,77,18,25321,0,1706,2112,386596,72.22,4937796,69.874,38.7,13.928,67335.293,126.459,3.28,0.938,0
95,78,13,25334,3,1709,3420,390016,72.22,4937796,69.874,38.7,13.928,67335.293,126.459,3.28,0.938,0
95,79,7,25341,1,1710,3359,393375,72.22,4937796,69.874,38.7,13.928,67335.293,126.459,3.28,0.938,0
95,80,14,25355,4,1714,3161,396536,72.22,4937796,69.874,38.7,13.928,67335.293,126.459,3.28,0.938,0
95,81,13,25368,0,1714,2724,399260,72.22,4937796,69.874,38.7,13.928,67335.293,126.459,3.28,0.938,0
95,82,6,25374,1,1715,2159,401419,72.22,4937796,69.874,38.7,13.928,67335.293,126.459,3.28,0.938,0
95,83,5,25379,0,1715,1498,402917,72.22,4937796,69.874,38.7,13.928,67335.293,126.459,3.28,0.938,0
95,84,4,25383,2,1717,2116,405033,72.22,4937796,69.874,38.7,13.928,67335.293,126.459,3.28,0.938,0
95,85,8,25391,3,1720,3252,408285,72.22,4937796,69.874,38.7,13.928,67335.293,126.459,3.28,0.938,0
95,86,5,25396,6,1726,2983,411268,72.22,4937796,69.874,38.7,13.928,67335.293,126.459,3.28,0.938,0
95,87,9,25405,1,1727,3689,414957,38.89,4937796,69.874,38.7,13.928,67335.293,126.459,3.28,0.938,0
95,88,9,25414,3,1730,4007,418964,38.89,4937796,69.874,38.7,13.928,67335.293,126.459,3.28,0.938,0
95,89,23,25437,4,1734,2724,421688,38.89,4937796,69.874,38.7,13.928,67335.293,126.459,3.28,0.938,0
95,90,2,25439,1,1735,3340,425028,38.89,4937796,69.874,38.7,13.928,67335.293,126.459,3.28,0.938,0
95,91,23,25462,0,1735,4591,429619,38.89,4937796,69.874,38.7,13.928,67335.293,126.459,3.28,0.938,0
95,92,11,25473,1,1736,4551,434170,38.89,4937796,69.874,38.7,13.928,67335.293,126.459,3.28,0.938,0
95,93,4,25477,2,1738,3792,437962,38.89,4937796,69.874,38.7,13.928,67335.293,126.459,3.28,0.938,0
95,94,12,25489,0,1738,8049,446011,38.89,4937796,69.874,38.7,13.928,67335.293,126.459,3.28,0.938,0
95,95,9,25498,2,1740,8312,454323,38.89,4937796,69.874,38.7,13.928,67335.293,126.459,3.28,0.938,0
95,96,11,25509,1,1741,7000,461323,38.89,4937796,69.874,38.7,13.928,67335.293,126.459,3.28,0.938,0
95,97,18,25527,0,1741,6529,467852,38.89,4937796,69.874,38.7,13.928,67335.293,126.459,3.28,0.938,0
95,98,4,25531,0,1741,6161,474013,38.89,4937796,69.874,38.7,13.928,67335.293,126.459,3.28,0.938,0
95,99,7,25538,2,1743,4361,478374,38.89,4937796,69.874,38.7,13.928,67335.293,126.459,3.28,0.938,0
95,100,4,25542,0,1743,3945,482319,38.89,4937796,69.874,38.7,13.928,67335.293,126.459,3.28,0.938,0
95,101,23,25565,0,1743,9330,491649,38.89,4937796,69.874,38.7,13.928,67335.293,126.459,3.28,0.938,0
95,102,24,25589,1,1744,8929,500578,38.89,4937796,69.874,38.7,13.928,67335.293,126.459,3.28,0.938,0
95,103,22,25611,2,1746,8717,509295,38.89,4937796,69.874,38.7,13.928,67335.293,126.459,3.28,0.938,0
95,104,17,25628,0,1746,7664,516959,38.89,4937796,69.874,38.7,13.928,67335.293,126.459,3.28,0.938,0
95,105,10,25638,0,1746,6400,523359,38.89,4937796,69.874,38.7,13.928,67335.293,126.459,3.28,0.938,0
95,106,32,25670,0,1746,4387,527746,38.89,4937796,69.874,38.7,13.928,67335.293,126.459,3.28,0.938,0
95,107,13,25683,2,1748,4316,532062,38.89,4937796,69.874,38.7,13.928,67335.293,126.459,3.28,0.938,0
95,108,15,25698,1,1749,9512,541574,38.89,4937796,69.874,38.7,13.928,67335.293,126.459,3.28,0.938,0
95,109,32,25730,3,1752,9243,550817,38.89,4937796,69.874,38.7,13.928,67335.293,126.459,3.28,0.938,0
95,110,20,25750,1,1753,8630,559447,38.89,4937796,69.874,38.7,13.928,67335.293,126.459,3.28,0.938,0
95,111,10,25760,0,1753,8415,567862,38.89,4937796,69.874,38.7,13.928,67335.293,126.459,3.28,0.938,0
95,112,6,25766,0,1753,6674,574536,38.89,4937796,69.874,38.7,13.928,67335.293,126.459,3.28,0.938,0
95,113,36,25802,0,1753,4619,579155,38.89,4937796,69.874,38.7,13.928,67335.293,126.459,3.28,0.938,0
95,114,17,25819,1,1754,4067,583222,38.89,4937796,69.874,38.7,13.928,67335.293,126.459,3.28,0.938,0
95,115,7,25826,9,1763,8980,592202,38.89,4937796,69.874,38.7,13.928,67335.293,126.459,3.28,0.938,0
95,116,19,25845,0,1763,8888,601090,38.89,4937796,69.874,38.7,13.928,67335.293,126.459,3.28,0.938,0
95,117,24,25869,0,1763,8016,609106,38.89,4937796,69.874,38.7,13.928,67335.293,126.459,3.28,0.938,0
95,118,12,25881,0,1763,5804,614910,38.89,4937796,69.874,38.7,13.928,67335.293,126.459,3.28,0.938,0
95,119,11,25892,0,1763,4965,619875,38.89,4937796,69.874,38.7,13.928,67335.293,126.459,3.28,0.938,0
95,120,37,25929,0,1763,4740,624615,38.89,4937796,69.874,38.7,13.928,67335.293,126.459,3.28,0.938,0
95,121,13,25942,0,1763,4383,628998,38.89,4937796,69.874,38.7,13.928,67335.293,126.459,3.28,0.938,0
95,122,85,26027,0,1763,3856,632854,38.89,4937796,69.874,38.7,13.928,67335.293,126.459,3.28,0.938,0
95,123,38,26065,0,1763,3306,636160,38.89,4937796,69.874,38.7,13.928,67335.293,126.459,3.28,0.938,0
95,124,44,26109,0,1763,3131,639291,38.89,4937796,69.874,38.7,13.928,67335.293,126.459,3.28,0.938,0
95,125,53,26162,0,1763,3041,642332,38.89,4937796,69.874,38.7,13.928,67335.293,126.459,3.28,0.938,0
95,126,46,26208,0,1763,1991,644323,38.89,4937796,69.874,38.7,13.928,67335.293,126.459,3.28,0.938,0
95,127,45,26253,0,1763,3761,648084,38.89,4937796,69.874,38.7,13.928,67335.293,126.459,3.28,0.938,0
95,128,50,26303,0,1763,4833,652917,38.89,4937796,69.874,38.7,13.928,67335.293,126.459,3.28,0.938,0
95,129,69,26372,5,1768,4980,657897,38.89,4937796,69.874,38.7,13.928,67335.293,126.459,3.28,0.938,0
95,130,98,26470,4,1772,4880,662777,59.72,4937796,69.874,38.7,13.928,67335.293,126.459,3.28,0.938,0
95,131,174,26644,0,1772,4107,666884,59.72,4937796,69.874,38.7,13.928,67335.293,126.459,3.28,0.938,0
95,132,68,26712,0,1772,3874,670758,59.72,4937796,69.874,38.7,13.928,67335.293,126.459,3.28,0.938,0
95,133,56,26768,0,1772,4026,674784,59.72,4937796,69.874,38.7,13.928,67335.293,126.459,3.28,0.938,0
95,134,33,26801,1,1773,5843,680627,59.72,4937796,69.874,38.7,13.928,67335.293,126.459,3.28,0.938,0
95,135,37,26838,1,1774,7072,687699,59.72,4937796,69.874,38.7,13.928,67335.293,126.459,3.28,0.938,0
95,136,91,26929,0,1774,11337,699036,59.72,4937796,69.874,38.7,13.928,67335.293,126.459,3.28,0.938,0
95,137,66,26995,0,1774,10653,709689,59.72,4937796,69.874,38.7,13.928,67335.293,126.459,3.28,0.938,0
95,138,196,27191,0,1774,10352,720041,59.72,4937796,69.874,38.7,13.928,67335.293,126.459,3.28,0.938,0
95,139,66,27257,0,1774,5533,725574,59.72,4937796,69.874,38.7,13.928,67335.293,126.459,3.28,0.938,0
95,140,56,27313,0,1774,4339,729913,70.83,4937796,69.874,38.7,13.928,67335.293,126.459,3.28,0.938,0
95,141,186,27499,1,1775,6192,736105,70.83,4937796,69.874,38.7,13.928,67335.293,126.459,3.28,0.938,0
95,142,48,27547,0,1775,11416,747521,70.83,4937796,69.874,38.7,13.928,67335.293,126.459,3.28,0.938,0
95,143,129,27676,1,1776,13080,760601,70.83,4937796,69.874,38.7,13.928,67335.293,126.459,3.28,0.938,0
95,144,79,27755,0,1776,6758,767359,70.83,4937796,69.874,38.7,13.928,67335.293,126.459,3.28,0.938,0
95,145,153,27908,1,1777,5438,772797,70.83,4937796,69.874,38.7,13.928,67335.293,126.459,3.28,0.938,0
95,146,61,27969,0,1777,4838,777635,70.83,4937796,69.874,38.7,13.928,67335.293,126.459,3.28,0.938,0
95,147,147,28116,0,1777,5015,782650,70.83,4937796,69.874,38.7,13.928,67335.293,126.459,3.28,0.938,0
95,148,85,28201,0,1777,7648,790298,70.83,4937796,69.874,38.7,13.928,67335.293,126.459,3.28,0.938,0
95,149,162,28363,0,1777,12274,802572,70.83,4937796,69.874,38.7,13.928,67335.293,126.459,3.28,0.938,0
95,150,90,28453,0,1777,12303,814875,70.83,4937796,69.874,38.7,13.928,67335.293,126.459,3.28,0.938,0
95,151,126,28579,0,1777,9940,824815,70.83,4937796,69.874,38.7,13.928,67335.293,126.459,3.28,0.938,0
95,152,141,28720,0,1777,5659,830474,70.83,4937796,69.874,38.7,13.928,67335.293,126.459,3.28,0.938,0
95,153,40,28760,0,1777,9340,839814,70.83,4937796,69.874,38.7,13.928,67335.293,126.459,3.28,0.938,0
95,154,51,28811,0,1777,4892,844706,70.83,4937796,69.874,38.7,13.928,67335.293,126.459,3.28,0.938,0
95,155,214,29025,0,1777,7301,852007,70.83,4937796,69.874,38.7,13.928,67335.293,126.459,3.28,0.938,0
95,156,89,29114,0,1777,12501,864508,70.83,4937796,69.874,38.7,13.928,67335.293,126.459,3.28,0.938,0
95,157,92,29206,0,1777,14064,878572,70.83,4937796,69.874,38.7,13.928,67335.293,126.459,3.28,0.938,0
95,158,97,29303,0,1777,11322,889894,70.83,4937796,69.874,38.7,13.928,67335.293,126.459,3.28,0.938,0
95,159,231,29534,0,1777,10343,900237,70.83,4937796,69.874,38.7,13.928,67335.293,126.459,3.28,0.938,0
95,160,138,29672,0,1777,6253,906490,70.83,4937796,69.874,38.7,13.928,67335.293,126.459,3.28,0.938,0
95,161,102,29774,0,1777,6678,913168,70.83,4937796,69.874,38.7,13.928,67335.293,126.459,3.28,0.938,0
95,162,306,30080,1,1778,10749,923917,70.83,4937796,69.874,38.7,13.928,67335.293,126.459,3.28,0.938,0
95,163,84,30164,3,1781,12363,936280,70.83,4937796,69.874,38.7,13.928,67335.293,126.459,3.28,0.938,0
95,164,196,30360,0,1781,13073,949353,70.83,4937796,69.874,38.7,13.928,67335.293,126.459,3.28,0.938,0
95,165,211,30571,0,1781,12230,961583,70.83,4937796,69.874,38.7,13.928,67335.293,126.459,3.28,0.938,0
95,166,159,30730,2,1783,9815,971398,70.83,4937796,69.874,38.7,13.928,67335.293,126.459,3.28,0.938,0
95,167,255,30985,1,1784,9888,981286,70.83,4937796,69.874,38.7,13.928,67335.293,126.459,3.28,0.938,0
95,168,207,31192,0,1784,8120,989406,70.83,4937796,69.874,38.7,13.928,67335.293,126.459,3.28,0.938,0
95,169,357,31549,3,1787,12241,1001647,70.83,4937796,69.874,38.7,13.928,67335.293,126.459,3.28,0.938,0
95,170,250,31799,1,1788,14663,1016310,70.83,4937796,69.874,38.7,13.928,67335.293,126.459,3.28,0.938,0
95,171,224,32023,1,1789,14506,1030816,63.43,4937796,69.874,38.7,13.928,67335.293,126.459,3.28,0.938,0
95,172,248,32271,3,1792,14380,1045196,63.43,4937796,69.874,38.7,13.928,67335.293,126.459,3.28,0.938,0
95,173,267,32538,0,1792,12138,1057334,63.43,4937796,69.874,38.7,13.928,67335.293,126.459,3.28,0.938,0
95,174,395,32933,0,1792,10031,1067365,52.31,4937796,69.874,38.7,13.928,67335.293,126.459,3.28,0.938,0
95,175,188,33121,0,1792,12583,1079948,52.31,4937796,69.874,38.7,13.928,67335.293,126.459,3.28,0.938,0
95,176,323,33444,0,1792,12671,1092619,52.31,4937796,69.874,38.7,13.928,67335.293,126.459,3.28,0.938,0
95,177,231,33675,2,1794,14356,1106975,52.31,4937796,69.874,38.7,13.928,67335.293,126.459,3.28,0.938,0
95,178,319,33994,3,1797,14538,1121513,52.31,4937796,69.874,38.7,13.928,67335.293,126.459,3.28,0.938,0
95,179,321,34315,0,1797,11808,1133321,52.31,4937796,69.874,38.7,13.928,67335.293,126.459,3.28,0.938,0
95,180,245,34560,5,1802,11878,1145199,52.31,4937796,69.874,38.7,13.928,67335.293,126.459,3.28,0.938,0
95,181,430,34990,0,1802,9866,1155065,52.31,4937796,69.874,38.7,13.928,67335.293,126.459,3.28,0.938,0
95,182,388,35378,0,1802,12673,1167738,52.31,4937796,69.874,38.7,13.928,67335.293,126.459,3.28,0.938,0
95,183,362,35740,1,1803,13247,1180985,52.31,4937796,69.874,38.7,13.928,67335.293,126.459,3.28,0.938,0
95,184,415,36155,1,1804,14524,1195509,52.31,4937796,69.874,38.7,13.928,67335.293,126.459,3.28,0.938,0
95,185,442,36597,2,1806,12673,1208182,52.31,4937796,69.874,38.7,13.928,67335.293,126.459,3.28,0.938,0
95,186,466,37063,-5,1801,13621,1221803,52.31,4937796,69.874,38.7,13.928,67335.293,126.459,3.28,0.938,0
95,187,605,37668,9,1810,11295,1233098,52.31,4937796,69.874,38.7,13.928,67335.293,126.459,3.28,0.938,0
95,188,364,38032,0,1810,12166,1245264,52.31,4937796,69.874,38.7,13.928,67335.293,126.459,3.28,0.938,0
95,189,519,38551,0,1810,11646,1256910,52.31,4937796,69.874,38.7,13.928,67335.293,126.459,3.28,0.938,0
95,190,424,38975,1,1811,14542,1271452,61.57,4937796,69.874,38.7,13.928,67335.293,126.459,3.28,0.938,0
95,191,609,39584,5,1816,15880,1287332,61.57,4937796,69.874,38.7,13.928,67335.293,126.459,3.28,0.938,0
95,192,502,40086,1,1817,16522,1303854,61.57,4937796,69.874,38.7,13.928,67335.293,126.459,3.28,0.938,0
95,193,617,40703,4,1821,15634,1319488,61.57,4937796,69.874,38.7,13.928,67335.293,126.459,3.28,0.938,0
95,194,1011,41714,0,1821,7998,1327486,61.57,4937796,69.874,38.7,13.928,67335.293,126.459,3.28,0.938,0
95,195,814,42528,5,1826,13988,1341474,61.57,4937796,69.874,38.7,13.928,67335.293,126.459,3.28,0.938,0
95,196,823,43351,1,1827,15122,1356596,61.57,4937796,69.874,38.7,13.928,67335.293,126.459,3.28,0.938,0
95,197,808,44159,3,1830,16255,1372851,61.57,4937796,69.874,38.7,13.928,67335.293,126.459,3.28,0.938,0
95,198,1084,45243,5,1835,13428,1386279,61.57,4937796,69.874,38.7,13.928,67335.293,126.459,3.28,0.938,0
95,199,1186,46429,3,1838,17758,1404037,61.57,4937796,69.874,38.7,13.928,67335.293,126.459,3.28,0.938,0
95,200,998,47427,3,1841,19040,1423077,61.57,4937796,69.874,38.7,13.928,67335.293,126.459,3.28,0.938,0
95,201,1251,48678,8,1849,16140,1439217,61.57,4937796,69.874,38.7,13.928,67335.293,126.459,3.28,0.938,0
95,202,1284,49962,3,1852,14391,1453608,61.57,4937796,69.874,38.7,13.928,67335.293,126.459,3.28,0.938,0
95,203,1031,50993,0,1852,0,1453608,61.57,4937796,69.874,38.7,13.928,67335.293,126.459,3.28,0.938,0
95,204,1263,52256,13,1865,0,1453608,61.57,4937796,69.874,38.7,13.928,67335.293,126.459,3.28,0.938,0
97,1,443,4916,3,20,9008,86793,85.19,8655541,402.606,30.6,11.733,33132.32,93.32,6.74,0.903,0
97,2,675,5591,1,21,10225,97018,85.19,8655541,402.606,30.6,11.733,33132.32,93.32,6.74,0.903,0
97,3,661,6252,13,34,10328,107346,87.96,8655541,402.606,30.6,11.733,33132.32,93.32,6.74,0.903,0
97,4,1176,7428,5,39,6355,113701,87.96,8655541,402.606,30.6,11.733,33132.32,93.32,6.74,0.903,0
97,5,590,8018,7,46,9394,123095,87.96,8655541,402.606,30.6,11.733,33132.32,93.32,6.74,0.903,0
97,6,412,8430,3,49,7498,130593,87.96,8655541,402.606,30.6,11.733,33132.32,93.32,6.74,0.903,0
97,7,474,8904,8,57,6967,137560,90.74,8655541,402.606,30.6,11.733,33132.32,93.32,6.74,0.903,0
97,8,344,9248,8,65,5878,143438,94.44,8655541,402.606,30.6,11.733,33132.32,93.32,6.74,0.903,0
97,9,156,9404,6,71,5748,149186,94.44,8655541,402.606,30.6,11.733,33132.32,93.32,6.74,0.903,0
97,10,564,9968,15,86,7346,156532,94.44,8655541,402.606,30.6,11.733,33132.32,93.32,6.74,0.903,0
97,11,440,10408,9,95,6702,163234,91.67,8655541,402.606,30.6,11.733,33132.32,93.32,6.74,0.903,0
97,12,335,10743,6,101,10598,173832,91.67,8655541,402.606,30.6,11.733,33132.32,93.32,6.74,0.903,0
97,13,402,11145,2,103,10950,184782,91.67,8655541,402.606,30.6,11.733,33132.32,93.32,6.74,0.903,0
97,14,441,11586,13,116,12678,197460,94.44,8655541,402.606,30.6,11.733,33132.32,93.32,6.74,0.903,0
97,15,460,12046,7,123,9450,206910,94.44,8655541,402.606,30.6,11.733,33132.32,93.32,6.74,0.903,0
97,16,455,12501,7,130,12789,219699,94.44,8655541,402.606,30.6,11.733,33132.32,93.32,6.74,0.903,0
97,17,257,12758,12,142,11595,231294,91.67,8655541,402.606,30.6,11.733,33132.32,93.32,6.74,0.903,0
97,18,224,12982,9,151,10606,241900,91.67,8655541,402.606,30.6,11.733,33132.32,93.32,6.74,0.903,0
97,19,283,13265,13,164,11479,253379,87.96,8655541,402.606,30.6,11.733,33132.32,93.32,6.74,0.903,0
97,20,226,13491,8,172,15367,268746,87.96,8655541,402.606,30.6,11.733,33132.32,93.32,6.74,0.903,0
97,21,222,13713,5,177,13612,282358,87.96,8655541,402.606,30.6,11.733,33132.32,93.32,6.74,0.903,0
97,22,229,13942,7,184,13293,295651,87.96,8655541,402.606,30.6,11.733,33132.32,93.32,6.74,0.903,0
97,23,650,14592,7,191,14183,309834,87.96,8655541,402.606,30.6,11.733,33132.32,93.32,6.74,0.903,0
97,24,290,14882,2,193,12627,322461,87.96,8655541,402.606,30.6,11.733,33132.32,93.32,6.74,0.903,0
97,25,176,15058,1,194,9077,331538,87.96,8655541,402.606,30.6,11.733,33132.32,93.32,6.74,0.903,0
97,26,240,15298,5,199,8464,340002,84.26,8655541,402.606,30.6,11.733,33132.32,93.32,6.74,0.903,0
97,27,100,15398,0,199,11406,351408,84.26,8655541,402.606,30.6,11.733,33132.32,93.32,6.74,0.903,0
97,28,68,15466,3,202,10640,362048,87.04,8655541,402.606,30.6,11.733,33132.32,93.32,6.74,0.903,0
97,29,123,15589,6,208,8996,371044,87.04,8655541,402.606,30.6,11.733,33132.32,93.32,6.74,0.903,0
97,30,245,15834,7,215,9930,380974,84.26,8655541,402.606,30.6,11.733,33132.32,93.32,6.74,0.903,0
97,31,112,15946,7,222,11052,392026,84.26,8655541,402.606,30.6,11.733,33132.32,93.32,6.74,0.903,0
97,32,155,16101,3,225,5568,397594,84.26,8655541,402.606,30.6,11.733,33132.32,93.32,6.74,0.903,0
97,33,84,16185,4,229,8029,405623,80.56,8655541,402.606,30.6,11.733,33132.32,93.32,6.74,0.903,0
97,34,23,16208,3,232,9258,414881,80.56,8655541,402.606,30.6,11.733,33132.32,93.32,6.74,0.903,0
97,35,38,16246,3,235,8957,423838,77.78,8655541,402.606,30.6,11.733,33132.32,93.32,6.74,0.903,0
97,36,43,16289,3,238,9467,433305,77.78,8655541,402.606,30.6,11.733,33132.32,93.32,6.74,0.903,0
97,37,21,16310,1,239,10119,443424,77.78,8655541,402.606,30.6,11.733,33132.32,93.32,6.74,0.903,0
97,38,71,16381,1,240,8157,451581,77.78,8655541,402.606,30.6,11.733,33132.32,93.32,6.74,0.903,0
97,39,55,16436,5,245,3868,455449,77.78,8655541,402.606,30.6,11.733,33132.32,93.32,6.74,0.903,0
97,40,18,16454,2,247,4944,460393,77.78,8655541,402.606,30.6,11.733,33132.32,93.32,6.74,0.903,0
97,41,23,16477,5,252,9216,469609,77.78,8655541,402.606,30.6,11.733,33132.32,93.32,6.74,0.903,0
97,42,29,16506,6,258,7538,477147,77.78,8655541,402.606,30.6,11.733,33132.32,93.32,6.74,0.903,0
97,43,23,16529,2,260,8272,485419,77.78,8655541,402.606,30.6,11.733,33132.32,93.32,6.74,0.903,0
97,44,19,16548,4,264,8416,493835,77.78,8655541,402.606,30.6,11.733,33132.32,93.32,6.74,0.903,0
97,45,31,16579,1,265,5696,499531,77.78,8655541,402.606,30.6,11.733,33132.32,93.32,6.74,0.903,0
97,46,10,16589,1,266,1502,501033,77.78,8655541,402.606,30.6,11.733,33132.32,93.32,6.74,0.903,0
97,47,19,16608,2,268,4633,505666,77.78,8655541,402.606,30.6,11.733,33132.32,93.32,6.74,0.903,0
97,48,9,16617,4,272,7692,513358,77.78,8655541,402.606,30.6,11.733,33132.32,93.32,6.74,0.903,0
97,49,4,16621,0,272,7142,520500,77.78,8655541,402.606,30.6,11.733,33132.32,93.32,6.74,0.903,0
97,50,29,16650,5,277,5968,526468,75,8655541,402.606,30.6,11.733,33132.32,93.32,6.74,0.903,0
97,51,20,16670,2,279,6164,532632,75,8655541,402.606,30.6,11.733,33132.32,93.32,6.74,0.903,0
97,52,20,16690,0,279,4995,537627,75,8655541,402.606,30.6,11.733,33132.32,93.32,6.74,0.903,0
97,53,0,16690,0,279,718,538345,75,8655541,402.606,30.6,11.733,33132.32,93.32,6.74,0.903,0
97,54,0,16690,0,279,3808,542153,75,8655541,402.606,30.6,11.733,33132.32,93.32,6.74,0.903,0
97,55,30,16720,1,280,5333,547486,75,8655541,402.606,30.6,11.733,33132.32,93.32,6.74,0.903,0
97,56,14,16734,1,281,6819,554305,75,8655541,402.606,30.6,11.733,33132.32,93.32,6.74,0.903,0
97,57,23,16757,0,281,6728,561033,75,8655541,402.606,30.6,11.733,33132.32,93.32,6.74,0.903,0
97,58,36,16793,0,281,5352,566385,75,8655541,402.606,30.6,11.733,33132.32,93.32,6.74,0.903,0
97,59,79,16872,3,284,1863,568248,75,8655541,402.606,30.6,11.733,33132.32,93.32,6.74,0.903,0
97,60,115,16987,0,284,1059,569307,75,8655541,402.606,30.6,11.733,33132.32,93.32,6.74,0.903,0
97,61,25,17012,0,284,5640,574947,75,8655541,402.606,30.6,11.733,33132.32,93.32,6.74,0.903,0
97,62,59,17071,1,285,8155,583102,75,8655541,402.606,30.6,11.733,33132.32,93.32,6.74,0.903,0
97,63,148,17219,2,287,11757,594859,75,8655541,402.606,30.6,11.733,33132.32,93.32,6.74,0.903,0
97,64,123,17342,3,290,13209,608068,75,8655541,402.606,30.6,11.733,33132.32,93.32,6.74,0.903,0
97,65,87,17429,1,291,14899,622967,75,8655541,402.606,30.6,11.733,33132.32,93.32,6.74,0.903,0
97,66,133,17562,0,291,16474,639441,75,8655541,402.606,30.6,11.733,33132.32,93.32,6.74,0.903,0
97,67,144,17706,1,292,11537,650978,75,8655541,402.606,30.6,11.733,33132.32,93.32,6.74,0.903,0
97,68,77,17783,5,297,15098,666076,75,8655541,402.606,30.6,11.733,33132.32,93.32,6.74,0.903,0
97,69,132,17915,1,298,14644,680720,75,8655541,402.606,30.6,11.733,33132.32,93.32,6.74,0.903,0
97,70,174,18089,0,298,15064,695784,75,8655541,402.606,30.6,11.733,33132.32,93.32,6.74,0.903,0
97,71,179,18268,1,299,18484,714268,75,8655541,402.606,30.6,11.733,33132.32,93.32,6.74,0.903,0
97,72,87,18355,0,299,15809,730077,75,8655541,402.606,30.6,11.733,33132.32,93.32,6.74,0.903,0
97,73,346,18701,1,300,13132,743209,75,8655541,402.606,30.6,11.733,33132.32,93.32,6.74,0.903,0
97,74,175,18876,0,300,6987,750196,75,8655541,402.606,30.6,11.733,33132.32,93.32,6.74,0.903,0
97,75,132,19008,0,300,8840,759036,75,8655541,402.606,30.6,11.733,33132.32,93.32,6.74,0.903,0
97,76,113,19121,2,302,14436,773472,75,8655541,402.606,30.6,11.733,33132.32,93.32,6.74,0.903,0
97,77,217,19338,0,302,16239,789711,75,8655541,402.606,30.6,11.733,33132.32,93.32,6.74,0.903,0
97,78,299,19637,1,303,16024,805735,75,8655541,402.606,30.6,11.733,33132.32,93.32,6.74,0.903,0
97,79,257,19894,0,303,17392,823127,75,8655541,402.606,30.6,11.733,33132.32,93.32,6.74,0.903,0
97,80,142,20036,0,303,12787,835914,75,8655541,402.606,30.6,11.733,33132.32,93.32,6.74,0.903,0
97,81,303,20339,1,304,6010,841924,75,8655541,402.606,30.6,11.733,33132.32,93.32,6.74,0.903,0
97,82,294,20633,1,305,9152,851076,75,8655541,402.606,30.6,11.733,33132.32,93.32,6.74,0.903,0
97,83,145,20778,1,306,14009,865085,75,8655541,402.606,30.6,11.733,33132.32,93.32,6.74,0.903,0
97,84,304,21082,1,307,19847,884932,75,8655541,402.606,30.6,11.733,33132.32,93.32,6.74,0.903,0
97,85,430,21512,1,308,18393,903325,75,8655541,402.606,30.6,11.733,33132.32,93.32,6.74,0.903,0
97,86,532,22044,0,308,18666,921991,75,8655541,402.606,30.6,11.733,33132.32,93.32,6.74,0.903,0
97,87,356,22400,1,309,16531,938522,75,8655541,402.606,30.6,11.733,33132.32,93.32,6.74,0.903,0
97,88,400,22800,5,314,10489,949011,75,8655541,402.606,30.6,11.733,33132.32,93.32,6.74,0.903,0
97,89,621,23421,3,317,10389,959400,75,8655541,402.606,30.6,11.733,33132.32,93.32,6.74,0.903,0
97,90,334,23755,1,318,21017,980417,75,8655541,402.606,30.6,11.733,33132.32,93.32,6.74,0.903,0
97,91,686,24441,1,319,20840,1001257,69.44,8655541,402.606,30.6,11.733,33132.32,93.32,6.74,0.903,0
97,92,803,25244,1,320,21460,1022717,69.44,8655541,402.606,30.6,11.733,33132.32,93.32,6.74,0.903,0
97,93,1013,26257,2,322,25041,1047758,69.44,8655541,402.606,30.6,11.733,33132.32,93.32,6.74,0.903,0
97,94,1285,27542,3,325,20951,1068709,69.44,8655541,402.606,30.6,11.733,33132.32,93.32,6.74,0.903,0
97,95,513,28055,1,326,17308,1086017,69.44,8655541,402.606,30.6,11.733,33132.32,93.32,6.74,0.903,0
97,96,1115,29170,4,330,21112,1107129,69.44,8655541,402.606,30.6,11.733,33132.32,93.32,6.74,0.903,0
97,97,788,29958,1,331,25601,1132730,72.22,8655541,402.606,30.6,11.733,33132.32,93.32,6.74,0.903,0
97,98,1228,31186,7,338,28634,1161364,72.22,8655541,402.606,30.6,11.733,33132.32,93.32,6.74,0.903,0
97,99,1036,32222,4,342,29420,1190784,72.22,8655541,402.606,30.6,11.733,33132.32,93.32,6.74,0.903,0
97,100,1335,33557,2,344,29988,1220772,72.22,8655541,402.606,30.6,11.733,33132.32,93.32,6.74,0.903,0
97,101,1268,34825,4,348,25829,1246601,72.22,8655541,402.606,30.6,11.733,33132.32,93.32,6.74,0.903,0
97,102,1441,36266,3,351,20468,1267069,72.22,8655541,402.606,30.6,11.733,33132.32,93.32,6.74,0.903,0
97,103,1197,37463,3,354,21762,1288831,72.22,8655541,402.606,30.6,11.733,33132.32,93.32,6.74,0.903,0
97,104,1207,38670,8,362,29247,1318078,68.52,8655541,402.606,30.6,11.733,33132.32,93.32,6.74,0.903,0
97,105,1962,40632,3,365,31750,1349828,68.52,8655541,402.606,30.6,11.733,33132.32,93.32,6.74,0.903,0
97,106,1728,42360,6,371,30692,1380520,68.52,8655541,402.606,30.6,11.733,33132.32,93.32,6.74,0.903,0
97,107,2354,44714,9,380,31078,1411598,68.52,8655541,402.606,30.6,11.733,33132.32,93.32,6.74,0.903,0
97,108,1345,46059,4,384,25732,1437330,68.52,8655541,402.606,30.6,11.733,33132.32,93.32,6.74,0.903,0
97,109,1400,47459,8,392,20457,1457787,54.63,8655541,402.606,30.6,11.733,33132.32,93.32,6.74,0.903,0
97,110,1906,49365,9,401,19846,1477633,54.63,8655541,402.606,30.6,11.733,33132.32,93.32,6.74,0.903,0
97,111,924,50289,8,409,27608,1505241,54.63,8655541,402.606,30.6,11.733,33132.32,93.32,6.74,0.903,0
97,112,1387,51676,6,415,30177,1535418,54.63,8655541,402.606,30.6,11.733,33132.32,93.32,6.74,0.903,0
97,113,2366,54042,10,425,28807,1564225,54.63,8655541,402.606,30.6,11.733,33132.32,93.32,6.74,0.903,0
97,114,2043,56085,5,430,32536,1596761,54.63,8655541,402.606,30.6,11.733,33132.32,93.32,6.74,0.903,0
97,115,1897,57982,12,442,24400,1621161,54.63,8655541,402.606,30.6,11.733,33132.32,93.32,6.74,0.903,0
97,116,1493,59475,6,448,15486,1636647,54.63,8655541,402.606,30.6,11.733,33132.32,93.32,6.74,0.903,0
97,117,1203,60678,9,457,12204,1648851,54.63,8655541,402.606,30.6,11.733,33132.32,93.32,6.74,0.903,0
97,118,1278,61956,13,470,28245,1677096,52.78,8655541,402.606,30.6,11.733,33132.32,93.32,6.74,0.903,0
97,119,2502,64458,4,474,26639,1703735,52.78,8655541,402.606,30.6,11.733,33132.32,93.32,6.74,0.903,0
97,120,2097,66555,12,486,26228,1729963,52.78,8655541,402.606,30.6,11.733,33132.32,93.32,6.74,0.903,0
97,121,2001,68556,5,491,21962,1751925,52.78,8655541,402.606,30.6,11.733,33132.32,93.32,6.74,0.903,0
97,122,1823,70379,12,503,22898,1774823,52.78,8655541,402.606,30.6,11.733,33132.32,93.32,6.74,0.903,0
97,123,591,70970,9,512,7790,1782613,52.78,8655541,402.606,30.6,11.733,33132.32,93.32,6.74,0.903,0
97,124,1313,72283,15,527,10087,1792700,52.78,8655541,402.606,30.6,11.733,33132.32,93.32,6.74,0.903,0
97,125,742,73025,9,536,23469,1816169,52.78,8655541,402.606,30.6,11.733,33132.32,93.32,6.74,0.903,0
97,126,1878,74903,10,546,26099,1842268,52.78,8655541,402.606,30.6,11.733,33132.32,93.32,6.74,0.903,0
97,127,1739,76642,15,561,25792,1868060,52.78,8655541,402.606,30.6,11.733,33132.32,93.32,6.74,0.903,0
97,128,1682,78324,4,565,28768,1896828,52.78,8655541,402.606,30.6,11.733,33132.32,93.32,6.74,0.903,0
97,129,1730,80054,11,576,25310,1922138,39.81,8655541,402.606,30.6,11.733,33132.32,93.32,6.74,0.903,0
97,130,937,80991,5,581,8583,1930721,39.81,8655541,402.606,30.6,11.733,33132.32,93.32,6.74,0.903,0
97,131,1474,82465,13,594,12163,1942884,39.81,8655541,402.606,30.6,11.733,33132.32,93.32,6.74,0.903,0
97,132,537,83002,6,600,24368,1967252,39.81,8655541,402.606,30.6,11.733,33132.32,93.32,6.74,0.903,0
97,133,2220,85222,13,613,27667,1994919,39.81,8655541,402.606,30.6,11.733,33132.32,93.32,6.74,0.903,0
97,134,1737,86959,9,622,26234,2021153,39.81,8655541,402.606,30.6,11.733,33132.32,93.32,6.74,0.903,0
97,135,1595,88554,17,639,28891,2050044,39.81,8655541,402.606,30.6,11.733,33132.32,93.32,6.74,0.903,0
97,136,1268,89822,12,651,20915,2070959,39.81,8655541,402.606,30.6,11.733,33132.32,93.32,6.74,0.903,0
97,137,1258,91080,14,665,9396,2080355,39.81,8655541,402.606,30.6,11.733,33132.32,93.32,6.74,0.903,0
97,138,1263,92343,9,674,12386,2092741,34.26,8655541,402.606,30.6,11.733,33132.32,93.32,6.74,0.903,0
97,139,337,92680,11,685,26061,2118802,34.26,8655541,402.606,30.6,11.733,33132.32,93.32,6.74,0.903,0
97,140,2449,95129,7,692,27899,2146701,34.26,8655541,402.606,30.6,11.733,33132.32,93.32,6.74,0.903,0
97,141,1280,96409,16,708,28401,2175102,34.26,8655541,402.606,30.6,11.733,33132.32,93.32,6.74,0.903,0
97,142,1560,97969,71,779,28854,2203956,34.26,8655541,402.606,30.6,11.733,33132.32,93.32,6.74,0.903,0
97,143,1630,99599,16,795,27217,2231173,34.26,8655541,402.606,30.6,11.733,33132.32,93.32,6.74,0.903,0
97,144,1117,100716,14,809,11059,2242232,34.26,8655541,402.606,30.6,11.733,33132.32,93.32,6.74,0.903,0
97,145,1364,102080,10,819,13298,2255530,34.26,8655541,402.606,30.6,11.733,33132.32,93.32,6.74,0.903,0
97,146,1071,103151,15,834,30139,2285669,34.26,8655541,402.606,30.6,11.733,33132.32,93.32,6.74,0.903,0
97,147,1912,105063,13,847,34052,2319721,34.26,8655541,402.606,30.6,11.733,33132.32,93.32,6.74,0.903,0
97,148,2015,107078,12,859,34254,2353975,34.26,8655541,402.606,30.6,11.733,33132.32,93.32,6.74,0.903,0
97,149,1886,108964,16,875,36428,2390403,34.26,8655541,402.606,30.6,11.733,33132.32,93.32,6.74,0.903,0
97,150,1439,110403,9,884,23288,2413691,34.26,8655541,402.606,30.6,11.733,33132.32,93.32,6.74,0.903,0
97,151,1597,112000,10,894,10708,2424399,34.26,8655541,402.606,30.6,11.733,33132.32,93.32,6.74,0.903,0
97,152,1623,113623,12,906,13553,2437952,34.26,8655541,402.606,30.6,11.733,33132.32,93.32,6.74,0.903,0
97,153,397,114020,13,919,31969,2469921,34.26,8655541,402.606,30.6,11.733,33132.32,93.32,6.74,0.903,0
97,154,3010,117030,20,939,28466,2498387,34.26,8655541,402.606,30.6,11.733,33132.32,93.32,6.74,0.903,0
97,155,2235,119265,18,957,35981,2534368,34.26,8655541,402.606,30.6,11.733,33132.32,93.32,6.74,0.903,0
97,156,3274,122539,12,969,35227,2569595,34.26,8655541,402.606,30.6,11.733,33132.32,93.32,6.74,0.903,0
97,157,2721,125260,16,985,31548,2601143,34.26,8655541,402.606,30.6,11.733,33132.32,93.32,6.74,0.903,0
97,158,1159,126419,8,993,15945,2617088,34.26,8655541,402.606,30.6,11.733,33132.32,93.32,6.74,0.903,0
97,159,2754,129173,14,1007,19671,2636759,34.26,8655541,402.606,30.6,11.733,33132.32,93.32,6.74,0.903,0
97,160,1471,130644,12,1019,41454,2678213,34.26,8655541,402.606,30.6,11.733,33132.32,93.32,6.74,0.903,0
97,161,4399,135043,7,1026,45675,2723888,34.26,8655541,402.606,30.6,11.733,33132.32,93.32,6.74,0.903,0
97,162,3676,138719,14,1040,46407,2770295,34.26,8655541,402.606,30.6,11.733,33132.32,93.32,6.74,0.903,0
97,163,3863,142582,14,1054,48750,2819045,34.26,8655541,402.606,30.6,11.733,33132.32,93.32,6.74,0.903,0
97,164,3960,146542,23,1077,43704,2862749,34.26,8655541,402.606,30.6,11.733,33132.32,93.32,6.74,0.903,0
97,165,2022,148564,13,1090,30572,2893321,34.26,8655541,402.606,30.6,11.733,33132.32,93.32,6.74,0.903,0
97,166,4653,153217,13,1103,34979,2928300,34.26,8655541,402.606,30.6,11.733,33132.32,93.32,6.74,0.903,0
97,167,3379,156596,16,1119,47549,2975849,34.26,8655541,402.606,30.6,11.733,33132.32,93.32,6.74,0.903,0
97,168,3772,160368,17,1136,57765,3033614,34.26,8655541,402.606,30.6,11.733,33132.32,93.32,6.74,0.903,0
97,169,6426,166794,11,1147,54229,3087843,34.26,8655541,402.606,30.6,11.733,33132.32,93.32,6.74,0.903,0
97,170,4974,171768,18,1165,58809,3146652,34.26,8655541,402.606,30.6,11.733,33132.32,93.32,6.74,0.903,0
97,171,5165,176933,4,1169,54471,3201123,81.48,8655541,402.606,30.6,11.733,33132.32,93.32,6.74,0.903,0
97,172,2138,179071,27,1196,42833,3243956,81.48,8655541,402.606,30.6,11.733,33132.32,93.32,6.74,0.903,0
97,173,4531,183602,30,1226,24494,3268450,81.48,8655541,402.606,30.6,11.733,33132.32,93.32,6.74,0.903,0
97,174,4825,188427,30,1256,34603,3303053,81.48,8655541,402.606,30.6,11.733,33132.32,93.32,6.74,0.903,0
97,175,4152,192579,17,1273,63062,3366115,81.48,8655541,402.606,30.6,11.733,33132.32,93.32,6.74,0.903,0
97,176,795,193374,12,1285,59352,3425467,81.48,8655541,402.606,30.6,11.733,33132.32,93.32,6.74,0.903,0
97,177,11316,204690,40,1325,67984,3493451,81.48,8655541,402.606,30.6,11.733,33132.32,93.32,6.74,0.903,0
97,178,9768,214458,53,1378,62716,3556167,85.19,8655541,402.606,30.6,11.733,33132.32,93.32,6.74,0.903,0
97,179,815,215273,27,1405,46422,3602589,85.19,8655541,402.606,30.6,11.733,33132.32,93.32,6.74,0.903,0
97,180,11827,227100,36,1441,25280,3627869,85.19,8655541,402.606,30.6,11.733,33132.32,93.32,6.74,0.903,0
97,181,3926,231026,25,1466,8220,3636089,85.19,8655541,402.606,30.6,11.733,33132.32,93.32,6.74,0.903,0
97,182,2239,233265,41,1507,34620,3670709,85.19,8655541,402.606,30.6,11.733,33132.32,93.32,6.74,0.903,0
97,183,3661,236926,21,1528,70152,3740861,85.19,8655541,402.606,30.6,11.733,33132.32,93.32,6.74,0.903,0
97,184,11207,248133,43,1571,65943,3806804,85.19,8655541,402.606,30.6,11.733,33132.32,93.32,6.74,0.903,0
97,185,7638,255771,51,1622,62163,3868967,85.19,8655541,402.606,30.6,11.733,33132.32,93.32,6.74,0.903,0
97,186,3131,258902,11,1633,25145,3894112,85.19,8655541,402.606,30.6,11.733,33132.32,93.32,6.74,0.903,0
97,187,5955,264857,49,1682,26458,3920570,85.19,8655541,402.606,30.6,11.733,33132.32,93.32,6.74,0.903,0
97,188,3318,268175,37,1719,52204,3972774,85.19,8655541,402.606,30.6,11.733,33132.32,93.32,6.74,0.903,0
97,189,4134,272309,38,1757,47036,4019810,85.19,8655541,402.606,30.6,11.733,33132.32,93.32,6.74,0.903,0
97,190,4717,277026,40,1797,49218,4069028,85.19,8655541,402.606,30.6,11.733,33132.32,93.32,6.74,0.903,0
97,191,4455,281481,27,1824,49798,4118826,85.19,8655541,402.606,30.6,11.733,33132.32,93.32,6.74,0.903,0
97,192,4912,286393,40,1864,37334,4156160,85.19,8655541,402.606,30.6,11.733,33132.32,93.32,6.74,0.903,0
97,193,1465,287858,22,1886,13459,4169619,85.19,8655541,402.606,30.6,11.733,33132.32,93.32,6.74,0.903,0
97,194,2145,290003,55,1941,23092,4192711,85.19,8655541,402.606,30.6,11.733,33132.32,93.32,6.74,0.903,0
97,195,1825,291828,42,1983,47305,4240016,85.19,8655541,402.606,30.6,11.733,33132.32,93.32,6.74,0.903,0
97,196,3209,295037,38,2021,45266,4285282,85.19,8655541,402.606,30.6,11.733,33132.32,93.32,6.74,0.903,0
97,197,2237,297274,34,2055,0,4285282,85.19,8655541,402.606,30.6,11.733,33132.32,93.32,6.74,0.903,0
97,198,1979,299253,44,2099,0,4285282,85.19,8655541,402.606,30.6,11.733,33132.32,93.32,6.74,0.903,0
97,199,948,300201,28,2127,0,4285282,85.19,8655541,402.606,30.6,11.733,33132.32,93.32,6.74,0.903,0
97,200,1695,301896,14,2141,0,4285282,85.19,8655541,402.606,30.6,11.733,33132.32,93.32,6.74,0.903,0
97,201,936,302832,49,2190,0,4285282,85.19,8655541,402.606,30.6,11.733,33132.32,93.32,6.74,0.903,0
97,202,1014,303846,19,2209,0,4285282,85.19,8655541,402.606,30.6,11.733,33132.32,93.32,6.74,0.903,0
97,203,1030,304876,54,2263,0,4285282,85.19,8655541,402.606,30.6,11.733,33132.32,93.32,6.74,0.903,0
97,204,1627,306503,15,2278,0,4285282,85.19,8655541,402.606,30.6,11.733,33132.32,93.32,6.74,0.903,0
98,1,4053,105792,839,12430,0,0,91.67,60461828,205.859,47.9,23.021,35220.084,113.151,4.78,0.88,4
98,2,4782,110574,727,13157,0,0,91.67,60461828,205.859,47.9,23.021,35220.084,113.151,4.78,0.88,4
98,3,4668,115242,760,13917,0,0,91.67,60461828,205.859,47.9,23.021,35220.084,113.151,4.78,0.88,4
98,4,4585,119827,764,14681,0,0,91.67,60461828,205.859,47.9,23.021,35220.084,113.151,4.78,0.88,4
98,5,4805,124632,681,15362,0,0,91.67,60461828,205.859,47.9,23.021,35220.084,113.151,4.78,0.88,4
98,6,4316,128948,527,15889,0,0,91.67,60461828,205.859,47.9,23.021,35220.084,113.151,4.78,0.88,4
98,7,3599,132547,636,16525,0,0,91.67,60461828,205.859,47.9,23.021,35220.084,113.151,4.78,0.88,4
98,8,3039,135586,604,17129,0,0,91.67,60461828,205.859,47.9,23.021,35220.084,113.151,4.78,0.88,4
98,9,3836,139422,540,17669,0,0,91.67,60461828,205.859,47.9,23.021,35220.084,113.151,4.78,0.88,4
98,10,4204,143626,612,18281,0,0,87.96,60461828,205.859,47.9,23.021,35220.084,113.151,4.78,0.88,4
98,11,3951,147577,570,18851,0,0,87.96,60461828,205.859,47.9,23.021,35220.084,113.151,4.78,0.88,4
98,12,4694,152271,619,19470,0,0,93.52,60461828,205.859,47.9,23.021,35220.084,113.151,4.78,0.88,4
98,13,4092,156363,431,19901,0,0,93.52,60461828,205.859,47.9,23.021,35220.084,113.151,4.78,0.88,4
98,14,3153,159516,564,20465,0,0,93.52,60461828,205.859,47.9,23.021,35220.084,113.151,4.78,0.88,4
98,15,2972,162488,604,21069,0,0,93.52,60461828,205.859,47.9,23.021,35220.084,113.151,4.78,0.88,4
98,16,2667,165155,578,21647,0,0,93.52,60461828,205.859,47.9,23.021,35220.084,113.151,4.78,0.88,4
98,17,3786,168941,525,22172,0,0,93.52,60461828,205.859,47.9,23.021,35220.084,113.151,4.78,0.88,4
98,18,3493,172434,575,22747,0,0,93.52,60461828,205.859,47.9,23.021,35220.084,113.151,4.78,0.88,4
98,19,3491,175925,480,23227,0,935310,93.52,60461828,205.859,47.9,23.021,35220.084,113.151,4.78,0.88,4
98,20,3047,178972,433,23660,7841,943151,93.52,60461828,205.859,47.9,23.021,35220.084,113.151,4.78,0.88,4
98,21,2256,181228,454,24114,28095,971246,93.52,60461828,205.859,47.9,23.021,35220.084,113.151,4.78,0.88,4
98,22,2729,183957,534,24648,44248,1015494,93.52,60461828,205.859,47.9,23.021,35220.084,113.151,4.78,0.88,4
98,23,3370,187327,437,25085,37083,1052577,93.52,60461828,205.859,47.9,23.021,35220.084,113.151,4.78,0.88,4
98,24,2646,189973,464,25549,95273,1147850,93.52,60461828,205.859,47.9,23.021,35220.084,113.151,4.78,0.88,4
98,25,3021,192994,420,25969,38676,1186526,93.52,60461828,205.859,47.9,23.021,35220.084,113.151,4.78,0.88,4
98,26,2357,195351,415,26384,24113,1210639,93.52,60461828,205.859,47.9,23.021,35220.084,113.151,4.78,0.88,4
98,27,2324,197675,260,26644,26678,1237317,93.52,60461828,205.859,47.9,23.021,35220.084,113.151,4.78,0.88,4
98,28,1739,199414,333,26977,37554,1274871,93.52,60461828,205.859,47.9,23.021,35220.084,113.151,4.78,0.88,4
98,29,2091,201505,382,27359,38589,1313460,93.52,60461828,205.859,47.9,23.021,35220.084,113.151,4.78,0.88,4
98,30,2086,203591,323,27682,41441,1354901,93.52,60461828,205.859,47.9,23.021,35220.084,113.151,4.78,0.88,4
98,31,1872,205463,285,27967,43732,1398633,93.52,60461828,205.859,47.9,23.021,35220.084,113.151,4.78,0.88,4
98,32,1965,207428,269,28236,31231,1429864,93.52,60461828,205.859,47.9,23.021,35220.084,113.151,4.78,0.88,4
98,33,1900,209328,474,28710,27047,1456911,93.52,60461828,205.859,47.9,23.021,35220.084,113.151,4.78,0.88,4
98,34,1389,210717,174,28884,22999,1479910,62.96,60461828,205.859,47.9,23.021,35220.084,113.151,4.78,0.88,4
98,35,1221,211938,195,29079,32211,1512121,62.96,60461828,205.859,47.9,23.021,35220.084,113.151,4.78,0.88,4
98,36,1075,213013,236,29315,37771,1549892,62.96,60461828,205.859,47.9,23.021,35220.084,113.151,4.78,0.88,4
98,37,1444,214457,369,29684,13665,1563557,62.96,60461828,205.859,47.9,23.021,35220.084,113.151,4.78,0.88,4
98,38,1401,215858,274,29958,45428,1608985,62.96,60461828,205.859,47.9,23.021,35220.084,113.151,4.78,0.88,4
98,39,1327,217185,243,30201,36091,1645076,62.96,60461828,205.859,47.9,23.021,35220.084,113.151,4.78,0.88,4
98,40,1083,218268,194,30395,31384,1676460,62.96,60461828,205.859,47.9,23.021,35220.084,113.151,4.78,0.88,4
98,41,802,219070,165,30560,25823,1702283,62.96,60461828,205.859,47.9,23.021,35220.084,113.151,4.78,0.88,4
98,42,744,219814,179,30739,39620,1741903,62.96,60461828,205.859,47.9,23.021,35220.084,113.151,4.78,0.88,4
98,43,1402,221216,172,30911,37049,1778952,62.96,60461828,205.859,47.9,23.021,35220.084,113.151,4.78,0.88,4
98,44,888,222104,195,31106,41131,1820083,62.96,60461828,205.859,47.9,23.021,35220.084,113.151,4.78,0.88,4
98,45,992,223096,262,31368,39027,1859110,62.96,60461828,205.859,47.9,23.021,35220.084,113.151,4.78,0.88,4
98,46,789,223885,242,31610,40657,1899767,66.67,60461828,205.859,47.9,23.021,35220.084,113.151,4.78,0.88,4
98,47,875,224760,153,31763,33505,1933272,66.67,60461828,205.859,47.9,23.021,35220.084,113.151,4.78,0.88,4
98,48,675,225435,145,31908,26101,1959373,63.89,60461828,205.859,47.9,23.021,35220.084,113.151,4.78,0.88,4
98,49,451,225886,99,32007,40226,1999599,63.89,60461828,205.859,47.9,23.021,35220.084,113.151,4.78,0.88,4
98,50,813,226699,162,32169,38617,2038216,63.89,60461828,205.859,47.9,23.021,35220.084,113.151,4.78,0.88,4
98,51,665,227364,161,32330,40644,2078860,63.89,60461828,205.859,47.9,23.021,35220.084,113.151,4.78,0.88,4
98,52,642,228006,156,32486,42987,2121847,63.89,60461828,205.859,47.9,23.021,35220.084,113.151,4.78,0.88,4
98,53,652,228658,130,32616,42579,2164426,63.89,60461828,205.859,47.9,23.021,35220.084,113.151,4.78,0.88,4
98,54,669,229327,119,32735,34206,2198632,63.89,60461828,205.859,47.9,23.021,35220.084,113.151,4.78,0.88,4
98,55,531,229858,50,32785,20676,2219308,63.89,60461828,205.859,47.9,23.021,35220.084,113.151,4.78,0.88,4
98,56,300,230158,92,32877,33944,2253252,63.89,60461828,205.859,47.9,23.021,35220.084,113.151,4.78,0.88,4
98,57,397,230555,78,32955,37299,2290551,63.89,60461828,205.859,47.9,23.021,35220.084,113.151,4.78,0.88,4
98,58,584,231139,117,33072,39838,2330389,63.89,60461828,205.859,47.9,23.021,35220.084,113.151,4.78,0.88,4
98,59,593,231732,70,33142,38233,2368622,63.89,60461828,205.859,47.9,23.021,35220.084,113.151,4.78,0.88,4
98,60,516,232248,87,33229,36051,2404673,63.89,60461828,205.859,47.9,23.021,35220.084,113.151,4.78,0.88,4
98,61,416,232664,111,33340,28948,2433621,63.89,60461828,205.859,47.9,23.021,35220.084,113.151,4.78,0.88,4
98,62,355,233019,75,33415,18053,2451674,63.89,60461828,205.859,47.9,23.021,35220.084,113.151,4.78,0.88,4
98,63,178,233197,60,33475,25628,2477302,52.78,60461828,205.859,47.9,23.021,35220.084,113.151,4.78,0.88,4
98,64,318,233515,55,33530,20035,2497337,44.44,60461828,205.859,47.9,23.021,35220.084,113.151,4.78,0.88,4
98,65,321,233836,71,33601,27451,2524788,44.44,60461828,205.859,47.9,23.021,35220.084,113.151,4.78,0.88,4
98,66,177,234013,88,33689,40470,2565258,44.44,60461828,205.859,47.9,23.021,35220.084,113.151,4.78,0.88,4
98,67,518,234531,85,33774,34036,2599294,44.44,60461828,205.859,47.9,23.021,35220.084,113.151,4.78,0.88,4
98,68,270,234801,72,33846,27894,2627188,44.44,60461828,205.859,47.9,23.021,35220.084,113.151,4.78,0.88,4
98,69,197,234998,53,33899,16301,2643489,44.44,60461828,205.859,47.9,23.021,35220.084,113.151,4.78,0.88,4
98,70,280,235278,65,33964,32200,2675689,44.44,60461828,205.859,47.9,23.021,35220.084,113.151,4.78,0.88,4
98,71,283,235561,79,34043,37865,2713554,44.44,60461828,205.859,47.9,23.021,35220.084,113.151,4.78,0.88,4
98,72,202,235763,71,34114,32991,2746545,50,60461828,205.859,47.9,23.021,35220.084,113.151,4.78,0.88,4
98,73,379,236142,53,34167,37651,2784196,50,60461828,205.859,47.9,23.021,35220.084,113.151,4.78,0.88,4
98,74,163,236305,56,34223,32880,2817076,50,60461828,205.859,47.9,23.021,35220.084,113.151,4.78,0.88,4
98,75,346,236651,78,34301,29545,2846621,50,60461828,205.859,47.9,23.021,35220.084,113.151,4.78,0.88,4
98,76,338,236989,44,34345,17463,2864084,55.56,60461828,205.859,47.9,23.021,35220.084,113.151,4.78,0.88,4
98,77,301,237290,26,34371,27762,2891846,55.56,60461828,205.859,47.9,23.021,35220.084,113.151,4.78,0.88,4
98,78,210,237500,34,34405,33957,2925803,55.56,60461828,205.859,47.9,23.021,35220.084,113.151,4.78,0.88,4
98,79,328,237828,43,34448,32921,2958724,55.56,60461828,205.859,47.9,23.021,35220.084,113.151,4.78,0.88,4
98,80,331,238159,66,34514,28570,2987294,55.56,60461828,205.859,47.9,23.021,35220.084,113.151,4.78,0.88,4
98,81,-148,238011,47,34561,29875,3017169,55.56,60461828,205.859,47.9,23.021,35220.084,113.151,4.78,0.88,4
98,82,264,238275,49,34610,24581,3041750,55.56,60461828,205.859,47.9,23.021,35220.084,113.151,4.78,0.88,4
98,83,224,238499,24,34634,16152,3057902,55.56,60461828,205.859,47.9,23.021,35220.084,113.151,4.78,0.88,4
98,84,221,238720,23,34657,23225,3081127,55.56,60461828,205.859,47.9,23.021,35220.084,113.151,4.78,0.88,4
98,85,113,238833,18,34675,30237,3111364,55.56,60461828,205.859,47.9,23.021,35220.084,113.151,4.78,0.88,4
98,86,577,239410,-31,34644,29421,3140785,55.56,60461828,205.859,47.9,23.021,35220.084,113.151,4.78,0.88,4
98,87,296,239706,34,34678,28331,3169116,55.56,60461828,205.859,47.9,23.021,35220.084,113.151,4.78,0.88,4
98,88,255,239961,30,34708,29721,3198837,55.56,60461828,205.859,47.9,23.021,35220.084,113.151,4.78,0.88,4
98,89,175,240136,8,34716,21183,3220020,55.56,60461828,205.859,47.9,23.021,35220.084,113.151,4.78,0.88,4
98,90,174,240310,22,34738,15484,3235504,55.56,60461828,205.859,47.9,23.021,35220.084,113.151,4.78,0.88,4
98,91,126,240436,6,34744,28471,3263975,55.56,60461828,205.859,47.9,23.021,35220.084,113.151,4.78,0.88,4
98,92,142,240578,23,34767,29325,3293300,55.56,60461828,205.859,47.9,23.021,35220.084,113.151,4.78,0.88,4
98,93,182,240760,21,34788,29147,3322447,55.56,60461828,205.859,47.9,23.021,35220.084,113.151,4.78,0.88,4
98,94,201,240961,30,34818,25680,3348127,55.56,60461828,205.859,47.9,23.021,35220.084,113.151,4.78,0.88,4
98,95,223,241184,15,34833,28946,3377073,55.56,60461828,205.859,47.9,23.021,35220.084,113.151,4.78,0.88,4
98,96,235,241419,21,34854,21166,3398239,55.56,60461828,205.859,47.9,23.021,35220.084,113.151,4.78,0.88,4
98,97,192,241611,7,34861,13771,3412010,55.56,60461828,205.859,47.9,23.021,35220.084,113.151,4.78,0.88,4
98,98,208,241819,8,34869,22490,3434500,55.56,60461828,205.859,47.9,23.021,35220.084,113.151,4.78,0.88,4
98,99,137,241956,30,34899,28679,3463179,55.56,60461828,205.859,47.9,23.021,35220.084,113.151,4.78,0.88,4
98,100,193,242149,15,34914,29947,3493126,58.33,60461828,205.859,47.9,23.021,35220.084,113.151,4.78,0.88,4
98,101,214,242363,12,34926,27251,3520377,58.33,60461828,205.859,47.9,23.021,35220.084,113.151,4.78,0.88,4
98,102,276,242639,12,34938,25449,3545826,58.33,60461828,205.859,47.9,23.021,35220.084,113.151,4.78,0.88,4
98,103,188,242827,7,34945,23061,3568887,58.33,60461828,205.859,47.9,23.021,35220.084,113.151,4.78,0.88,4
98,104,234,243061,9,34954,14006,3582893,58.33,60461828,205.859,47.9,23.021,35220.084,113.151,4.78,0.88,4
98,105,169,243230,13,34967,24222,3607115,58.33,60461828,205.859,47.9,23.021,35220.084,113.151,4.78,0.88,4
98,106,114,243344,17,34984,28392,3635507,58.33,60461828,205.859,47.9,23.021,35220.084,113.151,4.78,0.88,4
98,107,162,243506,13,34997,28089,3663596,58.33,60461828,205.859,47.9,23.021,35220.084,113.151,4.78,0.88,4
98,108,230,243736,20,35017,28661,3692257,58.33,60461828,205.859,47.9,23.021,35220.084,113.151,4.78,0.88,4
98,109,231,243967,11,35028,27569,3719826,58.33,60461828,205.859,47.9,23.021,35220.084,113.151,4.78,0.88,4
98,110,249,244216,14,35042,20621,3740447,58.33,60461828,205.859,47.9,23.021,35220.084,113.151,4.78,0.88,4
98,111,218,244434,3,35045,14121,3754568,58.33,60461828,205.859,47.9,23.021,35220.084,113.151,4.78,0.88,4
98,112,190,244624,13,35058,23915,3778483,58.33,60461828,205.859,47.9,23.021,35220.084,113.151,4.78,0.88,4
98,113,128,244752,15,35073,29288,3807771,58.33,60461828,205.859,47.9,23.021,35220.084,113.151,4.78,0.88,4
98,114,280,245032,9,35082,33018,3840789,58.33,60461828,205.859,47.9,23.021,35220.084,113.151,4.78,0.88,4
98,115,306,245338,10,35092,28970,3869759,58.33,60461828,205.859,47.9,23.021,35220.084,113.151,4.78,0.88,4
98,116,252,245590,5,35097,28059,3897818,58.33,60461828,205.859,47.9,23.021,35220.084,113.151,4.78,0.88,4
98,117,274,245864,5,35102,25177,3922995,58.33,60461828,205.859,47.9,23.021,35220.084,113.151,4.78,0.88,4
98,118,254,246118,5,35107,19374,3942369,48.15,60461828,205.859,47.9,23.021,35220.084,113.151,4.78,0.88,4
98,119,168,246286,5,35112,25341,3967710,48.15,60461828,205.859,47.9,23.021,35220.084,113.151,4.78,0.88,4
98,120,202,246488,11,35123,30875,3998585,48.15,60461828,205.859,47.9,23.021,35220.084,113.151,4.78,0.88,4
98,121,288,246776,6,35129,33396,4031981,48.15,60461828,205.859,47.9,23.021,35220.084,113.151,4.78,0.88,4
98,122,382,247158,3,35132,29686,4061667,48.15,60461828,205.859,47.9,23.021,35220.084,113.151,4.78,0.88,4
98,123,379,247537,9,35141,31905,4093572,48.15,60461828,205.859,47.9,23.021,35220.084,113.151,4.78,0.88,4
98,124,295,247832,5,35146,24496,4118068,48.15,60461828,205.859,47.9,23.021,35220.084,113.151,4.78,0.88,4
98,125,238,248070,8,35154,13467,4131535,48.15,60461828,205.859,47.9,23.021,35220.084,113.151,4.78,0.88,4
98,126,159,248229,12,35166,23491,4155026,48.15,60461828,205.859,47.9,23.021,35220.084,113.151,4.78,0.88,4
98,127,190,248419,5,35171,29739,4184765,48.15,60461828,205.859,47.9,23.021,35220.084,113.151,4.78,0.88,4
98,128,384,248803,10,35181,32169,4216934,48.15,60461828,205.859,47.9,23.021,35220.084,113.151,4.78,0.88,4
98,129,401,249204,6,35187,30392,4247326,48.15,60461828,205.859,47.9,23.021,35220.084,113.151,4.78,0.88,4
98,130,552,249756,3,35190,26631,4273957,50.93,60461828,205.859,47.9,23.021,35220.084,113.151,4.78,0.88,4
98,131,347,250103,13,35203,22773,4296730,50.93,60461828,205.859,47.9,23.021,35220.084,113.151,4.78,0.88,4
98,132,463,250566,2,35205,10904,4307634,50.93,60461828,205.859,47.9,23.021,35220.084,113.151,4.78,0.88,4
98,133,259,250825,4,35209,22063,4329697,50.93,60461828,205.859,47.9,23.021,35220.084,113.151,4.78,0.88,4
98,134,412,251237,6,35215,27330,4357027,50.93,60461828,205.859,47.9,23.021,35220.084,113.151,4.78,0.88,4
98,135,476,251713,10,35225,25629,4382656,50.93,60461828,205.859,47.9,23.021,35220.084,113.151,4.78,0.88,4
98,136,522,252235,6,35231,24868,4407524,50.93,60461828,205.859,47.9,23.021,35220.084,113.151,4.78,0.88,4
98,137,574,252809,3,35234,25937,4433461,50.93,60461828,205.859,47.9,23.021,35220.084,113.151,4.78,0.88,4
98,138,629,253438,158,35392,22470,4455931,50.93,60461828,205.859,47.9,23.021,35220.084,113.151,4.78,0.88,4
98,139,477,253915,4,35396,21379,4477310,54.63,60461828,205.859,47.9,23.021,35220.084,113.151,4.78,0.88,4
98,140,320,254235,4,35400,32687,4509997,54.63,60461828,205.859,47.9,23.021,35220.084,113.151,4.78,0.88,4
98,141,401,254636,5,35405,41290,4551287,54.63,60461828,205.859,47.9,23.021,35220.084,113.151,4.78,0.88,4
98,142,642,255278,7,35412,49662,4600949,54.63,60461828,205.859,47.9,23.021,35220.084,113.151,4.78,0.88,4
98,143,840,256118,6,35418,44943,4645892,54.63,60461828,205.859,47.9,23.021,35220.084,113.151,4.78,0.88,4
98,144,947,257065,9,35427,46613,4692505,54.63,60461828,205.859,47.9,23.021,35220.084,113.151,4.78,0.88,4
98,145,1071,258136,3,35430,47463,4739968,54.63,60461828,205.859,47.9,23.021,35220.084,113.151,4.78,0.88,4
98,146,1209,259345,7,35437,33358,4773326,54.63,60461828,205.859,47.9,23.021,35220.084,113.151,4.78,0.88,4
98,147,953,260298,4,35441,45798,4819124,54.63,60461828,205.859,47.9,23.021,35220.084,113.151,4.78,0.88,4
98,148,876,261174,4,35445,58054,4877178,54.63,60461828,205.859,47.9,23.021,35220.084,113.151,4.78,0.88,4
98,149,1366,262540,13,35458,57640,4934818,54.63,60461828,205.859,47.9,23.021,35220.084,113.151,4.78,0.88,4
98,150,1409,263949,5,35463,65135,4999953,54.63,60461828,205.859,47.9,23.021,35220.084,113.151,4.78,0.88,4
98,151,1460,265409,9,35472,64294,5064247,54.63,60461828,205.859,47.9,23.021,35220.084,113.151,4.78,0.88,4
98,152,1444,266853,1,35473,53541,5117788,54.63,60461828,205.859,47.9,23.021,35220.084,113.151,4.78,0.88,4
98,153,1365,268218,4,35477,42583,5160371,54.63,60461828,205.859,47.9,23.021,35220.084,113.151,4.78,0.88,4
98,154,996,269214,6,35483,54395,5214766,54.63,60461828,205.859,47.9,23.021,35220.084,113.151,4.78,0.88,4
98,155,975,270189,8,35491,66182,5280948,54.63,60461828,205.859,47.9,23.021,35220.084,113.151,4.78,0.88,4
98,156,1326,271515,6,35497,61202,5342150,54.63,60461828,205.859,47.9,23.021,35220.084,113.151,4.78,0.88,4
98,157,1397,272912,10,35507,72558,5414708,54.63,60461828,205.859,47.9,23.021,35220.084,113.151,4.78,0.88,4
98,158,1732,274644,11,35518,69637,5484345,54.63,60461828,205.859,47.9,23.021,35220.084,113.151,4.78,0.88,4
98,159,1694,276338,16,35534,53683,5538028,54.63,60461828,205.859,47.9,23.021,35220.084,113.151,4.78,0.88,4
98,160,1296,277634,7,35541,40703,5578731,54.63,60461828,205.859,47.9,23.021,35220.084,113.151,4.78,0.88,4
98,161,1150,278784,12,35553,57932,5636663,54.63,60461828,205.859,47.9,23.021,35220.084,113.151,4.78,0.88,4
98,162,1369,280153,10,35563,63046,5699709,54.63,60461828,205.859,47.9,23.021,35220.084,113.151,4.78,0.88,4
98,163,1430,281583,14,35577,57779,5757488,54.63,60461828,205.859,47.9,23.021,35220.084,113.151,4.78,0.88,4
98,164,1597,283180,10,35587,61422,5818910,54.63,60461828,205.859,47.9,23.021,35220.084,113.151,4.78,0.88,4
98,165,1616,284796,10,35597,56552,5875462,54.63,60461828,205.859,47.9,23.021,35220.084,113.151,4.78,0.88,4
98,166,1501,286297,6,35603,48860,5924322,54.63,60461828,205.859,47.9,23.021,35220.084,113.151,4.78,0.88,4
98,167,1456,287753,7,35610,31849,5956171,43.52,60461828,205.859,47.9,23.021,35220.084,113.151,4.78,0.88,4
98,168,1008,288761,14,35624,50504,6006675,43.52,60461828,205.859,47.9,23.021,35220.084,113.151,4.78,0.88,4
98,169,1229,289990,9,35633,58117,6064792,43.52,60461828,205.859,47.9,23.021,35220.084,113.151,4.78,0.88,4
98,170,1452,291442,12,35645,62451,6127243,43.52,60461828,205.859,47.9,23.021,35220.084,113.151,4.78,0.88,4
98,171,1583,293025,13,35658,60015,6187258,43.52,60461828,205.859,47.9,23.021,35220.084,113.151,4.78,0.88,4
98,172,1907,294932,10,35668,60770,6248028,43.52,60461828,205.859,47.9,23.021,35220.084,113.151,4.78,0.88,4
98,173,1637,296569,24,35692,54733,6302761,43.52,60461828,205.859,47.9,23.021,35220.084,113.151,4.78,0.88,4
98,174,1587,298156,15,35707,39893,6342654,43.52,60461828,205.859,47.9,23.021,35220.084,113.151,4.78,0.88,4
98,175,1350,299506,17,35724,49345,6391999,43.52,60461828,205.859,47.9,23.021,35220.084,113.151,4.78,0.88,4
98,176,1391,300897,14,35738,63763,6455762,43.52,60461828,205.859,47.9,23.021,35220.084,113.151,4.78,0.88,4
98,177,1640,302537,20,35758,64899,6520661,43.52,60461828,205.859,47.9,23.021,35220.084,113.151,4.78,0.88,4
98,178,1786,304323,23,35781,64009,6584670,43.52,60461828,205.859,47.9,23.021,35220.084,113.151,4.78,0.88,4
98,179,1912,306235,20,35801,62025,6646695,43.52,60461828,205.859,47.9,23.021,35220.084,113.151,4.78,0.88,4
98,180,1869,308104,17,35818,53737,6700432,43.52,60461828,205.859,47.9,23.021,35220.084,113.151,4.78,0.88,4
98,181,1766,309870,17,35835,32345,6732777,43.52,60461828,205.859,47.9,23.021,35220.084,113.151,4.78,0.88,4
98,182,1494,311364,16,35851,53618,6786395,43.52,60461828,205.859,47.9,23.021,35220.084,113.151,4.78,0.88,4
98,183,1647,313011,24,35875,62360,6848755,43.52,60461828,205.859,47.9,23.021,35220.084,113.151,4.78,0.88,4
98,184,1850,314861,19,35894,67833,6916588,43.52,60461828,205.859,47.9,23.021,35220.084,113.151,4.78,0.88,4
98,185,2548,317409,24,35918,71729,6988317,43.52,60461828,205.859,47.9,23.021,35220.084,113.151,4.78,0.88,4
98,186,2499,319908,23,35941,69632,7057949,43.52,60461828,205.859,47.9,23.021,35220.084,113.151,4.78,0.88,4
98,187,2843,322751,27,35968,59366,7117315,43.52,60461828,205.859,47.9,23.021,35220.084,113.151,4.78,0.88,4
98,188,2578,325329,18,35986,36551,7153866,43.52,60461828,205.859,47.9,23.021,35220.084,113.151,4.78,0.88,4
98,189,2257,327586,16,36002,62513,7216379,51.85,60461828,205.859,47.9,23.021,35220.084,113.151,4.78,0.88,4
98,190,2677,330263,28,36030,80387,7296766,51.85,60461828,205.859,47.9,23.021,35220.084,113.151,4.78,0.88,4
98,191,3677,333940,31,36061,68985,7365751,51.85,60461828,205.859,47.9,23.021,35220.084,113.151,4.78,0.88,4
98,192,4458,338398,22,36083,77842,7443593,51.85,60461828,205.859,47.9,23.021,35220.084,113.151,4.78,0.88,4
98,193,5372,343770,28,36111,80109,7523702,51.85,60461828,205.859,47.9,23.021,35220.084,113.151,4.78,0.88,4
98,194,5724,349494,29,36140,68708,7592410,51.85,60461828,205.859,47.9,23.021,35220.084,113.151,4.78,0.88,4
98,195,5456,354950,26,36166,59649,7652059,51.85,60461828,205.859,47.9,23.021,35220.084,113.151,4.78,0.88,4
98,196,4619,359569,39,36205,70260,7722319,51.85,60461828,205.859,47.9,23.021,35220.084,113.151,4.78,0.88,4
98,197,5898,365467,41,36246,87601,7809920,51.85,60461828,205.859,47.9,23.021,35220.084,113.151,4.78,0.88,4
98,198,7332,372799,43,36289,98542,7908462,51.85,60461828,205.859,47.9,23.021,35220.084,113.151,4.78,0.88,4
98,199,8803,381602,83,36372,92402,8000864,51.85,60461828,205.859,47.9,23.021,35220.084,113.151,4.78,0.88,4
98,200,10009,391611,55,36427,103326,8104190,51.85,60461828,205.859,47.9,23.021,35220.084,113.151,4.78,0.88,4
98,201,10925,402536,47,36474,95554,8199744,51.85,60461828,205.859,47.9,23.021,35220.084,113.151,4.78,0.88,4
98,202,11705,414241,69,36543,65824,8265568,51.85,60461828,205.859,47.9,23.021,35220.084,113.151,4.78,0.88,4
98,203,9337,423578,73,36616,0,8265568,51.85,60461828,205.859,47.9,23.021,35220.084,113.151,4.78,0.88,4
98,204,10871,434449,89,36705,0,8265568,51.85,60461828,205.859,47.9,23.021,35220.084,113.151,4.78,0.88,4
99,1,0,38,0,1,0,0,78.7,2961161,266.879,31.4,9.684,8193.571,206.537,11.28,0.732,0
99,2,6,44,2,3,0,473,78.7,2961161,266.879,31.4,9.684,8193.571,206.537,11.28,0.732,0
99,3,3,47,0,3,0,473,78.7,2961161,266.879,31.4,9.684,8193.571,206.537,11.28,0.732,0
99,4,6,53,0,3,0,473,78.7,2961161,266.879,31.4,9.684,8193.571,206.537,11.28,0.732,0
99,5,2,55,0,3,0,473,78.7,2961161,266.879,31.4,9.684,8193.571,206.537,11.28,0.732,0
99,6,3,58,0,3,0,473,78.7,2961161,266.879,31.4,9.684,8193.571,206.537,11.28,0.732,0
99,7,1,59,0,3,0,473,78.7,2961161,266.879,31.4,9.684,8193.571,206.537,11.28,0.732,0
99,8,4,63,0,3,0,473,78.7,2961161,266.879,31.4,9.684,8193.571,206.537,11.28,0.732,0
99,9,0,63,1,4,0,473,78.7,2961161,266.879,31.4,9.684,8193.571,206.537,11.28,0.732,0
99,10,0,63,0,4,0,473,78.7,2961161,266.879,31.4,9.684,8193.571,206.537,11.28,0.732,0
99,11,2,65,0,4,0,473,78.7,2961161,266.879,31.4,9.684,8193.571,206.537,11.28,0.732,0
99,12,4,69,0,4,0,473,78.7,2961161,266.879,31.4,9.684,8193.571,206.537,11.28,0.732,0
99,13,3,72,0,4,0,1194,78.7,2961161,266.879,31.4,9.684,8193.571,206.537,11.28,0.732,0
99,14,1,73,0,4,0,1194,78.7,2961161,266.879,31.4,9.684,8193.571,206.537,11.28,0.732,0
99,15,32,105,1,5,0,1383,80.56,2961161,266.879,31.4,9.684,8193.571,206.537,11.28,0.732,0
99,16,20,125,0,5,0,1383,80.56,2961161,266.879,31.4,9.684,8193.571,206.537,11.28,0.732,0
99,17,18,143,0,5,0,1516,80.56,2961161,266.879,31.4,9.684,8193.571,206.537,11.28,0.732,0
99,18,20,163,0,5,64,1580,80.56,2961161,266.879,31.4,9.684,8193.571,206.537,11.28,0.732,0
99,19,10,173,0,5,0,1580,80.56,2961161,266.879,31.4,9.684,8193.571,206.537,11.28,0.732,0
99,20,23,196,0,5,0,1787,80.56,2961161,266.879,31.4,9.684,8193.571,206.537,11.28,0.732,0
99,21,27,223,1,6,141,1928,80.56,2961161,266.879,31.4,9.684,8193.571,206.537,11.28,0.732,0
99,22,10,233,0,6,0,1928,87.04,2961161,266.879,31.4,9.684,8193.571,206.537,11.28,0.732,0
99,23,19,252,0,6,0,2124,87.04,2961161,266.879,31.4,9.684,8193.571,206.537,11.28,0.732,0
99,24,0,252,0,6,385,2509,87.04,2961161,266.879,31.4,9.684,8193.571,206.537,11.28,0.732,0
99,25,36,288,1,7,0,2509,87.04,2961161,266.879,31.4,9.684,8193.571,206.537,11.28,0.732,0
99,26,17,305,0,7,0,3240,87.04,2961161,266.879,31.4,9.684,8193.571,206.537,11.28,0.732,0
99,27,45,350,0,7,0,3240,87.04,2961161,266.879,31.4,9.684,8193.571,206.537,11.28,0.732,0
99,28,14,364,0,7,0,3240,87.04,2961161,266.879,31.4,9.684,8193.571,206.537,11.28,0.732,0
99,29,17,381,0,7,0,3963,87.04,2961161,266.879,31.4,9.684,8193.571,206.537,11.28,0.732,0
99,30,15,396,0,7,456,4419,87.04,2961161,266.879,31.4,9.684,8193.571,206.537,11.28,0.732,0
99,31,26,422,1,8,320,4739,87.04,2961161,266.879,31.4,9.684,8193.571,206.537,11.28,0.732,0
99,32,10,432,0,8,440,5179,87.04,2961161,266.879,31.4,9.684,8193.571,206.537,11.28,0.732,0
99,33,31,463,0,8,416,5595,87.04,2961161,266.879,31.4,9.684,8193.571,206.537,11.28,0.732,0
99,34,6,469,1,9,0,5595,87.04,2961161,266.879,31.4,9.684,8193.571,206.537,11.28,0.732,0
99,35,2,471,0,9,0,5940,87.04,2961161,266.879,31.4,9.684,8193.571,206.537,11.28,0.732,0
99,36,2,473,0,9,0,5940,87.04,2961161,266.879,31.4,9.684,8193.571,206.537,11.28,0.732,0
99,37,5,478,0,9,0,5940,87.04,2961161,266.879,31.4,9.684,8193.571,206.537,11.28,0.732,0
99,38,10,488,0,9,0,5940,87.04,2961161,266.879,31.4,9.684,8193.571,206.537,11.28,0.732,0
99,39,2,490,0,9,0,5940,87.04,2961161,266.879,31.4,9.684,8193.571,206.537,11.28,0.732,0
99,40,8,498,0,9,0,6839,87.04,2961161,266.879,31.4,9.684,8193.571,206.537,11.28,0.732,0
99,41,4,502,0,9,0,6839,87.04,2961161,266.879,31.4,9.684,8193.571,206.537,11.28,0.732,0
99,42,3,505,0,9,0,6839,87.04,2961161,266.879,31.4,9.684,8193.571,206.537,11.28,0.732,0
99,43,2,507,0,9,0,6839,87.04,2961161,266.879,31.4,9.684,8193.571,206.537,11.28,0.732,0
99,44,2,509,0,9,0,6839,87.04,2961161,266.879,31.4,9.684,8193.571,206.537,11.28,0.732,0
99,45,0,509,0,9,0,7886,87.04,2961161,266.879,31.4,9.684,8193.571,206.537,11.28,0.732,0
99,46,2,511,0,9,242,8128,87.04,2961161,266.879,31.4,9.684,8193.571,206.537,11.28,0.732,0
99,47,6,517,0,9,322,8450,87.04,2961161,266.879,31.4,9.684,8193.571,206.537,11.28,0.732,0
99,48,3,520,0,9,0,8450,87.04,2961161,266.879,31.4,9.684,8193.571,206.537,11.28,0.732,0
99,49,0,520,0,9,0,8754,87.04,2961161,266.879,31.4,9.684,8193.571,206.537,11.28,0.732,0
99,50,0,520,0,9,195,8949,87.04,2961161,266.879,31.4,9.684,8193.571,206.537,11.28,0.732,0
99,51,9,529,0,9,157,9106,87.04,2961161,266.879,31.4,9.684,8193.571,206.537,11.28,0.732,0
99,52,5,534,0,9,372,9478,87.04,2961161,266.879,31.4,9.684,8193.571,206.537,11.28,0.732,0
99,53,10,544,0,9,413,9891,87.04,2961161,266.879,31.4,9.684,8193.571,206.537,11.28,0.732,0
99,54,6,550,0,9,315,10206,87.04,2961161,266.879,31.4,9.684,8193.571,206.537,11.28,0.732,0
99,55,2,552,0,9,335,10541,87.04,2961161,266.879,31.4,9.684,8193.571,206.537,11.28,0.732,0
99,56,4,556,0,9,0,10541,87.04,2961161,266.879,31.4,9.684,8193.571,206.537,11.28,0.732,0
99,57,8,564,0,9,0,11226,87.04,2961161,266.879,31.4,9.684,8193.571,206.537,11.28,0.732,0
99,58,5,569,0,9,201,11427,87.04,2961161,266.879,31.4,9.684,8193.571,206.537,11.28,0.732,0
99,59,0,569,0,9,602,12029,87.04,2961161,266.879,31.4,9.684,8193.571,206.537,11.28,0.732,0
99,60,6,575,0,9,310,12339,87.04,2961161,266.879,31.4,9.684,8193.571,206.537,11.28,0.732,0
99,61,6,581,0,9,328,12667,84.26,2961161,266.879,31.4,9.684,8193.571,206.537,11.28,0.732,0
99,62,5,586,0,9,492,13159,80.56,2961161,266.879,31.4,9.684,8193.571,206.537,11.28,0.732,0
99,63,2,588,0,9,215,13374,76.85,2961161,266.879,31.4,9.684,8193.571,206.537,11.28,0.732,0
99,64,2,590,0,9,0,13374,76.85,2961161,266.879,31.4,9.684,8193.571,206.537,11.28,0.732,0
99,65,0,590,0,9,0,13583,76.85,2961161,266.879,31.4,9.684,8193.571,206.537,11.28,0.732,0
99,66,1,591,1,10,378,13961,76.85,2961161,266.879,31.4,9.684,8193.571,206.537,11.28,0.732,0
99,67,4,595,0,10,230,14191,76.85,2961161,266.879,31.4,9.684,8193.571,206.537,11.28,0.732,0
99,68,1,596,0,10,361,14552,76.85,2961161,266.879,31.4,9.684,8193.571,206.537,11.28,0.732,0
99,69,2,598,0,10,215,14767,73.15,2961161,266.879,31.4,9.684,8193.571,206.537,11.28,0.732,0
99,70,1,599,0,10,209,14976,73.15,2961161,266.879,31.4,9.684,8193.571,206.537,11.28,0.732,0
99,71,6,605,0,10,138,15114,73.15,2961161,266.879,31.4,9.684,8193.571,206.537,11.28,0.732,0
99,72,0,605,0,10,319,15433,73.15,2961161,266.879,31.4,9.684,8193.571,206.537,11.28,0.732,0
99,73,6,611,0,10,372,15805,73.15,2961161,266.879,31.4,9.684,8193.571,206.537,11.28,0.732,0
99,74,3,614,0,10,297,16102,73.15,2961161,266.879,31.4,9.684,8193.571,206.537,11.28,0.732,0
99,75,1,615,0,10,344,16446,73.15,2961161,266.879,31.4,9.684,8193.571,206.537,11.28,0.732,0
99,76,2,617,0,10,398,16844,64.81,2961161,266.879,31.4,9.684,8193.571,206.537,11.28,0.732,0
99,77,4,621,0,10,55,16899,64.81,2961161,266.879,31.4,9.684,8193.571,206.537,11.28,0.732,0
99,78,0,621,0,10,516,17415,64.81,2961161,266.879,31.4,9.684,8193.571,206.537,11.28,0.732,0
99,79,5,626,0,10,1149,18564,64.81,2961161,266.879,31.4,9.684,8193.571,206.537,11.28,0.732,0
99,80,0,626,0,10,992,19556,64.81,2961161,266.879,31.4,9.684,8193.571,206.537,11.28,0.732,0
99,81,26,652,0,10,544,20100,64.81,2961161,266.879,31.4,9.684,8193.571,206.537,11.28,0.732,0
99,82,5,657,0,10,274,20374,64.81,2961161,266.879,31.4,9.684,8193.571,206.537,11.28,0.732,0
99,83,2,659,0,10,843,21217,64.81,2961161,266.879,31.4,9.684,8193.571,206.537,11.28,0.732,0
99,84,6,665,0,10,379,21596,64.81,2961161,266.879,31.4,9.684,8193.571,206.537,11.28,0.732,0
99,85,5,670,0,10,602,22198,64.81,2961161,266.879,31.4,9.684,8193.571,206.537,11.28,0.732,0
99,86,8,678,0,10,451,22649,64.81,2961161,266.879,31.4,9.684,8193.571,206.537,11.28,0.732,0
99,87,6,684,0,10,615,23264,64.81,2961161,266.879,31.4,9.684,8193.571,206.537,11.28,0.732,0
99,88,2,686,0,10,256,23520,64.81,2961161,266.879,31.4,9.684,8193.571,206.537,11.28,0.732,0
99,89,4,690,0,10,277,23797,64.81,2961161,266.879,31.4,9.684,8193.571,206.537,11.28,0.732,0
99,90,6,696,0,10,319,24116,64.81,2961161,266.879,31.4,9.684,8193.571,206.537,11.28,0.732,0
99,91,2,698,0,10,327,24443,64.81,2961161,266.879,31.4,9.684,8193.571,206.537,11.28,0.732,0
99,92,4,702,0,10,444,24887,64.81,2961161,266.879,31.4,9.684,8193.571,206.537,11.28,0.732,0
99,93,5,707,0,10,285,25172,64.81,2961161,266.879,31.4,9.684,8193.571,206.537,11.28,0.732,0
99,94,8,715,0,10,510,25682,64.81,2961161,266.879,31.4,9.684,8193.571,206.537,11.28,0.732,0
99,95,6,721,0,10,259,25941,64.81,2961161,266.879,31.4,9.684,8193.571,206.537,11.28,0.732,0
99,96,7,728,0,10,529,26470,64.81,2961161,266.879,31.4,9.684,8193.571,206.537,11.28,0.732,0
99,97,4,732,0,10,269,26739,64.81,2961161,266.879,31.4,9.684,8193.571,206.537,11.28,0.732,0
99,98,5,737,0,10,343,27082,64.81,2961161,266.879,31.4,9.684,8193.571,206.537,11.28,0.732,0
99,99,8,745,0,10,217,27299,64.81,2961161,266.879,31.4,9.684,8193.571,206.537,11.28,0.732,0
99,100,6,751,0,10,176,27475,64.81,2961161,266.879,31.4,9.684,8193.571,206.537,11.28,0.732,0
99,101,2,753,0,10,300,27775,64.81,2961161,266.879,31.4,9.684,8193.571,206.537,11.28,0.732,0
99,102,0,753,0,10,255,28030,64.81,2961161,266.879,31.4,9.684,8193.571,206.537,11.28,0.732,0
99,103,5,758,0,10,130,28160,64.81,2961161,266.879,31.4,9.684,8193.571,206.537,11.28,0.732,0
99,104,0,758,0,10,232,28392,64.81,2961161,266.879,31.4,9.684,8193.571,206.537,11.28,0.732,0
99,105,1,759,0,10,154,28546,64.81,2961161,266.879,31.4,9.684,8193.571,206.537,11.28,0.732,0
99,106,3,762,0,10,354,28900,64.81,2961161,266.879,31.4,9.684,8193.571,206.537,11.28,0.732,0
99,107,1,763,0,10,483,29383,64.81,2961161,266.879,31.4,9.684,8193.571,206.537,11.28,0.732,0
99,108,2,765,0,10,208,29591,64.81,2961161,266.879,31.4,9.684,8193.571,206.537,11.28,0.732,0
99,109,3,768,0,10,568,30159,64.81,2961161,266.879,31.4,9.684,8193.571,206.537,11.28,0.732,0
99,110,6,774,0,10,733,30892,64.81,2961161,266.879,31.4,9.684,8193.571,206.537,11.28,0.732,0
99,111,16,790,0,10,1093,31985,64.81,2961161,266.879,31.4,9.684,8193.571,206.537,11.28,0.732,0
99,112,19,809,0,10,494,32479,64.81,2961161,266.879,31.4,9.684,8193.571,206.537,11.28,0.732,0
99,113,0,809,0,10,628,33107,64.81,2961161,266.879,31.4,9.684,8193.571,206.537,11.28,0.732,0
99,114,7,816,0,10,589,33696,64.81,2961161,266.879,31.4,9.684,8193.571,206.537,11.28,0.732,0
99,115,0,816,0,10,900,34596,64.81,2961161,266.879,31.4,9.684,8193.571,206.537,11.28,0.732,0
99,116,5,821,0,10,757,35353,64.81,2961161,266.879,31.4,9.684,8193.571,206.537,11.28,0.732,0
99,117,16,837,0,10,775,36128,64.81,2961161,266.879,31.4,9.684,8193.571,206.537,11.28,0.732,0
99,118,5,842,0,10,602,36730,64.81,2961161,266.879,31.4,9.684,8193.571,206.537,11.28,0.732,0
99,119,11,853,0,10,413,37143,64.81,2961161,266.879,31.4,9.684,8193.571,206.537,11.28,0.732,0
99,120,2,855,0,10,318,37461,64.81,2961161,266.879,31.4,9.684,8193.571,206.537,11.28,0.732,0
99,121,1,856,0,10,579,38040,64.81,2961161,266.879,31.4,9.684,8193.571,206.537,11.28,0.732,0
99,122,8,864,0,10,626,38666,64.81,2961161,266.879,31.4,9.684,8193.571,206.537,11.28,0.732,0
99,123,0,864,0,10,322,38988,68.52,2961161,266.879,31.4,9.684,8193.571,206.537,11.28,0.732,0
99,124,19,883,0,10,703,39691,68.52,2961161,266.879,31.4,9.684,8193.571,206.537,11.28,0.732,0
99,125,11,894,2,12,335,40026,68.52,2961161,266.879,31.4,9.684,8193.571,206.537,11.28,0.732,0
99,126,11,905,0,12,621,40647,68.52,2961161,266.879,31.4,9.684,8193.571,206.537,11.28,0.732,0
99,127,15,920,0,12,605,41252,68.52,2961161,266.879,31.4,9.684,8193.571,206.537,11.28,0.732,0
99,128,8,928,0,12,541,41793,68.52,2961161,266.879,31.4,9.684,8193.571,206.537,11.28,0.732,0
99,129,30,958,0,12,598,42391,71.3,2961161,266.879,31.4,9.684,8193.571,206.537,11.28,0.732,0
99,130,29,987,1,13,529,42920,71.3,2961161,266.879,31.4,9.684,8193.571,206.537,11.28,0.732,0
99,131,16,1003,0,13,397,43317,71.3,2961161,266.879,31.4,9.684,8193.571,206.537,11.28,0.732,0
99,132,20,1023,1,14,384,43701,71.3,2961161,266.879,31.4,9.684,8193.571,206.537,11.28,0.732,0
99,133,8,1031,0,14,591,44292,71.3,2961161,266.879,31.4,9.684,8193.571,206.537,11.28,0.732,0
99,134,16,1047,0,14,549,44841,71.3,2961161,266.879,31.4,9.684,8193.571,206.537,11.28,0.732,0
99,135,18,1065,0,14,354,45195,73.15,2961161,266.879,31.4,9.684,8193.571,206.537,11.28,0.732,0
99,136,6,1071,0,14,425,45620,73.15,2961161,266.879,31.4,9.684,8193.571,206.537,11.28,0.732,0
99,137,11,1082,0,14,507,46127,73.15,2961161,266.879,31.4,9.684,8193.571,206.537,11.28,0.732,0
99,138,0,1082,0,14,292,46419,73.15,2961161,266.879,31.4,9.684,8193.571,206.537,11.28,0.732,0
99,139,31,1113,0,14,415,46834,73.15,2961161,266.879,31.4,9.684,8193.571,206.537,11.28,0.732,0
99,140,16,1129,0,14,933,47767,73.15,2961161,266.879,31.4,9.684,8193.571,206.537,11.28,0.732,0
99,141,17,1146,0,14,1320,49087,73.15,2961161,266.879,31.4,9.684,8193.571,206.537,11.28,0.732,0
99,142,46,1192,0,14,1482,50569,73.15,2961161,266.879,31.4,9.684,8193.571,206.537,11.28,0.732,0
99,143,98,1290,1,15,1080,51649,73.15,2961161,266.879,31.4,9.684,8193.571,206.537,11.28,0.732,0
99,144,56,1346,1,16,743,52392,73.15,2961161,266.879,31.4,9.684,8193.571,206.537,11.28,0.732,0
99,145,67,1413,0,16,888,53280,73.15,2961161,266.879,31.4,9.684,8193.571,206.537,11.28,0.732,0
99,146,116,1529,0,16,665,53945,73.15,2961161,266.879,31.4,9.684,8193.571,206.537,11.28,0.732,0
99,147,83,1612,0,16,603,54548,78.7,2961161,266.879,31.4,9.684,8193.571,206.537,11.28,0.732,0
99,148,120,1732,3,19,441,54989,78.7,2961161,266.879,31.4,9.684,8193.571,206.537,11.28,0.732,0
99,149,72,1804,0,19,514,55503,78.7,2961161,266.879,31.4,9.684,8193.571,206.537,11.28,0.732,0
99,150,66,1870,0,19,889,56392,78.7,2961161,266.879,31.4,9.684,8193.571,206.537,11.28,0.732,0
99,151,141,2011,0,19,581,56973,78.7,2961161,266.879,31.4,9.684,8193.571,206.537,11.28,0.732,0
99,152,102,2113,1,20,1204,58177,78.7,2961161,266.879,31.4,9.684,8193.571,206.537,11.28,0.732,0
99,153,244,2357,1,21,828,59005,78.7,2961161,266.879,31.4,9.684,8193.571,206.537,11.28,0.732,0
99,154,0,2357,0,21,1202,60207,78.7,2961161,266.879,31.4,9.684,8193.571,206.537,11.28,0.732,0
99,155,326,2683,3,24,920,61127,78.7,2961161,266.879,31.4,9.684,8193.571,206.537,11.28,0.732,0
99,156,139,2822,3,27,461,61588,78.7,2961161,266.879,31.4,9.684,8193.571,206.537,11.28,0.732,0
99,157,74,2896,2,29,568,62156,78.7,2961161,266.879,31.4,9.684,8193.571,206.537,11.28,0.732,0
99,158,68,2964,1,30,351,62507,78.7,2961161,266.879,31.4,9.684,8193.571,206.537,11.28,0.732,0
99,159,60,3024,2,32,639,63146,78.7,2961161,266.879,31.4,9.684,8193.571,206.537,11.28,0.732,0
99,160,79,3103,1,33,0,63146,78.7,2961161,266.879,31.4,9.684,8193.571,206.537,11.28,0.732,0
99,161,80,3183,1,34,0,64607,78.7,2961161,266.879,31.4,9.684,8193.571,206.537,11.28,0.732,0
99,162,140,3323,2,36,915,65522,78.7,2961161,266.879,31.4,9.684,8193.571,206.537,11.28,0.732,0
99,163,114,3437,2,38,486,66008,78.7,2961161,266.879,31.4,9.684,8193.571,206.537,11.28,0.732,0
99,164,74,3511,2,40,662,66670,78.7,2961161,266.879,31.4,9.684,8193.571,206.537,11.28,0.732,0
99,165,0,3511,0,40,632,67302,78.7,2961161,266.879,31.4,9.684,8193.571,206.537,11.28,0.732,0
99,166,112,3623,0,40,625,67927,78.7,2961161,266.879,31.4,9.684,8193.571,206.537,11.28,0.732,0
99,167,148,3771,2,42,518,68445,78.7,2961161,266.879,31.4,9.684,8193.571,206.537,11.28,0.732,0
99,168,162,3933,2,44,535,68980,78.7,2961161,266.879,31.4,9.684,8193.571,206.537,11.28,0.732,0
99,169,109,4042,2,46,1049,70029,78.7,2961161,266.879,31.4,9.684,8193.571,206.537,11.28,0.732,0
99,170,109,4151,0,46,971,71000,78.7,2961161,266.879,31.4,9.684,8193.571,206.537,11.28,0.732,0
99,171,223,4374,5,51,638,71638,78.7,2961161,266.879,31.4,9.684,8193.571,206.537,11.28,0.732,0
99,172,197,4571,4,55,631,72269,78.7,2961161,266.879,31.4,9.684,8193.571,206.537,11.28,0.732,0
99,173,187,4758,5,60,629,72898,78.7,2961161,266.879,31.4,9.684,8193.571,206.537,11.28,0.732,0
99,174,230,4988,7,67,577,73475,78.7,2961161,266.879,31.4,9.684,8193.571,206.537,11.28,0.732,0
99,175,134,5122,3,70,538,74013,78.7,2961161,266.879,31.4,9.684,8193.571,206.537,11.28,0.732,0
99,176,129,5251,5,75,695,74708,78.7,2961161,266.879,31.4,9.684,8193.571,206.537,11.28,0.732,0
99,177,122,5373,1,76,641,75349,78.7,2961161,266.879,31.4,9.684,8193.571,206.537,11.28,0.732,0
99,178,192,5565,1,77,640,75989,78.7,2961161,266.879,31.4,9.684,8193.571,206.537,11.28,0.732,0
99,179,135,5700,3,80,701,76690,78.7,2961161,266.879,31.4,9.684,8193.571,206.537,11.28,0.732,0
99,180,129,5829,8,88,646,77336,78.7,2961161,266.879,31.4,9.684,8193.571,206.537,11.28,0.732,0
99,181,164,5993,1,89,871,78207,78.7,2961161,266.879,31.4,9.684,8193.571,206.537,11.28,0.732,0
99,182,150,6143,4,93,354,78561,78.7,2961161,266.879,31.4,9.684,8193.571,206.537,11.28,0.732,0
99,183,239,6382,7,100,350,78911,78.7,2961161,266.879,31.4,9.684,8193.571,206.537,11.28,0.732,0
99,184,80,6462,7,107,534,79445,78.7,2961161,266.879,31.4,9.684,8193.571,206.537,11.28,0.732,0
99,185,93,6555,4,111,549,79994,78.7,2961161,266.879,31.4,9.684,8193.571,206.537,11.28,0.732,0
99,186,136,6691,5,116,536,80530,78.7,2961161,266.879,31.4,9.684,8193.571,206.537,11.28,0.732,0
99,187,104,6795,3,119,541,81071,78.7,2961161,266.879,31.4,9.684,8193.571,206.537,11.28,0.732,0
99,188,100,6895,1,120,728,81799,71.3,2961161,266.879,31.4,9.684,8193.571,206.537,11.28,0.732,0
99,189,117,7012,0,120,551,82350,71.3,2961161,266.879,31.4,9.684,8193.571,206.537,11.28,0.732,0
99,190,97,7109,3,123,547,82897,71.3,2961161,266.879,31.4,9.684,8193.571,206.537,11.28,0.732,0
99,191,82,7191,3,126,554,83451,71.3,2961161,266.879,31.4,9.684,8193.571,206.537,11.28,0.732,0
99,192,82,7273,2,128,902,84353,71.3,2961161,266.879,31.4,9.684,8193.571,206.537,11.28,0.732,0
99,193,90,7363,4,132,363,84716,71.3,2961161,266.879,31.4,9.684,8193.571,206.537,11.28,0.732,0
99,194,196,7559,6,138,543,85259,71.3,2961161,266.879,31.4,9.684,8193.571,206.537,11.28,0.732,0
99,195,159,7718,1,139,541,85800,71.3,2961161,266.879,31.4,9.684,8193.571,206.537,11.28,0.732,0
99,196,95,7813,7,146,460,86260,62.04,2961161,266.879,31.4,9.684,8193.571,206.537,11.28,0.732,0
99,197,97,7910,0,146,454,86714,62.04,2961161,266.879,31.4,9.684,8193.571,206.537,11.28,0.732,0
99,198,79,7989,5,151,552,87266,62.04,2961161,266.879,31.4,9.684,8193.571,206.537,11.28,0.732,0
99,199,78,8067,9,160,645,87911,62.04,2961161,266.879,31.4,9.684,8193.571,206.537,11.28,0.732,0
99,200,65,8132,2,162,362,88273,62.04,2961161,266.879,31.4,9.684,8193.571,206.537,11.28,0.732,0
99,201,63,8195,6,168,555,88828,62.04,2961161,266.879,31.4,9.684,8193.571,206.537,11.28,0.732,0
99,202,79,8274,3,171,0,88828,62.04,2961161,266.879,31.4,9.684,8193.571,206.537,11.28,0.732,0
99,203,47,8321,2,173,0,88828,62.04,2961161,266.879,31.4,9.684,8193.571,206.537,11.28,0.732,0
99,204,53,8374,1,174,0,88828,62.04,2961161,266.879,31.4,9.684,8193.571,206.537,11.28,0.732,0
100,1,0,1953,0,56,0,0,40.74,126476458,347.778,48.2,27.049,39002.223,79.37,5.72,0.909,3
100,2,225,2178,1,57,0,0,40.74,126476458,347.778,48.2,27.049,39002.223,79.37,5.72,0.909,3
100,3,439,2617,6,63,0,0,43.52,126476458,347.778,48.2,27.049,39002.223,79.37,5.72,0.909,3
100,4,318,2935,6,69,0,87230,43.52,126476458,347.778,48.2,27.049,39002.223,79.37,5.72,0.909,3
100,5,336,3271,1,70,0,87230,43.52,126476458,347.778,48.2,27.049,39002.223,79.37,5.72,0.909,3
100,6,383,3654,3,73,0,87230,43.52,126476458,347.778,48.2,27.049,39002.223,79.37,5.72,0.909,3
100,7,252,3906,7,80,0,87230,45.37,126476458,347.778,48.2,27.049,39002.223,79.37,5.72,0.909,3
100,8,351,4257,1,81,0,87230,45.37,126476458,347.778,48.2,27.049,39002.223,79.37,5.72,0.909,3
100,9,511,4768,4,85,0,87230,45.37,126476458,347.778,48.2,27.049,39002.223,79.37,5.72,0.909,3
100,10,579,5347,3,88,0,87230,45.37,126476458,347.778,48.2,27.049,39002.223,79.37,5.72,0.909,3
100,11,658,6005,6,94,0,136080,45.37,126476458,347.778,48.2,27.049,39002.223,79.37,5.72,0.909,3
100,12,743,6748,4,98,0,136080,45.37,126476458,347.778,48.2,27.049,39002.223,79.37,5.72,0.909,3
100,13,507,7255,4,102,0,136080,45.37,126476458,347.778,48.2,27.049,39002.223,79.37,5.72,0.909,3
100,14,390,7645,7,109,0,136080,45.37,126476458,347.778,48.2,27.049,39002.223,79.37,5.72,0.909,3
100,15,455,8100,10,119,0,136080,45.37,126476458,347.778,48.2,27.049,39002.223,79.37,5.72,0.909,3
100,16,482,8582,17,136,0,136080,47.22,126476458,347.778,48.2,27.049,39002.223,79.37,5.72,0.909,3
100,17,585,9167,12,148,0,136080,47.22,126476458,347.778,48.2,27.049,39002.223,79.37,5.72,0.909,3
100,18,628,9795,6,154,0,193202,47.22,126476458,347.778,48.2,27.049,39002.223,79.37,5.72,0.909,3
100,19,566,10361,7,161,0,193202,47.22,126476458,347.778,48.2,27.049,39002.223,79.37,5.72,0.909,3
100,20,390,10751,10,171,0,193202,47.22,126476458,347.778,48.2,27.049,39002.223,79.37,5.72,0.909,3
100,21,367,11118,15,186,0,193202,47.22,126476458,347.778,48.2,27.049,39002.223,79.37,5.72,0.909,3
100,22,378,11496,0,186,0,193202,47.22,126476458,347.778,48.2,27.049,39002.223,79.37,5.72,0.909,3
100,23,276,11772,101,287,0,193202,47.22,126476458,347.778,48.2,27.049,39002.223,79.37,5.72,0.909,3
100,24,468,12240,30,317,0,193202,47.22,126476458,347.778,48.2,27.049,39002.223,79.37,5.72,0.909,3
100,25,652,12892,17,334,0,251473,47.22,126476458,347.778,48.2,27.049,39002.223,79.37,5.72,0.909,3
100,26,290,13182,14,348,0,251473,47.22,126476458,347.778,48.2,27.049,39002.223,79.37,5.72,0.909,3
100,27,203,13385,3,351,0,251473,47.22,126476458,347.778,48.2,27.049,39002.223,79.37,5.72,0.909,3
100,28,191,13576,25,376,0,251473,47.22,126476458,347.778,48.2,27.049,39002.223,79.37,5.72,0.909,3
100,29,276,13852,13,389,0,251473,47.22,126476458,347.778,48.2,27.049,39002.223,79.37,5.72,0.909,3
100,30,236,14088,26,415,0,251473,47.22,126476458,347.778,48.2,27.049,39002.223,79.37,5.72,0.909,3
100,31,193,14281,17,432,0,251473,47.22,126476458,347.778,48.2,27.049,39002.223,79.37,5.72,0.909,3
100,32,263,14544,26,458,0,307601,47.22,126476458,347.778,48.2,27.049,39002.223,79.37,5.72,0.909,3
100,33,295,14839,34,492,0,307601,47.22,126476458,347.778,48.2,27.049,39002.223,79.37,5.72,0.909,3
100,34,218,15057,18,510,0,307601,47.22,126476458,347.778,48.2,27.049,39002.223,79.37,5.72,0.909,3
100,35,174,15231,11,521,0,307601,47.22,126476458,347.778,48.2,27.049,39002.223,79.37,5.72,0.909,3
100,36,123,15354,22,543,0,307601,47.22,126476458,347.778,48.2,27.049,39002.223,79.37,5.72,0.909,3
100,37,109,15463,8,551,0,307601,47.22,126476458,347.778,48.2,27.049,39002.223,79.37,5.72,0.909,3
100,38,84,15547,6,557,0,307601,47.22,126476458,347.778,48.2,27.049,39002.223,79.37,5.72,0.909,3
100,39,81,15628,44,601,0,354236,47.22,126476458,347.778,48.2,27.049,39002.223,79.37,5.72,0.909,3
100,40,119,15747,12,613,0,354236,47.22,126476458,347.778,48.2,27.049,39002.223,79.37,5.72,0.909,3
100,41,51,15798,8,621,0,354236,47.22,126476458,347.778,48.2,27.049,39002.223,79.37,5.72,0.909,3
100,42,76,15874,22,643,0,354236,47.22,126476458,347.778,48.2,27.049,39002.223,79.37,5.72,0.909,3
100,43,150,16024,25,668,0,354236,47.22,126476458,347.778,48.2,27.049,39002.223,79.37,5.72,0.909,3
100,44,55,16079,19,687,0,354236,40.74,126476458,347.778,48.2,27.049,39002.223,79.37,5.72,0.909,3
100,45,114,16193,23,710,0,354236,40.74,126476458,347.778,48.2,27.049,39002.223,79.37,5.72,0.909,3
100,46,44,16237,15,725,0,406752,40.74,126476458,347.778,48.2,27.049,39002.223,79.37,5.72,0.909,3
100,47,48,16285,19,744,0,406752,40.74,126476458,347.778,48.2,27.049,39002.223,79.37,5.72,0.909,3
100,48,20,16305,5,749,0,406752,40.74,126476458,347.778,48.2,27.049,39002.223,79.37,5.72,0.909,3
100,49,60,16365,14,763,0,406752,40.74,126476458,347.778,48.2,27.049,39002.223,79.37,5.72,0.909,3
100,50,20,16385,8,771,0,406752,40.74,126476458,347.778,48.2,27.049,39002.223,79.37,5.72,0.909,3
100,51,39,16424,6,777,0,406752,40.74,126476458,347.778,48.2,27.049,39002.223,79.37,5.72,0.909,3
100,52,89,16513,19,796,0,406752,40.74,126476458,347.778,48.2,27.049,39002.223,79.37,5.72,0.909,3
100,53,23,16536,12,808,0,447484,40.74,126476458,347.778,48.2,27.049,39002.223,79.37,5.72,0.909,3
100,54,14,16550,12,820,0,447484,40.74,126476458,347.778,48.2,27.049,39002.223,79.37,5.72,0.909,3
100,55,31,16581,10,830,0,447484,31.48,126476458,347.778,48.2,27.049,39002.223,79.37,5.72,0.909,3
100,56,42,16623,16,846,0,447484,34.26,126476458,347.778,48.2,27.049,39002.223,79.37,5.72,0.909,3
100,57,28,16651,12,858,0,447484,34.26,126476458,347.778,48.2,27.049,39002.223,79.37,5.72,0.909,3
100,58,0,16651,0,858,0,447484,34.26,126476458,347.778,48.2,27.049,39002.223,79.37,5.72,0.909,3
100,59,68,16719,16,874,0,447484,34.26,126476458,347.778,48.2,27.049,39002.223,79.37,5.72,0.909,3
100,60,85,16804,12,886,0,484972,34.26,126476458,347.778,48.2,27.049,39002.223,79.37,5.72,0.909,3
100,61,47,16851,5,891,0,484972,34.26,126476458,347.778,48.2,27.049,39002.223,79.37,5.72,0.909,3
100,62,33,16884,1,892,0,484972,26.85,126476458,347.778,48.2,27.049,39002.223,79.37,5.72,0.909,3
100,63,46,16930,2,894,0,484972,26.85,126476458,347.778,48.2,27.049,39002.223,79.37,5.72,0.909,3
100,64,56,16986,6,900,0,484972,26.85,126476458,347.778,48.2,27.049,39002.223,79.37,5.72,0.909,3
100,65,32,17018,3,903,0,484972,26.85,126476458,347.778,48.2,27.049,39002.223,79.37,5.72,0.909,3
100,66,46,17064,4,907,0,484972,26.85,126476458,347.778,48.2,27.049,39002.223,79.37,5.72,0.909,3
100,67,39,17103,7,914,0,529482,26.85,126476458,347.778,48.2,27.049,39002.223,79.37,5.72,0.909,3
100,68,38,17141,2,916,0,529482,26.85,126476458,347.778,48.2,27.049,39002.223,79.37,5.72,0.909,3
100,69,33,17174,0,916,0,529482,26.85,126476458,347.778,48.2,27.049,39002.223,79.37,5.72,0.909,3
100,70,36,17210,0,916,0,529482,26.85,126476458,347.778,48.2,27.049,39002.223,79.37,5.72,0.909,3
100,71,41,17251,3,919,0,529482,26.85,126476458,347.778,48.2,27.049,39002.223,79.37,5.72,0.909,3
100,72,41,17292,1,920,0,529482,26.85,126476458,347.778,48.2,27.049,39002.223,79.37,5.72,0.909,3
100,73,40,17332,2,922,0,529482,26.85,126476458,347.778,48.2,27.049,39002.223,79.37,5.72,0.909,3
100,74,50,17382,2,924,0,576841,26.85,126476458,347.778,48.2,27.049,39002.223,79.37,5.72,0.909,3
100,75,47,17429,1,925,0,576841,26.85,126476458,347.778,48.2,27.049,39002.223,79.37,5.72,0.909,3
100,76,73,17502,0,925,0,576841,26.85,126476458,347.778,48.2,27.049,39002.223,79.37,5.72,0.909,3
100,77,85,17587,2,927,0,576841,26.85,126476458,347.778,48.2,27.049,39002.223,79.37,5.72,0.909,3
100,78,41,17628,4,931,0,576841,26.85,126476458,347.778,48.2,27.049,39002.223,79.37,5.72,0.909,3
100,79,40,17668,4,935,0,576841,26.85,126476458,347.778,48.2,27.049,39002.223,79.37,5.72,0.909,3
100,80,72,17740,0,935,0,576841,26.85,126476458,347.778,48.2,27.049,39002.223,79.37,5.72,0.909,3
100,81,59,17799,17,952,0,622956,26.85,126476458,347.778,48.2,27.049,39002.223,79.37,5.72,0.909,3
100,82,0,17799,0,952,0,622956,24.07,126476458,347.778,48.2,27.049,39002.223,79.37,5.72,0.909,3
100,83,117,17916,1,953,0,622956,24.07,126476458,347.778,48.2,27.049,39002.223,79.37,5.72,0.909,3
100,84,52,17968,2,955,0,622956,24.07,126476458,347.778,48.2,27.049,39002.223,79.37,5.72,0.909,3
100,85,59,18027,8,963,0,622956,24.07,126476458,347.778,48.2,27.049,39002.223,79.37,5.72,0.909,3
100,86,83,18110,5,968,0,622956,24.07,126476458,347.778,48.2,27.049,39002.223,79.37,5.72,0.909,3
100,87,87,18197,1,969,0,622956,24.07,126476458,347.778,48.2,27.049,39002.223,79.37,5.72,0.909,3
100,88,100,18297,2,971,0,672641,24.07,126476458,347.778,48.2,27.049,39002.223,79.37,5.72,0.909,3
100,89,93,18390,0,971,0,672641,24.07,126476458,347.778,48.2,27.049,39002.223,79.37,5.72,0.909,3
100,90,86,18476,1,972,0,672641,24.07,126476458,347.778,48.2,27.049,39002.223,79.37,5.72,0.909,3
100,91,117,18593,0,972,0,672641,24.07,126476458,347.778,48.2,27.049,39002.223,79.37,5.72,0.909,3
100,92,130,18723,2,974,0,672641,24.07,126476458,347.778,48.2,27.049,39002.223,79.37,5.72,0.909,3
100,93,151,18874,1,975,0,672641,24.07,126476458,347.778,48.2,27.049,39002.223,79.37,5.72,0.909,3
100,94,194,19068,1,976,0,672641,24.07,126476458,347.778,48.2,27.049,39002.223,79.37,5.72,0.909,3
100,95,214,19282,1,977,0,731228,24.07,126476458,347.778,48.2,27.049,39002.223,79.37,5.72,0.909,3
100,96,240,19522,0,977,0,731228,24.07,126476458,347.778,48.2,27.049,39002.223,79.37,5.72,0.909,3
100,97,253,19775,0,977,0,731228,24.07,126476458,347.778,48.2,27.049,39002.223,79.37,5.72,0.909,3
100,98,206,19981,1,978,0,731228,24.07,126476458,347.778,48.2,27.049,39002.223,79.37,5.72,0.909,3
100,99,193,20174,2,980,0,731228,24.07,126476458,347.778,48.2,27.049,39002.223,79.37,5.72,0.909,3
100,100,197,20371,1,981,0,731228,24.07,126476458,347.778,48.2,27.049,39002.223,79.37,5.72,0.909,3
100,101,348,20719,1,982,0,731228,24.07,126476458,347.778,48.2,27.049,39002.223,79.37,5.72,0.909,3
100,102,410,21129,0,982,0,810752,24.07,126476458,347.778,48.2,27.049,39002.223,79.37,5.72,0.909,3
100,103,373,21502,0,982,0,810752,24.07,126476458,347.778,48.2,27.049,39002.223,79.37,5.72,0.909,3
100,104,366,21868,0,982,0,810752,24.07,126476458,347.778,48.2,27.049,39002.223,79.37,5.72,0.909,3
100,105,352,22220,0,982,0,810752,24.07,126476458,347.778,48.2,27.049,39002.223,79.37,5.72,0.909,3
100,106,288,22508,2,984,0,810752,24.07,126476458,347.778,48.2,27.049,39002.223,79.37,5.72,0.909,3
100,107,382,22890,1,985,0,810752,24.07,126476458,347.778,48.2,27.049,39002.223,79.37,5.72,0.909,3
100,108,583,23473,0,985,0,810752,24.07,126476458,347.778,48.2,27.049,39002.223,79.37,5.72,0.909,3
100,109,659,24132,0,985,0,913108,24.07,126476458,347.778,48.2,27.049,39002.223,79.37,5.72,0.909,3
100,110,510,24642,0,985,0,913108,24.07,126476458,347.778,48.2,27.049,39002.223,79.37,5.72,0.909,3
100,111,454,25096,0,985,0,913108,24.07,126476458,347.778,48.2,27.049,39002.223,79.37,5.72,0.909,3
100,112,640,25736,3,988,0,913108,24.07,126476458,347.778,48.2,27.049,39002.223,79.37,5.72,0.909,3
100,113,567,26303,1,989,0,913108,24.07,126476458,347.778,48.2,27.049,39002.223,79.37,5.72,0.909,3
100,114,726,27029,1,990,0,913108,28.7,126476458,347.778,48.2,27.049,39002.223,79.37,5.72,0.909,3
100,115,927,27956,2,992,0,913108,28.7,126476458,347.778,48.2,27.049,39002.223,79.37,5.72,0.909,3
100,116,830,28786,1,993,0,1017420,28.7,126476458,347.778,48.2,27.049,39002.223,79.37,5.72,0.909,3
100,117,596,29382,3,996,0,1017420,32.41,126476458,347.778,48.2,27.049,39002.223,79.37,5.72,0.909,3
100,118,607,29989,0,996,0,1017420,32.41,126476458,347.778,48.2,27.049,39002.223,79.37,5.72,0.909,3
100,119,0,29989,0,996,0,1017420,32.41,126476458,347.778,48.2,27.049,39002.223,79.37,5.72,0.909,3
100,120,1344,31333,4,1000,0,1017420,32.41,126476458,347.778,48.2,27.049,39002.223,79.37,5.72,0.909,3
100,121,1126,32459,3,1003,0,1017420,32.41,126476458,347.778,48.2,27.049,39002.223,79.37,5.72,0.909,3
100,122,1315,33774,2,1005,0,1017420,32.41,126476458,347.778,48.2,27.049,39002.223,79.37,5.72,0.909,3
100,123,598,34372,1,1006,0,1173215,32.41,126476458,347.778,48.2,27.049,39002.223,79.37,5.72,0.909,3
100,124,1709,36081,4,1010,0,1173215,32.41,126476458,347.778,48.2,27.049,39002.223,79.37,5.72,0.909,3
100,125,1991,38072,1,1011,0,1173215,32.41,126476458,347.778,48.2,27.049,39002.223,79.37,5.72,0.909,3
100,126,1786,39858,5,1016,0,1173215,32.41,126476458,347.778,48.2,27.049,39002.223,79.37,5.72,0.909,3
100,127,1271,41129,6,1022,0,1173215,32.41,126476458,347.778,48.2,27.049,39002.223,79.37,5.72,0.909,3
100,128,1134,42263,4,1026,0,1173215,30.56,126476458,347.778,48.2,27.049,39002.223,79.37,5.72,0.909,3
100,129,1552,43815,7,1033,0,1173215,30.56,126476458,347.778,48.2,27.049,39002.223,79.37,5.72,0.909,3
100,130,1624,45439,6,1039,0,1355956,30.56,126476458,347.778,48.2,27.049,39002.223,79.37,5.72,0.909,3
100,131,1344,46783,1,1040,0,1355956,30.56,126476458,347.778,48.2,27.049,39002.223,79.37,5.72,0.909,3
100,132,1207,47990,7,1047,0,1355956,30.56,126476458,347.778,48.2,27.049,39002.223,79.37,5.72,0.909,3
100,133,248,48238,4,1051,0,1355956,30.56,126476458,347.778,48.2,27.049,39002.223,79.37,5.72,0.909,3
100,134,1274,49512,7,1058,0,1355956,30.56,126476458,347.778,48.2,27.049,39002.223,79.37,5.72,0.909,3
100,135,932,50444,4,1062,0,1355956,30.56,126476458,347.778,48.2,27.049,39002.223,79.37,5.72,0.909,3
100,136,1069,51513,10,1072,0,1355956,30.56,126476458,347.778,48.2,27.049,39002.223,79.37,5.72,0.909,3
100,137,2064,53577,13,1085,0,1507108,30.56,126476458,347.778,48.2,27.049,39002.223,79.37,5.72,0.909,3
100,138,1137,54714,3,1088,0,1507108,30.56,126476458,347.778,48.2,27.049,39002.223,79.37,5.72,0.909,3
100,139,238,54952,10,1098,0,1507108,30.56,126476458,347.778,48.2,27.049,39002.223,79.37,5.72,0.909,3
100,140,1006,55958,16,1114,0,1507108,30.56,126476458,347.778,48.2,27.049,39002.223,79.37,5.72,0.909,3
100,141,1592,57550,14,1128,0,1507108,30.56,126476458,347.778,48.2,27.049,39002.223,79.37,5.72,0.909,3
100,142,951,58501,16,1144,0,1507108,30.56,126476458,347.778,48.2,27.049,39002.223,79.37,5.72,0.909,3
100,143,1220,59721,11,1155,0,1507108,30.56,126476458,347.778,48.2,27.049,39002.223,79.37,5.72,0.909,3
100,144,1012,60733,14,1169,0,1681228,30.56,126476458,347.778,48.2,27.049,39002.223,79.37,5.72,0.909,3
100,145,1014,61747,7,1176,0,1681228,30.56,126476458,347.778,48.2,27.049,39002.223,79.37,5.72,0.909,3
100,146,7,61754,4,1180,0,1681228,30.56,126476458,347.778,48.2,27.049,39002.223,79.37,5.72,0.909,3
100,147,1367,63121,16,1196,0,1681228,30.56,126476458,347.778,48.2,27.049,39002.223,79.37,5.72,0.909,3
100,148,701,63822,13,1209,0,1681228,30.56,126476458,347.778,48.2,27.049,39002.223,79.37,5.72,0.909,3
100,149,846,64668,17,1226,0,1681228,30.56,126476458,347.778,48.2,27.049,39002.223,79.37,5.72,0.909,3
100,150,905,65573,12,1238,0,1681228,30.56,126476458,347.778,48.2,27.049,39002.223,79.37,5.72,0.909,3
100,151,850,66423,17,1255,0,1843388,30.56,126476458,347.778,48.2,27.049,39002.223,79.37,5.72,0.909,3
100,152,841,67264,9,1264,0,1843388,30.56,126476458,347.778,48.2,27.049,39002.223,79.37,5.72,0.909,3
100,153,601,67865,15,1279,0,1843388,30.56,126476458,347.778,48.2,27.049,39002.223,79.37,5.72,0.909,3
100,154,527,68392,17,1296,0,1843388,30.56,126476458,347.778,48.2,27.049,39002.223,79.37,5.72,0.909,3
100,155,609,69001,11,1307,0,1843388,30.56,126476458,347.778,48.2,27.049,39002.223,79.37,5.72,0.909,3
100,156,598,69599,12,1319,0,1843388,30.56,126476458,347.778,48.2,27.049,39002.223,79.37,5.72,0.909,3
100,157,669,70268,11,1330,0,1843388,30.56,126476458,347.778,48.2,27.049,39002.223,79.37,5.72,0.909,3
100,158,608,70876,19,1349,0,2007880,30.56,126476458,347.778,48.2,27.049,39002.223,79.37,5.72,0.909,3
100,159,543,71419,8,1357,0,2007880,30.56,126476458,347.778,48.2,27.049,39002.223,79.37,5.72,0.909,3
100,160,437,71856,6,1363,0,2007880,30.56,126476458,347.778,48.2,27.049,39002.223,79.37,5.72,0.909,3
100,161,378,72234,14,1377,0,2007880,30.56,126476458,347.778,48.2,27.049,39002.223,79.37,5.72,0.909,3
100,162,492,72726,16,1393,0,2007880,30.56,126476458,347.778,48.2,27.049,39002.223,79.37,5.72,0.909,3
100,163,495,73221,13,1406,0,2007880,37.04,126476458,347.778,48.2,27.049,39002.223,79.37,5.72,0.909,3
100,164,680,73901,6,1412,0,2007880,37.04,126476458,347.778,48.2,27.049,39002.223,79.37,5.72,0.909,3
100,165,643,74544,11,1423,0,2149944,37.04,126476458,347.778,48.2,27.049,39002.223,79.37,5.72,0.909,3
100,166,674,75218,16,1439,0,2149944,37.04,126476458,347.778,48.2,27.049,39002.223,79.37,5.72,0.909,3
100,167,439,75657,3,1442,0,2149944,37.04,126476458,347.778,48.2,27.049,39002.223,79.37,5.72,0.909,3
100,168,301,75958,9,1451,0,2149944,37.04,126476458,347.778,48.2,27.049,39002.223,79.37,5.72,0.909,3
100,169,490,76448,10,1461,0,2149944,37.04,126476458,347.778,48.2,27.049,39002.223,79.37,5.72,0.909,3
100,170,561,77009,12,1473,0,2149944,37.04,126476458,347.778,48.2,27.049,39002.223,79.37,5.72,0.909,3
100,171,485,77494,9,1482,0,2149944,37.04,126476458,347.778,48.2,27.049,39002.223,79.37,5.72,0.909,3
100,172,579,78073,13,1495,0,2295541,37.04,126476458,347.778,48.2,27.049,39002.223,79.37,5.72,0.909,3
100,173,584,78657,5,1500,0,2295541,37.04,126476458,347.778,48.2,27.049,39002.223,79.37,5.72,0.909,3
100,174,0,78657,0,1500,0,2295541,37.04,126476458,347.778,48.2,27.049,39002.223,79.37,5.72,0.909,3
100,175,781,79438,8,1508,0,2295541,37.04,126476458,347.778,48.2,27.049,39002.223,79.37,5.72,0.909,3
100,176,330,79768,4,1512,0,2295541,37.04,126476458,347.778,48.2,27.049,39002.223,79.37,5.72,0.909,3
100,177,273,80041,8,1520,0,2295541,31.48,126476458,347.778,48.2,27.049,39002.223,79.37,5.72,0.909,3
100,178,456,80497,12,1532,0,2295541,31.48,126476458,347.778,48.2,27.049,39002.223,79.37,5.72,0.909,3
100,179,558,81055,8,1540,0,2408962,31.48,126476458,347.778,48.2,27.049,39002.223,79.37,5.72,0.909,3
100,180,635,81690,5,1545,0,2408962,31.48,126476458,347.778,48.2,27.049,39002.223,79.37,5.72,0.909,3
100,181,441,82131,3,1548,0,2408962,31.48,126476458,347.778,48.2,27.049,39002.223,79.37,5.72,0.909,3
100,182,363,82494,9,1557,0,2408962,31.48,126476458,347.778,48.2,27.049,39002.223,79.37,5.72,0.909,3
100,183,516,83010,7,1564,0,2408962,31.48,126476458,347.778,48.2,27.049,39002.223,79.37,5.72,0.909,3
100,184,0,83010,0,1564,0,2408962,31.48,126476458,347.778,48.2,27.049,39002.223,79.37,5.72,0.909,3
100,185,1205,84215,14,1578,0,2408962,31.48,126476458,347.778,48.2,27.049,39002.223,79.37,5.72,0.909,3
100,186,553,84768,12,1590,0,2559119,31.48,126476458,347.778,48.2,27.049,39002.223,79.37,5.72,0.909,3
100,187,571,85339,7,1597,9223,2568342,31.48,126476458,347.778,48.2,27.049,39002.223,79.37,5.72,0.909,3
100,188,400,85739,2,1599,19868,2588210,31.48,126476458,347.778,48.2,27.049,39002.223,79.37,5.72,0.909,3
100,189,308,86047,3,1602,23422,2611632,31.48,126476458,347.778,48.2,27.049,39002.223,79.37,5.72,0.909,3
100,190,496,86543,3,1605,25909,2637541,31.48,126476458,347.778,48.2,27.049,39002.223,79.37,5.72,0.909,3
100,191,477,87020,8,1613,24511,2662052,31.48,126476458,347.778,48.2,27.049,39002.223,79.37,5.72,0.909,3
100,192,619,87639,3,1616,22649,2684701,31.48,126476458,347.778,48.2,27.049,39002.223,79.37,5.72,0.909,3
100,193,594,88233,8,1624,18802,2703503,31.48,126476458,347.778,48.2,27.049,39002.223,79.37,5.72,0.909,3
100,194,679,88912,3,1627,8419,2711922,31.48,126476458,347.778,48.2,27.049,39002.223,79.37,5.72,0.909,3
100,195,435,89347,2,1629,20319,2732241,31.48,126476458,347.778,48.2,27.049,39002.223,79.37,5.72,0.909,3
100,196,326,89673,5,1634,20006,2752247,31.48,126476458,347.778,48.2,27.049,39002.223,79.37,5.72,0.909,3
100,197,467,90140,4,1638,22064,2774311,31.48,126476458,347.778,48.2,27.049,39002.223,79.37,5.72,0.909,3
100,198,570,90710,8,1646,19310,2793621,31.48,126476458,347.778,48.2,27.049,39002.223,79.37,5.72,0.909,3
100,199,721,91431,4,1650,0,2793621,31.48,126476458,347.778,48.2,27.049,39002.223,79.37,5.72,0.909,3
100,200,632,92063,11,1661,0,2793621,31.48,126476458,347.778,48.2,27.049,39002.223,79.37,5.72,0.909,3
100,201,593,92656,9,1670,0,2793621,31.48,126476458,347.778,48.2,27.049,39002.223,79.37,5.72,0.909,3
100,202,471,93127,4,1674,0,2793621,31.48,126476458,347.778,48.2,27.049,39002.223,79.37,5.72,0.909,3
100,203,353,93480,2,1676,0,2793621,31.48,126476458,347.778,48.2,27.049,39002.223,79.37,5.72,0.909,3
100,204,453,93933,3,1679,0,2793621,31.48,126476458,347.778,48.2,27.049,39002.223,79.37,5.72,0.909,3
102,1,6,274,0,5,0,0,100,10203140,109.285,23.2,3.81,8337.49,208.257,11.75,0.735,0
102,2,4,278,0,5,0,0,100,10203140,109.285,23.2,3.81,8337.49,208.257,11.75,0.735,0
102,3,21,299,0,5,0,0,100,10203140,109.285,23.2,3.81,8337.49,208.257,11.75,0.735,0
102,4,0,299,0,5,0,0,100,10203140,109.285,23.2,3.81,8337.49,208.257,11.75,0.735,0
102,5,24,323,0,5,0,0,100,10203140,109.285,23.2,3.81,8337.49,208.257,11.75,0.735,0
102,6,22,345,0,5,0,0,100,10203140,109.285,23.2,3.81,8337.49,208.257,11.75,0.735,0
102,7,4,349,1,6,0,0,100,10203140,109.285,23.2,3.81,8337.49,208.257,11.75,0.735,0
102,8,0,349,0,6,0,0,100,10203140,109.285,23.2,3.81,8337.49,208.257,11.75,0.735,0
102,9,9,358,0,6,0,0,100,10203140,109.285,23.2,3.81,8337.49,208.257,11.75,0.735,0
102,10,14,372,1,7,0,0,100,10203140,109.285,23.2,3.81,8337.49,208.257,11.75,0.735,0
102,11,0,372,0,7,0,0,100,10203140,109.285,23.2,3.81,8337.49,208.257,11.75,0.735,0
102,12,9,381,0,7,0,0,100,10203140,109.285,23.2,3.81,8337.49,208.257,11.75,0.735,0
102,13,8,389,0,7,0,0,100,10203140,109.285,23.2,3.81,8337.49,208.257,11.75,0.735,0
102,14,2,391,0,7,0,0,100,10203140,109.285,23.2,3.81,8337.49,208.257,11.75,0.735,0
102,15,6,397,0,7,0,0,100,10203140,109.285,23.2,3.81,8337.49,208.257,11.75,0.735,0
102,16,4,401,0,7,0,0,100,10203140,109.285,23.2,3.81,8337.49,208.257,11.75,0.735,0
102,17,1,402,0,7,0,0,100,10203140,109.285,23.2,3.81,8337.49,208.257,11.75,0.735,0
102,18,5,407,0,7,0,0,100,10203140,109.285,23.2,3.81,8337.49,208.257,11.75,0.735,0
102,19,6,413,0,7,0,0,100,10203140,109.285,23.2,3.81,8337.49,208.257,11.75,0.735,0
102,20,4,417,0,7,0,0,100,10203140,109.285,23.2,3.81,8337.49,208.257,11.75,0.735,0
102,21,8,425,0,7,0,0,96.3,10203140,109.285,23.2,3.81,8337.49,208.257,11.75,0.735,0
102,22,0,425,0,7,0,0,96.3,10203140,109.285,23.2,3.81,8337.49,208.257,11.75,0.735,0
102,23,3,428,0,7,0,0,96.3,10203140,109.285,23.2,3.81,8337.49,208.257,11.75,0.735,0
102,24,9,437,0,7,0,0,96.3,10203140,109.285,23.2,3.81,8337.49,208.257,11.75,0.735,0
102,25,4,441,0,7,0,0,96.3,10203140,109.285,23.2,3.81,8337.49,208.257,11.75,0.735,0
102,26,3,444,0,7,0,0,96.3,10203140,109.285,23.2,3.81,8337.49,208.257,11.75,0.735,0
102,27,3,447,0,7,0,0,89.81,10203140,109.285,23.2,3.81,8337.49,208.257,11.75,0.735,0
102,28,2,449,0,7,0,0,89.81,10203140,109.285,23.2,3.81,8337.49,208.257,11.75,0.735,0
102,29,0,449,1,8,0,0,89.81,10203140,109.285,23.2,3.81,8337.49,208.257,11.75,0.735,0
102,30,2,451,0,8,0,0,89.81,10203140,109.285,23.2,3.81,8337.49,208.257,11.75,0.735,0
102,31,2,453,0,8,0,78885,89.81,10203140,109.285,23.2,3.81,8337.49,208.257,11.75,0.735,0
102,32,6,459,0,8,0,78885,89.81,10203140,109.285,23.2,3.81,8337.49,208.257,11.75,0.735,0
102,33,1,460,1,9,0,78885,89.81,10203140,109.285,23.2,3.81,8337.49,208.257,11.75,0.735,0
102,34,1,461,0,9,0,78885,87.04,10203140,109.285,23.2,3.81,8337.49,208.257,11.75,0.735,0
102,35,4,465,0,9,0,78885,87.04,10203140,109.285,23.2,3.81,8337.49,208.257,11.75,0.735,0
102,36,6,471,0,9,0,78885,87.04,10203140,109.285,23.2,3.81,8337.49,208.257,11.75,0.735,0
102,37,2,473,0,9,0,78885,87.04,10203140,109.285,23.2,3.81,8337.49,208.257,11.75,0.735,0
102,38,21,494,0,9,0,78885,87.04,10203140,109.285,23.2,3.81,8337.49,208.257,11.75,0.735,0
102,39,14,508,0,9,0,78885,87.04,10203140,109.285,23.2,3.81,8337.49,208.257,11.75,0.735,0
102,40,14,522,0,9,0,78885,87.04,10203140,109.285,23.2,3.81,8337.49,208.257,11.75,0.735,0
102,41,18,540,0,9,0,78885,87.04,10203140,109.285,23.2,3.81,8337.49,208.257,11.75,0.735,0
102,42,22,562,0,9,0,78885,77.78,10203140,109.285,23.2,3.81,8337.49,208.257,11.75,0.735,0
102,43,14,576,0,9,0,78885,77.78,10203140,109.285,23.2,3.81,8337.49,208.257,11.75,0.735,0
102,44,6,582,0,9,0,78885,77.78,10203140,109.285,23.2,3.81,8337.49,208.257,11.75,0.735,0
102,45,4,586,0,9,0,78885,77.78,10203140,109.285,23.2,3.81,8337.49,208.257,11.75,0.735,0
102,46,10,596,0,9,0,78885,77.78,10203140,109.285,23.2,3.81,8337.49,208.257,11.75,0.735,0
102,47,11,607,0,9,0,78885,77.78,10203140,109.285,23.2,3.81,8337.49,208.257,11.75,0.735,0
102,48,6,613,0,9,0,78885,77.78,10203140,109.285,23.2,3.81,8337.49,208.257,11.75,0.735,0
102,49,16,629,0,9,0,78885,77.78,10203140,109.285,23.2,3.81,8337.49,208.257,11.75,0.735,0
102,50,20,649,0,9,0,78885,77.78,10203140,109.285,23.2,3.81,8337.49,208.257,11.75,0.735,0
102,51,23,672,0,9,0,78885,77.78,10203140,109.285,23.2,3.81,8337.49,208.257,11.75,0.735,0
102,52,12,684,0,9,0,78885,77.78,10203140,109.285,23.2,3.81,8337.49,208.257,11.75,0.735,0
102,53,16,700,0,9,0,78885,77.78,10203140,109.285,23.2,3.81,8337.49,208.257,11.75,0.735,0
102,54,4,704,0,9,0,78885,77.78,10203140,109.285,23.2,3.81,8337.49,208.257,11.75,0.735,0
102,55,4,708,0,9,0,78885,77.78,10203140,109.285,23.2,3.81,8337.49,208.257,11.75,0.735,0
102,56,3,711,0,9,0,78885,77.78,10203140,109.285,23.2,3.81,8337.49,208.257,11.75,0.735,0
102,57,7,718,0,9,0,78885,77.78,10203140,109.285,23.2,3.81,8337.49,208.257,11.75,0.735,0
102,58,2,720,0,9,0,78885,77.78,10203140,109.285,23.2,3.81,8337.49,208.257,11.75,0.735,0
102,59,8,728,0,9,0,78885,77.78,10203140,109.285,23.2,3.81,8337.49,208.257,11.75,0.735,0
102,60,2,730,0,9,0,78885,77.78,10203140,109.285,23.2,3.81,8337.49,208.257,11.75,0.735,0
102,61,4,734,0,9,0,78885,77.78,10203140,109.285,23.2,3.81,8337.49,208.257,11.75,0.735,0
102,62,5,739,0,9,0,78885,77.78,10203140,109.285,23.2,3.81,8337.49,208.257,11.75,0.735,0
102,63,7,746,0,9,0,78885,77.78,10203140,109.285,23.2,3.81,8337.49,208.257,11.75,0.735,0
102,64,9,755,0,9,0,78885,77.78,10203140,109.285,23.2,3.81,8337.49,208.257,11.75,0.735,0
102,65,2,757,0,9,0,78885,77.78,10203140,109.285,23.2,3.81,8337.49,208.257,11.75,0.735,0
102,66,8,765,0,9,0,78885,77.78,10203140,109.285,23.2,3.81,8337.49,208.257,11.75,0.735,0
102,67,19,784,0,9,0,78885,48.15,10203140,109.285,23.2,3.81,8337.49,208.257,11.75,0.735,0
102,68,11,795,0,9,0,78885,48.15,10203140,109.285,23.2,3.81,8337.49,208.257,11.75,0.735,0
102,69,13,808,0,9,0,78885,48.15,10203140,109.285,23.2,3.81,8337.49,208.257,11.75,0.735,0
102,70,23,831,0,9,0,78885,48.15,10203140,109.285,23.2,3.81,8337.49,208.257,11.75,0.735,0
102,71,14,845,0,9,0,78885,48.15,10203140,109.285,23.2,3.81,8337.49,208.257,11.75,0.735,0
102,72,18,863,0,9,0,78885,48.15,10203140,109.285,23.2,3.81,8337.49,208.257,11.75,0.735,0
102,73,27,890,0,9,0,78885,48.15,10203140,109.285,23.2,3.81,8337.49,208.257,11.75,0.735,0
102,74,25,915,0,9,0,78885,48.15,10203140,109.285,23.2,3.81,8337.49,208.257,11.75,0.735,0
102,75,38,953,0,9,0,78885,48.15,10203140,109.285,23.2,3.81,8337.49,208.257,11.75,0.735,0
102,76,8,961,0,9,0,78885,48.15,10203140,109.285,23.2,3.81,8337.49,208.257,11.75,0.735,0
102,77,18,979,0,9,0,78885,48.15,10203140,109.285,23.2,3.81,8337.49,208.257,11.75,0.735,0
102,78,2,981,0,9,0,78885,48.15,10203140,109.285,23.2,3.81,8337.49,208.257,11.75,0.735,0
102,79,6,987,0,9,0,78885,48.15,10203140,109.285,23.2,3.81,8337.49,208.257,11.75,0.735,0
102,80,14,1001,0,9,0,78885,48.15,10203140,109.285,23.2,3.81,8337.49,208.257,11.75,0.735,0
102,81,7,1008,0,9,0,78885,48.15,10203140,109.285,23.2,3.81,8337.49,208.257,11.75,0.735,0
102,82,7,1015,0,9,0,78885,48.15,10203140,109.285,23.2,3.81,8337.49,208.257,11.75,0.735,0
102,83,18,1033,0,9,0,78885,48.15,10203140,109.285,23.2,3.81,8337.49,208.257,11.75,0.735,0
102,84,9,1042,0,9,0,78885,48.15,10203140,109.285,23.2,3.81,8337.49,208.257,11.75,0.735,0
102,85,5,1047,0,9,0,78885,48.15,10203140,109.285,23.2,3.81,8337.49,208.257,11.75,0.735,0
102,86,24,1071,0,9,0,78885,48.15,10203140,109.285,23.2,3.81,8337.49,208.257,11.75,0.735,0
102,87,15,1086,0,9,0,78885,48.15,10203140,109.285,23.2,3.81,8337.49,208.257,11.75,0.735,0
102,88,18,1104,0,9,0,78885,48.15,10203140,109.285,23.2,3.81,8337.49,208.257,11.75,0.735,0
102,89,7,1111,0,9,0,78885,48.15,10203140,109.285,23.2,3.81,8337.49,208.257,11.75,0.735,0
102,90,10,1121,0,9,0,78885,48.15,10203140,109.285,23.2,3.81,8337.49,208.257,11.75,0.735,0
102,91,7,1128,0,9,0,78885,48.15,10203140,109.285,23.2,3.81,8337.49,208.257,11.75,0.735,0
102,92,4,1132,0,9,0,78885,48.15,10203140,109.285,23.2,3.81,8337.49,208.257,11.75,0.735,0
102,93,1,1133,0,9,0,78885,48.15,10203140,109.285,23.2,3.81,8337.49,208.257,11.75,0.735,0
102,94,3,1136,0,9,0,78885,48.15,10203140,109.285,23.2,3.81,8337.49,208.257,11.75,0.735,0
102,95,11,1147,1,10,0,78885,48.15,10203140,109.285,23.2,3.81,8337.49,208.257,11.75,0.735,0
102,96,3,1150,0,10,0,78885,48.15,10203140,109.285,23.2,3.81,8337.49,208.257,11.75,0.735,0
102,97,14,1164,0,10,0,78885,48.15,10203140,109.285,23.2,3.81,8337.49,208.257,11.75,0.735,0
102,98,3,1167,0,10,0,78885,48.15,10203140,109.285,23.2,3.81,8337.49,208.257,11.75,0.735,0
102,99,2,1169,0,10,0,78885,48.15,10203140,109.285,23.2,3.81,8337.49,208.257,11.75,0.735,0
102,100,0,1169,0,10,0,78885,48.15,10203140,109.285,23.2,3.81,8337.49,208.257,11.75,0.735,0
102,101,0,1169,0,10,0,78885,48.15,10203140,109.285,23.2,3.81,8337.49,208.257,11.75,0.735,0
102,102,4,1173,0,10,0,78885,48.15,10203140,109.285,23.2,3.81,8337.49,208.257,11.75,0.735,0
102,103,3,1176,0,10,0,78885,48.15,10203140,109.285,23.2,3.81,8337.49,208.257,11.75,0.735,0
102,104,3,1179,0,10,0,78885,48.15,10203140,109.285,23.2,3.81,8337.49,208.257,11.75,0.735,0
102,105,4,1183,0,10,0,78885,48.15,10203140,109.285,23.2,3.81,8337.49,208.257,11.75,0.735,0
102,106,15,1198,0,10,0,78885,48.15,10203140,109.285,23.2,3.81,8337.49,208.257,11.75,0.735,0
102,107,3,1201,0,10,0,78885,48.15,10203140,109.285,23.2,3.81,8337.49,208.257,11.75,0.735,0
102,108,5,1206,0,10,0,78885,48.15,10203140,109.285,23.2,3.81,8337.49,208.257,11.75,0.735,0
102,109,3,1209,0,10,0,78885,48.15,10203140,109.285,23.2,3.81,8337.49,208.257,11.75,0.735,0
102,110,5,1214,1,11,0,78885,48.15,10203140,109.285,23.2,3.81,8337.49,208.257,11.75,0.735,0
102,111,4,1218,0,11,0,78885,48.15,10203140,109.285,23.2,3.81,8337.49,208.257,11.75,0.735,0
102,112,5,1223,0,11,0,78885,48.15,10203140,109.285,23.2,3.81,8337.49,208.257,11.75,0.735,0
102,113,-110,1113,0,11,0,78885,48.15,10203140,109.285,23.2,3.81,8337.49,208.257,11.75,0.735,0
102,114,7,1120,0,11,0,78885,48.15,10203140,109.285,23.2,3.81,8337.49,208.257,11.75,0.735,0
102,115,11,1131,0,11,0,78885,48.15,10203140,109.285,23.2,3.81,8337.49,208.257,11.75,0.735,0
102,116,15,1146,0,11,0,78885,48.15,10203140,109.285,23.2,3.81,8337.49,208.257,11.75,0.735,0
102,117,8,1154,0,11,0,78885,48.15,10203140,109.285,23.2,3.81,8337.49,208.257,11.75,0.735,0
102,118,14,1168,0,11,0,78885,48.15,10203140,109.285,23.2,3.81,8337.49,208.257,11.75,0.735,0
102,119,8,1176,0,11,0,78885,48.15,10203140,109.285,23.2,3.81,8337.49,208.257,11.75,0.735,0
102,120,6,1182,0,11,0,78885,48.15,10203140,109.285,23.2,3.81,8337.49,208.257,11.75,0.735,0
102,121,5,1187,0,11,0,78885,48.15,10203140,109.285,23.2,3.81,8337.49,208.257,11.75,0.735,0
102,122,4,1191,0,11,0,78885,48.15,10203140,109.285,23.2,3.81,8337.49,208.257,11.75,0.735,0
102,123,2,1193,0,11,0,78885,48.15,10203140,109.285,23.2,3.81,8337.49,208.257,11.75,0.735,0
102,124,1,1194,0,11,0,78885,48.15,10203140,109.285,23.2,3.81,8337.49,208.257,11.75,0.735,0
102,125,19,1213,0,11,0,78885,48.15,10203140,109.285,23.2,3.81,8337.49,208.257,11.75,0.735,0
102,126,5,1218,0,11,0,78885,48.15,10203140,109.285,23.2,3.81,8337.49,208.257,11.75,0.735,0
102,127,6,1224,0,11,0,78885,48.15,10203140,109.285,23.2,3.81,8337.49,208.257,11.75,0.735,0
102,128,7,1231,0,11,0,78885,48.15,10203140,109.285,23.2,3.81,8337.49,208.257,11.75,0.735,0
102,129,1,1232,0,11,0,78885,56.48,10203140,109.285,23.2,3.81,8337.49,208.257,11.75,0.735,0
102,130,5,1237,0,11,0,78885,56.48,10203140,109.285,23.2,3.81,8337.49,208.257,11.75,0.735,0
102,131,9,1246,0,11,0,78885,56.48,10203140,109.285,23.2,3.81,8337.49,208.257,11.75,0.735,0
102,132,6,1252,0,11,0,78885,56.48,10203140,109.285,23.2,3.81,8337.49,208.257,11.75,0.735,0
102,133,16,1268,0,11,0,78885,56.48,10203140,109.285,23.2,3.81,8337.49,208.257,11.75,0.735,0
102,134,15,1283,0,11,0,78885,56.48,10203140,109.285,23.2,3.81,8337.49,208.257,11.75,0.735,0
102,135,20,1303,0,11,0,78885,56.48,10203140,109.285,23.2,3.81,8337.49,208.257,11.75,0.735,0
102,136,17,1320,0,11,0,78885,56.48,10203140,109.285,23.2,3.81,8337.49,208.257,11.75,0.735,0
102,137,9,1329,0,11,0,78885,56.48,10203140,109.285,23.2,3.81,8337.49,208.257,11.75,0.735,0
102,138,10,1339,0,11,0,78885,56.48,10203140,109.285,23.2,3.81,8337.49,208.257,11.75,0.735,0
102,139,39,1378,0,11,0,78885,56.48,10203140,109.285,23.2,3.81,8337.49,208.257,11.75,0.735,0
102,140,20,1398,0,11,0,78885,56.48,10203140,109.285,23.2,3.81,8337.49,208.257,11.75,0.735,0
102,141,40,1438,0,11,0,78885,56.48,10203140,109.285,23.2,3.81,8337.49,208.257,11.75,0.735,0
102,142,44,1482,0,11,0,78885,56.48,10203140,109.285,23.2,3.81,8337.49,208.257,11.75,0.735,0
102,143,16,1498,0,11,0,78885,56.48,10203140,109.285,23.2,3.81,8337.49,208.257,11.75,0.735,0
102,144,34,1532,0,11,0,78885,56.48,10203140,109.285,23.2,3.81,8337.49,208.257,11.75,0.735,0
102,145,44,1576,0,11,0,78885,56.48,10203140,109.285,23.2,3.81,8337.49,208.257,11.75,0.735,0
102,146,33,1609,1,12,0,78885,56.48,10203140,109.285,23.2,3.81,8337.49,208.257,11.75,0.735,0
102,147,30,1639,2,14,0,78885,56.48,10203140,109.285,23.2,3.81,8337.49,208.257,11.75,0.735,0
102,148,77,1716,0,14,0,78885,56.48,10203140,109.285,23.2,3.81,8337.49,208.257,11.75,0.735,0
102,149,40,1756,1,15,0,78885,50.93,10203140,109.285,23.2,3.81,8337.49,208.257,11.75,0.735,0
102,150,45,1801,0,15,0,78885,50.93,10203140,109.285,23.2,3.81,8337.49,208.257,11.75,0.735,0
102,151,68,1869,0,15,0,78885,50.93,10203140,109.285,23.2,3.81,8337.49,208.257,11.75,0.735,0
102,152,24,1893,0,15,0,78885,50.93,10203140,109.285,23.2,3.81,8337.49,208.257,11.75,0.735,0
102,153,73,1966,0,15,0,78885,50.93,10203140,109.285,23.2,3.81,8337.49,208.257,11.75,0.735,0
102,154,68,2034,0,15,0,78885,63.89,10203140,109.285,23.2,3.81,8337.49,208.257,11.75,0.735,0
102,155,63,2097,0,15,0,78885,63.89,10203140,109.285,23.2,3.81,8337.49,208.257,11.75,0.735,0
102,156,64,2161,0,15,0,78885,63.89,10203140,109.285,23.2,3.81,8337.49,208.257,11.75,0.735,0
102,157,72,2233,1,16,0,78885,63.89,10203140,109.285,23.2,3.81,8337.49,208.257,11.75,0.735,0
102,158,68,2301,0,16,0,78885,63.89,10203140,109.285,23.2,3.81,8337.49,208.257,11.75,0.735,0
102,159,52,2353,0,16,0,78885,63.89,10203140,109.285,23.2,3.81,8337.49,208.257,11.75,0.735,0
102,160,58,2411,0,16,0,78885,63.89,10203140,109.285,23.2,3.81,8337.49,208.257,11.75,0.735,0
102,161,67,2478,1,17,0,78885,61.11,10203140,109.285,23.2,3.81,8337.49,208.257,11.75,0.735,0
102,162,103,2581,2,19,0,78885,61.11,10203140,109.285,23.2,3.81,8337.49,208.257,11.75,0.735,0
102,163,78,2659,0,19,0,78885,61.11,10203140,109.285,23.2,3.81,8337.49,208.257,11.75,0.735,0
102,164,80,2739,1,20,0,78885,61.11,10203140,109.285,23.2,3.81,8337.49,208.257,11.75,0.735,0
102,165,206,2945,1,21,0,78885,61.11,10203140,109.285,23.2,3.81,8337.49,208.257,11.75,0.735,0
102,166,117,3062,1,22,0,78885,61.11,10203140,109.285,23.2,3.81,8337.49,208.257,11.75,0.735,0
102,167,252,3314,2,24,0,78885,61.11,10203140,109.285,23.2,3.81,8337.49,208.257,11.75,0.735,0
102,168,214,3528,2,26,0,78885,61.11,10203140,109.285,23.2,3.81,8337.49,208.257,11.75,0.735,0
102,169,149,3677,0,26,0,78885,61.11,10203140,109.285,23.2,3.81,8337.49,208.257,11.75,0.735,0
102,170,175,3852,0,26,0,78885,66.67,10203140,109.285,23.2,3.81,8337.49,208.257,11.75,0.735,0
102,171,279,4131,0,26,0,78885,66.67,10203140,109.285,23.2,3.81,8337.49,208.257,11.75,0.735,0
102,172,213,4344,3,29,0,78885,66.67,10203140,109.285,23.2,3.81,8337.49,208.257,11.75,0.735,0
102,173,196,4540,1,30,0,78885,66.67,10203140,109.285,23.2,3.81,8337.49,208.257,11.75,0.735,0
102,174,239,4779,0,30,0,78885,66.67,10203140,109.285,23.2,3.81,8337.49,208.257,11.75,0.735,0
102,175,266,5045,2,32,0,78885,66.67,10203140,109.285,23.2,3.81,8337.49,208.257,11.75,0.735,0
102,176,634,5679,1,33,0,78885,66.67,10203140,109.285,23.2,3.81,8337.49,208.257,11.75,0.735,0
102,177,363,6042,2,35,0,78885,66.67,10203140,109.285,23.2,3.81,8337.49,208.257,11.75,0.735,0
102,178,549,6591,1,36,0,78885,63.89,10203140,109.285,23.2,3.81,8337.49,208.257,11.75,0.735,0
102,179,620,7211,3,39,0,78885,63.89,10203140,109.285,23.2,3.81,8337.49,208.257,11.75,0.735,0
102,180,850,8061,4,43,0,78885,63.89,10203140,109.285,23.2,3.81,8337.49,208.257,11.75,0.735,0
102,181,431,8492,2,45,0,78885,63.89,10203140,109.285,23.2,3.81,8337.49,208.257,11.75,0.735,0
102,182,734,9226,6,51,0,78885,63.89,10203140,109.285,23.2,3.81,8337.49,208.257,11.75,0.735,0
102,183,823,10049,6,57,0,78885,63.89,10203140,109.285,23.2,3.81,8337.49,208.257,11.75,0.735,0
102,184,1776,11825,4,61,0,78885,63.89,10203140,109.285,23.2,3.81,8337.49,208.257,11.75,0.735,0
102,185,1276,13101,8,69,0,78885,65.74,10203140,109.285,23.2,3.81,8337.49,208.257,11.75,0.735,0
102,186,549,13650,10,79,0,78885,65.74,10203140,109.285,23.2,3.81,8337.49,208.257,11.75,0.735,0
102,187,1099,14749,9,88,0,78885,65.74,10203140,109.285,23.2,3.81,8337.49,208.257,11.75,0.735,0
102,188,891,15640,13,101,0,78885,65.74,10203140,109.285,23.2,3.81,8337.49,208.257,11.75,0.735,0
102,189,1824,17464,9,110,0,78885,78.7,10203140,109.285,23.2,3.81,8337.49,208.257,11.75,0.735,0
102,190,1537,19001,12,122,0,78885,78.7,10203140,109.285,23.2,3.81,8337.49,208.257,11.75,0.735,0
102,191,1199,20200,9,131,0,78885,78.7,10203140,109.285,23.2,3.81,8337.49,208.257,11.75,0.735,0
102,192,1317,21517,13,144,0,78885,78.7,10203140,109.285,23.2,3.81,8337.49,208.257,11.75,0.735,0
102,193,1246,22763,22,166,0,78885,78.7,10203140,109.285,23.2,3.81,8337.49,208.257,11.75,0.735,0
102,194,1235,23998,15,181,0,78885,78.7,10203140,109.285,23.2,3.81,8337.49,208.257,11.75,0.735,0
102,195,928,24926,10,191,0,78885,78.7,10203140,109.285,23.2,3.81,8337.49,208.257,11.75,0.735,0
102,196,1147,26073,16,207,0,78885,78.7,10203140,109.285,23.2,3.81,8337.49,208.257,11.75,0.735,0
102,197,2054,28127,18,225,0,78885,78.7,10203140,109.285,23.2,3.81,8337.49,208.257,11.75,0.735,0
102,198,2423,30550,32,257,0,78885,78.7,10203140,109.285,23.2,3.81,8337.49,208.257,11.75,0.735,0
102,199,2459,33009,25,282,0,78885,78.7,10203140,109.285,23.2,3.81,8337.49,208.257,11.75,0.735,0
102,200,1539,34548,28,310,0,78885,78.7,10203140,109.285,23.2,3.81,8337.49,208.257,11.75,0.735,0
102,201,1505,36053,20,330,0,78885,78.7,10203140,109.285,23.2,3.81,8337.49,208.257,11.75,0.735,0
102,202,1520,37573,15,345,0,78885,78.7,10203140,109.285,23.2,3.81,8337.49,208.257,11.75,0.735,0
102,203,1364,38937,35,380,0,78885,78.7,10203140,109.285,23.2,3.81,8337.49,208.257,11.75,0.735,0
102,204,2035,40972,34,414,0,78885,78.7,10203140,109.285,23.2,3.81,8337.49,208.257,11.75,0.735,0
103,1,15,340,0,1,1914,32819,89.35,18776707,6.681,30.6,6.991,24055.588,466.792,7.11,0.8,0
103,2,8,348,1,2,2372,35191,89.35,18776707,6.681,30.6,6.991,24055.588,466.792,7.11,0.8,0
103,3,38,386,1,3,7958,43149,89.35,18776707,6.681,30.6,6.991,24055.588,466.792,7.11,0.8,0
103,4,74,460,0,3,2403,45552,89.35,18776707,6.681,30.6,6.991,24055.588,466.792,7.11,0.8,0
103,5,0,460,0,3,4970,50522,89.35,18776707,6.681,30.6,6.991,24055.588,466.792,7.11,0.8,0
103,6,71,531,2,5,2359,52881,89.35,18776707,6.681,30.6,6.991,24055.588,466.792,7.11,0.8,0
103,7,139,670,1,6,1886,54767,89.35,18776707,6.681,30.6,6.991,24055.588,466.792,7.11,0.8,0
103,8,34,704,0,6,2008,56775,89.35,18776707,6.681,30.6,6.991,24055.588,466.792,7.11,0.8,0
103,9,55,759,1,7,2596,59371,89.35,18776707,6.681,30.6,6.991,24055.588,466.792,7.11,0.8,0
103,10,43,802,2,9,2584,61955,89.35,18776707,6.681,30.6,6.991,24055.588,466.792,7.11,0.8,0
103,11,38,840,1,10,3901,65856,89.35,18776707,6.681,30.6,6.991,24055.588,466.792,7.11,0.8,0
103,12,40,880,0,10,3448,69304,89.35,18776707,6.681,30.6,6.991,24055.588,466.792,7.11,0.8,0
103,13,81,961,0,10,3802,73106,89.35,18776707,6.681,30.6,6.991,24055.588,466.792,7.11,0.8,0
103,14,218,1179,4,14,3798,76904,89.35,18776707,6.681,30.6,6.991,24055.588,466.792,7.11,0.8,0
103,15,88,1267,0,14,4455,81359,89.35,18776707,6.681,30.6,6.991,24055.588,466.792,7.11,0.8,0
103,16,64,1331,2,16,4376,85735,89.35,18776707,6.681,30.6,6.991,24055.588,466.792,7.11,0.8,0
103,17,139,1470,1,17,6564,92299,89.35,18776707,6.681,30.6,6.991,24055.588,466.792,7.11,0.8,0
103,18,121,1591,0,17,8579,100878,89.35,18776707,6.681,30.6,6.991,24055.588,466.792,7.11,0.8,0
103,19,63,1654,0,17,7954,108832,89.35,18776707,6.681,30.6,6.991,24055.588,466.792,7.11,0.8,0
103,20,81,1735,2,19,9117,117949,89.35,18776707,6.681,30.6,6.991,24055.588,466.792,7.11,0.8,0
103,21,214,1949,0,19,8778,126727,89.35,18776707,6.681,30.6,6.991,24055.588,466.792,7.11,0.8,0
103,22,76,2025,0,19,12480,139207,89.35,18776707,6.681,30.6,6.991,24055.588,466.792,7.11,0.8,0
103,23,166,2191,0,19,14285,153492,89.35,18776707,6.681,30.6,6.991,24055.588,466.792,7.11,0.8,0
103,24,143,2334,3,22,11013,164505,89.35,18776707,6.681,30.6,6.991,24055.588,466.792,7.11,0.8,0
103,25,148,2482,3,25,15997,180502,89.35,18776707,6.681,30.6,6.991,24055.588,466.792,7.11,0.8,0
103,26,170,2652,0,25,15796,196298,89.35,18776707,6.681,30.6,6.991,24055.588,466.792,7.11,0.8,0
103,27,65,2717,0,25,9262,205560,89.35,18776707,6.681,30.6,6.991,24055.588,466.792,7.11,0.8,0
103,28,143,2860,0,25,10716,216276,89.35,18776707,6.681,30.6,6.991,24055.588,466.792,7.11,0.8,0
103,29,203,3063,0,25,16139,232415,89.35,18776707,6.681,30.6,6.991,24055.588,466.792,7.11,0.8,0
103,30,142,3205,0,25,17112,249527,89.35,18776707,6.681,30.6,6.991,24055.588,466.792,7.11,0.8,0
103,31,299,3504,0,25,19007,268534,89.35,18776707,6.681,30.6,6.991,24055.588,466.792,7.11,0.8,0
103,32,167,3671,0,25,14328,282862,89.35,18776707,6.681,30.6,6.991,24055.588,466.792,7.11,0.8,0
103,33,206,3877,0,25,13274,296136,89.35,18776707,6.681,30.6,6.991,24055.588,466.792,7.11,0.8,0
103,34,87,3964,2,27,10725,306861,89.35,18776707,6.681,30.6,6.991,24055.588,466.792,7.11,0.8,0
103,35,157,4121,2,29,13550,320411,89.35,18776707,6.681,30.6,6.991,24055.588,466.792,7.11,0.8,0
103,36,156,4277,0,29,16069,336480,89.35,18776707,6.681,30.6,6.991,24055.588,466.792,7.11,0.8,0
103,37,225,4502,1,30,17363,353843,89.35,18776707,6.681,30.6,6.991,24055.588,466.792,7.11,0.8,0
103,38,188,4690,1,31,17283,371126,89.35,18776707,6.681,30.6,6.991,24055.588,466.792,7.11,0.8,0
103,39,144,4834,0,31,13978,385104,89.35,18776707,6.681,30.6,6.991,24055.588,466.792,7.11,0.8,0
103,40,202,5036,0,31,13307,398411,89.35,18776707,6.681,30.6,6.991,24055.588,466.792,7.11,0.8,0
103,41,90,5126,0,31,10302,408713,81.94,18776707,6.681,30.6,6.991,24055.588,466.792,7.11,0.8,0
103,42,114,5240,1,32,13298,422011,81.94,18776707,6.681,30.6,6.991,24055.588,466.792,7.11,0.8,0
103,43,177,5417,0,32,17484,439495,81.94,18776707,6.681,30.6,6.991,24055.588,466.792,7.11,0.8,0
103,44,154,5571,0,32,20241,459736,81.94,18776707,6.681,30.6,6.991,24055.588,466.792,7.11,0.8,0
103,45,0,5571,0,32,23500,483236,81.94,18776707,6.681,30.6,6.991,24055.588,466.792,7.11,0.8,0
103,46,279,5850,2,34,21980,505216,81.94,18776707,6.681,30.6,6.991,24055.588,466.792,7.11,0.8,0
103,47,307,6157,0,34,22224,527440,81.94,18776707,6.681,30.6,6.991,24055.588,466.792,7.11,0.8,0
103,48,283,6440,0,34,13268,540708,83.8,18776707,6.681,30.6,6.991,24055.588,466.792,7.11,0.8,0
103,49,311,6751,1,35,12354,553062,83.8,18776707,6.681,30.6,6.991,24055.588,466.792,7.11,0.8,0
103,50,218,6969,0,35,18485,571547,83.8,18776707,6.681,30.6,6.991,24055.588,466.792,7.11,0.8,0
103,51,265,7234,0,35,19955,591502,83.8,18776707,6.681,30.6,6.991,24055.588,466.792,7.11,0.8,0
103,52,363,7597,0,35,21495,612997,83.8,18776707,6.681,30.6,6.991,24055.588,466.792,7.11,0.8,0
103,53,322,7919,0,35,22715,635712,83.8,18776707,6.681,30.6,6.991,24055.588,466.792,7.11,0.8,0
103,54,403,8322,0,35,21502,657214,83.8,18776707,6.681,30.6,6.991,24055.588,466.792,7.11,0.8,0
103,55,209,8531,0,35,14560,671774,83.8,18776707,6.681,30.6,6.991,24055.588,466.792,7.11,0.8,0
103,56,438,8969,0,35,15493,687267,83.8,18776707,6.681,30.6,6.991,24055.588,466.792,7.11,0.8,0
103,57,335,9304,2,37,23085,710352,83.8,18776707,6.681,30.6,6.991,24055.588,466.792,7.11,0.8,0
103,58,272,9576,0,37,24921,735273,83.8,18776707,6.681,30.6,6.991,24055.588,466.792,7.11,0.8,0
103,59,356,9932,0,37,26454,761727,83.8,18776707,6.681,30.6,6.991,24055.588,466.792,7.11,0.8,0
103,60,450,10382,0,37,26562,788289,83.8,18776707,6.681,30.6,6.991,24055.588,466.792,7.11,0.8,0
103,61,476,10858,1,38,24592,812881,83.8,18776707,6.681,30.6,6.991,24055.588,466.792,7.11,0.8,0
103,62,450,11308,3,41,15496,828377,77.31,18776707,6.681,30.6,6.991,24055.588,466.792,7.11,0.8,0
103,63,263,11571,0,41,15249,843626,77.31,18776707,6.681,30.6,6.991,24055.588,466.792,7.11,0.8,0
103,64,225,11796,3,44,23660,867286,77.31,18776707,6.681,30.6,6.991,24055.588,466.792,7.11,0.8,0
103,65,271,12067,4,48,24815,892101,77.31,18776707,6.681,30.6,6.991,24055.588,466.792,7.11,0.8,0
103,66,245,12312,4,52,23803,915904,77.31,18776707,6.681,30.6,6.991,24055.588,466.792,7.11,0.8,0
103,67,199,12511,0,52,26672,942576,77.31,18776707,6.681,30.6,6.991,24055.588,466.792,7.11,0.8,0
103,68,183,12694,1,53,22513,965089,77.31,18776707,6.681,30.6,6.991,24055.588,466.792,7.11,0.8,0
103,69,165,12859,3,56,16284,981373,77.31,18776707,6.681,30.6,6.991,24055.588,466.792,7.11,0.8,0
103,70,215,13074,2,58,17183,998556,77.31,18776707,6.681,30.6,6.991,24055.588,466.792,7.11,0.8,0
103,71,245,13319,3,61,24861,1023417,77.31,18776707,6.681,30.6,6.991,24055.588,466.792,7.11,0.8,0
103,72,239,13558,6,67,26681,1050098,80.09,18776707,6.681,30.6,6.991,24055.588,466.792,7.11,0.8,0
103,73,314,13872,0,67,28441,1078539,80.09,18776707,6.681,30.6,6.991,24055.588,466.792,7.11,0.8,0
103,74,366,14238,3,70,30380,1108919,80.09,18776707,6.681,30.6,6.991,24055.588,466.792,7.11,0.8,0
103,75,258,14496,3,73,27275,1136194,80.09,18776707,6.681,30.6,6.991,24055.588,466.792,7.11,0.8,0
103,76,313,14809,4,77,24582,1160776,80.09,18776707,6.681,30.6,6.991,24055.588,466.792,7.11,0.8,0
103,77,383,15192,4,81,23640,1184416,80.09,18776707,6.681,30.6,6.991,24055.588,466.792,7.11,0.8,0
103,78,350,15542,7,88,27161,1211577,80.09,18776707,6.681,30.6,6.991,24055.588,466.792,7.11,0.8,0
103,79,335,15877,12,100,27561,1239138,80.09,18776707,6.681,30.6,6.991,24055.588,466.792,7.11,0.8,0
103,80,474,16351,5,105,30450,1269588,80.09,18776707,6.681,30.6,6.991,24055.588,466.792,7.11,0.8,0
103,81,428,16779,8,113,32506,1302094,80.09,18776707,6.681,30.6,6.991,24055.588,466.792,7.11,0.8,0
103,82,446,17225,5,118,28483,1330577,80.09,18776707,6.681,30.6,6.991,24055.588,466.792,7.11,0.8,0
103,83,507,17732,2,120,23879,1354456,80.09,18776707,6.681,30.6,6.991,24055.588,466.792,7.11,0.8,0
103,84,499,18231,7,127,22406,1376862,80.09,18776707,6.681,30.6,6.991,24055.588,466.792,7.11,0.8,0
103,85,534,18765,7,134,24830,1401692,80.09,18776707,6.681,30.6,6.991,24055.588,466.792,7.11,0.8,0
103,86,520,19285,2,136,22955,1424647,80.09,18776707,6.681,30.6,6.991,24055.588,466.792,7.11,0.8,0
103,87,465,19750,11,147,22519,1447166,80.09,18776707,6.681,30.6,6.991,24055.588,466.792,7.11,0.8,0
103,88,569,20319,3,150,20390,1467556,80.09,18776707,6.681,30.6,6.991,24055.588,466.792,7.11,0.8,0
103,89,461,20780,23,173,17632,1485188,80.09,18776707,6.681,30.6,6.991,24055.588,466.792,7.11,0.8,0
103,90,547,21327,10,183,16606,1501794,80.09,18776707,6.681,30.6,6.991,24055.588,466.792,7.11,0.8,0
103,91,492,21819,5,188,15304,1517098,80.09,18776707,6.681,30.6,6.991,24055.588,466.792,7.11,0.8,0
103,92,19246,41065,0,188,19509,1536607,80.09,18776707,6.681,30.6,6.991,24055.588,466.792,7.11,0.8,0
103,93,1509,42574,0,188,19251,1555858,80.09,18776707,6.681,30.6,6.991,24055.588,466.792,7.11,0.8,0
103,94,1501,44075,0,188,34286,1590144,80.09,18776707,6.681,30.6,6.991,24055.588,466.792,7.11,0.8,0
103,95,1644,45719,0,188,16278,1606422,80.09,18776707,6.681,30.6,6.991,24055.588,466.792,7.11,0.8,0
103,96,1452,47171,0,188,0,1606422,79.63,18776707,6.681,30.6,6.991,24055.588,466.792,7.11,0.8,0
103,97,1403,48574,0,188,0,1630669,79.63,18776707,6.681,30.6,6.991,24055.588,466.792,7.11,0.8,0
103,98,1109,49683,76,264,12447,1643116,79.63,18776707,6.681,30.6,6.991,24055.588,466.792,7.11,0.8,0
103,99,1376,51059,0,264,16427,1659543,79.63,18776707,6.681,30.6,6.991,24055.588,466.792,7.11,0.8,0
103,100,1962,53021,0,264,16774,1676317,79.63,18776707,6.681,30.6,6.991,24055.588,466.792,7.11,0.8,0
103,101,1726,54747,0,264,18269,1694586,74.07,18776707,6.681,30.6,6.991,24055.588,466.792,7.11,0.8,0
103,102,1708,56455,0,264,0,1694586,74.07,18776707,6.681,30.6,6.991,24055.588,466.792,7.11,0.8,0
103,103,1798,58253,0,264,0,1707337,74.07,18776707,6.681,30.6,6.991,24055.588,466.792,7.11,0.8,0
103,104,1636,59889,111,375,11958,1719295,74.07,18776707,6.681,30.6,6.991,24055.588,466.792,7.11,0.8,0
103,105,1866,61755,0,375,18251,1737546,74.07,18776707,6.681,30.6,6.991,24055.588,466.792,7.11,0.8,0
103,106,1759,63514,0,375,19388,1756934,74.07,18776707,6.681,30.6,6.991,24055.588,466.792,7.11,0.8,0
103,107,1674,65188,0,375,20346,1777280,74.07,18776707,6.681,30.6,6.991,24055.588,466.792,7.11,0.8,0
103,108,1707,66895,0,375,0,1777280,74.07,18776707,6.681,30.6,6.991,24055.588,466.792,7.11,0.8,0
103,109,1808,68703,0,375,0,1777280,74.07,18776707,6.681,30.6,6.991,24055.588,466.792,7.11,0.8,0
103,110,1636,70339,0,375,0,1791293,74.07,18776707,6.681,30.6,6.991,24055.588,466.792,7.11,0.8,0
103,111,1499,71838,0,375,14680,1805973,74.07,18776707,6.681,30.6,6.991,24055.588,466.792,7.11,0.8,0
103,112,1630,73468,210,585,17359,1823332,74.07,18776707,6.681,30.6,6.991,24055.588,466.792,7.11,0.8,0
103,113,1685,75153,0,585,21125,1844457,74.07,18776707,6.681,30.6,6.991,24055.588,466.792,7.11,0.8,0
103,114,1646,76799,0,585,23450,1867907,74.07,18776707,6.681,30.6,6.991,24055.588,466.792,7.11,0.8,0
103,115,1687,78486,0,585,26908,1894815,74.07,18776707,6.681,30.6,6.991,24055.588,466.792,7.11,0.8,0
103,116,1740,80226,0,585,68801,1963616,74.07,18776707,6.681,30.6,6.991,24055.588,466.792,7.11,0.8,0
103,117,1494,81720,0,585,17183,1980799,74.07,18776707,6.681,30.6,6.991,24055.588,466.792,7.11,0.8,0
103,118,1402,83122,0,585,10850,1991649,74.07,18776707,6.681,30.6,6.991,24055.588,466.792,7.11,0.8,0
103,119,1526,84648,0,585,14780,2006429,74.07,18776707,6.681,30.6,6.991,24055.588,466.792,7.11,0.8,0
103,120,1544,86192,208,793,19210,2025639,74.07,18776707,6.681,30.6,6.991,24055.588,466.792,7.11,0.8,0
103,121,1472,87664,0,793,22316,2047955,74.07,18776707,6.681,30.6,6.991,24055.588,466.792,7.11,0.8,0
103,122,1414,89078,0,793,25171,2073126,76.85,18776707,6.681,30.6,6.991,24055.588,466.792,7.11,0.8,0
103,123,1289,90367,0,793,19496,2092622,76.85,18776707,6.681,30.6,6.991,24055.588,466.792,7.11,0.8,0
103,124,6407,96774,30,823,12658,2105280,76.85,18776707,6.681,30.6,6.991,24055.588,466.792,7.11,0.8,0
103,125,1867,98641,286,1109,8515,2113795,76.85,18776707,6.681,30.6,6.991,24055.588,466.792,7.11,0.8,0
103,126,1434,100075,0,1109,12564,2126359,76.85,18776707,6.681,30.6,6.991,24055.588,466.792,7.11,0.8,0
103,127,2861,102936,0,1109,18400,2144759,76.85,18776707,6.681,30.6,6.991,24055.588,466.792,7.11,0.8,0
103,128,2590,105526,0,1109,18954,2163713,76.85,18776707,6.681,30.6,6.991,24055.588,466.792,7.11,0.8,0
103,129,2404,107930,0,1109,19595,2183308,76.85,18776707,6.681,30.6,6.991,24055.588,466.792,7.11,0.8,0
103,130,2009,109939,0,1109,19128,2202436,76.85,18776707,6.681,30.6,6.991,24055.588,466.792,7.11,0.8,0
103,131,1883,111822,0,1109,15207,2217643,76.85,18776707,6.681,30.6,6.991,24055.588,466.792,7.11,0.8,0
103,132,900,112722,324,1433,9226,2226869,76.85,18776707,6.681,30.6,6.991,24055.588,466.792,7.11,0.8,0
103,133,779,113501,0,1433,10055,2236924,76.85,18776707,6.681,30.6,6.991,24055.588,466.792,7.11,0.8,0
103,134,2114,115615,0,1433,15229,2252153,76.85,18776707,6.681,30.6,6.991,24055.588,466.792,7.11,0.8,0
103,135,1489,117104,0,1433,19601,2271754,76.85,18776707,6.681,30.6,6.991,24055.588,466.792,7.11,0.8,0
103,136,1410,118514,0,1433,19573,2291327,76.85,18776707,6.681,30.6,6.991,24055.588,466.792,7.11,0.8,0
103,137,1267,119781,47,1480,19179,2310506,76.85,18776707,6.681,30.6,6.991,24055.588,466.792,7.11,0.8,0
103,138,1380,121161,5,1485,13883,2324389,76.85,18776707,6.681,30.6,6.991,24055.588,466.792,7.11,0.8,0
103,139,478,121639,2,1487,9718,2334107,75.93,18776707,6.681,30.6,6.991,24055.588,466.792,7.11,0.8,0
103,140,334,121973,148,1635,7942,2342049,75.93,18776707,6.681,30.6,6.991,24055.588,466.792,7.11,0.8,0
103,141,1352,123325,11,1646,14953,2357002,75.93,18776707,6.681,30.6,6.991,24055.588,466.792,7.11,0.8,0
103,142,1031,124356,6,1652,17224,2374226,75.93,18776707,6.681,30.6,6.991,24055.588,466.792,7.11,0.8,0
103,143,979,125335,6,1658,15331,2389557,75.93,18776707,6.681,30.6,6.991,24055.588,466.792,7.11,0.8,0
103,144,908,126243,5,1663,16046,2405603,75.93,18776707,6.681,30.6,6.991,24055.588,466.792,7.11,0.8,0
103,145,960,127203,8,1671,12152,2417755,75.93,18776707,6.681,30.6,6.991,24055.588,466.792,7.11,0.8,0
103,146,259,127462,2,1673,9432,2427187,75.93,18776707,6.681,30.6,6.991,24055.588,466.792,7.11,0.8,0
103,147,0,127462,108,1781,7257,2434444,75.93,18776707,6.681,30.6,6.991,24055.588,466.792,7.11,0.8,0
103,148,0,127462,0,1781,15112,2449556,75.93,18776707,6.681,30.6,6.991,24055.588,466.792,7.11,0.8,0
103,149,202,127664,0,1781,14729,2464285,75.93,18776707,6.681,30.6,6.991,24055.588,466.792,7.11,0.8,0
103,150,954,128618,0,1781,17299,2481584,75.93,18776707,6.681,30.6,6.991,24055.588,466.792,7.11,0.8,0
103,151,1422,130040,0,1781,18237,2499821,75.93,18776707,6.681,30.6,6.991,24055.588,466.792,7.11,0.8,0
103,152,633,130673,0,1781,14019,2513840,75.93,18776707,6.681,30.6,6.991,24055.588,466.792,7.11,0.8,0
103,153,0,130673,0,1781,9320,2523160,75.93,18776707,6.681,30.6,6.991,24055.588,466.792,7.11,0.8,0
103,154,923,131596,34,1815,4972,2528132,75.93,18776707,6.681,30.6,6.991,24055.588,466.792,7.11,0.8,0
103,155,99,131695,68,1883,9040,2537172,75.93,18776707,6.681,30.6,6.991,24055.588,466.792,7.11,0.8,0
103,156,659,132354,6,1889,16534,2553706,75.93,18776707,6.681,30.6,6.991,24055.588,466.792,7.11,0.8,0
103,157,570,132924,4,1893,17856,2571562,75.93,18776707,6.681,30.6,6.991,24055.588,466.792,7.11,0.8,0
103,158,104,133028,0,1893,17518,2589080,80.56,18776707,6.681,30.6,6.991,24055.588,466.792,7.11,0.8,0
103,159,896,133924,8,1901,14020,2603100,80.56,18776707,6.681,30.6,6.991,24055.588,466.792,7.11,0.8,0
103,160,199,134123,1,1902,9764,2612864,80.56,18776707,6.681,30.6,6.991,24055.588,466.792,7.11,0.8,0
103,161,80,134203,1,1903,9440,2622304,80.56,18776707,6.681,30.6,6.991,24055.588,466.792,7.11,0.8,0
103,162,523,134726,47,1950,18260,2640564,80.56,18776707,6.681,30.6,6.991,24055.588,466.792,7.11,0.8,0
103,163,433,135159,1,1951,17779,2658343,80.56,18776707,6.681,30.6,6.991,24055.588,466.792,7.11,0.8,0
103,164,430,135589,1,1952,18485,2676828,80.56,18776707,6.681,30.6,6.991,24055.588,466.792,7.11,0.8,0
103,165,375,135964,2,1954,19590,2696418,80.56,18776707,6.681,30.6,6.991,24055.588,466.792,7.11,0.8,0
103,166,420,136384,1,1955,15968,2712386,80.56,18776707,6.681,30.6,6.991,24055.588,466.792,7.11,0.8,0
103,167,129,136513,7,1962,11595,2723981,78.7,18776707,6.681,30.6,6.991,24055.588,466.792,7.11,0.8,0
103,168,73,136586,3,1965,9474,2733455,78.7,18776707,6.681,30.6,6.991,24055.588,466.792,7.11,0.8,0
103,169,472,137058,38,2003,17142,2750597,78.7,18776707,6.681,30.6,6.991,24055.588,466.792,7.11,0.8,0
103,170,335,137393,3,2006,17639,2768236,78.7,18776707,6.681,30.6,6.991,24055.588,466.792,7.11,0.8,0
103,171,320,137713,2,2008,19738,2787974,78.7,18776707,6.681,30.6,6.991,24055.588,466.792,7.11,0.8,0
103,172,300,138013,1,2009,18521,2806495,78.7,18776707,6.681,30.6,6.991,24055.588,466.792,7.11,0.8,0
103,173,335,138348,5,2014,13559,2820054,78.7,18776707,6.681,30.6,6.991,24055.588,466.792,7.11,0.8,0
103,174,107,138455,1,2015,11017,2831071,78.7,18776707,6.681,30.6,6.991,24055.588,466.792,7.11,0.8,0
103,175,87,138542,1,2016,9381,2840452,78.7,18776707,6.681,30.6,6.991,24055.588,466.792,7.11,0.8,0
103,176,440,138982,28,2044,17969,2858421,78.7,18776707,6.681,30.6,6.991,24055.588,466.792,7.11,0.8,0
103,177,307,139289,1,2045,21162,2879583,78.7,18776707,6.681,30.6,6.991,24055.588,466.792,7.11,0.8,0
103,178,292,139581,1,2046,16222,2895805,78.7,18776707,6.681,30.6,6.991,24055.588,466.792,7.11,0.8,0
103,179,301,139882,0,2046,18859,2914664,78.7,18776707,6.681,30.6,6.991,24055.588,466.792,7.11,0.8,0
103,180,293,140175,2,2048,16694,2931358,78.7,18776707,6.681,30.6,6.991,24055.588,466.792,7.11,0.8,0
103,181,90,140265,1,2049,9208,2940566,78.7,18776707,6.681,30.6,6.991,24055.588,466.792,7.11,0.8,0
103,182,68,140333,1,2050,5532,2946098,78.7,18776707,6.681,30.6,6.991,24055.588,466.792,7.11,0.8,0
103,183,374,140707,28,2078,18183,2964281,78.7,18776707,6.681,30.6,6.991,24055.588,466.792,7.11,0.8,0
103,184,251,140958,2,2080,9208,2973489,78.7,18776707,6.681,30.6,6.991,24055.588,466.792,7.11,0.8,0
103,185,298,141256,2,2082,16928,2990417,78.7,18776707,6.681,30.6,6.991,24055.588,466.792,7.11,0.8,0
103,186,228,141484,1,2083,17953,3008370,78.7,18776707,6.681,30.6,6.991,24055.588,466.792,7.11,0.8,0
103,187,264,141748,0,2083,18980,3027350,78.7,18776707,6.681,30.6,6.991,24055.588,466.792,7.11,0.8,0
103,188,96,141844,2,2085,10871,3038221,78.7,18776707,6.681,30.6,6.991,24055.588,466.792,7.11,0.8,0
103,189,60,141904,0,2085,7218,3045439,78.7,18776707,6.681,30.6,6.991,24055.588,466.792,7.11,0.8,0
103,190,335,142239,22,2107,17176,3062615,78.7,18776707,6.681,30.6,6.991,24055.588,466.792,7.11,0.8,0
103,191,358,142597,1,2108,22627,3085242,78.7,18776707,6.681,30.6,6.991,24055.588,466.792,7.11,0.8,0
103,192,348,142945,2,2110,21763,3107005,78.7,18776707,6.681,30.6,6.991,24055.588,466.792,7.11,0.8,0
103,193,335,143280,1,2111,23470,3130475,78.7,18776707,6.681,30.6,6.991,24055.588,466.792,7.11,0.8,0
103,194,352,143632,2,2113,19521,3149996,78.7,18776707,6.681,30.6,6.991,24055.588,466.792,7.11,0.8,0
103,195,108,143740,1,2114,14773,3164769,78.7,18776707,6.681,30.6,6.991,24055.588,466.792,7.11,0.8,0
103,196,74,143814,2,2116,10906,3175675,78.7,18776707,6.681,30.6,6.991,24055.588,466.792,7.11,0.8,0
103,197,404,144218,25,2141,0,3175675,78.7,18776707,6.681,30.6,6.991,24055.588,466.792,7.11,0.8,0
103,198,110,144328,0,2141,0,3175675,78.7,18776707,6.681,30.6,6.991,24055.588,466.792,7.11,0.8,0
103,199,433,144761,3,2144,0,3175675,78.7,18776707,6.681,30.6,6.991,24055.588,466.792,7.11,0.8,0
103,200,258,145019,4,2148,0,3175675,78.7,18776707,6.681,30.6,6.991,24055.588,466.792,7.11,0.8,0
103,201,301,145320,1,2149,0,3175675,78.7,18776707,6.681,30.6,6.991,24055.588,466.792,7.11,0.8,0
103,202,153,145473,1,2150,0,3175675,78.7,18776707,6.681,30.6,6.991,24055.588,466.792,7.11,0.8,0
103,203,130,145603,5,2155,0,3175675,78.7,18776707,6.681,30.6,6.991,24055.588,466.792,7.11,0.8,0
103,204,363,145966,29,2184,0,3175675,78.7,18776707,6.681,30.6,6.991,24055.588,466.792,7.11,0.8,0
104,1,9,59,0,1,380,1688,87.04,53771300,87.324,20,2.686,2993.028,218.637,2.92,0.59,4
104,2,22,81,0,1,662,2350,87.04,53771300,87.324,20,2.686,2993.028,218.637,2.92,0.59,4
104,3,29,110,2,3,362,2712,87.04,53771300,87.324,20,2.686,2993.028,218.637,2.92,0.59,4
104,4,12,122,1,4,372,3084,87.04,53771300,87.324,20,2.686,2993.028,218.637,2.92,0.59,4
104,5,4,126,0,4,530,3614,87.04,53771300,87.324,20,2.686,2993.028,218.637,2.92,0.59,4
104,6,16,142,0,4,663,4277,88.89,53771300,87.324,20,2.686,2993.028,218.637,2.92,0.59,4
104,7,16,158,0,4,696,4973,88.89,53771300,87.324,20,2.686,2993.028,218.637,2.92,0.59,4
104,8,14,172,2,6,305,5278,88.89,53771300,87.324,20,2.686,2993.028,218.637,2.92,0.59,4
104,9,7,179,0,6,308,5586,88.89,53771300,87.324,20,2.686,2993.028,218.637,2.92,0.59,4
104,10,5,184,1,7,606,6192,88.89,53771300,87.324,20,2.686,2993.028,218.637,2.92,0.59,4
104,11,5,189,0,7,491,6683,88.89,53771300,87.324,20,2.686,2993.028,218.637,2.92,0.59,4
104,12,2,191,0,7,766,7449,88.89,53771300,87.324,20,2.686,2993.028,218.637,2.92,0.59,4
104,13,6,197,1,8,674,8123,88.89,53771300,87.324,20,2.686,2993.028,218.637,2.92,0.59,4
104,14,11,208,1,9,694,8817,88.89,53771300,87.324,20,2.686,2993.028,218.637,2.92,0.59,4
104,15,8,216,0,9,803,9620,88.89,53771300,87.324,20,2.686,2993.028,218.637,2.92,0.59,4
104,16,9,225,1,10,704,10324,88.89,53771300,87.324,20,2.686,2993.028,218.637,2.92,0.59,4
104,17,9,234,1,11,450,10774,88.89,53771300,87.324,20,2.686,2993.028,218.637,2.92,0.59,4
104,18,12,246,0,11,1115,11889,88.89,53771300,87.324,20,2.686,2993.028,218.637,2.92,0.59,4
104,19,16,262,1,12,1350,13239,88.89,53771300,87.324,20,2.686,2993.028,218.637,2.92,0.59,4
104,20,8,270,2,14,633,13872,88.89,53771300,87.324,20,2.686,2993.028,218.637,2.92,0.59,4
104,21,11,281,0,14,832,14704,88.89,53771300,87.324,20,2.686,2993.028,218.637,2.92,0.59,4
104,22,0,281,0,14,707,15411,88.89,53771300,87.324,20,2.686,2993.028,218.637,2.92,0.59,4
104,23,22,303,0,14,668,16079,88.89,53771300,87.324,20,2.686,2993.028,218.637,2.92,0.59,4
104,24,17,320,0,14,659,16738,88.89,53771300,87.324,20,2.686,2993.028,218.637,2.92,0.59,4
104,25,16,336,0,14,0,16738,88.89,53771300,87.324,20,2.686,2993.028,218.637,2.92,0.59,4
104,26,7,343,0,14,0,16738,88.89,53771300,87.324,20,2.686,2993.028,218.637,2.92,0.59,4
104,27,12,355,0,14,0,16738,88.89,53771300,87.324,20,2.686,2993.028,218.637,2.92,0.59,4
104,28,8,363,0,14,0,16738,88.89,53771300,87.324,20,2.686,2993.028,218.637,2.92,0.59,4
104,29,11,374,0,14,0,16738,88.89,53771300,87.324,20,2.686,2993.028,218.637,2.92,0.59,4
104,30,10,384,1,15,0,20268,88.89,53771300,87.324,20,2.686,2993.028,218.637,2.92,0.59,4
104,31,12,396,2,17,1434,21702,88.89,53771300,87.324,20,2.686,2993.028,218.637,2.92,0.59,4
104,32,15,411,4,21,1195,22897,88.89,53771300,87.324,20,2.686,2993.028,218.637,2.92,0.59,4
104,33,24,435,1,22,883,23780,88.89,53771300,87.324,20,2.686,2993.028,218.637,2.92,0.59,4
104,34,30,465,2,24,1012,24792,88.89,53771300,87.324,20,2.686,2993.028,218.637,2.92,0.59,4
104,35,25,490,0,24,1077,25869,88.89,53771300,87.324,20,2.686,2993.028,218.637,2.92,0.59,4
104,36,45,535,0,24,0,25869,88.89,53771300,87.324,20,2.686,2993.028,218.637,2.92,0.59,4
104,37,47,582,2,26,0,25869,88.89,53771300,87.324,20,2.686,2993.028,218.637,2.92,0.59,4
104,38,25,607,3,29,0,29430,88.89,53771300,87.324,20,2.686,2993.028,218.637,2.92,0.59,4
104,39,14,621,0,29,1611,31041,88.89,53771300,87.324,20,2.686,2993.028,218.637,2.92,0.59,4
104,40,28,649,1,30,1056,32097,88.89,53771300,87.324,20,2.686,2993.028,218.637,2.92,0.59,4
104,41,23,672,2,32,841,32938,88.89,53771300,87.324,20,2.686,2993.028,218.637,2.92,0.59,4
104,42,28,700,1,33,978,33916,88.89,53771300,87.324,20,2.686,2993.028,218.637,2.92,0.59,4
104,43,15,715,3,36,1516,35432,88.89,53771300,87.324,20,2.686,2993.028,218.637,2.92,0.59,4
104,44,22,737,4,40,1486,36918,88.89,53771300,87.324,20,2.686,2993.028,218.637,2.92,0.59,4
104,45,21,758,2,42,2100,39018,88.89,53771300,87.324,20,2.686,2993.028,218.637,2.92,0.59,4
104,46,23,781,3,45,0,39018,88.89,53771300,87.324,20,2.686,2993.028,218.637,2.92,0.59,4
104,47,49,830,5,50,0,43712,88.89,53771300,87.324,20,2.686,2993.028,218.637,2.92,0.59,4
104,48,57,887,0,50,1139,44851,88.89,53771300,87.324,20,2.686,2993.028,218.637,2.92,0.59,4
104,49,25,912,0,50,1933,46784,88.89,53771300,87.324,20,2.686,2993.028,218.637,2.92,0.59,4
104,50,51,963,0,50,2621,49405,88.89,53771300,87.324,20,2.686,2993.028,218.637,2.92,0.59,4
104,51,66,1029,0,50,3102,52507,88.89,53771300,87.324,20,2.686,2993.028,218.637,2.92,0.59,4
104,52,80,1109,0,50,2567,55074,88.89,53771300,87.324,20,2.686,2993.028,218.637,2.92,0.59,4
104,53,52,1161,0,50,0,55074,88.89,53771300,87.324,20,2.686,2993.028,218.637,2.92,0.59,4
104,54,31,1192,0,50,0,59260,88.89,53771300,87.324,20,2.686,2993.028,218.637,2.92,0.59,4
104,55,22,1214,1,51,2711,61971,88.89,53771300,87.324,20,2.686,2993.028,218.637,2.92,0.59,4
104,56,72,1286,1,52,2293,64264,88.89,53771300,87.324,20,2.686,2993.028,218.637,2.92,0.59,4
104,57,62,1348,0,52,3077,67341,88.89,53771300,87.324,20,2.686,2993.028,218.637,2.92,0.59,4
104,58,123,1471,3,55,2831,70172,88.89,53771300,87.324,20,2.686,2993.028,218.637,2.92,0.59,4
104,59,147,1618,3,58,3831,74003,88.89,53771300,87.324,20,2.686,2993.028,218.637,2.92,0.59,4
104,60,127,1745,4,62,0,74003,88.89,53771300,87.324,20,2.686,2993.028,218.637,2.92,0.59,4
104,61,143,1888,1,63,0,78536,88.89,53771300,87.324,20,2.686,2993.028,218.637,2.92,0.59,4
104,62,74,1962,1,64,1518,80054,88.89,53771300,87.324,20,2.686,2993.028,218.637,2.92,0.59,4
104,63,59,2021,5,69,2892,82946,88.89,53771300,87.324,20,2.686,2993.028,218.637,2.92,0.59,4
104,64,72,2093,2,71,2112,85058,88.89,53771300,87.324,20,2.686,2993.028,218.637,2.92,0.59,4
104,65,123,2216,3,74,2640,87698,88.89,53771300,87.324,20,2.686,2993.028,218.637,2.92,0.59,4
104,66,124,2340,4,78,3177,90875,88.89,53771300,87.324,20,2.686,2993.028,218.637,2.92,0.59,4
104,67,134,2474,1,79,3632,94507,88.89,53771300,87.324,20,2.686,2993.028,218.637,2.92,0.59,4
104,68,126,2600,4,83,2833,97340,88.89,53771300,87.324,20,2.686,2993.028,218.637,2.92,0.59,4
104,69,167,2767,1,84,1099,98439,88.89,53771300,87.324,20,2.686,2993.028,218.637,2.92,0.59,4
104,70,95,2862,1,85,2244,100683,88.89,53771300,87.324,20,2.686,2993.028,218.637,2.92,0.59,4
104,71,127,2989,3,88,2273,102956,88.89,53771300,87.324,20,2.686,2993.028,218.637,2.92,0.59,4
104,72,105,3094,1,89,3291,106247,88.89,53771300,87.324,20,2.686,2993.028,218.637,2.92,0.59,4
104,73,121,3215,3,92,2419,108666,88.89,53771300,87.324,20,2.686,2993.028,218.637,2.92,0.59,4
104,74,90,3305,4,96,3505,112171,88.89,53771300,87.324,20,2.686,2993.028,218.637,2.92,0.59,4
104,75,152,3457,4,100,3165,115336,88.89,53771300,87.324,20,2.686,2993.028,218.637,2.92,0.59,4
104,76,137,3594,3,103,3365,118701,88.89,53771300,87.324,20,2.686,2993.028,218.637,2.92,0.59,4
104,77,133,3727,1,104,3255,121956,88.89,53771300,87.324,20,2.686,2993.028,218.637,2.92,0.59,4
104,78,133,3860,1,105,0,121956,88.89,53771300,87.324,20,2.686,2993.028,218.637,2.92,0.59,4
104,79,184,4044,2,107,0,130498,88.89,53771300,87.324,20,2.686,2993.028,218.637,2.92,0.59,4
104,80,213,4257,10,117,3043,133541,88.89,53771300,87.324,20,2.686,2993.028,218.637,2.92,0.59,4
104,81,117,4374,2,119,2820,136361,88.89,53771300,87.324,20,2.686,2993.028,218.637,2.92,0.59,4
104,82,104,4478,2,121,3651,140012,88.89,53771300,87.324,20,2.686,2993.028,218.637,2.92,0.59,4
104,83,260,4738,2,123,2354,142366,88.89,53771300,87.324,20,2.686,2993.028,218.637,2.92,0.59,4
104,84,59,4797,2,125,4171,146537,84.26,53771300,87.324,20,2.686,2993.028,218.637,2.92,0.59,4
104,85,155,4952,3,128,4859,151396,84.26,53771300,87.324,20,2.686,2993.028,218.637,2.92,0.59,4
104,86,254,5206,2,130,3918,155314,84.26,53771300,87.324,20,2.686,2993.028,218.637,2.92,0.59,4
104,87,178,5384,2,132,3090,158404,84.26,53771300,87.324,20,2.686,2993.028,218.637,2.92,0.59,4
104,88,149,5533,5,137,4074,162478,84.26,53771300,87.324,20,2.686,2993.028,218.637,2.92,0.59,4
104,89,278,5811,4,141,2718,165196,84.26,53771300,87.324,20,2.686,2993.028,218.637,2.92,0.59,4
104,90,259,6070,2,143,2221,167417,84.26,53771300,87.324,20,2.686,2993.028,218.637,2.92,0.59,4
104,91,120,6190,1,144,2419,169836,84.26,53771300,87.324,20,2.686,2993.028,218.637,2.92,0.59,4
104,92,176,6366,4,148,3519,173355,84.26,53771300,87.324,20,2.686,2993.028,218.637,2.92,0.59,4
104,93,307,6673,1,149,2704,176059,84.26,53771300,87.324,20,2.686,2993.028,218.637,2.92,0.59,4
104,94,268,6941,3,152,4147,180206,84.26,53771300,87.324,20,2.686,2993.028,218.637,2.92,0.59,4
104,95,247,7188,2,154,4829,185035,84.26,53771300,87.324,20,2.686,2993.028,218.637,2.92,0.59,4
104,96,389,7577,5,159,4228,189263,84.26,53771300,87.324,20,2.686,2993.028,218.637,2.92,0.59,4
104,97,309,7886,1,160,2131,191394,84.26,53771300,87.324,20,2.686,2993.028,218.637,2.92,0.59,4
104,98,181,8067,4,164,2061,193455,81.48,53771300,87.324,20,2.686,2993.028,218.637,2.92,0.59,4
104,99,183,8250,3,167,3053,196508,81.48,53771300,87.324,20,2.686,2993.028,218.637,2.92,0.59,4
104,100,278,8528,2,169,3803,200311,81.48,53771300,87.324,20,2.686,2993.028,218.637,2.92,0.59,4
104,101,447,8975,4,173,6273,206584,81.48,53771300,87.324,20,2.686,2993.028,218.637,2.92,0.59,4
104,102,473,9448,8,181,1403,207987,81.48,53771300,87.324,20,2.686,2993.028,218.637,2.92,0.59,4
104,103,278,9726,3,184,7050,215037,81.48,53771300,87.324,20,2.686,2993.028,218.637,2.92,0.59,4
104,104,379,10105,1,185,1205,216242,81.48,53771300,87.324,20,2.686,2993.028,218.637,2.92,0.59,4
104,105,189,10294,12,197,4992,221234,81.48,53771300,87.324,20,2.686,2993.028,218.637,2.92,0.59,4
104,106,497,10791,5,202,4261,225495,81.48,53771300,87.324,20,2.686,2993.028,218.637,2.92,0.59,4
104,107,461,11252,7,209,3895,229390,81.48,53771300,87.324,20,2.686,2993.028,218.637,2.92,0.59,4
104,108,421,11673,4,213,3545,232935,81.48,53771300,87.324,20,2.686,2993.028,218.637,2.92,0.59,4
104,109,389,12062,9,222,5228,238163,81.48,53771300,87.324,20,2.686,2993.028,218.637,2.92,0.59,4
104,110,688,12750,3,225,5724,243887,81.48,53771300,87.324,20,2.686,2993.028,218.637,2.92,0.59,4
104,111,603,13353,9,234,2474,246361,81.48,53771300,87.324,20,2.686,2993.028,218.637,2.92,0.59,4
104,112,418,13771,4,238,3637,249998,81.48,53771300,87.324,20,2.686,2993.028,218.637,2.92,0.59,4
104,113,397,14168,12,250,4275,254273,81.48,53771300,87.324,20,2.686,2993.028,218.637,2.92,0.59,4
104,114,637,14805,10,260,6754,261027,81.48,53771300,87.324,20,2.686,2993.028,218.637,2.92,0.59,4
104,115,796,15601,3,263,5075,266102,78.7,53771300,87.324,20,2.686,2993.028,218.637,2.92,0.59,4
104,116,667,16268,11,274,0,266102,78.7,53771300,87.324,20,2.686,2993.028,218.637,2.92,0.59,4
104,117,375,16643,4,278,0,266102,78.7,53771300,87.324,20,2.686,2993.028,218.637,2.92,0.59,4
104,118,960,17603,2,280,0,279612,78.7,53771300,87.324,20,2.686,2993.028,218.637,2.92,0.59,4
104,119,372,17975,5,285,4888,284500,78.7,53771300,87.324,20,2.686,2993.028,218.637,2.92,0.59,4
104,120,606,18581,14,299,5259,289759,78.7,53771300,87.324,20,2.686,2993.028,218.637,2.92,0.59,4
104,121,544,19125,12,311,5521,295280,78.7,53771300,87.324,20,2.686,2993.028,218.637,2.92,0.59,4
104,122,788,19913,14,325,8679,303959,78.7,53771300,87.324,20,2.686,2993.028,218.637,2.92,0.59,4
104,123,723,20636,16,341,6371,310330,73.15,53771300,87.324,20,2.686,2993.028,218.637,2.92,0.59,4
104,124,727,21363,23,364,5393,315723,73.15,53771300,87.324,20,2.686,2993.028,218.637,2.92,0.59,4
104,125,690,22053,5,369,2653,318376,73.15,53771300,87.324,20,2.686,2993.028,218.637,2.92,0.59,4
104,126,544,22597,13,382,4547,322923,73.15,53771300,87.324,20,2.686,2993.028,218.637,2.92,0.59,4
104,127,605,23202,6,388,6200,329123,73.15,53771300,87.324,20,2.686,2993.028,218.637,2.92,0.59,4
104,128,671,23873,3,391,6195,335318,73.15,53771300,87.324,20,2.686,2993.028,218.637,2.92,0.59,4
104,129,538,24411,8,399,6814,342132,73.15,53771300,87.324,20,2.686,2993.028,218.637,2.92,0.59,4
104,130,727,25138,14,413,7175,349307,73.15,53771300,87.324,20,2.686,2993.028,218.637,2.92,0.59,4
104,131,699,25837,5,418,4420,353727,73.15,53771300,87.324,20,2.686,2993.028,218.637,2.92,0.59,4
104,132,599,26436,2,420,4603,358330,73.15,53771300,87.324,20,2.686,2993.028,218.637,2.92,0.59,4
104,133,492,26928,3,423,4171,362501,73.15,53771300,87.324,20,2.686,2993.028,218.637,2.92,0.59,4
104,134,497,27425,15,438,6590,369091,73.15,53771300,87.324,20,2.686,2993.028,218.637,2.92,0.59,4
104,135,679,28104,18,456,6768,375859,70.37,53771300,87.324,20,2.686,2993.028,218.637,2.92,0.59,4
104,136,650,28754,4,460,5458,381317,70.37,53771300,87.324,20,2.686,2993.028,218.637,2.92,0.59,4
104,137,580,29334,5,465,0,381317,70.37,53771300,87.324,20,2.686,2993.028,218.637,2.92,0.59,4
104,138,515,29849,7,472,0,391416,70.37,53771300,87.324,20,2.686,2993.028,218.637,2.92,0.59,4
104,139,271,30120,2,474,3150,394566,70.37,53771300,87.324,20,2.686,2993.028,218.637,2.92,0.59,4
104,140,245,30365,8,482,4019,398585,70.37,53771300,87.324,20,2.686,2993.028,218.637,2.92,0.59,4
104,141,271,30636,5,487,0,398585,70.37,53771300,87.324,20,2.686,2993.028,218.637,2.92,0.59,4
104,142,379,31015,19,506,0,398585,70.37,53771300,87.324,20,2.686,2993.028,218.637,2.92,0.59,4
104,143,426,31441,10,516,0,412080,70.37,53771300,87.324,20,2.686,2993.028,218.637,2.92,0.59,4
104,144,322,31763,16,532,5724,417804,70.37,53771300,87.324,20,2.686,2993.028,218.637,2.92,0.59,4
104,145,355,32118,10,542,4179,421983,70.37,53771300,87.324,20,2.686,2993.028,218.637,2.92,0.59,4
104,146,246,32364,6,548,3381,425364,70.37,53771300,87.324,20,2.686,2993.028,218.637,2.92,0.59,4
104,147,193,32557,6,554,4149,429513,70.37,53771300,87.324,20,2.686,2993.028,218.637,2.92,0.59,4
104,148,246,32803,5,559,0,429513,70.37,53771300,87.324,20,2.686,2993.028,218.637,2.92,0.59,4
104,149,213,33016,5,564,0,438193,70.37,53771300,87.324,20,2.686,2993.028,218.637,2.92,0.59,4
104,150,373,33389,3,567,4520,442713,70.37,53771300,87.324,20,2.686,2993.028,218.637,2.92,0.59,4
104,151,241,33630,0,567,3009,445722,70.37,53771300,87.324,20,2.686,2993.028,218.637,2.92,0.59,4
104,152,164,33794,5,572,4424,450146,70.37,53771300,87.324,20,2.686,2993.028,218.637,2.92,0.59,4
104,153,263,34057,2,574,4260,454406,70.37,53771300,87.324,20,2.686,2993.028,218.637,2.92,0.59,4
104,154,144,34201,3,577,1682,456088,67.59,53771300,87.324,20,2.686,2993.028,218.637,2.92,0.59,4
104,155,114,34315,0,577,3474,459562,67.59,53771300,87.324,20,2.686,2993.028,218.637,2.92,0.59,4
104,156,178,34493,0,577,3937,463499,67.59,53771300,87.324,20,2.686,2993.028,218.637,2.92,0.59,4
104,157,212,34705,8,585,4178,467677,67.59,53771300,87.324,20,2.686,2993.028,218.637,2.92,0.59,4
104,158,179,34884,4,589,3707,471384,67.59,53771300,87.324,20,2.686,2993.028,218.637,2.92,0.59,4
104,159,136,35020,5,594,3093,474477,67.59,53771300,87.324,20,2.686,2993.028,218.637,2.92,0.59,4
104,160,83,35103,3,597,2668,477145,67.59,53771300,87.324,20,2.686,2993.028,218.637,2.92,0.59,4
104,161,102,35205,2,599,2552,479697,67.59,53771300,87.324,20,2.686,2993.028,218.637,2.92,0.59,4
104,162,151,35356,0,599,2285,481982,67.59,53771300,87.324,20,2.686,2993.028,218.637,2.92,0.59,4
104,163,104,35460,8,607,0,481982,67.59,53771300,87.324,20,2.686,2993.028,218.637,2.92,0.59,4
104,164,143,35603,5,612,0,481982,67.59,53771300,87.324,20,2.686,2993.028,218.637,2.92,0.59,4
104,165,190,35793,4,616,0,494560,67.59,53771300,87.324,20,2.686,2993.028,218.637,2.92,0.59,4
104,166,176,35969,3,619,3092,497652,67.59,53771300,87.324,20,2.686,2993.028,218.637,2.92,0.59,4
104,167,188,36157,3,622,0,497652,67.59,53771300,87.324,20,2.686,2993.028,218.637,2.92,0.59,4
104,168,0,36157,0,622,0,497652,67.59,53771300,87.324,20,2.686,2993.028,218.637,2.92,0.59,4
104,169,48,36205,2,624,0,497652,67.59,53771300,87.324,20,2.686,2993.028,218.637,2.92,0.59,4
104,170,96,36301,10,634,0,497652,67.59,53771300,87.324,20,2.686,2993.028,218.637,2.92,0.59,4
104,171,275,36576,8,642,0,497652,67.59,53771300,87.324,20,2.686,2993.028,218.637,2.92,0.59,4
104,172,148,36724,4,646,0,497652,67.59,53771300,87.324,20,2.686,2993.028,218.637,2.92,0.59,4
104,173,105,36829,0,646,0,497652,67.59,53771300,87.324,20,2.686,2993.028,218.637,2.92,0.59,4
104,174,152,36981,2,648,0,518350,67.59,53771300,87.324,20,2.686,2993.028,218.637,2.92,0.59,4
104,175,98,37079,2,650,1774,520124,67.59,53771300,87.324,20,2.686,2993.028,218.637,2.92,0.59,4
104,176,139,37218,9,659,3874,523998,67.59,53771300,87.324,20,2.686,2993.028,218.637,2.92,0.59,4
104,177,130,37348,5,664,3307,527305,67.59,53771300,87.324,20,2.686,2993.028,218.637,2.92,0.59,4
104,178,141,37489,5,669,5424,532729,67.59,53771300,87.324,20,2.686,2993.028,218.637,2.92,0.59,4
104,179,218,37707,13,682,2872,535601,67.59,53771300,87.324,20,2.686,2993.028,218.637,2.92,0.59,4
104,180,164,37871,7,689,3707,539308,67.59,53771300,87.324,20,2.686,2993.028,218.637,2.92,0.59,4
104,181,244,38115,2,691,2107,541415,67.59,53771300,87.324,20,2.686,2993.028,218.637,2.92,0.59,4
104,182,53,38168,9,700,3604,545019,67.59,53771300,87.324,20,2.686,2993.028,218.637,2.92,0.59,4
104,183,210,38378,7,707,2927,547946,67.59,53771300,87.324,20,2.686,2993.028,218.637,2.92,0.59,4
104,184,151,38529,4,711,4700,552646,67.59,53771300,87.324,20,2.686,2993.028,218.637,2.92,0.59,4
104,185,184,38713,7,718,3065,555711,67.59,53771300,87.324,20,2.686,2993.028,218.637,2.92,0.59,4
104,186,210,38923,7,725,3387,559098,67.59,53771300,87.324,20,2.686,2993.028,218.637,2.92,0.59,4
104,187,261,39184,3,728,4385,563483,67.59,53771300,87.324,20,2.686,2993.028,218.637,2.92,0.59,4
104,188,243,39427,3,731,595,564078,67.59,53771300,87.324,20,2.686,2993.028,218.637,2.92,0.59,4
104,189,22,39449,4,735,1258,565336,67.59,53771300,87.324,20,2.686,2993.028,218.637,2.92,0.59,4
104,190,137,39586,8,743,4342,569678,67.59,53771300,87.324,20,2.686,2993.028,218.637,2.92,0.59,4
104,191,321,39907,5,748,5034,574712,67.59,53771300,87.324,20,2.686,2993.028,218.637,2.92,0.59,4
104,192,271,40178,3,751,5327,580039,64.81,53771300,87.324,20,2.686,2993.028,218.637,2.92,0.59,4
104,193,442,40620,4,755,6872,586911,64.81,53771300,87.324,20,2.686,2993.028,218.637,2.92,0.59,4
104,194,538,41158,5,760,4287,591198,64.81,53771300,87.324,20,2.686,2993.028,218.637,2.92,0.59,4
104,195,388,41546,6,766,2001,593199,64.81,53771300,87.324,20,2.686,2993.028,218.637,2.92,0.59,4
104,196,73,41619,11,777,2592,595791,64.81,53771300,87.324,20,2.686,2993.028,218.637,2.92,0.59,4
104,197,318,41937,10,787,5832,601623,64.81,53771300,87.324,20,2.686,2993.028,218.637,2.92,0.59,4
104,198,604,42541,10,797,5618,607241,64.81,53771300,87.324,20,2.686,2993.028,218.637,2.92,0.59,4
104,199,602,43143,8,805,0,607241,64.81,53771300,87.324,20,2.686,2993.028,218.637,2.92,0.59,4
104,200,437,43580,8,813,0,617064,64.81,53771300,87.324,20,2.686,2993.028,218.637,2.92,0.59,4
104,201,616,44196,12,825,0,617064,64.81,53771300,87.324,20,2.686,2993.028,218.637,2.92,0.59,4
104,202,685,44881,7,832,0,617064,64.81,53771300,87.324,20,2.686,2993.028,218.637,2.92,0.59,4
104,203,195,45076,7,839,0,617064,64.81,53771300,87.324,20,2.686,2993.028,218.637,2.92,0.59,4
104,204,571,45647,3,842,0,617064,64.81,53771300,87.324,20,2.686,2993.028,218.637,2.92,0.59,4
106,1,23,289,0,0,0,0,81.48,4270563,232.128,33.7,2.345,65530.537,132.235,15.84,0.803,0
106,2,28,317,0,0,0,0,81.48,4270563,232.128,33.7,2.345,65530.537,132.235,15.84,0.803,0
106,3,25,342,0,0,0,0,81.48,4270563,232.128,33.7,2.345,65530.537,132.235,15.84,0.803,0
106,4,0,342,0,0,0,0,81.48,4270563,232.128,33.7,2.345,65530.537,132.235,15.84,0.803,0
106,5,137,479,1,1,0,0,81.48,4270563,232.128,33.7,2.345,65530.537,132.235,15.84,0.803,0
106,6,77,556,0,1,0,0,93.52,4270563,232.128,33.7,2.345,65530.537,132.235,15.84,0.803,0
106,7,109,665,0,1,0,0,93.52,4270563,232.128,33.7,2.345,65530.537,132.235,15.84,0.803,0
106,8,78,743,0,1,0,0,93.52,4270563,232.128,33.7,2.345,65530.537,132.235,15.84,0.803,0
106,9,112,855,0,1,0,0,93.52,4270563,232.128,33.7,2.345,65530.537,132.235,15.84,0.803,0
106,10,55,910,0,1,0,0,93.52,4270563,232.128,33.7,2.345,65530.537,132.235,15.84,0.803,0
106,11,83,993,0,1,0,0,93.52,4270563,232.128,33.7,2.345,65530.537,132.235,15.84,0.803,0
106,12,161,1154,0,1,0,0,93.52,4270563,232.128,33.7,2.345,65530.537,132.235,15.84,0.803,0
106,13,80,1234,0,1,0,0,93.52,4270563,232.128,33.7,2.345,65530.537,132.235,15.84,0.803,0
106,14,66,1300,1,2,0,0,93.52,4270563,232.128,33.7,2.345,65530.537,132.235,15.84,0.803,0
106,15,55,1355,1,3,0,0,93.52,4270563,232.128,33.7,2.345,65530.537,132.235,15.84,0.803,0
106,16,50,1405,0,3,0,0,93.52,4270563,232.128,33.7,2.345,65530.537,132.235,15.84,0.803,0
106,17,119,1524,0,3,0,0,93.52,4270563,232.128,33.7,2.345,65530.537,132.235,15.84,0.803,0
106,18,134,1658,2,5,0,0,93.52,4270563,232.128,33.7,2.345,65530.537,132.235,15.84,0.803,0
106,19,94,1752,1,6,0,0,93.52,4270563,232.128,33.7,2.345,65530.537,132.235,15.84,0.803,0
106,20,163,1915,1,7,0,0,93.52,4270563,232.128,33.7,2.345,65530.537,132.235,15.84,0.803,0
106,21,80,1995,2,9,0,0,88.89,4270563,232.128,33.7,2.345,65530.537,132.235,15.84,0.803,0
106,22,85,2080,2,11,0,0,88.89,4270563,232.128,33.7,2.345,65530.537,132.235,15.84,0.803,0
106,23,168,2248,2,13,0,0,88.89,4270563,232.128,33.7,2.345,65530.537,132.235,15.84,0.803,0
106,24,151,2399,1,14,0,0,88.89,4270563,232.128,33.7,2.345,65530.537,132.235,15.84,0.803,0
106,25,215,2614,1,15,0,0,88.89,4270563,232.128,33.7,2.345,65530.537,132.235,15.84,0.803,0
106,26,278,2892,4,19,0,0,88.89,4270563,232.128,33.7,2.345,65530.537,132.235,15.84,0.803,0
106,27,183,3075,1,20,0,0,88.89,4270563,232.128,33.7,2.345,65530.537,132.235,15.84,0.803,0
106,28,213,3288,2,22,0,0,88.89,4270563,232.128,33.7,2.345,65530.537,132.235,15.84,0.803,0
106,29,152,3440,1,23,0,0,88.89,4270563,232.128,33.7,2.345,65530.537,132.235,15.84,0.803,0
106,30,300,3740,1,24,0,0,88.89,4270563,232.128,33.7,2.345,65530.537,132.235,15.84,0.803,0
106,31,284,4024,2,26,0,0,88.89,4270563,232.128,33.7,2.345,65530.537,132.235,15.84,0.803,0
106,32,353,4377,4,30,0,0,88.89,4270563,232.128,33.7,2.345,65530.537,132.235,15.84,0.803,0
106,33,242,4619,3,33,0,0,88.89,4270563,232.128,33.7,2.345,65530.537,132.235,15.84,0.803,0
106,34,364,4983,5,38,0,0,88.89,4270563,232.128,33.7,2.345,65530.537,132.235,15.84,0.803,0
106,35,295,5278,2,40,0,0,88.89,4270563,232.128,33.7,2.345,65530.537,132.235,15.84,0.803,0
106,36,526,5804,0,40,0,0,88.89,4270563,232.128,33.7,2.345,65530.537,132.235,15.84,0.803,0
106,37,485,6289,2,42,0,0,88.89,4270563,232.128,33.7,2.345,65530.537,132.235,15.84,0.803,0
106,38,278,6567,2,44,0,0,88.89,4270563,232.128,33.7,2.345,65530.537,132.235,15.84,0.803,0
106,39,641,7208,3,47,0,0,88.89,4270563,232.128,33.7,2.345,65530.537,132.235,15.84,0.803,0
106,40,415,7623,2,49,0,0,100,4270563,232.128,33.7,2.345,65530.537,132.235,15.84,0.803,0
106,41,1065,8688,9,58,0,0,100,4270563,232.128,33.7,2.345,65530.537,132.235,15.84,0.803,0
106,42,598,9286,7,65,0,0,100,4270563,232.128,33.7,2.345,65530.537,132.235,15.84,0.803,0
106,43,991,10277,10,75,0,227000,100,4270563,232.128,33.7,2.345,65530.537,132.235,15.84,0.803,0
106,44,751,11028,7,82,4930,231930,100,4270563,232.128,33.7,2.345,65530.537,132.235,15.84,0.803,0
106,45,947,11975,6,88,4074,236004,100,4270563,232.128,33.7,2.345,65530.537,132.235,15.84,0.803,0
106,46,885,12860,8,96,4712,240716,100,4270563,232.128,33.7,2.345,65530.537,132.235,15.84,0.803,0
106,47,942,13802,11,107,3760,244476,100,4270563,232.128,33.7,2.345,65530.537,132.235,15.84,0.803,0
106,48,1048,14850,5,112,3838,248314,100,4270563,232.128,33.7,2.345,65530.537,132.235,15.84,0.803,0
106,49,841,15691,6,118,4382,252696,100,4270563,232.128,33.7,2.345,65530.537,132.235,15.84,0.803,0
106,50,1073,16764,3,121,3618,256314,100,4270563,232.128,33.7,2.345,65530.537,132.235,15.84,0.803,0
106,51,804,17568,3,124,4757,261071,100,4270563,232.128,33.7,2.345,65530.537,132.235,15.84,0.803,0
106,52,1041,18609,5,129,3888,264959,100,4270563,232.128,33.7,2.345,65530.537,132.235,15.84,0.803,0
106,53,955,19564,9,138,3195,268154,100,4270563,232.128,33.7,2.345,65530.537,132.235,15.84,0.803,0
106,54,900,20464,10,148,2935,271089,100,4270563,232.128,33.7,2.345,65530.537,132.235,15.84,0.803,0
106,55,838,21302,8,156,2723,273812,100,4270563,232.128,33.7,2.345,65530.537,132.235,15.84,0.803,0
106,56,665,21967,9,165,2395,276207,100,4270563,232.128,33.7,2.345,65530.537,132.235,15.84,0.803,0
106,57,608,22575,7,172,2738,278945,100,4270563,232.128,33.7,2.345,65530.537,132.235,15.84,0.803,0
106,58,692,23267,3,175,3396,282341,100,4270563,232.128,33.7,2.345,65530.537,132.235,15.84,0.803,0
106,59,845,24112,10,185,4011,286352,100,4270563,232.128,33.7,2.345,65530.537,132.235,15.84,0.803,0
106,60,1072,25184,9,194,3661,290013,100,4270563,232.128,33.7,2.345,65530.537,132.235,15.84,0.803,0
106,61,1008,26192,11,205,3349,293362,84.26,4270563,232.128,33.7,2.345,65530.537,132.235,15.84,0.803,0
106,62,851,27043,7,212,3664,297026,84.26,4270563,232.128,33.7,2.345,65530.537,132.235,15.84,0.803,0
106,63,719,27762,8,220,3325,300351,84.26,4270563,232.128,33.7,2.345,65530.537,132.235,15.84,0.803,0
106,64,887,28649,6,226,2934,303285,84.26,4270563,232.128,33.7,2.345,65530.537,132.235,15.84,0.803,0
106,65,710,29359,4,230,2721,306006,84.26,4270563,232.128,33.7,2.345,65530.537,132.235,15.84,0.803,0
106,66,562,29921,6,236,2894,308900,84.26,4270563,232.128,33.7,2.345,65530.537,132.235,15.84,0.803,0
106,67,723,30644,8,244,2724,311624,84.26,4270563,232.128,33.7,2.345,65530.537,132.235,15.84,0.803,0
106,68,487,31131,10,254,3661,315285,84.26,4270563,232.128,33.7,2.345,65530.537,132.235,15.84,0.803,0
106,69,717,31848,10,264,2999,318284,84.26,4270563,232.128,33.7,2.345,65530.537,132.235,15.84,0.803,0
106,70,662,32510,5,269,3218,321502,85.19,4270563,232.128,33.7,2.345,65530.537,132.235,15.84,0.803,0
106,71,630,33140,4,273,2871,324373,85.19,4270563,232.128,33.7,2.345,65530.537,132.235,15.84,0.803,0
106,72,683,33823,2,275,2771,327144,85.19,4270563,232.128,33.7,2.345,65530.537,132.235,15.84,0.803,0
106,73,609,34432,4,279,2985,330129,85.19,4270563,232.128,33.7,2.345,65530.537,132.235,15.84,0.803,0
106,74,520,34952,6,285,2159,332288,85.19,4270563,232.128,33.7,2.345,65530.537,132.235,15.84,0.803,0
106,75,514,35466,4,289,2324,334612,85.19,4270563,232.128,33.7,2.345,65530.537,132.235,15.84,0.803,0
106,76,454,35920,7,296,2775,337387,85.19,4270563,232.128,33.7,2.345,65530.537,132.235,15.84,0.803,0
106,77,511,36431,2,298,2755,340142,85.19,4270563,232.128,33.7,2.345,65530.537,132.235,15.84,0.803,0
106,78,527,36958,5,303,2885,343027,85.19,4270563,232.128,33.7,2.345,65530.537,132.235,15.84,0.803,0
106,79,575,37533,3,306,3298,346325,85.19,4270563,232.128,33.7,2.345,65530.537,132.235,15.84,0.803,0
106,80,541,38074,2,308,3087,349412,85.19,4270563,232.128,33.7,2.345,65530.537,132.235,15.84,0.803,0
106,81,604,38678,5,313,2224,351636,85.19,4270563,232.128,33.7,2.345,65530.537,132.235,15.84,0.803,0
106,82,467,39145,6,319,2742,354378,85.19,4270563,232.128,33.7,2.345,65530.537,132.235,15.84,0.803,0
106,83,505,39650,7,326,3216,357594,85.19,4270563,232.128,33.7,2.345,65530.537,132.235,15.84,0.803,0
106,84,641,40291,4,330,3645,361239,85.19,4270563,232.128,33.7,2.345,65530.537,132.235,15.84,0.803,0
106,85,742,41033,4,334,3985,365224,85.19,4270563,232.128,33.7,2.345,65530.537,132.235,15.84,0.803,0
106,86,846,41879,3,337,3286,368510,85.19,4270563,232.128,33.7,2.345,65530.537,132.235,15.84,0.803,0
106,87,909,42788,2,339,3774,372284,85.19,4270563,232.128,33.7,2.345,65530.537,132.235,15.84,0.803,0
106,88,915,43703,2,341,3240,375524,85.19,4270563,232.128,33.7,2.345,65530.537,132.235,15.84,0.803,0
106,89,688,44391,3,344,3814,379338,85.19,4270563,232.128,33.7,2.345,65530.537,132.235,15.84,0.803,0
106,90,551,44942,4,348,3504,382842,85.19,4270563,232.128,33.7,2.345,65530.537,132.235,15.84,0.803,0
106,91,582,45524,2,350,4045,386887,85.19,4270563,232.128,33.7,2.345,65530.537,132.235,15.84,0.803,0
106,92,671,46195,4,354,4150,391037,83.33,4270563,232.128,33.7,2.345,65530.537,132.235,15.84,0.803,0
106,93,745,46940,4,358,4312,395349,83.33,4270563,232.128,33.7,2.345,65530.537,132.235,15.84,0.803,0
106,94,919,47859,1,359,4149,399498,83.33,4270563,232.128,33.7,2.345,65530.537,132.235,15.84,0.803,0
106,95,813,48672,1,360,3443,402941,83.33,4270563,232.128,33.7,2.345,65530.537,132.235,15.84,0.803,0
106,96,631,49303,5,365,3043,405984,83.33,4270563,232.128,33.7,2.345,65530.537,132.235,15.84,0.803,0
106,97,638,49941,3,368,3351,409335,83.33,4270563,232.128,33.7,2.345,65530.537,132.235,15.84,0.803,0
106,98,703,50644,5,373,4195,413530,83.33,4270563,232.128,33.7,2.345,65530.537,132.235,15.84,0.803,0
106,99,601,51245,4,377,4344,417874,83.33,4270563,232.128,33.7,2.345,65530.537,132.235,15.84,0.803,0
106,100,762,52007,2,379,5011,422885,83.33,4270563,232.128,33.7,2.345,65530.537,132.235,15.84,0.803,0
106,101,833,52840,3,382,4121,427006,83.33,4270563,232.128,33.7,2.345,65530.537,132.235,15.84,0.803,0
106,102,740,53580,1,383,2495,429501,83.33,4270563,232.128,33.7,2.345,65530.537,132.235,15.84,0.803,0
106,103,478,54058,3,386,3835,433336,83.33,4270563,232.128,33.7,2.345,65530.537,132.235,15.84,0.803,0
106,104,836,54894,4,390,4086,437422,83.33,4270563,232.128,33.7,2.345,65530.537,132.235,15.84,0.803,0
106,105,614,55508,3,393,3721,441143,83.33,4270563,232.128,33.7,2.345,65530.537,132.235,15.84,0.803,0
106,106,666,56174,3,396,4041,445184,83.33,4270563,232.128,33.7,2.345,65530.537,132.235,15.84,0.803,0
106,107,703,56877,3,399,4341,449525,83.33,4270563,232.128,33.7,2.345,65530.537,132.235,15.84,0.803,0
106,108,791,57668,3,402,3445,452970,77.78,4270563,232.128,33.7,2.345,65530.537,132.235,15.84,0.803,0
106,109,553,58221,2,404,4370,457340,77.78,4270563,232.128,33.7,2.345,65530.537,132.235,15.84,0.803,0
106,110,683,58904,3,407,2009,459349,77.78,4270563,232.128,33.7,2.345,65530.537,132.235,15.84,0.803,0
106,111,300,59204,1,408,3355,462704,77.78,4270563,232.128,33.7,2.345,65530.537,132.235,15.84,0.803,0
106,112,559,59763,0,408,4157,466861,77.78,4270563,232.128,33.7,2.345,65530.537,132.235,15.84,0.803,0
106,113,671,60434,4,412,4139,471000,77.78,4270563,232.128,33.7,2.345,65530.537,132.235,15.84,0.803,0
106,114,751,61185,5,417,3808,474808,77.78,4270563,232.128,33.7,2.345,65530.537,132.235,15.84,0.803,0
106,115,687,61872,4,421,4603,479411,77.78,4270563,232.128,33.7,2.345,65530.537,132.235,15.84,0.803,0
106,116,753,62625,4,425,3909,483320,77.78,4270563,232.128,33.7,2.345,65530.537,132.235,15.84,0.803,0
106,117,684,63309,4,429,2418,485738,77.78,4270563,232.128,33.7,2.345,65530.537,132.235,15.84,0.803,0
106,118,464,63773,4,433,3828,489566,77.78,4270563,232.128,33.7,2.345,65530.537,132.235,15.84,0.803,0
106,119,606,64379,5,438,4732,494298,71.3,4270563,232.128,33.7,2.345,65530.537,132.235,15.84,0.803,0
106,120,770,65149,4,442,4059,498357,71.3,4270563,232.128,33.7,2.345,65530.537,132.235,15.84,0.803,0
106,121,754,65903,2,444,3811,502168,71.3,4270563,232.128,33.7,2.345,65530.537,132.235,15.84,0.803,0
106,122,626,66529,1,445,2920,505088,71.3,4270563,232.128,33.7,2.345,65530.537,132.235,15.84,0.803,0
106,123,428,66957,2,447,2432,507520,65.74,4270563,232.128,33.7,2.345,65530.537,132.235,15.84,0.803,0
106,124,491,67448,6,453,2041,509561,65.74,4270563,232.128,33.7,2.345,65530.537,132.235,15.84,0.803,0
106,125,463,67911,4,457,2038,511599,65.74,4270563,232.128,33.7,2.345,65530.537,132.235,15.84,0.803,0
106,126,388,68299,4,461,2452,514051,65.74,4270563,232.128,33.7,2.345,65530.537,132.235,15.84,0.803,0
106,127,475,68774,4,465,4550,518601,65.74,4270563,232.128,33.7,2.345,65530.537,132.235,15.84,0.803,0
106,128,651,69425,3,468,3599,522200,65.74,4270563,232.128,33.7,2.345,65530.537,132.235,15.84,0.803,0
106,129,620,70045,1,469,4086,526286,65.74,4270563,232.128,33.7,2.345,65530.537,132.235,15.84,0.803,0
106,130,682,70727,2,471,2844,529130,65.74,4270563,232.128,33.7,2.345,65530.537,132.235,15.84,0.803,0
106,131,472,71199,3,474,3223,532353,65.74,4270563,232.128,33.7,2.345,65530.537,132.235,15.84,0.803,0
106,132,514,71713,4,478,3450,535803,65.74,4270563,232.128,33.7,2.345,65530.537,132.235,15.84,0.803,0
106,133,687,72400,4,482,3658,539461,65.74,4270563,232.128,33.7,2.345,65530.537,132.235,15.84,0.803,0
106,134,668,73068,4,486,4397,543858,65.74,4270563,232.128,33.7,2.345,65530.537,132.235,15.84,0.803,0
106,135,717,73785,3,489,4147,548005,65.74,4270563,232.128,33.7,2.345,65530.537,132.235,15.84,0.803,0
106,136,701,74486,0,489,4576,552581,65.74,4270563,232.128,33.7,2.345,65530.537,132.235,15.84,0.803,0
106,137,699,75185,5,494,3356,555937,65.74,4270563,232.128,33.7,2.345,65530.537,132.235,15.84,0.803,0
106,138,512,75697,4,498,2863,558800,65.74,4270563,232.128,33.7,2.345,65530.537,132.235,15.84,0.803,0
106,139,508,76205,3,501,4334,563134,65.74,4270563,232.128,33.7,2.345,65530.537,132.235,15.84,0.803,0
106,140,622,76827,1,502,5306,568440,65.74,4270563,232.128,33.7,2.345,65530.537,132.235,15.84,0.803,0
106,141,643,77470,3,505,4811,573251,65.74,4270563,232.128,33.7,2.345,65530.537,132.235,15.84,0.803,0
106,142,675,78145,2,507,4337,577588,65.74,4270563,232.128,33.7,2.345,65530.537,132.235,15.84,0.803,0
106,143,622,78767,2,509,3530,581118,65.74,4270563,232.128,33.7,2.345,65530.537,132.235,15.84,0.803,0
106,144,502,79269,2,511,4006,585124,65.74,4270563,232.128,33.7,2.345,65530.537,132.235,15.84,0.803,0
106,145,688,79957,2,513,2443,587567,65.74,4270563,232.128,33.7,2.345,65530.537,132.235,15.84,0.803,0
106,146,571,80528,2,515,3056,590623,65.74,4270563,232.128,33.7,2.345,65530.537,132.235,15.84,0.803,0
106,147,432,80960,3,518,4426,595049,65.74,4270563,232.128,33.7,2.345,65530.537,132.235,15.84,0.803,0
106,148,613,81573,1,519,4364,599413,65.74,4270563,232.128,33.7,2.345,65530.537,132.235,15.84,0.803,0
106,149,698,82271,2,521,4191,603604,65.74,4270563,232.128,33.7,2.345,65530.537,132.235,15.84,0.803,0
106,150,674,82945,1,522,4317,607921,65.74,4270563,232.128,33.7,2.345,65530.537,132.235,15.84,0.803,0
106,151,633,83578,3,525,3718,611639,65.74,4270563,232.128,33.7,2.345,65530.537,132.235,15.84,0.803,0
106,152,646,84224,3,528,2490,614129,65.74,4270563,232.128,33.7,2.345,65530.537,132.235,15.84,0.803,0
106,153,412,84636,2,530,3490,617619,65.74,4270563,232.128,33.7,2.345,65530.537,132.235,15.84,0.803,0
106,154,473,85109,1,531,3997,621616,65.74,4270563,232.128,33.7,2.345,65530.537,132.235,15.84,0.803,0
106,155,702,85811,3,534,4425,626041,65.74,4270563,232.128,33.7,2.345,65530.537,132.235,15.84,0.803,0
106,156,667,86478,1,535,5441,631482,65.74,4270563,232.128,33.7,2.345,65530.537,132.235,15.84,0.803,0
106,157,900,87378,1,536,4738,636220,65.74,4270563,232.128,33.7,2.345,65530.537,132.235,15.84,0.803,0
106,158,865,88243,1,537,4414,640634,65.74,4270563,232.128,33.7,2.345,65530.537,132.235,15.84,0.803,0
106,159,720,88963,3,540,3093,643727,65.74,4270563,232.128,33.7,2.345,65530.537,132.235,15.84,0.803,0
106,160,619,89582,4,544,4324,648051,65.74,4270563,232.128,33.7,2.345,65530.537,132.235,15.84,0.803,0
106,161,805,90387,2,546,5048,653099,65.74,4270563,232.128,33.7,2.345,65530.537,132.235,15.84,0.803,0
106,162,857,91244,2,548,4652,657751,65.74,4270563,232.128,33.7,2.345,65530.537,132.235,15.84,0.803,0
106,163,838,92082,4,552,5384,663135,65.74,4270563,232.128,33.7,2.345,65530.537,132.235,15.84,0.803,0
106,164,740,92822,4,556,4870,668005,65.74,4270563,232.128,33.7,2.345,65530.537,132.235,15.84,0.803,0
106,165,653,93475,1,557,4998,673003,65.74,4270563,232.128,33.7,2.345,65530.537,132.235,15.84,0.803,0
106,166,736,94211,1,558,2739,675742,65.74,4270563,232.128,33.7,2.345,65530.537,132.235,15.84,0.803,0
106,167,553,94764,2,560,3928,679670,65.74,4270563,232.128,33.7,2.345,65530.537,132.235,15.84,0.803,0
106,168,708,95472,3,563,4534,684204,65.74,4270563,232.128,33.7,2.345,65530.537,132.235,15.84,0.803,0
106,169,829,96301,5,568,5384,689588,65.74,4270563,232.128,33.7,2.345,65530.537,132.235,15.84,0.803,0
106,170,698,96999,3,571,5968,695556,65.74,4270563,232.128,33.7,2.345,65530.537,132.235,15.84,0.803,0
106,171,825,97824,5,576,5928,701484,65.74,4270563,232.128,33.7,2.345,65530.537,132.235,15.84,0.803,0
106,172,704,98528,4,580,3545,705029,65.74,4270563,232.128,33.7,2.345,65530.537,132.235,15.84,0.803,0
106,173,521,99049,1,581,2263,707292,65.74,4270563,232.128,33.7,2.345,65530.537,132.235,15.84,0.803,0
106,174,385,99434,3,584,3944,711236,65.74,4270563,232.128,33.7,2.345,65530.537,132.235,15.84,0.803,0
106,175,530,99964,1,585,4651,715887,65.74,4270563,232.128,33.7,2.345,65530.537,132.235,15.84,0.803,0
106,176,719,100683,3,588,4622,720509,65.74,4270563,232.128,33.7,2.345,65530.537,132.235,15.84,0.803,0
106,177,616,101299,2,590,4516,725025,65.74,4270563,232.128,33.7,2.345,65530.537,132.235,15.84,0.803,0
106,178,552,101851,2,592,4730,729755,65.74,4270563,232.128,33.7,2.345,65530.537,132.235,15.84,0.803,0
106,179,590,102441,3,595,4138,733893,65.74,4270563,232.128,33.7,2.345,65530.537,132.235,15.84,0.803,0
106,180,758,103199,2,597,2025,735918,65.74,4270563,232.128,33.7,2.345,65530.537,132.235,15.84,0.803,0
106,181,345,103544,4,601,2865,738783,65.74,4270563,232.128,33.7,2.345,65530.537,132.235,15.84,0.803,0
106,182,437,103981,4,605,4014,742797,65.74,4270563,232.128,33.7,2.345,65530.537,132.235,15.84,0.803,0
106,183,587,104568,2,607,4436,747233,65.74,4270563,232.128,33.7,2.345,65530.537,132.235,15.84,0.803,0
106,184,614,105182,3,610,3930,751163,65.74,4270563,232.128,33.7,2.345,65530.537,132.235,15.84,0.803,0
106,185,494,105676,2,612,2612,753775,65.74,4270563,232.128,33.7,2.345,65530.537,132.235,15.84,0.803,0
106,186,411,106087,3,615,1990,755765,62.96,4270563,232.128,33.7,2.345,65530.537,132.235,15.84,0.803,0
106,187,371,106458,5,620,2050,757815,62.96,4270563,232.128,33.7,2.345,65530.537,132.235,15.84,0.803,0
106,188,567,107025,4,624,3210,761025,62.96,4270563,232.128,33.7,2.345,65530.537,132.235,15.84,0.803,0
106,189,567,107592,4,628,3583,764608,62.96,4270563,232.128,33.7,2.345,65530.537,132.235,15.84,0.803,0
106,190,676,108268,4,632,4083,768691,62.96,4270563,232.128,33.7,2.345,65530.537,132.235,15.84,0.803,0
106,191,475,108743,7,639,4120,772811,62.96,4270563,232.128,33.7,2.345,65530.537,132.235,15.84,0.803,0
106,192,698,109441,3,642,3922,776733,62.96,4270563,232.128,33.7,2.345,65530.537,132.235,15.84,0.803,0
106,193,635,110076,7,649,2805,779538,62.96,4270563,232.128,33.7,2.345,65530.537,132.235,15.84,0.803,0
106,194,492,110568,6,655,2717,782255,62.96,4270563,232.128,33.7,2.345,65530.537,132.235,15.84,0.803,0
106,195,548,111116,3,658,6450,788705,62.96,4270563,232.128,33.7,2.345,65530.537,132.235,15.84,0.803,0
106,196,777,111893,6,664,8055,796760,62.96,4270563,232.128,33.7,2.345,65530.537,132.235,15.84,0.803,0
106,197,844,112737,8,672,4177,800937,62.96,4270563,232.128,33.7,2.345,65530.537,132.235,15.84,0.803,0
106,198,532,113269,4,676,8554,809491,62.96,4270563,232.128,33.7,2.345,65530.537,132.235,15.84,0.803,0
106,199,746,114015,8,684,8014,817505,62.96,4270563,232.128,33.7,2.345,65530.537,132.235,15.84,0.803,0
106,200,729,114744,6,690,5701,823206,62.96,4270563,232.128,33.7,2.345,65530.537,132.235,15.84,0.803,0
106,201,739,115483,4,694,4959,828165,62.96,4270563,232.128,33.7,2.345,65530.537,132.235,15.84,0.803,0
106,202,663,116146,7,701,6002,834167,62.96,4270563,232.128,33.7,2.345,65530.537,132.235,15.84,0.803,0
106,203,686,116832,9,710,0,834167,62.96,4270563,232.128,33.7,2.345,65530.537,132.235,15.84,0.803,0
106,204,886,117718,4,714,0,834167,62.96,4270563,232.128,33.7,2.345,65530.537,132.235,15.84,0.803,0
107,1,23,107,0,0,0,0,92.13,6524191,32.333,26.3,4.489,3393.474,436.362,7.11,0.672,0
107,2,5,112,1,1,0,0,92.13,6524191,32.333,26.3,4.489,3393.474,436.362,7.11,0.672,0
107,3,13,125,0,1,0,0,92.13,6524191,32.333,26.3,4.489,3393.474,436.362,7.11,0.672,0
107,4,19,144,0,1,0,0,92.13,6524191,32.333,26.3,4.489,3393.474,436.362,7.11,0.672,0
107,5,0,144,0,1,0,0,92.13,6524191,32.333,26.3,4.489,3393.474,436.362,7.11,0.672,0
107,6,72,216,3,4,0,0,92.13,6524191,32.333,26.3,4.489,3393.474,436.362,7.11,0.672,0
107,7,12,228,0,4,0,0,92.13,6524191,32.333,26.3,4.489,3393.474,436.362,7.11,0.672,0
107,8,42,270,0,4,0,0,92.13,6524191,32.333,26.3,4.489,3393.474,436.362,7.11,0.672,0
107,9,10,280,0,4,0,0,92.13,6524191,32.333,26.3,4.489,3393.474,436.362,7.11,0.672,0
107,10,18,298,1,5,0,0,92.13,6524191,32.333,26.3,4.489,3393.474,436.362,7.11,0.672,0
107,11,41,339,0,5,0,0,92.13,6524191,32.333,26.3,4.489,3393.474,436.362,7.11,0.672,0
107,12,38,377,0,5,0,0,92.13,6524191,32.333,26.3,4.489,3393.474,436.362,7.11,0.672,0
107,13,42,419,0,5,0,0,92.13,6524191,32.333,26.3,4.489,3393.474,436.362,7.11,0.672,0
107,14,11,430,0,5,0,0,92.13,6524191,32.333,26.3,4.489,3393.474,436.362,7.11,0.672,0
107,15,19,449,0,5,0,0,92.13,6524191,32.333,26.3,4.489,3393.474,436.362,7.11,0.672,0
107,16,17,466,0,5,0,0,92.13,6524191,32.333,26.3,4.489,3393.474,436.362,7.11,0.672,0
107,17,23,489,0,5,0,0,92.13,6524191,32.333,26.3,4.489,3393.474,436.362,7.11,0.672,0
107,18,17,506,0,5,0,0,92.13,6524191,32.333,26.3,4.489,3393.474,436.362,7.11,0.672,0
107,19,48,554,0,5,0,0,92.13,6524191,32.333,26.3,4.489,3393.474,436.362,7.11,0.672,0
107,20,14,568,2,7,0,0,92.13,6524191,32.333,26.3,4.489,3393.474,436.362,7.11,0.672,0
107,21,22,590,0,7,0,0,92.13,6524191,32.333,26.3,4.489,3393.474,436.362,7.11,0.672,0
107,22,22,612,0,7,0,0,92.13,6524191,32.333,26.3,4.489,3393.474,436.362,7.11,0.672,0
107,23,19,631,1,8,0,0,92.13,6524191,32.333,26.3,4.489,3393.474,436.362,7.11,0.672,0
107,24,25,656,0,8,0,0,92.13,6524191,32.333,26.3,4.489,3393.474,436.362,7.11,0.672,0
107,25,9,665,0,8,0,0,92.13,6524191,32.333,26.3,4.489,3393.474,436.362,7.11,0.672,0
107,26,17,682,0,8,0,0,92.13,6524191,32.333,26.3,4.489,3393.474,436.362,7.11,0.672,0
107,27,13,695,0,8,0,0,92.13,6524191,32.333,26.3,4.489,3393.474,436.362,7.11,0.672,0
107,28,13,708,0,8,0,0,92.13,6524191,32.333,26.3,4.489,3393.474,436.362,7.11,0.672,0
107,29,21,729,0,8,0,0,92.13,6524191,32.333,26.3,4.489,3393.474,436.362,7.11,0.672,0
107,30,17,746,0,8,0,0,88.43,6524191,32.333,26.3,4.489,3393.474,436.362,7.11,0.672,0
107,31,0,746,0,8,0,0,88.43,6524191,32.333,26.3,4.489,3393.474,436.362,7.11,0.672,0
107,32,23,769,0,8,0,0,88.43,6524191,32.333,26.3,4.489,3393.474,436.362,7.11,0.672,0
107,33,26,795,2,10,0,0,88.43,6524191,32.333,26.3,4.489,3393.474,436.362,7.11,0.672,0
107,34,35,830,0,10,0,0,85.65,6524191,32.333,26.3,4.489,3393.474,436.362,7.11,0.672,0
107,35,13,843,1,11,0,0,85.65,6524191,32.333,26.3,4.489,3393.474,436.362,7.11,0.672,0
107,36,28,871,1,12,0,0,85.65,6524191,32.333,26.3,4.489,3393.474,436.362,7.11,0.672,0
107,37,24,895,0,12,0,0,85.65,6524191,32.333,26.3,4.489,3393.474,436.362,7.11,0.672,0
107,38,11,906,0,12,0,0,85.65,6524191,32.333,26.3,4.489,3393.474,436.362,7.11,0.672,0
107,39,25,931,0,12,0,0,85.65,6524191,32.333,26.3,4.489,3393.474,436.362,7.11,0.672,0
107,40,71,1002,0,12,0,0,85.65,6524191,32.333,26.3,4.489,3393.474,436.362,7.11,0.672,0
107,41,14,1016,0,12,0,0,81.94,6524191,32.333,26.3,4.489,3393.474,436.362,7.11,0.672,0
107,42,21,1037,0,12,0,0,81.94,6524191,32.333,26.3,4.489,3393.474,436.362,7.11,0.672,0
107,43,7,1044,0,12,0,0,81.94,6524191,32.333,26.3,4.489,3393.474,436.362,7.11,0.672,0
107,44,38,1082,0,12,0,0,81.94,6524191,32.333,26.3,4.489,3393.474,436.362,7.11,0.672,0
107,45,29,1111,2,14,0,0,81.94,6524191,32.333,26.3,4.489,3393.474,436.362,7.11,0.672,0
107,46,6,1117,0,14,0,0,84.72,6524191,32.333,26.3,4.489,3393.474,436.362,7.11,0.672,0
107,47,21,1138,0,14,0,0,84.72,6524191,32.333,26.3,4.489,3393.474,436.362,7.11,0.672,0
107,48,78,1216,0,14,0,0,84.72,6524191,32.333,26.3,4.489,3393.474,436.362,7.11,0.672,0
107,49,27,1243,0,14,0,0,84.72,6524191,32.333,26.3,4.489,3393.474,436.362,7.11,0.672,0
107,50,27,1270,0,14,0,0,84.72,6524191,32.333,26.3,4.489,3393.474,436.362,7.11,0.672,0
107,51,43,1313,0,14,0,0,84.72,6524191,32.333,26.3,4.489,3393.474,436.362,7.11,0.672,0
107,52,37,1350,0,14,0,0,84.72,6524191,32.333,26.3,4.489,3393.474,436.362,7.11,0.672,0
107,53,14,1364,0,14,0,0,84.72,6524191,32.333,26.3,4.489,3393.474,436.362,7.11,0.672,0
107,54,39,1403,0,14,0,0,79.17,6524191,32.333,26.3,4.489,3393.474,436.362,7.11,0.672,0
107,55,30,1433,2,16,0,0,79.17,6524191,32.333,26.3,4.489,3393.474,436.362,7.11,0.672,0
107,56,35,1468,0,16,0,0,79.17,6524191,32.333,26.3,4.489,3393.474,436.362,7.11,0.672,0
107,57,52,1520,0,16,0,0,79.17,6524191,32.333,26.3,4.489,3393.474,436.362,7.11,0.672,0
107,58,74,1594,0,16,0,0,79.17,6524191,32.333,26.3,4.489,3393.474,436.362,7.11,0.672,0
107,59,68,1662,0,16,0,0,79.17,6524191,32.333,26.3,4.489,3393.474,436.362,7.11,0.672,0
107,60,60,1722,0,16,0,0,79.17,6524191,32.333,26.3,4.489,3393.474,436.362,7.11,0.672,0
107,61,26,1748,0,16,0,0,79.17,6524191,32.333,26.3,4.489,3393.474,436.362,7.11,0.672,0
107,62,69,1817,0,16,0,0,79.17,6524191,32.333,26.3,4.489,3393.474,436.362,7.11,0.672,0
107,63,28,1845,1,17,0,0,79.17,6524191,32.333,26.3,4.489,3393.474,436.362,7.11,0.672,0
107,64,26,1871,3,20,0,0,76.39,6524191,32.333,26.3,4.489,3393.474,436.362,7.11,0.672,0
107,65,28,1899,0,20,0,0,76.39,6524191,32.333,26.3,4.489,3393.474,436.362,7.11,0.672,0
107,66,37,1936,2,22,0,0,76.39,6524191,32.333,26.3,4.489,3393.474,436.362,7.11,0.672,0
107,67,38,1974,0,22,0,0,76.39,6524191,32.333,26.3,4.489,3393.474,436.362,7.11,0.672,0
107,68,33,2007,0,22,0,0,76.39,6524191,32.333,26.3,4.489,3393.474,436.362,7.11,0.672,0
107,69,25,2032,1,23,0,0,76.39,6524191,32.333,26.3,4.489,3393.474,436.362,7.11,0.672,0
107,70,23,2055,1,24,0,0,76.39,6524191,32.333,26.3,4.489,3393.474,436.362,7.11,0.672,0
107,71,38,2093,2,26,0,0,76.39,6524191,32.333,26.3,4.489,3393.474,436.362,7.11,0.672,0
107,72,36,2129,0,26,0,0,76.39,6524191,32.333,26.3,4.489,3393.474,436.362,7.11,0.672,0
107,73,37,2166,0,26,0,0,76.39,6524191,32.333,26.3,4.489,3393.474,436.362,7.11,0.672,0
107,74,41,2207,1,27,0,0,76.39,6524191,32.333,26.3,4.489,3393.474,436.362,7.11,0.672,0
107,75,78,2285,0,27,0,0,76.39,6524191,32.333,26.3,4.489,3393.474,436.362,7.11,0.672,0
107,76,87,2372,0,27,0,0,76.39,6524191,32.333,26.3,4.489,3393.474,436.362,7.11,0.672,0
107,77,100,2472,1,28,0,0,76.39,6524191,32.333,26.3,4.489,3393.474,436.362,7.11,0.672,0
107,78,90,2562,2,30,0,0,76.39,6524191,32.333,26.3,4.489,3393.474,436.362,7.11,0.672,0
107,79,95,2657,1,31,0,0,76.39,6524191,32.333,26.3,4.489,3393.474,436.362,7.11,0.672,0
107,80,132,2789,1,32,0,0,76.39,6524191,32.333,26.3,4.489,3393.474,436.362,7.11,0.672,0
107,81,192,2981,3,35,0,0,73.61,6524191,32.333,26.3,4.489,3393.474,436.362,7.11,0.672,0
107,82,170,3151,2,37,0,0,73.61,6524191,32.333,26.3,4.489,3393.474,436.362,7.11,0.672,0
107,83,205,3356,3,40,0,0,73.61,6524191,32.333,26.3,4.489,3393.474,436.362,7.11,0.672,0
107,84,163,3519,1,41,0,0,73.61,6524191,32.333,26.3,4.489,3393.474,436.362,7.11,0.672,0
107,85,207,3726,1,42,0,0,73.61,6524191,32.333,26.3,4.489,3393.474,436.362,7.11,0.672,0
107,86,228,3954,1,43,0,0,73.61,6524191,32.333,26.3,4.489,3393.474,436.362,7.11,0.672,0
107,87,250,4204,0,43,0,0,73.61,6524191,32.333,26.3,4.489,3393.474,436.362,7.11,0.672,0
107,88,309,4513,3,46,0,0,76.39,6524191,32.333,26.3,4.489,3393.474,436.362,7.11,0.672,0
107,89,235,4748,1,47,0,0,76.39,6524191,32.333,26.3,4.489,3393.474,436.362,7.11,0.672,0
107,90,269,5017,3,50,0,0,76.39,6524191,32.333,26.3,4.489,3393.474,436.362,7.11,0.672,0
107,91,279,5296,7,57,0,0,76.39,6524191,32.333,26.3,4.489,3393.474,436.362,7.11,0.672,0
107,92,439,5735,5,62,0,0,76.39,6524191,32.333,26.3,4.489,3393.474,436.362,7.11,0.672,0
107,93,0,5735,0,62,0,0,76.39,6524191,32.333,26.3,4.489,3393.474,436.362,7.11,0.672,0
107,94,1032,6767,14,76,0,0,76.39,6524191,32.333,26.3,4.489,3393.474,436.362,7.11,0.672,0
107,95,327,7094,2,78,0,0,76.39,6524191,32.333,26.3,4.489,3393.474,436.362,7.11,0.672,0
107,96,283,7377,10,88,0,0,76.39,6524191,32.333,26.3,4.489,3393.474,436.362,7.11,0.672,0
107,97,314,7691,4,92,0,0,76.39,6524191,32.333,26.3,4.489,3393.474,436.362,7.11,0.672,0
107,98,450,8141,7,99,0,0,76.39,6524191,32.333,26.3,4.489,3393.474,436.362,7.11,0.672,0
107,99,345,8486,13,112,0,0,76.39,6524191,32.333,26.3,4.489,3393.474,436.362,7.11,0.672,0
107,100,361,8847,4,116,0,0,76.39,6524191,32.333,26.3,4.489,3393.474,436.362,7.11,0.672,0
107,101,511,9358,6,122,0,0,76.39,6524191,32.333,26.3,4.489,3393.474,436.362,7.11,0.672,0
107,102,552,9910,3,125,0,0,76.39,6524191,32.333,26.3,4.489,3393.474,436.362,7.11,0.672,0
107,103,719,10629,7,132,0,0,76.39,6524191,32.333,26.3,4.489,3393.474,436.362,7.11,0.672,0
107,104,488,11117,15,147,0,0,76.39,6524191,32.333,26.3,4.489,3393.474,436.362,7.11,0.672,0
107,105,421,11538,2,149,0,0,76.39,6524191,32.333,26.3,4.489,3393.474,436.362,7.11,0.672,0
107,106,439,11977,11,160,0,0,76.39,6524191,32.333,26.3,4.489,3393.474,436.362,7.11,0.672,0
107,107,521,12498,7,167,0,0,76.39,6524191,32.333,26.3,4.489,3393.474,436.362,7.11,0.672,0
107,108,603,13101,5,172,0,0,76.39,6524191,32.333,26.3,4.489,3393.474,436.362,7.11,0.672,0
107,109,11505,24606,728,900,0,0,76.39,6524191,32.333,26.3,4.489,3393.474,436.362,7.11,0.672,0
107,110,1926,26532,103,1003,0,0,76.39,6524191,32.333,26.3,4.489,3393.474,436.362,7.11,0.672,0
107,111,611,27143,34,1037,0,0,76.39,6524191,32.333,26.3,4.489,3393.474,436.362,7.11,0.672,0
107,112,1108,28251,42,1079,0,0,76.39,6524191,32.333,26.3,4.489,3393.474,436.362,7.11,0.672,0
107,113,1108,29359,44,1123,0,0,76.39,6524191,32.333,26.3,4.489,3393.474,436.362,7.11,0.672,0
107,114,967,30326,46,1169,0,0,76.39,6524191,32.333,26.3,4.489,3393.474,436.362,7.11,0.672,0
107,115,921,31247,42,1211,0,0,76.39,6524191,32.333,26.3,4.489,3393.474,436.362,7.11,0.672,0
107,116,317,31564,38,1249,0,0,76.39,6524191,32.333,26.3,4.489,3393.474,436.362,7.11,0.672,0
107,117,1249,32813,28,1277,0,0,76.39,6524191,32.333,26.3,4.489,3393.474,436.362,7.11,0.672,0
107,118,483,33296,24,1301,0,0,76.39,6524191,32.333,26.3,4.489,3393.474,436.362,7.11,0.672,0
107,119,548,33844,28,1329,0,0,76.39,6524191,32.333,26.3,4.489,3393.474,436.362,7.11,0.672,0
107,120,748,34592,18,1347,0,0,76.39,6524191,32.333,26.3,4.489,3393.474,436.362,7.11,0.672,0
107,121,631,35223,17,1364,0,0,76.39,6524191,32.333,26.3,4.489,3393.474,436.362,7.11,0.672,0
107,122,582,35805,14,1378,0,0,79.17,6524191,32.333,26.3,4.489,3393.474,436.362,7.11,0.672,0
107,123,494,36299,19,1397,0,0,79.17,6524191,32.333,26.3,4.489,3393.474,436.362,7.11,0.672,0
107,124,420,36719,12,1409,0,0,79.17,6524191,32.333,26.3,4.489,3393.474,436.362,7.11,0.672,0
107,125,410,37129,11,1420,0,0,79.17,6524191,32.333,26.3,4.489,3393.474,436.362,7.11,0.672,0
107,126,412,37541,7,1427,0,0,79.17,6524191,32.333,26.3,4.489,3393.474,436.362,7.11,0.672,0
107,127,569,38110,11,1438,0,0,79.17,6524191,32.333,26.3,4.489,3393.474,436.362,7.11,0.672,0
107,128,549,38659,9,1447,0,0,79.17,6524191,32.333,26.3,4.489,3393.474,436.362,7.11,0.672,0
107,129,503,39162,4,1451,0,0,79.17,6524191,32.333,26.3,4.489,3393.474,436.362,7.11,0.672,0
107,130,425,39587,9,1460,0,0,79.17,6524191,32.333,26.3,4.489,3393.474,436.362,7.11,0.672,0
107,131,332,39919,8,1468,0,0,79.17,6524191,32.333,26.3,4.489,3393.474,436.362,7.11,0.672,0
107,132,258,40177,6,1474,0,0,79.17,6524191,32.333,26.3,4.489,3393.474,436.362,7.11,0.672,0
107,133,278,40455,4,1478,0,0,79.17,6524191,32.333,26.3,4.489,3393.474,436.362,7.11,0.672,0
107,134,304,40759,6,1484,0,0,79.17,6524191,32.333,26.3,4.489,3393.474,436.362,7.11,0.672,0
107,135,0,40759,0,1484,0,0,79.17,6524191,32.333,26.3,4.489,3393.474,436.362,7.11,0.672,0
107,136,310,41069,3,1487,0,0,79.17,6524191,32.333,26.3,4.489,3393.474,436.362,7.11,0.672,0
107,137,304,41373,4,1491,0,0,79.17,6524191,32.333,26.3,4.489,3393.474,436.362,7.11,0.672,0
107,138,483,41856,4,1495,0,0,79.17,6524191,32.333,26.3,4.489,3393.474,436.362,7.11,0.672,0
107,139,135,41991,1,1496,0,0,79.17,6524191,32.333,26.3,4.489,3393.474,436.362,7.11,0.672,0
107,140,155,42146,2,1498,0,0,79.17,6524191,32.333,26.3,4.489,3393.474,436.362,7.11,0.672,0
107,141,0,42146,0,1498,0,0,79.17,6524191,32.333,26.3,4.489,3393.474,436.362,7.11,0.672,0
107,142,179,42325,0,1498,0,0,79.17,6524191,32.333,26.3,4.489,3393.474,436.362,7.11,0.672,0
107,143,378,42703,1,1499,0,0,79.17,6524191,32.333,26.3,4.489,3393.474,436.362,7.11,0.672,0
107,144,0,42703,0,1499,0,0,79.17,6524191,32.333,26.3,4.489,3393.474,436.362,7.11,0.672,0
107,145,186,42889,1,1500,0,0,79.17,6524191,32.333,26.3,4.489,3393.474,436.362,7.11,0.672,0
107,146,237,43126,-443,1057,0,0,76.39,6524191,32.333,26.3,4.489,3393.474,436.362,7.11,0.672,0
107,147,119,43245,0,1057,0,0,73.61,6524191,32.333,26.3,4.489,3393.474,436.362,7.11,0.672,0
107,148,113,43358,0,1057,0,0,73.61,6524191,32.333,26.3,4.489,3393.474,436.362,7.11,0.672,0
107,149,101,43459,0,1057,0,0,73.61,6524191,32.333,26.3,4.489,3393.474,436.362,7.11,0.672,0
107,150,128,43587,0,1057,0,0,73.61,6524191,32.333,26.3,4.489,3393.474,436.362,7.11,0.672,0
107,151,125,43712,0,1057,0,0,73.61,6524191,32.333,26.3,4.489,3393.474,436.362,7.11,0.672,0
107,152,108,43820,1,1058,0,0,73.61,6524191,32.333,26.3,4.489,3393.474,436.362,7.11,0.672,0
107,153,78,43898,0,1058,0,0,73.61,6524191,32.333,26.3,4.489,3393.474,436.362,7.11,0.672,0
107,154,60,43958,1,1059,0,0,69.91,6524191,32.333,26.3,4.489,3393.474,436.362,7.11,0.672,0
107,155,78,44036,0,1059,0,0,69.91,6524191,32.333,26.3,4.489,3393.474,436.362,7.11,0.672,0
107,156,99,44135,0,1059,0,0,69.91,6524191,32.333,26.3,4.489,3393.474,436.362,7.11,0.672,0
107,157,92,44227,1,1060,0,0,69.91,6524191,32.333,26.3,4.489,3393.474,436.362,7.11,0.672,0
107,158,89,44316,0,1060,0,0,69.91,6524191,32.333,26.3,4.489,3393.474,436.362,7.11,0.672,0
107,159,87,44403,0,1060,0,0,69.91,6524191,32.333,26.3,4.489,3393.474,436.362,7.11,0.672,0
107,160,48,44451,0,1060,0,0,69.91,6524191,32.333,26.3,4.489,3393.474,436.362,7.11,0.672,0
107,161,75,44526,0,1060,0,0,69.91,6524191,32.333,26.3,4.489,3393.474,436.362,7.11,0.672,0
107,162,87,44613,1,1061,0,0,69.91,6524191,32.333,26.3,4.489,3393.474,436.362,7.11,0.672,0
107,163,71,44684,0,1061,0,0,69.91,6524191,32.333,26.3,4.489,3393.474,436.362,7.11,0.672,0
107,164,0,44684,2,1063,0,0,69.91,6524191,32.333,26.3,4.489,3393.474,436.362,7.11,0.672,0
107,165,144,44828,0,1063,0,0,69.91,6524191,32.333,26.3,4.489,3393.474,436.362,7.11,0.672,0
107,166,53,44881,0,1063,0,0,69.91,6524191,32.333,26.3,4.489,3393.474,436.362,7.11,0.672,0
107,167,47,44928,0,1063,0,0,69.91,6524191,32.333,26.3,4.489,3393.474,436.362,7.11,0.672,0
107,168,0,44928,0,1063,0,0,69.91,6524191,32.333,26.3,4.489,3393.474,436.362,7.11,0.672,0
107,169,144,45072,0,1063,0,0,69.91,6524191,32.333,26.3,4.489,3393.474,436.362,7.11,0.672,0
107,170,81,45153,0,1063,0,0,69.91,6524191,32.333,26.3,4.489,3393.474,436.362,7.11,0.672,0
107,171,91,45244,0,1063,0,0,69.91,6524191,32.333,26.3,4.489,3393.474,436.362,7.11,0.672,0
107,172,91,45335,0,1063,0,0,69.91,6524191,32.333,26.3,4.489,3393.474,436.362,7.11,0.672,0
107,173,81,45416,0,1063,0,0,69.91,6524191,32.333,26.3,4.489,3393.474,436.362,7.11,0.672,0
107,174,55,45471,0,1063,0,0,69.91,6524191,32.333,26.3,4.489,3393.474,436.362,7.11,0.672,0
107,175,71,45542,0,1063,0,0,67.13,6524191,32.333,26.3,4.489,3393.474,436.362,7.11,0.672,0
107,176,88,45630,0,1063,0,0,67.13,6524191,32.333,26.3,4.489,3393.474,436.362,7.11,0.672,0
107,177,127,45757,0,1063,0,0,67.13,6524191,32.333,26.3,4.489,3393.474,436.362,7.11,0.672,0
107,178,175,45932,0,1063,0,0,67.13,6524191,32.333,26.3,4.489,3393.474,436.362,7.11,0.672,0
107,179,158,46090,0,1063,0,0,67.13,6524191,32.333,26.3,4.489,3393.474,436.362,7.11,0.672,0
107,180,161,46251,0,1063,0,0,67.13,6524191,32.333,26.3,4.489,3393.474,436.362,7.11,0.672,0
107,181,104,46355,1,1064,0,0,67.13,6524191,32.333,26.3,4.489,3393.474,436.362,7.11,0.672,0
107,182,167,46522,0,1064,0,0,67.13,6524191,32.333,26.3,4.489,3393.474,436.362,7.11,0.672,0
107,183,147,46669,0,1064,0,0,67.13,6524191,32.333,26.3,4.489,3393.474,436.362,7.11,0.672,0
107,184,172,46841,1,1065,0,0,67.13,6524191,32.333,26.3,4.489,3393.474,436.362,7.11,0.672,0
107,185,215,47056,0,1065,0,0,67.13,6524191,32.333,26.3,4.489,3393.474,436.362,7.11,0.672,0
107,186,128,47184,0,1065,0,0,67.13,6524191,32.333,26.3,4.489,3393.474,436.362,7.11,0.672,0
107,187,244,47428,1,1066,0,0,67.13,6524191,32.333,26.3,4.489,3393.474,436.362,7.11,0.672,0
107,188,207,47635,0,1066,0,0,67.13,6524191,32.333,26.3,4.489,3393.474,436.362,7.11,0.672,0
107,189,164,47799,0,1066,0,0,67.13,6524191,32.333,26.3,4.489,3393.474,436.362,7.11,0.672,0
107,190,0,47799,0,1066,0,0,67.13,6524191,32.333,26.3,4.489,3393.474,436.362,7.11,0.672,0
107,191,298,48097,3,1069,0,0,67.13,6524191,32.333,26.3,4.489,3393.474,436.362,7.11,0.672,0
107,192,520,48617,8,1077,0,0,67.13,6524191,32.333,26.3,4.489,3393.474,436.362,7.11,0.672,0
107,193,307,48924,5,1082,0,0,67.13,6524191,32.333,26.3,4.489,3393.474,436.362,7.11,0.672,0
107,194,0,48924,0,1082,0,0,67.13,6524191,32.333,26.3,4.489,3393.474,436.362,7.11,0.672,0
107,195,306,49230,3,1085,0,0,67.13,6524191,32.333,26.3,4.489,3393.474,436.362,7.11,0.672,0
107,196,641,49871,7,1092,0,0,67.13,6524191,32.333,26.3,4.489,3393.474,436.362,7.11,0.672,0
107,197,330,50201,2,1094,0,0,67.13,6524191,32.333,26.3,4.489,3393.474,436.362,7.11,0.672,0
107,198,388,50589,5,1099,0,0,67.13,6524191,32.333,26.3,4.489,3393.474,436.362,7.11,0.672,0
107,199,431,51020,4,1103,0,0,67.13,6524191,32.333,26.3,4.489,3393.474,436.362,7.11,0.672,0
107,200,470,51490,5,1108,0,0,67.13,6524191,32.333,26.3,4.489,3393.474,436.362,7.11,0.672,0
107,201,0,51490,0,1108,0,0,67.13,6524191,32.333,26.3,4.489,3393.474,436.362,7.11,0.672,0
107,202,1036,52526,3,1111,0,0,67.13,6524191,32.333,26.3,4.489,3393.474,436.362,7.11,0.672,0
107,203,384,52910,2,1113,0,0,67.13,6524191,32.333,26.3,4.489,3393.474,436.362,7.11,0.672,0
107,204,549,53459,5,1118,0,0,67.13,6524191,32.333,26.3,4.489,3393.474,436.362,7.11,0.672,0
108,1,0,9,0,0,0,0,96.3,7275556,29.715,24.4,4.029,6397.36,368.111,4,0.601,0
108,2,1,10,0,0,0,0,96.3,7275556,29.715,24.4,4.029,6397.36,368.111,4,0.601,0
108,3,0,10,0,0,0,0,96.3,7275556,29.715,24.4,4.029,6397.36,368.111,4,0.601,0
108,4,0,10,0,0,0,0,96.3,7275556,29.715,24.4,4.029,6397.36,368.111,4,0.601,0
108,5,0,10,0,0,0,0,96.3,7275556,29.715,24.4,4.029,6397.36,368.111,4,0.601,0
108,6,1,11,0,0,0,0,96.3,7275556,29.715,24.4,4.029,6397.36,368.111,4,0.601,0
108,7,1,12,0,0,0,0,96.3,7275556,29.715,24.4,4.029,6397.36,368.111,4,0.601,0
108,8,0,12,0,0,0,0,96.3,7275556,29.715,24.4,4.029,6397.36,368.111,4,0.601,0
108,9,3,15,0,0,0,0,96.3,7275556,29.715,24.4,4.029,6397.36,368.111,4,0.601,0
108,10,1,16,0,0,0,0,96.3,7275556,29.715,24.4,4.029,6397.36,368.111,4,0.601,0
108,11,0,16,0,0,0,0,96.3,7275556,29.715,24.4,4.029,6397.36,368.111,4,0.601,0
108,12,2,18,0,0,0,0,96.3,7275556,29.715,24.4,4.029,6397.36,368.111,4,0.601,0
108,13,1,19,0,0,0,0,96.3,7275556,29.715,24.4,4.029,6397.36,368.111,4,0.601,0
108,14,0,19,0,0,0,0,96.3,7275556,29.715,24.4,4.029,6397.36,368.111,4,0.601,0
108,15,0,19,0,0,0,0,96.3,7275556,29.715,24.4,4.029,6397.36,368.111,4,0.601,0
108,16,0,19,0,0,0,0,96.3,7275556,29.715,24.4,4.029,6397.36,368.111,4,0.601,0
108,17,0,19,0,0,0,0,96.3,7275556,29.715,24.4,4.029,6397.36,368.111,4,0.601,0
108,18,0,19,0,0,0,0,96.3,7275556,29.715,24.4,4.029,6397.36,368.111,4,0.601,0
108,19,0,19,0,0,0,0,96.3,7275556,29.715,24.4,4.029,6397.36,368.111,4,0.601,0
108,20,0,19,0,0,0,0,96.3,7275556,29.715,24.4,4.029,6397.36,368.111,4,0.601,0
108,21,0,19,0,0,0,0,96.3,7275556,29.715,24.4,4.029,6397.36,368.111,4,0.601,0
108,22,0,19,0,0,0,0,96.3,7275556,29.715,24.4,4.029,6397.36,368.111,4,0.601,0
108,23,0,19,0,0,0,0,96.3,7275556,29.715,24.4,4.029,6397.36,368.111,4,0.601,0
108,24,0,19,0,0,0,0,96.3,7275556,29.715,24.4,4.029,6397.36,368.111,4,0.601,0
108,25,0,19,0,0,0,0,96.3,7275556,29.715,24.4,4.029,6397.36,368.111,4,0.601,0
108,26,0,19,0,0,0,0,96.3,7275556,29.715,24.4,4.029,6397.36,368.111,4,0.601,0
108,27,0,19,0,0,0,0,96.3,7275556,29.715,24.4,4.029,6397.36,368.111,4,0.601,0
108,28,0,19,0,0,0,0,96.3,7275556,29.715,24.4,4.029,6397.36,368.111,4,0.601,0
108,29,0,19,0,0,0,0,96.3,7275556,29.715,24.4,4.029,6397.36,368.111,4,0.601,0
108,30,0,19,0,0,0,0,96.3,7275556,29.715,24.4,4.029,6397.36,368.111,4,0.601,0
108,31,0,19,0,0,0,0,96.3,7275556,29.715,24.4,4.029,6397.36,368.111,4,0.601,0
108,32,0,19,0,0,0,0,96.3,7275556,29.715,24.4,4.029,6397.36,368.111,4,0.601,0
108,33,0,19,0,0,0,0,96.3,7275556,29.715,24.4,4.029,6397.36,368.111,4,0.601,0
108,34,0,19,0,0,0,0,82.41,7275556,29.715,24.4,4.029,6397.36,368.111,4,0.601,0
108,35,0,19,0,0,0,0,82.41,7275556,29.715,24.4,4.029,6397.36,368.111,4,0.601,0
108,36,0,19,0,0,0,0,82.41,7275556,29.715,24.4,4.029,6397.36,368.111,4,0.601,0
108,37,0,19,0,0,0,0,82.41,7275556,29.715,24.4,4.029,6397.36,368.111,4,0.601,0
108,38,0,19,0,0,0,0,82.41,7275556,29.715,24.4,4.029,6397.36,368.111,4,0.601,0
108,39,0,19,0,0,0,0,82.41,7275556,29.715,24.4,4.029,6397.36,368.111,4,0.601,0
108,40,0,19,0,0,0,0,82.41,7275556,29.715,24.4,4.029,6397.36,368.111,4,0.601,0
108,41,0,19,0,0,0,0,82.41,7275556,29.715,24.4,4.029,6397.36,368.111,4,0.601,0
108,42,0,19,0,0,0,0,82.41,7275556,29.715,24.4,4.029,6397.36,368.111,4,0.601,0
108,43,0,19,0,0,0,0,82.41,7275556,29.715,24.4,4.029,6397.36,368.111,4,0.601,0
108,44,0,19,0,0,0,0,82.41,7275556,29.715,24.4,4.029,6397.36,368.111,4,0.601,0
108,45,0,19,0,0,0,0,82.41,7275556,29.715,24.4,4.029,6397.36,368.111,4,0.601,0
108,46,0,19,0,0,0,0,82.41,7275556,29.715,24.4,4.029,6397.36,368.111,4,0.601,0
108,47,0,19,0,0,0,0,82.41,7275556,29.715,24.4,4.029,6397.36,368.111,4,0.601,0
108,48,0,19,0,0,0,0,54.63,7275556,29.715,24.4,4.029,6397.36,368.111,4,0.601,0
108,49,0,19,0,0,0,0,54.63,7275556,29.715,24.4,4.029,6397.36,368.111,4,0.601,0
108,50,0,19,0,0,0,0,54.63,7275556,29.715,24.4,4.029,6397.36,368.111,4,0.601,0
108,51,0,19,0,0,0,0,54.63,7275556,29.715,24.4,4.029,6397.36,368.111,4,0.601,0
108,52,0,19,0,0,0,0,54.63,7275556,29.715,24.4,4.029,6397.36,368.111,4,0.601,0
108,53,0,19,0,0,0,0,54.63,7275556,29.715,24.4,4.029,6397.36,368.111,4,0.601,0
108,54,0,19,0,0,0,0,54.63,7275556,29.715,24.4,4.029,6397.36,368.111,4,0.601,0
108,55,0,19,0,0,0,0,54.63,7275556,29.715,24.4,4.029,6397.36,368.111,4,0.601,0
108,56,0,19,0,0,0,0,54.63,7275556,29.715,24.4,4.029,6397.36,368.111,4,0.601,0
108,57,0,19,0,0,0,0,54.63,7275556,29.715,24.4,4.029,6397.36,368.111,4,0.601,0
108,58,0,19,0,0,0,0,54.63,7275556,29.715,24.4,4.029,6397.36,368.111,4,0.601,0
108,59,0,19,0,0,0,0,54.63,7275556,29.715,24.4,4.029,6397.36,368.111,4,0.601,0
108,60,0,19,0,0,0,0,54.63,7275556,29.715,24.4,4.029,6397.36,368.111,4,0.601,0
108,61,0,19,0,0,0,0,54.63,7275556,29.715,24.4,4.029,6397.36,368.111,4,0.601,0
108,62,0,19,0,0,0,0,43.52,7275556,29.715,24.4,4.029,6397.36,368.111,4,0.601,0
108,63,0,19,0,0,0,0,36.11,7275556,29.715,24.4,4.029,6397.36,368.111,4,0.601,0
108,64,0,19,0,0,0,0,36.11,7275556,29.715,24.4,4.029,6397.36,368.111,4,0.601,0
108,65,0,19,0,0,0,0,36.11,7275556,29.715,24.4,4.029,6397.36,368.111,4,0.601,0
108,66,0,19,0,0,0,0,36.11,7275556,29.715,24.4,4.029,6397.36,368.111,4,0.601,0
108,67,0,19,0,0,0,0,36.11,7275556,29.715,24.4,4.029,6397.36,368.111,4,0.601,0
108,68,0,19,0,0,0,0,36.11,7275556,29.715,24.4,4.029,6397.36,368.111,4,0.601,0
108,69,0,19,0,0,0,0,36.11,7275556,29.715,24.4,4.029,6397.36,368.111,4,0.601,0
108,70,0,19,0,0,0,0,36.11,7275556,29.715,24.4,4.029,6397.36,368.111,4,0.601,0
108,71,0,19,0,0,0,0,36.11,7275556,29.715,24.4,4.029,6397.36,368.111,4,0.601,0
108,72,0,19,0,0,0,0,36.11,7275556,29.715,24.4,4.029,6397.36,368.111,4,0.601,0
108,73,0,19,0,0,0,0,36.11,7275556,29.715,24.4,4.029,6397.36,368.111,4,0.601,0
108,74,0,19,0,0,0,0,36.11,7275556,29.715,24.4,4.029,6397.36,368.111,4,0.601,0
108,75,0,19,0,0,0,0,36.11,7275556,29.715,24.4,4.029,6397.36,368.111,4,0.601,0
108,76,0,19,0,0,0,0,36.11,7275556,29.715,24.4,4.029,6397.36,368.111,4,0.601,0
108,77,0,19,0,0,0,0,36.11,7275556,29.715,24.4,4.029,6397.36,368.111,4,0.601,0
108,78,0,19,0,0,0,0,36.11,7275556,29.715,24.4,4.029,6397.36,368.111,4,0.601,0
108,79,0,19,0,0,0,0,36.11,7275556,29.715,24.4,4.029,6397.36,368.111,4,0.601,0
108,80,0,19,0,0,0,0,36.11,7275556,29.715,24.4,4.029,6397.36,368.111,4,0.601,0
108,81,0,19,0,0,0,0,36.11,7275556,29.715,24.4,4.029,6397.36,368.111,4,0.601,0
108,82,0,19,0,0,0,0,36.11,7275556,29.715,24.4,4.029,6397.36,368.111,4,0.601,0
108,83,0,19,0,0,0,0,36.11,7275556,29.715,24.4,4.029,6397.36,368.111,4,0.601,0
108,84,0,19,0,0,0,0,36.11,7275556,29.715,24.4,4.029,6397.36,368.111,4,0.601,0
108,85,0,19,0,0,0,0,36.11,7275556,29.715,24.4,4.029,6397.36,368.111,4,0.601,0
108,86,0,19,0,0,0,0,36.11,7275556,29.715,24.4,4.029,6397.36,368.111,4,0.601,0
108,87,0,19,0,0,0,0,36.11,7275556,29.715,24.4,4.029,6397.36,368.111,4,0.601,0
108,88,0,19,0,0,0,0,36.11,7275556,29.715,24.4,4.029,6397.36,368.111,4,0.601,0
108,89,0,19,0,0,0,0,33.33,7275556,29.715,24.4,4.029,6397.36,368.111,4,0.601,0
108,90,0,19,0,0,0,0,33.33,7275556,29.715,24.4,4.029,6397.36,368.111,4,0.601,0
108,91,0,19,0,0,0,0,33.33,7275556,29.715,24.4,4.029,6397.36,368.111,4,0.601,0
108,92,0,19,0,0,0,0,16.67,7275556,29.715,24.4,4.029,6397.36,368.111,4,0.601,0
108,93,0,19,0,0,0,0,16.67,7275556,29.715,24.4,4.029,6397.36,368.111,4,0.601,0
108,94,0,19,0,0,0,0,16.67,7275556,29.715,24.4,4.029,6397.36,368.111,4,0.601,0
108,95,0,19,0,0,0,0,16.67,7275556,29.715,24.4,4.029,6397.36,368.111,4,0.601,0
108,96,0,19,0,0,0,0,16.67,7275556,29.715,24.4,4.029,6397.36,368.111,4,0.601,0
108,97,0,19,0,0,0,0,16.67,7275556,29.715,24.4,4.029,6397.36,368.111,4,0.601,0
108,98,0,19,0,0,0,0,16.67,7275556,29.715,24.4,4.029,6397.36,368.111,4,0.601,0
108,99,0,19,0,0,0,0,16.67,7275556,29.715,24.4,4.029,6397.36,368.111,4,0.601,0
108,100,0,19,0,0,0,0,16.67,7275556,29.715,24.4,4.029,6397.36,368.111,4,0.601,0
108,101,0,19,0,0,0,0,16.67,7275556,29.715,24.4,4.029,6397.36,368.111,4,0.601,0
108,102,0,19,0,0,0,0,16.67,7275556,29.715,24.4,4.029,6397.36,368.111,4,0.601,0
108,103,0,19,0,0,0,0,16.67,7275556,29.715,24.4,4.029,6397.36,368.111,4,0.601,0
108,104,0,19,0,0,0,0,16.67,7275556,29.715,24.4,4.029,6397.36,368.111,4,0.601,0
108,105,0,19,0,0,0,0,16.67,7275556,29.715,24.4,4.029,6397.36,368.111,4,0.601,0
108,106,0,19,0,0,0,0,16.67,7275556,29.715,24.4,4.029,6397.36,368.111,4,0.601,0
108,107,0,19,0,0,0,0,16.67,7275556,29.715,24.4,4.029,6397.36,368.111,4,0.601,0
108,108,0,19,0,0,0,0,16.67,7275556,29.715,24.4,4.029,6397.36,368.111,4,0.601,0
108,109,0,19,0,0,0,0,16.67,7275556,29.715,24.4,4.029,6397.36,368.111,4,0.601,0
108,110,0,19,0,0,0,0,16.67,7275556,29.715,24.4,4.029,6397.36,368.111,4,0.601,0
108,111,0,19,0,0,0,0,16.67,7275556,29.715,24.4,4.029,6397.36,368.111,4,0.601,0
108,112,0,19,0,0,0,0,16.67,7275556,29.715,24.4,4.029,6397.36,368.111,4,0.601,0
108,113,0,19,0,0,0,0,16.67,7275556,29.715,24.4,4.029,6397.36,368.111,4,0.601,0
108,114,0,19,0,0,0,0,16.67,7275556,29.715,24.4,4.029,6397.36,368.111,4,0.601,0
108,115,0,19,0,0,0,0,16.67,7275556,29.715,24.4,4.029,6397.36,368.111,4,0.601,0
108,116,1,20,0,0,0,0,16.67,7275556,29.715,24.4,4.029,6397.36,368.111,4,0.601,0
108,117,0,20,0,0,0,0,11.11,7275556,29.715,24.4,4.029,6397.36,368.111,4,0.601,0
108,118,0,20,0,0,0,0,11.11,7275556,29.715,24.4,4.029,6397.36,368.111,4,0.601,0
108,119,0,20,0,0,0,0,11.11,7275556,29.715,24.4,4.029,6397.36,368.111,4,0.601,0
108,120,0,20,0,0,0,0,11.11,7275556,29.715,24.4,4.029,6397.36,368.111,4,0.601,0
108,121,0,20,0,0,0,0,11.11,7275556,29.715,24.4,4.029,6397.36,368.111,4,0.601,0
108,122,0,20,0,0,0,0,11.11,7275556,29.715,24.4,4.029,6397.36,368.111,4,0.601,0
108,123,0,20,0,0,0,0,32.41,7275556,29.715,24.4,4.029,6397.36,368.111,4,0.601,0
108,124,0,20,0,0,0,0,32.41,7275556,29.715,24.4,4.029,6397.36,368.111,4,0.601,0
108,125,0,20,0,0,0,0,26.85,7275556,29.715,24.4,4.029,6397.36,368.111,4,0.601,0
108,126,0,20,0,0,0,0,26.85,7275556,29.715,24.4,4.029,6397.36,368.111,4,0.601,0
108,127,0,20,0,0,0,0,26.85,7275556,29.715,24.4,4.029,6397.36,368.111,4,0.601,0
108,128,0,20,0,0,0,0,26.85,7275556,29.715,24.4,4.029,6397.36,368.111,4,0.601,0
108,129,0,20,0,0,0,0,26.85,7275556,29.715,24.4,4.029,6397.36,368.111,4,0.601,0
108,130,0,20,0,0,0,0,26.85,7275556,29.715,24.4,4.029,6397.36,368.111,4,0.601,0
108,131,0,20,0,0,0,0,26.85,7275556,29.715,24.4,4.029,6397.36,368.111,4,0.601,0
108,132,0,20,0,0,0,0,26.85,7275556,29.715,24.4,4.029,6397.36,368.111,4,0.601,0
108,133,0,20,0,0,0,0,26.85,7275556,29.715,24.4,4.029,6397.36,368.111,4,0.601,0
108,134,0,20,0,0,0,0,26.85,7275556,29.715,24.4,4.029,6397.36,368.111,4,0.601,0
108,135,0,20,0,0,0,0,26.85,7275556,29.715,24.4,4.029,6397.36,368.111,4,0.601,0
108,136,0,20,0,0,0,0,26.85,7275556,29.715,24.4,4.029,6397.36,368.111,4,0.601,0
108,137,0,20,0,0,0,0,26.85,7275556,29.715,24.4,4.029,6397.36,368.111,4,0.601,0
108,138,0,20,0,0,0,0,26.85,7275556,29.715,24.4,4.029,6397.36,368.111,4,0.601,0
108,139,0,20,0,0,0,0,26.85,7275556,29.715,24.4,4.029,6397.36,368.111,4,0.601,0
108,140,0,20,0,0,0,0,26.85,7275556,29.715,24.4,4.029,6397.36,368.111,4,0.601,0
108,141,0,20,0,0,0,0,26.85,7275556,29.715,24.4,4.029,6397.36,368.111,4,0.601,0
108,142,0,20,0,0,0,0,26.85,7275556,29.715,24.4,4.029,6397.36,368.111,4,0.601,0
108,143,0,20,0,0,0,0,26.85,7275556,29.715,24.4,4.029,6397.36,368.111,4,0.601,0
108,144,2,22,0,0,0,0,26.85,7275556,29.715,24.4,4.029,6397.36,368.111,4,0.601,0
108,145,0,22,0,0,0,0,26.85,7275556,29.715,24.4,4.029,6397.36,368.111,4,0.601,0
108,146,0,22,0,0,0,0,26.85,7275556,29.715,24.4,4.029,6397.36,368.111,4,0.601,0
108,147,0,22,0,0,0,0,32.41,7275556,29.715,24.4,4.029,6397.36,368.111,4,0.601,0
108,148,0,22,0,0,0,0,32.41,7275556,29.715,24.4,4.029,6397.36,368.111,4,0.601,0
108,149,0,22,0,0,0,0,32.41,7275556,29.715,24.4,4.029,6397.36,368.111,4,0.601,0
108,150,0,22,0,0,0,0,32.41,7275556,29.715,24.4,4.029,6397.36,368.111,4,0.601,0
108,151,0,22,0,0,0,0,32.41,7275556,29.715,24.4,4.029,6397.36,368.111,4,0.601,0
108,152,0,22,0,0,0,0,32.41,7275556,29.715,24.4,4.029,6397.36,368.111,4,0.601,0
108,153,0,22,0,0,0,0,32.41,7275556,29.715,24.4,4.029,6397.36,368.111,4,0.601,0
108,154,0,22,0,0,0,0,32.41,7275556,29.715,24.4,4.029,6397.36,368.111,4,0.601,0
108,155,0,22,0,0,0,0,32.41,7275556,29.715,24.4,4.029,6397.36,368.111,4,0.601,0
108,156,0,22,0,0,0,0,32.41,7275556,29.715,24.4,4.029,6397.36,368.111,4,0.601,0
108,157,0,22,0,0,0,0,32.41,7275556,29.715,24.4,4.029,6397.36,368.111,4,0.601,0
108,158,0,22,0,0,0,0,32.41,7275556,29.715,24.4,4.029,6397.36,368.111,4,0.601,0
108,159,0,22,0,0,0,0,32.41,7275556,29.715,24.4,4.029,6397.36,368.111,4,0.601,0
108,160,0,22,0,0,0,0,32.41,7275556,29.715,24.4,4.029,6397.36,368.111,4,0.601,0
108,161,0,22,0,0,0,0,32.41,7275556,29.715,24.4,4.029,6397.36,368.111,4,0.601,0
108,162,0,22,0,0,0,0,32.41,7275556,29.715,24.4,4.029,6397.36,368.111,4,0.601,0
108,163,0,22,0,0,0,0,32.41,7275556,29.715,24.4,4.029,6397.36,368.111,4,0.601,0
108,164,0,22,0,0,0,0,32.41,7275556,29.715,24.4,4.029,6397.36,368.111,4,0.601,0
108,165,1,23,0,0,0,0,32.41,7275556,29.715,24.4,4.029,6397.36,368.111,4,0.601,0
108,166,0,23,0,0,0,0,32.41,7275556,29.715,24.4,4.029,6397.36,368.111,4,0.601,0
108,167,0,23,0,0,0,0,32.41,7275556,29.715,24.4,4.029,6397.36,368.111,4,0.601,0
108,168,0,23,0,0,0,0,32.41,7275556,29.715,24.4,4.029,6397.36,368.111,4,0.601,0
108,169,0,23,0,0,0,0,32.41,7275556,29.715,24.4,4.029,6397.36,368.111,4,0.601,0
108,170,0,23,0,0,0,0,32.41,7275556,29.715,24.4,4.029,6397.36,368.111,4,0.601,0
108,171,0,23,0,0,0,0,32.41,7275556,29.715,24.4,4.029,6397.36,368.111,4,0.601,0
108,172,0,23,0,0,0,0,32.41,7275556,29.715,24.4,4.029,6397.36,368.111,4,0.601,0
108,173,0,23,0,0,0,0,32.41,7275556,29.715,24.4,4.029,6397.36,368.111,4,0.601,0
108,174,0,23,0,0,0,0,32.41,7275556,29.715,24.4,4.029,6397.36,368.111,4,0.601,0
108,175,0,23,0,0,0,0,32.41,7275556,29.715,24.4,4.029,6397.36,368.111,4,0.601,0
108,176,0,23,0,0,0,0,32.41,7275556,29.715,24.4,4.029,6397.36,368.111,4,0.601,0
108,177,0,23,0,0,0,0,32.41,7275556,29.715,24.4,4.029,6397.36,368.111,4,0.601,0
108,178,0,23,0,0,0,0,32.41,7275556,29.715,24.4,4.029,6397.36,368.111,4,0.601,0
108,179,0,23,0,0,0,0,32.41,7275556,29.715,24.4,4.029,6397.36,368.111,4,0.601,0
108,180,0,23,0,0,0,0,32.41,7275556,29.715,24.4,4.029,6397.36,368.111,4,0.601,0
108,181,0,23,0,0,0,0,32.41,7275556,29.715,24.4,4.029,6397.36,368.111,4,0.601,0
108,182,0,23,0,0,0,0,32.41,7275556,29.715,24.4,4.029,6397.36,368.111,4,0.601,0
108,183,0,23,0,0,0,0,32.41,7275556,29.715,24.4,4.029,6397.36,368.111,4,0.601,0
108,184,0,23,0,0,0,0,32.41,7275556,29.715,24.4,4.029,6397.36,368.111,4,0.601,0
108,185,0,23,0,0,0,0,32.41,7275556,29.715,24.4,4.029,6397.36,368.111,4,0.601,0
108,186,0,23,0,0,0,0,32.41,7275556,29.715,24.4,4.029,6397.36,368.111,4,0.601,0
108,187,0,23,0,0,0,0,32.41,7275556,29.715,24.4,4.029,6397.36,368.111,4,0.601,0
108,188,0,23,0,0,0,0,32.41,7275556,29.715,24.4,4.029,6397.36,368.111,4,0.601,0
108,189,0,23,0,0,0,0,32.41,7275556,29.715,24.4,4.029,6397.36,368.111,4,0.601,0
108,190,0,23,0,0,0,0,32.41,7275556,29.715,24.4,4.029,6397.36,368.111,4,0.601,0
108,191,0,23,0,0,0,0,32.41,7275556,29.715,24.4,4.029,6397.36,368.111,4,0.601,0
108,192,0,23,0,0,0,0,32.41,7275556,29.715,24.4,4.029,6397.36,368.111,4,0.601,0
108,193,0,23,0,0,0,0,32.41,7275556,29.715,24.4,4.029,6397.36,368.111,4,0.601,0
108,194,0,23,0,0,0,0,32.41,7275556,29.715,24.4,4.029,6397.36,368.111,4,0.601,0
108,195,0,23,0,0,0,0,32.41,7275556,29.715,24.4,4.029,6397.36,368.111,4,0.601,0
108,196,0,23,0,0,0,0,32.41,7275556,29.715,24.4,4.029,6397.36,368.111,4,0.601,0
108,197,0,23,0,0,0,0,32.41,7275556,29.715,24.4,4.029,6397.36,368.111,4,0.601,0
108,198,0,23,0,0,0,0,32.41,7275556,29.715,24.4,4.029,6397.36,368.111,4,0.601,0
108,199,0,23,0,0,0,0,32.41,7275556,29.715,24.4,4.029,6397.36,368.111,4,0.601,0
108,200,0,23,0,0,0,0,32.41,7275556,29.715,24.4,4.029,6397.36,368.111,4,0.601,0
108,201,0,23,0,0,0,0,32.41,7275556,29.715,24.4,4.029,6397.36,368.111,4,0.601,0
108,202,0,23,0,0,0,0,32.41,7275556,29.715,24.4,4.029,6397.36,368.111,4,0.601,0
108,203,0,23,0,0,0,0,32.41,7275556,29.715,24.4,4.029,6397.36,368.111,4,0.601,0
108,204,0,23,0,0,0,0,32.41,7275556,29.715,24.4,4.029,6397.36,368.111,4,0.601,0
109,1,22,398,0,0,1003,15810,65.74,1886202,31.212,43.9,19.754,25063.846,350.06,4.91,0.847,0
109,2,48,446,0,0,1024,16834,65.74,1886202,31.212,43.9,19.754,25063.846,350.06,4.91,0.847,0
109,3,12,458,0,0,1364,18198,65.74,1886202,31.212,43.9,19.754,25063.846,350.06,4.91,0.847,0
109,4,35,493,1,1,1182,19380,65.74,1886202,31.212,43.9,19.754,25063.846,350.06,4.91,0.847,0
109,5,16,509,0,1,1300,20680,65.74,1886202,31.212,43.9,19.754,25063.846,350.06,4.91,0.847,0
109,6,24,533,0,1,773,21453,65.74,1886202,31.212,43.9,19.754,25063.846,350.06,4.91,0.847,0
109,7,9,542,0,1,1122,22575,65.74,1886202,31.212,43.9,19.754,25063.846,350.06,4.91,0.847,0
109,8,6,548,1,2,1461,24036,65.74,1886202,31.212,43.9,19.754,25063.846,350.06,4.91,0.847,0
109,9,29,577,0,2,1422,25458,65.74,1886202,31.212,43.9,19.754,25063.846,350.06,4.91,0.847,0
109,10,12,589,0,2,1198,26656,65.74,1886202,31.212,43.9,19.754,25063.846,350.06,4.91,0.847,0
109,11,23,612,0,2,1140,27796,65.74,1886202,31.212,43.9,19.754,25063.846,350.06,4.91,0.847,0
109,12,18,630,1,3,418,28214,65.74,1886202,31.212,43.9,19.754,25063.846,350.06,4.91,0.847,0
109,13,21,651,2,5,562,28776,65.74,1886202,31.212,43.9,19.754,25063.846,350.06,4.91,0.847,0
109,14,4,655,0,5,242,29018,65.74,1886202,31.212,43.9,19.754,25063.846,350.06,4.91,0.847,0
109,15,2,657,0,5,878,29896,65.74,1886202,31.212,43.9,19.754,25063.846,350.06,4.91,0.847,0
109,16,9,666,0,5,1406,31302,65.74,1886202,31.212,43.9,19.754,25063.846,350.06,4.91,0.847,0
109,17,9,675,0,5,1535,32837,65.74,1886202,31.212,43.9,19.754,25063.846,350.06,4.91,0.847,0
109,18,7,682,0,5,1860,34697,65.74,1886202,31.212,43.9,19.754,25063.846,350.06,4.91,0.847,0
109,19,30,712,0,5,1184,35881,65.74,1886202,31.212,43.9,19.754,25063.846,350.06,4.91,0.847,0
109,20,15,727,0,5,787,36668,65.74,1886202,31.212,43.9,19.754,25063.846,350.06,4.91,0.847,0
109,21,12,739,0,5,1304,37972,65.74,1886202,31.212,43.9,19.754,25063.846,350.06,4.91,0.847,0
109,22,9,748,4,9,1364,39336,65.74,1886202,31.212,43.9,19.754,25063.846,350.06,4.91,0.847,0
109,23,13,761,2,11,1705,41041,65.74,1886202,31.212,43.9,19.754,25063.846,350.06,4.91,0.847,0
109,24,17,778,0,11,2039,43080,65.74,1886202,31.212,43.9,19.754,25063.846,350.06,4.91,0.847,0
109,25,6,784,1,12,2663,45743,65.74,1886202,31.212,43.9,19.754,25063.846,350.06,4.91,0.847,0
109,26,20,804,0,12,1874,47617,65.74,1886202,31.212,43.9,19.754,25063.846,350.06,4.91,0.847,0
109,27,8,812,0,12,1564,49181,65.74,1886202,31.212,43.9,19.754,25063.846,350.06,4.91,0.847,0
109,28,6,818,1,13,2380,51561,65.74,1886202,31.212,43.9,19.754,25063.846,350.06,4.91,0.847,0
109,29,18,836,0,13,3250,54811,65.74,1886202,31.212,43.9,19.754,25063.846,350.06,4.91,0.847,0
109,30,13,849,2,15,3075,57886,65.74,1886202,31.212,43.9,19.754,25063.846,350.06,4.91,0.847,0
109,31,9,858,0,15,3234,61120,65.74,1886202,31.212,43.9,19.754,25063.846,350.06,4.91,0.847,0
109,32,12,870,1,16,1982,63102,65.74,1886202,31.212,43.9,19.754,25063.846,350.06,4.91,0.847,0
109,33,1,871,0,16,1143,64245,65.74,1886202,31.212,43.9,19.754,25063.846,350.06,4.91,0.847,0
109,34,8,879,0,16,1219,65464,65.74,1886202,31.212,43.9,19.754,25063.846,350.06,4.91,0.847,0
109,35,17,896,0,16,686,66150,65.74,1886202,31.212,43.9,19.754,25063.846,350.06,4.91,0.847,0
109,36,0,896,1,17,2477,68627,65.74,1886202,31.212,43.9,19.754,25063.846,350.06,4.91,0.847,0
109,37,4,900,0,17,2442,71069,65.74,1886202,31.212,43.9,19.754,25063.846,350.06,4.91,0.847,0
109,38,9,909,1,18,1947,73016,65.74,1886202,31.212,43.9,19.754,25063.846,350.06,4.91,0.847,0
109,39,19,928,0,18,2555,75571,65.74,1886202,31.212,43.9,19.754,25063.846,350.06,4.91,0.847,0
109,40,2,930,0,18,1021,76592,65.74,1886202,31.212,43.9,19.754,25063.846,350.06,4.91,0.847,0
109,41,9,939,0,18,555,77147,65.74,1886202,31.212,43.9,19.754,25063.846,350.06,4.91,0.847,0
109,42,7,946,0,18,1900,79047,60.19,1886202,31.212,43.9,19.754,25063.846,350.06,4.91,0.847,0
109,43,4,950,0,18,2199,81246,60.19,1886202,31.212,43.9,19.754,25063.846,350.06,4.91,0.847,0
109,44,1,951,1,19,2029,83275,60.19,1886202,31.212,43.9,19.754,25063.846,350.06,4.91,0.847,0
109,45,11,962,0,19,2156,85431,57.41,1886202,31.212,43.9,19.754,25063.846,350.06,4.91,0.847,0
109,46,8,970,0,19,1946,87377,57.41,1886202,31.212,43.9,19.754,25063.846,350.06,4.91,0.847,0
109,47,27,997,0,19,1028,88405,57.41,1886202,31.212,43.9,19.754,25063.846,350.06,4.91,0.847,0
109,48,11,1008,0,19,718,89123,57.41,1886202,31.212,43.9,19.754,25063.846,350.06,4.91,0.847,0
109,49,1,1009,0,19,1845,90968,57.41,1886202,31.212,43.9,19.754,25063.846,350.06,4.91,0.847,0
109,50,3,1012,2,21,1783,92751,57.41,1886202,31.212,43.9,19.754,25063.846,350.06,4.91,0.847,0
109,51,4,1016,0,21,1870,94621,57.41,1886202,31.212,43.9,19.754,25063.846,350.06,4.91,0.847,0
109,52,9,1025,1,22,1745,96366,57.41,1886202,31.212,43.9,19.754,25063.846,350.06,4.91,0.847,0
109,53,5,1030,0,22,1480,97846,57.41,1886202,31.212,43.9,19.754,25063.846,350.06,4.91,0.847,0
109,54,16,1046,0,22,1203,99049,57.41,1886202,31.212,43.9,19.754,25063.846,350.06,4.91,0.847,0
109,55,1,1047,0,22,721,99770,57.41,1886202,31.212,43.9,19.754,25063.846,350.06,4.91,0.847,0
109,56,2,1049,0,22,1828,101598,57.41,1886202,31.212,43.9,19.754,25063.846,350.06,4.91,0.847,0
109,57,4,1053,0,22,1955,103553,57.41,1886202,31.212,43.9,19.754,25063.846,350.06,4.91,0.847,0
109,58,4,1057,1,23,1951,105504,57.41,1886202,31.212,43.9,19.754,25063.846,350.06,4.91,0.847,0
109,59,4,1061,1,24,1427,106931,57.41,1886202,31.212,43.9,19.754,25063.846,350.06,4.91,0.847,0
109,60,3,1064,0,24,1243,108174,57.41,1886202,31.212,43.9,19.754,25063.846,350.06,4.91,0.847,0
109,61,1,1065,0,24,897,109071,57.41,1886202,31.212,43.9,19.754,25063.846,350.06,4.91,0.847,0
109,62,1,1066,0,24,652,109723,57.41,1886202,31.212,43.9,19.754,25063.846,350.06,4.91,0.847,0
109,63,5,1071,0,24,1681,111404,57.41,1886202,31.212,43.9,19.754,25063.846,350.06,4.91,0.847,0
109,64,8,1079,0,24,1561,112965,57.41,1886202,31.212,43.9,19.754,25063.846,350.06,4.91,0.847,0
109,65,0,1079,0,24,1486,114451,57.41,1886202,31.212,43.9,19.754,25063.846,350.06,4.91,0.847,0
109,66,3,1082,1,25,1010,115461,57.41,1886202,31.212,43.9,19.754,25063.846,350.06,4.91,0.847,0
109,67,0,1082,0,25,1074,116535,57.41,1886202,31.212,43.9,19.754,25063.846,350.06,4.91,0.847,0
109,68,4,1086,0,25,1125,117660,57.41,1886202,31.212,43.9,19.754,25063.846,350.06,4.91,0.847,0
109,69,2,1088,0,25,662,118322,57.41,1886202,31.212,43.9,19.754,25063.846,350.06,4.91,0.847,0
109,70,0,1088,1,26,1730,120052,57.41,1886202,31.212,43.9,19.754,25063.846,350.06,4.91,0.847,0
109,71,1,1089,0,26,1731,121783,46.3,1886202,31.212,43.9,19.754,25063.846,350.06,4.91,0.847,0
109,72,3,1092,0,26,1581,123364,46.3,1886202,31.212,43.9,19.754,25063.846,350.06,4.91,0.847,0
109,73,2,1094,0,26,1298,124662,46.3,1886202,31.212,43.9,19.754,25063.846,350.06,4.91,0.847,0
109,74,2,1096,1,27,1392,126054,46.3,1886202,31.212,43.9,19.754,25063.846,350.06,4.91,0.847,0
109,75,1,1097,1,28,1396,127450,46.3,1886202,31.212,43.9,19.754,25063.846,350.06,4.91,0.847,0
109,76,0,1097,0,28,695,128145,46.3,1886202,31.212,43.9,19.754,25063.846,350.06,4.91,0.847,0
109,77,0,1097,0,28,1691,129836,46.3,1886202,31.212,43.9,19.754,25063.846,350.06,4.91,0.847,0
109,78,1,1098,0,28,1810,131646,46.3,1886202,31.212,43.9,19.754,25063.846,350.06,4.91,0.847,0
109,79,6,1104,2,30,1911,133557,46.3,1886202,31.212,43.9,19.754,25063.846,350.06,4.91,0.847,0
109,80,4,1108,0,30,1324,134881,46.3,1886202,31.212,43.9,19.754,25063.846,350.06,4.91,0.847,0
109,81,2,1110,0,30,1686,136567,46.3,1886202,31.212,43.9,19.754,25063.846,350.06,4.91,0.847,0
109,82,1,1111,0,30,1294,137861,46.3,1886202,31.212,43.9,19.754,25063.846,350.06,4.91,0.847,0
109,83,0,1111,0,30,1163,139024,46.3,1886202,31.212,43.9,19.754,25063.846,350.06,4.91,0.847,0
109,84,0,1111,0,30,1413,140437,46.3,1886202,31.212,43.9,19.754,25063.846,350.06,4.91,0.847,0
109,85,0,1111,0,30,1276,141713,46.3,1886202,31.212,43.9,19.754,25063.846,350.06,4.91,0.847,0
109,86,0,1111,0,30,1081,142794,46.3,1886202,31.212,43.9,19.754,25063.846,350.06,4.91,0.847,0
109,87,0,1111,0,30,2292,145086,46.3,1886202,31.212,43.9,19.754,25063.846,350.06,4.91,0.847,0
109,88,1,1112,0,30,1788,146874,46.3,1886202,31.212,43.9,19.754,25063.846,350.06,4.91,0.847,0
109,89,3,1115,0,30,1042,147916,46.3,1886202,31.212,43.9,19.754,25063.846,350.06,4.91,0.847,0
109,90,1,1116,0,30,861,148777,46.3,1886202,31.212,43.9,19.754,25063.846,350.06,4.91,0.847,0
109,91,1,1117,0,30,2060,150837,46.3,1886202,31.212,43.9,19.754,25063.846,350.06,4.91,0.847,0
109,92,1,1118,0,30,1941,152778,46.3,1886202,31.212,43.9,19.754,25063.846,350.06,4.91,0.847,0
109,93,3,1121,0,30,1716,154494,46.3,1886202,31.212,43.9,19.754,25063.846,350.06,4.91,0.847,0
109,94,1,1122,0,30,1105,155599,46.3,1886202,31.212,43.9,19.754,25063.846,350.06,4.91,0.847,0
109,95,0,1122,0,30,1185,156784,46.3,1886202,31.212,43.9,19.754,25063.846,350.06,4.91,0.847,0
109,96,1,1123,0,30,1042,157826,46.3,1886202,31.212,43.9,19.754,25063.846,350.06,4.91,0.847,0
109,97,1,1124,0,30,692,158518,46.3,1886202,31.212,43.9,19.754,25063.846,350.06,4.91,0.847,0
109,98,3,1127,0,30,1763,160281,46.3,1886202,31.212,43.9,19.754,25063.846,350.06,4.91,0.847,0
109,99,7,1134,0,30,1773,162054,46.3,1886202,31.212,43.9,19.754,25063.846,350.06,4.91,0.847,0
109,100,7,1141,0,30,1715,163769,46.3,1886202,31.212,43.9,19.754,25063.846,350.06,4.91,0.847,0
109,101,13,1154,0,30,1841,165610,46.3,1886202,31.212,43.9,19.754,25063.846,350.06,4.91,0.847,0
109,102,0,1154,0,30,1870,167480,46.3,1886202,31.212,43.9,19.754,25063.846,350.06,4.91,0.847,0
109,103,19,1173,0,30,1467,168947,46.3,1886202,31.212,43.9,19.754,25063.846,350.06,4.91,0.847,0
109,104,0,1173,0,30,996,169943,46.3,1886202,31.212,43.9,19.754,25063.846,350.06,4.91,0.847,0
109,105,1,1174,1,31,2135,172078,46.3,1886202,31.212,43.9,19.754,25063.846,350.06,4.91,0.847,0
109,106,4,1178,0,31,1979,174057,46.3,1886202,31.212,43.9,19.754,25063.846,350.06,4.91,0.847,0
109,107,0,1178,0,31,1639,175696,46.3,1886202,31.212,43.9,19.754,25063.846,350.06,4.91,0.847,0
109,108,1,1179,0,31,2189,177885,46.3,1886202,31.212,43.9,19.754,25063.846,350.06,4.91,0.847,0
109,109,6,1185,0,31,1751,179636,46.3,1886202,31.212,43.9,19.754,25063.846,350.06,4.91,0.847,0
109,110,4,1189,0,31,1292,180928,46.3,1886202,31.212,43.9,19.754,25063.846,350.06,4.91,0.847,0
109,111,3,1192,0,31,1297,182225,46.3,1886202,31.212,43.9,19.754,25063.846,350.06,4.91,0.847,0
109,112,0,1192,0,31,1385,183610,46.3,1886202,31.212,43.9,19.754,25063.846,350.06,4.91,0.847,0
109,113,1,1193,0,31,1613,185223,46.3,1886202,31.212,43.9,19.754,25063.846,350.06,4.91,0.847,0
109,114,4,1197,0,31,1752,186975,46.3,1886202,31.212,43.9,19.754,25063.846,350.06,4.91,0.847,0
109,115,6,1203,0,31,1510,188485,46.3,1886202,31.212,43.9,19.754,25063.846,350.06,4.91,0.847,0
109,116,2,1205,0,31,1240,189725,46.3,1886202,31.212,43.9,19.754,25063.846,350.06,4.91,0.847,0
109,117,1,1206,0,31,1345,191070,46.3,1886202,31.212,43.9,19.754,25063.846,350.06,4.91,0.847,0
109,118,13,1219,0,31,801,191871,46.3,1886202,31.212,43.9,19.754,25063.846,350.06,4.91,0.847,0
109,119,1,1220,0,31,1574,193445,46.3,1886202,31.212,43.9,19.754,25063.846,350.06,4.91,0.847,0
109,120,0,1220,0,31,1886,195331,46.3,1886202,31.212,43.9,19.754,25063.846,350.06,4.91,0.847,0
109,121,4,1224,0,31,1704,197035,46.3,1886202,31.212,43.9,19.754,25063.846,350.06,4.91,0.847,0
109,122,4,1228,0,31,1473,198508,46.3,1886202,31.212,43.9,19.754,25063.846,350.06,4.91,0.847,0
109,123,3,1231,1,32,1448,199956,43.52,1886202,31.212,43.9,19.754,25063.846,350.06,4.91,0.847,0
109,124,7,1238,0,32,1354,201310,43.52,1886202,31.212,43.9,19.754,25063.846,350.06,4.91,0.847,0
109,125,5,1243,0,32,687,201997,43.52,1886202,31.212,43.9,19.754,25063.846,350.06,4.91,0.847,0
109,126,3,1246,0,32,1871,203868,43.52,1886202,31.212,43.9,19.754,25063.846,350.06,4.91,0.847,0
109,127,3,1249,0,32,2212,206080,43.52,1886202,31.212,43.9,19.754,25063.846,350.06,4.91,0.847,0
109,128,8,1257,0,32,1829,207909,43.52,1886202,31.212,43.9,19.754,25063.846,350.06,4.91,0.847,0
109,129,18,1275,0,32,2137,210046,43.52,1886202,31.212,43.9,19.754,25063.846,350.06,4.91,0.847,0
109,130,6,1281,0,32,1891,211937,43.52,1886202,31.212,43.9,19.754,25063.846,350.06,4.91,0.847,0
109,131,7,1288,0,32,1597,213534,43.52,1886202,31.212,43.9,19.754,25063.846,350.06,4.91,0.847,0
109,132,2,1290,0,32,668,214202,43.52,1886202,31.212,43.9,19.754,25063.846,350.06,4.91,0.847,0
109,133,3,1293,0,32,2328,216530,43.52,1886202,31.212,43.9,19.754,25063.846,350.06,4.91,0.847,0
109,134,10,1303,0,32,2226,218756,43.52,1886202,31.212,43.9,19.754,25063.846,350.06,4.91,0.847,0
109,135,0,1303,0,32,2071,220827,43.52,1886202,31.212,43.9,19.754,25063.846,350.06,4.91,0.847,0
109,136,4,1307,0,32,1704,222531,43.52,1886202,31.212,43.9,19.754,25063.846,350.06,4.91,0.847,0
109,137,1,1308,0,32,1881,224412,43.52,1886202,31.212,43.9,19.754,25063.846,350.06,4.91,0.847,0
109,138,7,1315,0,32,1224,225636,43.52,1886202,31.212,43.9,19.754,25063.846,350.06,4.91,0.847,0
109,139,7,1322,0,32,888,226524,43.52,1886202,31.212,43.9,19.754,25063.846,350.06,4.91,0.847,0
109,140,1,1323,0,32,2234,228758,43.52,1886202,31.212,43.9,19.754,25063.846,350.06,4.91,0.847,0
109,141,0,1323,1,33,2163,230921,43.52,1886202,31.212,43.9,19.754,25063.846,350.06,4.91,0.847,0
109,142,3,1326,0,33,1997,232918,43.52,1886202,31.212,43.9,19.754,25063.846,350.06,4.91,0.847,0
109,143,1,1327,0,33,1602,234520,43.52,1886202,31.212,43.9,19.754,25063.846,350.06,4.91,0.847,0
109,144,3,1330,0,33,1777,236297,43.52,1886202,31.212,43.9,19.754,25063.846,350.06,4.91,0.847,0
109,145,3,1333,0,33,1180,237477,43.52,1886202,31.212,43.9,19.754,25063.846,350.06,4.91,0.847,0
109,146,4,1337,0,33,926,238403,43.52,1886202,31.212,43.9,19.754,25063.846,350.06,4.91,0.847,0
109,147,0,1337,0,33,2130,240533,43.52,1886202,31.212,43.9,19.754,25063.846,350.06,4.91,0.847,0
109,148,5,1342,0,33,2290,242823,43.52,1886202,31.212,43.9,19.754,25063.846,350.06,4.91,0.847,0
109,149,18,1360,0,33,2004,244827,43.52,1886202,31.212,43.9,19.754,25063.846,350.06,4.91,0.847,0
109,150,6,1366,1,34,2040,246867,43.52,1886202,31.212,43.9,19.754,25063.846,350.06,4.91,0.847,0
109,151,9,1375,0,34,2065,248932,43.52,1886202,31.212,43.9,19.754,25063.846,350.06,4.91,0.847,0
109,152,0,1375,0,34,1777,250709,43.52,1886202,31.212,43.9,19.754,25063.846,350.06,4.91,0.847,0
109,153,18,1393,0,34,1008,251717,43.52,1886202,31.212,43.9,19.754,25063.846,350.06,4.91,0.847,0
109,154,3,1396,0,34,2101,253818,43.52,1886202,31.212,43.9,19.754,25063.846,350.06,4.91,0.847,0
109,155,8,1404,0,34,2532,256350,43.52,1886202,31.212,43.9,19.754,25063.846,350.06,4.91,0.847,0
109,156,2,1406,0,34,2445,258795,43.52,1886202,31.212,43.9,19.754,25063.846,350.06,4.91,0.847,0
109,157,4,1410,0,34,1903,260698,43.52,1886202,31.212,43.9,19.754,25063.846,350.06,4.91,0.847,0
109,158,6,1416,1,35,1964,262662,43.52,1886202,31.212,43.9,19.754,25063.846,350.06,4.91,0.847,0
109,159,9,1425,0,35,1596,264258,43.52,1886202,31.212,43.9,19.754,25063.846,350.06,4.91,0.847,0
109,160,3,1428,0,35,1047,265305,43.52,1886202,31.212,43.9,19.754,25063.846,350.06,4.91,0.847,0
109,161,1,1429,0,35,2395,267700,43.52,1886202,31.212,43.9,19.754,25063.846,350.06,4.91,0.847,0
109,162,3,1432,0,35,2397,270097,43.52,1886202,31.212,43.9,19.754,25063.846,350.06,4.91,0.847,0
109,163,11,1443,0,35,2284,272381,43.52,1886202,31.212,43.9,19.754,25063.846,350.06,4.91,0.847,0
109,164,5,1448,0,35,2445,274826,43.52,1886202,31.212,43.9,19.754,25063.846,350.06,4.91,0.847,0
109,165,11,1459,0,35,2258,277084,43.52,1886202,31.212,43.9,19.754,25063.846,350.06,4.91,0.847,0
109,166,5,1464,0,35,1583,278667,43.52,1886202,31.212,43.9,19.754,25063.846,350.06,4.91,0.847,0
109,167,10,1474,0,35,1451,280118,43.52,1886202,31.212,43.9,19.754,25063.846,350.06,4.91,0.847,0
109,168,3,1477,0,35,2717,282835,43.52,1886202,31.212,43.9,19.754,25063.846,350.06,4.91,0.847,0
109,169,5,1482,0,35,3041,285876,43.52,1886202,31.212,43.9,19.754,25063.846,350.06,4.91,0.847,0
109,170,4,1486,0,35,2767,288643,43.52,1886202,31.212,43.9,19.754,25063.846,350.06,4.91,0.847,0
109,171,8,1494,1,36,2264,290907,43.52,1886202,31.212,43.9,19.754,25063.846,350.06,4.91,0.847,0
109,172,4,1498,0,36,2402,293309,43.52,1886202,31.212,43.9,19.754,25063.846,350.06,4.91,0.847,0
109,173,17,1515,0,36,1933,295242,43.52,1886202,31.212,43.9,19.754,25063.846,350.06,4.91,0.847,0
109,174,10,1525,0,36,1153,296395,42.59,1886202,31.212,43.9,19.754,25063.846,350.06,4.91,0.847,0
109,175,1,1526,0,36,2690,299085,42.59,1886202,31.212,43.9,19.754,25063.846,350.06,4.91,0.847,0
109,176,34,1560,0,36,2733,301818,42.59,1886202,31.212,43.9,19.754,25063.846,350.06,4.91,0.847,0
109,177,12,1572,0,36,2403,304221,42.59,1886202,31.212,43.9,19.754,25063.846,350.06,4.91,0.847,0
109,178,22,1594,0,36,2431,306652,42.59,1886202,31.212,43.9,19.754,25063.846,350.06,4.91,0.847,0
109,179,31,1625,0,36,2520,309172,42.59,1886202,31.212,43.9,19.754,25063.846,350.06,4.91,0.847,0
109,180,29,1654,0,36,1660,310832,42.59,1886202,31.212,43.9,19.754,25063.846,350.06,4.91,0.847,0
109,181,22,1676,0,36,1398,312230,42.59,1886202,31.212,43.9,19.754,25063.846,350.06,4.91,0.847,0
109,182,21,1697,0,36,3517,315747,42.59,1886202,31.212,43.9,19.754,25063.846,350.06,4.91,0.847,0
109,183,32,1729,1,37,4271,320018,42.59,1886202,31.212,43.9,19.754,25063.846,350.06,4.91,0.847,0
109,184,95,1824,0,37,4699,324717,42.59,1886202,31.212,43.9,19.754,25063.846,350.06,4.91,0.847,0
109,185,44,1868,0,37,3914,328631,42.59,1886202,31.212,43.9,19.754,25063.846,350.06,4.91,0.847,0
109,186,77,1945,1,38,3654,332285,30.56,1886202,31.212,43.9,19.754,25063.846,350.06,4.91,0.847,0
109,187,74,2019,0,38,2544,334829,30.56,1886202,31.212,43.9,19.754,25063.846,350.06,4.91,0.847,0
109,188,67,2086,0,38,1748,336577,30.56,1886202,31.212,43.9,19.754,25063.846,350.06,4.91,0.847,0
109,189,40,2126,1,39,3818,340395,30.56,1886202,31.212,43.9,19.754,25063.846,350.06,4.91,0.847,0
109,190,68,2194,0,39,4426,344821,30.56,1886202,31.212,43.9,19.754,25063.846,350.06,4.91,0.847,0
109,191,67,2261,1,40,4416,349237,30.56,1886202,31.212,43.9,19.754,25063.846,350.06,4.91,0.847,0
109,192,109,2370,0,40,4551,353788,30.56,1886202,31.212,43.9,19.754,25063.846,350.06,4.91,0.847,0
109,193,137,2507,0,40,4710,358498,30.56,1886202,31.212,43.9,19.754,25063.846,350.06,4.91,0.847,0
109,194,89,2596,0,40,3345,361843,30.56,1886202,31.212,43.9,19.754,25063.846,350.06,4.91,0.847,0
109,195,74,2670,0,40,2169,364012,30.56,1886202,31.212,43.9,19.754,25063.846,350.06,4.91,0.847,0
109,196,95,2765,0,40,4433,368445,30.56,1886202,31.212,43.9,19.754,25063.846,350.06,4.91,0.847,0
109,197,75,2840,1,41,5078,373523,30.56,1886202,31.212,43.9,19.754,25063.846,350.06,4.91,0.847,0
109,198,102,2942,0,41,4667,378190,30.56,1886202,31.212,43.9,19.754,25063.846,350.06,4.91,0.847,0
109,199,114,3056,0,41,4759,382949,30.56,1886202,31.212,43.9,19.754,25063.846,350.06,4.91,0.847,0
109,200,148,3204,1,42,5332,388281,30.56,1886202,31.212,43.9,19.754,25063.846,350.06,4.91,0.847,0
109,201,188,3392,0,42,2690,390971,30.56,1886202,31.212,43.9,19.754,25063.846,350.06,4.91,0.847,0
109,202,58,3450,0,42,2215,393186,30.56,1886202,31.212,43.9,19.754,25063.846,350.06,4.91,0.847,0
109,203,44,3494,0,42,4171,397357,30.56,1886202,31.212,43.9,19.754,25063.846,350.06,4.91,0.847,0
109,204,115,3609,4,46,0,397357,30.56,1886202,31.212,43.9,19.754,25063.846,350.06,4.91,0.847,0
110,1,17,463,1,12,0,0,85.19,6825442,594.561,31.1,8.514,13367.565,266.591,12.71,0.757,0
110,2,16,479,0,12,0,0,85.19,6825442,594.561,31.1,8.514,13367.565,266.591,12.71,0.757,0
110,3,15,494,4,16,0,0,85.19,6825442,594.561,31.1,8.514,13367.565,266.591,12.71,0.757,0
110,4,0,494,0,16,0,0,85.19,6825442,594.561,31.1,8.514,13367.565,266.591,12.71,0.757,0
110,5,26,520,1,17,0,0,85.19,6825442,594.561,31.1,8.514,13367.565,266.591,12.71,0.757,0
110,6,7,527,1,18,0,0,85.19,6825442,594.561,31.1,8.514,13367.565,266.591,12.71,0.757,0
110,7,14,541,1,19,0,0,85.19,6825442,594.561,31.1,8.514,13367.565,266.591,12.71,0.757,0
110,8,7,548,0,19,0,0,85.19,6825442,594.561,31.1,8.514,13367.565,266.591,12.71,0.757,0
110,9,27,575,0,19,0,0,85.19,6825442,594.561,31.1,8.514,13367.565,266.591,12.71,0.757,0
110,10,7,582,0,19,0,0,85.19,6825442,594.561,31.1,8.514,13367.565,266.591,12.71,0.757,0
110,11,27,609,1,20,0,0,85.19,6825442,594.561,31.1,8.514,13367.565,266.591,12.71,0.757,0
110,12,10,619,0,20,0,0,85.19,6825442,594.561,31.1,8.514,13367.565,266.591,12.71,0.757,0
110,13,11,630,0,20,0,0,85.19,6825442,594.561,31.1,8.514,13367.565,266.591,12.71,0.757,0
110,14,2,632,0,20,0,0,85.19,6825442,594.561,31.1,8.514,13367.565,266.591,12.71,0.757,0
110,15,9,641,1,21,0,0,85.19,6825442,594.561,31.1,8.514,13367.565,266.591,12.71,0.757,0
110,16,17,658,0,21,0,0,85.19,6825442,594.561,31.1,8.514,13367.565,266.591,12.71,0.757,0
110,17,5,663,0,21,0,0,85.19,6825442,594.561,31.1,8.514,13367.565,266.591,12.71,0.757,0
110,18,5,668,0,21,0,0,85.19,6825442,594.561,31.1,8.514,13367.565,266.591,12.71,0.757,0
110,19,4,672,0,21,0,0,85.19,6825442,594.561,31.1,8.514,13367.565,266.591,12.71,0.757,0
110,20,1,673,0,21,0,0,85.19,6825442,594.561,31.1,8.514,13367.565,266.591,12.71,0.757,0
110,21,4,677,0,21,0,0,85.19,6825442,594.561,31.1,8.514,13367.565,266.591,12.71,0.757,0
110,22,0,677,0,21,0,0,85.19,6825442,594.561,31.1,8.514,13367.565,266.591,12.71,0.757,0
110,23,5,682,1,22,0,0,85.19,6825442,594.561,31.1,8.514,13367.565,266.591,12.71,0.757,0
110,24,6,688,0,22,0,0,85.19,6825442,594.561,31.1,8.514,13367.565,266.591,12.71,0.757,0
110,25,8,696,0,22,0,0,85.19,6825442,594.561,31.1,8.514,13367.565,266.591,12.71,0.757,0
110,26,8,704,2,24,0,0,85.19,6825442,594.561,31.1,8.514,13367.565,266.591,12.71,0.757,0
110,27,3,707,0,24,0,0,81.48,6825442,594.561,31.1,8.514,13367.565,266.591,12.71,0.757,0
110,28,3,710,0,24,0,0,81.48,6825442,594.561,31.1,8.514,13367.565,266.591,12.71,0.757,0
110,29,7,717,0,24,0,0,81.48,6825442,594.561,31.1,8.514,13367.565,266.591,12.71,0.757,0
110,30,4,721,0,24,0,0,81.48,6825442,594.561,31.1,8.514,13367.565,266.591,12.71,0.757,0
110,31,4,725,0,24,0,0,81.48,6825442,594.561,31.1,8.514,13367.565,266.591,12.71,0.757,0
110,32,4,729,0,24,0,0,81.48,6825442,594.561,31.1,8.514,13367.565,266.591,12.71,0.757,0
110,33,4,733,1,25,0,0,77.78,6825442,594.561,31.1,8.514,13367.565,266.591,12.71,0.757,0
110,34,4,737,0,25,0,0,77.78,6825442,594.561,31.1,8.514,13367.565,266.591,12.71,0.757,0
110,35,3,740,0,25,0,0,77.78,6825442,594.561,31.1,8.514,13367.565,266.591,12.71,0.757,0
110,36,1,741,0,25,0,0,77.78,6825442,594.561,31.1,8.514,13367.565,266.591,12.71,0.757,0
110,37,9,750,0,25,0,0,77.78,6825442,594.561,31.1,8.514,13367.565,266.591,12.71,0.757,0
110,38,34,784,0,25,0,0,77.78,6825442,594.561,31.1,8.514,13367.565,266.591,12.71,0.757,0
110,39,12,796,1,26,0,0,77.78,6825442,594.561,31.1,8.514,13367.565,266.591,12.71,0.757,0
110,40,13,809,0,26,0,0,77.78,6825442,594.561,31.1,8.514,13367.565,266.591,12.71,0.757,0
110,41,36,845,0,26,0,0,77.78,6825442,594.561,31.1,8.514,13367.565,266.591,12.71,0.757,0
110,42,14,859,0,26,0,0,77.78,6825442,594.561,31.1,8.514,13367.565,266.591,12.71,0.757,0
110,43,11,870,0,26,0,0,85.19,6825442,594.561,31.1,8.514,13367.565,266.591,12.71,0.757,0
110,44,8,878,0,26,0,0,85.19,6825442,594.561,31.1,8.514,13367.565,266.591,12.71,0.757,0
110,45,8,886,0,26,0,0,85.19,6825442,594.561,31.1,8.514,13367.565,266.591,12.71,0.757,0
110,46,5,891,0,26,0,0,85.19,6825442,594.561,31.1,8.514,13367.565,266.591,12.71,0.757,0
110,47,11,902,0,26,0,0,85.19,6825442,594.561,31.1,8.514,13367.565,266.591,12.71,0.757,0
110,48,9,911,0,26,0,0,77.78,6825442,594.561,31.1,8.514,13367.565,266.591,12.71,0.757,0
110,49,20,931,0,26,0,0,77.78,6825442,594.561,31.1,8.514,13367.565,266.591,12.71,0.757,0
110,50,23,954,0,26,0,0,77.78,6825442,594.561,31.1,8.514,13367.565,266.591,12.71,0.757,0
110,51,7,961,0,26,0,0,77.78,6825442,594.561,31.1,8.514,13367.565,266.591,12.71,0.757,0
110,52,63,1024,0,26,0,0,77.78,6825442,594.561,31.1,8.514,13367.565,266.591,12.71,0.757,0
110,53,62,1086,0,26,0,0,77.78,6825442,594.561,31.1,8.514,13367.565,266.591,12.71,0.757,0
110,54,11,1097,0,26,0,0,77.78,6825442,594.561,31.1,8.514,13367.565,266.591,12.71,0.757,0
110,55,17,1114,0,26,0,0,77.78,6825442,594.561,31.1,8.514,13367.565,266.591,12.71,0.757,0
110,56,5,1119,0,26,0,0,77.78,6825442,594.561,31.1,8.514,13367.565,266.591,12.71,0.757,0
110,57,21,1140,0,26,0,0,77.78,6825442,594.561,31.1,8.514,13367.565,266.591,12.71,0.757,0
110,58,21,1161,0,26,0,0,77.78,6825442,594.561,31.1,8.514,13367.565,266.591,12.71,0.757,0
110,59,7,1168,0,26,0,0,74.07,6825442,594.561,31.1,8.514,13367.565,266.591,12.71,0.757,0
110,60,4,1172,0,26,0,0,74.07,6825442,594.561,31.1,8.514,13367.565,266.591,12.71,0.757,0
110,61,19,1191,0,26,0,0,74.07,6825442,594.561,31.1,8.514,13367.565,266.591,12.71,0.757,0
110,62,29,1220,1,27,0,0,74.07,6825442,594.561,31.1,8.514,13367.565,266.591,12.71,0.757,0
110,63,13,1233,0,27,0,0,74.07,6825442,594.561,31.1,8.514,13367.565,266.591,12.71,0.757,0
110,64,9,1242,0,27,0,0,74.07,6825442,594.561,31.1,8.514,13367.565,266.591,12.71,0.757,0
110,65,14,1256,0,27,0,0,74.07,6825442,594.561,31.1,8.514,13367.565,266.591,12.71,0.757,0
110,66,50,1306,1,28,0,0,74.07,6825442,594.561,31.1,8.514,13367.565,266.591,12.71,0.757,0
110,67,6,1312,0,28,0,0,74.07,6825442,594.561,31.1,8.514,13367.565,266.591,12.71,0.757,0
110,68,8,1320,1,29,0,0,74.07,6825442,594.561,31.1,8.514,13367.565,266.591,12.71,0.757,0
110,69,11,1331,1,30,0,0,74.07,6825442,594.561,31.1,8.514,13367.565,266.591,12.71,0.757,0
110,70,19,1350,0,30,0,0,74.07,6825442,594.561,31.1,8.514,13367.565,266.591,12.71,0.757,0
110,71,18,1368,0,30,0,0,74.07,6825442,594.561,31.1,8.514,13367.565,266.591,12.71,0.757,0
110,72,20,1388,0,30,0,0,74.07,6825442,594.561,31.1,8.514,13367.565,266.591,12.71,0.757,0
110,73,14,1402,1,31,0,0,74.07,6825442,594.561,31.1,8.514,13367.565,266.591,12.71,0.757,0
110,74,20,1422,0,31,0,0,74.07,6825442,594.561,31.1,8.514,13367.565,266.591,12.71,0.757,0
110,75,20,1442,1,32,0,0,74.07,6825442,594.561,31.1,8.514,13367.565,266.591,12.71,0.757,0
110,76,4,1446,0,32,0,0,74.07,6825442,594.561,31.1,8.514,13367.565,266.591,12.71,0.757,0
110,77,18,1464,0,32,0,0,74.07,6825442,594.561,31.1,8.514,13367.565,266.591,12.71,0.757,0
110,78,9,1473,0,32,0,0,74.07,6825442,594.561,31.1,8.514,13367.565,266.591,12.71,0.757,0
110,79,16,1489,0,32,0,0,74.07,6825442,594.561,31.1,8.514,13367.565,266.591,12.71,0.757,0
110,80,6,1495,0,32,0,0,74.07,6825442,594.561,31.1,8.514,13367.565,266.591,12.71,0.757,0
110,81,15,1510,0,32,0,0,74.07,6825442,594.561,31.1,8.514,13367.565,266.591,12.71,0.757,0
110,82,26,1536,0,32,0,0,74.07,6825442,594.561,31.1,8.514,13367.565,266.591,12.71,0.757,0
110,83,51,1587,0,32,0,0,74.07,6825442,594.561,31.1,8.514,13367.565,266.591,12.71,0.757,0
110,84,16,1603,0,32,0,0,74.07,6825442,594.561,31.1,8.514,13367.565,266.591,12.71,0.757,0
110,85,19,1622,0,32,0,0,74.07,6825442,594.561,31.1,8.514,13367.565,266.591,12.71,0.757,0
110,86,22,1644,1,33,0,0,74.07,6825442,594.561,31.1,8.514,13367.565,266.591,12.71,0.757,0
110,87,18,1662,0,33,0,0,74.07,6825442,594.561,31.1,8.514,13367.565,266.591,12.71,0.757,0
110,88,35,1697,0,33,0,0,74.07,6825442,594.561,31.1,8.514,13367.565,266.591,12.71,0.757,0
110,89,22,1719,0,33,0,0,74.07,6825442,594.561,31.1,8.514,13367.565,266.591,12.71,0.757,0
110,90,21,1740,1,34,0,0,74.07,6825442,594.561,31.1,8.514,13367.565,266.591,12.71,0.757,0
110,91,5,1745,0,34,0,0,74.07,6825442,594.561,31.1,8.514,13367.565,266.591,12.71,0.757,0
110,92,33,1778,0,34,0,0,68.52,6825442,594.561,31.1,8.514,13367.565,266.591,12.71,0.757,0
110,93,10,1788,0,34,0,0,68.52,6825442,594.561,31.1,8.514,13367.565,266.591,12.71,0.757,0
110,94,8,1796,1,35,0,0,68.52,6825442,594.561,31.1,8.514,13367.565,266.591,12.71,0.757,0
110,95,34,1830,0,35,0,0,68.52,6825442,594.561,31.1,8.514,13367.565,266.591,12.71,0.757,0
110,96,25,1855,0,35,0,0,68.52,6825442,594.561,31.1,8.514,13367.565,266.591,12.71,0.757,0
110,97,18,1873,1,36,0,0,68.52,6825442,594.561,31.1,8.514,13367.565,266.591,12.71,0.757,0
110,98,12,1885,0,36,0,0,68.52,6825442,594.561,31.1,8.514,13367.565,266.591,12.71,0.757,0
110,99,22,1907,0,36,0,0,68.52,6825442,594.561,31.1,8.514,13367.565,266.591,12.71,0.757,0
110,100,39,1946,0,36,0,0,68.52,6825442,594.561,31.1,8.514,13367.565,266.591,12.71,0.757,0
110,101,65,2011,0,36,0,0,68.52,6825442,594.561,31.1,8.514,13367.565,266.591,12.71,0.757,0
110,102,71,2082,0,36,0,0,68.52,6825442,594.561,31.1,8.514,13367.565,266.591,12.71,0.757,0
110,103,86,2168,0,36,0,0,68.52,6825442,594.561,31.1,8.514,13367.565,266.591,12.71,0.757,0
110,104,166,2334,0,36,0,0,68.52,6825442,594.561,31.1,8.514,13367.565,266.591,12.71,0.757,0
110,105,85,2419,0,36,0,0,68.52,6825442,594.561,31.1,8.514,13367.565,266.591,12.71,0.757,0
110,106,32,2451,1,37,0,0,68.52,6825442,594.561,31.1,8.514,13367.565,266.591,12.71,0.757,0
110,107,91,2542,1,38,0,0,68.52,6825442,594.561,31.1,8.514,13367.565,266.591,12.71,0.757,0
110,108,57,2599,2,40,0,0,68.52,6825442,594.561,31.1,8.514,13367.565,266.591,12.71,0.757,0
110,109,101,2700,0,40,0,0,68.52,6825442,594.561,31.1,8.514,13367.565,266.591,12.71,0.757,0
110,110,75,2775,0,40,0,0,68.52,6825442,594.561,31.1,8.514,13367.565,266.591,12.71,0.757,0
110,111,84,2859,0,40,0,0,42.59,6825442,594.561,31.1,8.514,13367.565,266.591,12.71,0.757,0
110,112,46,2905,1,41,0,0,42.59,6825442,594.561,31.1,8.514,13367.565,266.591,12.71,0.757,0
110,113,75,2980,0,41,0,0,42.59,6825442,594.561,31.1,8.514,13367.565,266.591,12.71,0.757,0
110,114,124,3104,2,43,0,0,42.59,6825442,594.561,31.1,8.514,13367.565,266.591,12.71,0.757,0
110,115,156,3260,0,43,0,0,41.67,6825442,594.561,31.1,8.514,13367.565,266.591,12.71,0.757,0
110,116,147,3407,3,46,0,0,41.67,6825442,594.561,31.1,8.514,13367.565,266.591,12.71,0.757,0
110,117,175,3582,1,47,0,0,41.67,6825442,594.561,31.1,8.514,13367.565,266.591,12.71,0.757,0
110,118,168,3750,4,51,0,0,41.67,6825442,594.561,31.1,8.514,13367.565,266.591,12.71,0.757,0
110,119,132,3882,0,51,0,0,41.67,6825442,594.561,31.1,8.514,13367.565,266.591,12.71,0.757,0
110,120,141,4023,3,54,0,0,41.67,6825442,594.561,31.1,8.514,13367.565,266.591,12.71,0.757,0
110,121,182,4205,1,55,0,0,61.11,6825442,594.561,31.1,8.514,13367.565,266.591,12.71,0.757,0
110,122,129,4334,2,57,0,0,61.11,6825442,594.561,31.1,8.514,13367.565,266.591,12.71,0.757,0
110,123,221,4555,4,61,0,0,61.11,6825442,594.561,31.1,8.514,13367.565,266.591,12.71,0.757,0
110,124,175,4730,0,61,0,0,61.11,6825442,594.561,31.1,8.514,13367.565,266.591,12.71,0.757,0
110,125,155,4885,1,62,0,0,61.11,6825442,594.561,31.1,8.514,13367.565,266.591,12.71,0.757,0
110,126,177,5062,3,65,0,0,57.41,6825442,594.561,31.1,8.514,13367.565,266.591,12.71,0.757,0
110,127,0,5062,0,65,0,0,57.41,6825442,594.561,31.1,8.514,13367.565,266.591,12.71,0.757,0
110,128,355,5417,3,68,0,0,61.11,6825442,594.561,31.1,8.514,13367.565,266.591,12.71,0.757,0
110,129,255,5672,2,70,0,0,61.11,6825442,594.561,31.1,8.514,13367.565,266.591,12.71,0.757,0
110,130,279,5951,0,70,0,0,61.11,6825442,594.561,31.1,8.514,13367.565,266.591,12.71,0.757,0
110,131,272,6223,6,76,0,0,61.11,6825442,594.561,31.1,8.514,13367.565,266.591,12.71,0.757,0
110,132,294,6517,0,76,0,0,61.11,6825442,594.561,31.1,8.514,13367.565,266.591,12.71,0.757,0
110,133,295,6812,4,80,0,0,24.07,6825442,594.561,31.1,8.514,13367.565,266.591,12.71,0.757,0
110,134,309,7121,7,87,0,0,24.07,6825442,594.561,31.1,8.514,13367.565,266.591,12.71,0.757,0
110,135,292,7413,2,89,0,0,24.07,6825442,594.561,31.1,8.514,13367.565,266.591,12.71,0.757,0
110,136,298,7711,3,92,0,0,24.07,6825442,594.561,31.1,8.514,13367.565,266.591,12.71,0.757,0
110,137,334,8045,2,94,0,0,24.07,6825442,594.561,31.1,8.514,13367.565,266.591,12.71,0.757,0
110,138,397,8442,3,97,0,0,24.07,6825442,594.561,31.1,8.514,13367.565,266.591,12.71,0.757,0
110,139,439,8881,6,103,0,0,24.07,6825442,594.561,31.1,8.514,13367.565,266.591,12.71,0.757,0
110,140,456,9337,2,105,0,0,24.07,6825442,594.561,31.1,8.514,13367.565,266.591,12.71,0.757,0
110,141,0,9337,0,105,0,0,24.07,6825442,594.561,31.1,8.514,13367.565,266.591,12.71,0.757,0
110,142,1010,10347,4,109,0,0,24.07,6825442,594.561,31.1,8.514,13367.565,266.591,12.71,0.757,0
110,143,605,10952,4,113,0,0,64.81,6825442,594.561,31.1,8.514,13367.565,266.591,12.71,0.757,0
110,144,628,11580,3,116,0,0,64.81,6825442,594.561,31.1,8.514,13367.565,266.591,12.71,0.757,0
110,145,611,12191,5,121,0,0,64.81,6825442,594.561,31.1,8.514,13367.565,266.591,12.71,0.757,0
110,146,0,12191,0,121,0,0,64.81,6825442,594.561,31.1,8.514,13367.565,266.591,12.71,0.757,0
110,147,964,13155,5,126,0,0,64.81,6825442,594.561,31.1,8.514,13367.565,266.591,12.71,0.757,0
110,148,532,13687,12,138,0,0,64.81,6825442,594.561,31.1,8.514,13367.565,266.591,12.71,0.757,0
110,149,561,14248,1,139,0,0,64.81,6825442,594.561,31.1,8.514,13367.565,266.591,12.71,0.757,0
110,150,689,14937,7,146,0,0,64.81,6825442,594.561,31.1,8.514,13367.565,266.591,12.71,0.757,0
110,151,676,15613,2,148,0,0,64.81,6825442,594.561,31.1,8.514,13367.565,266.591,12.71,0.757,0
110,152,662,16275,7,155,0,0,64.81,6825442,594.561,31.1,8.514,13367.565,266.591,12.71,0.757,0
110,153,595,16870,5,160,0,0,64.81,6825442,594.561,31.1,8.514,13367.565,266.591,12.71,0.757,0
110,154,438,17308,7,167,0,0,64.81,6825442,594.561,31.1,8.514,13367.565,266.591,12.71,0.757,0
110,155,469,17777,4,171,0,0,64.81,6825442,594.561,31.1,8.514,13367.565,266.591,12.71,0.757,0
110,156,598,18375,6,177,0,0,64.81,6825442,594.561,31.1,8.514,13367.565,266.591,12.71,0.757,0
110,157,588,18963,2,179,0,0,64.81,6825442,594.561,31.1,8.514,13367.565,266.591,12.71,0.757,0
110,158,527,19490,4,183,0,0,64.81,6825442,594.561,31.1,8.514,13367.565,266.591,12.71,0.757,0
110,159,521,20011,4,187,0,0,64.81,6825442,594.561,31.1,8.514,13367.565,266.591,12.71,0.757,0
110,160,415,20426,4,191,0,0,64.81,6825442,594.561,31.1,8.514,13367.565,266.591,12.71,0.757,0
110,161,400,20826,9,200,0,0,61.11,6825442,594.561,31.1,8.514,13367.565,266.591,12.71,0.757,0
110,162,498,21324,7,207,0,0,61.11,6825442,594.561,31.1,8.514,13367.565,266.591,12.71,0.757,0
110,163,553,21877,5,212,0,0,61.11,6825442,594.561,31.1,8.514,13367.565,266.591,12.71,0.757,0
110,164,560,22437,7,219,0,0,61.11,6825442,594.561,31.1,8.514,13367.565,266.591,12.71,0.757,0
110,165,546,22983,10,229,0,0,61.11,6825442,594.561,31.1,8.514,13367.565,266.591,12.71,0.757,0
110,166,686,23669,10,239,0,0,61.11,6825442,594.561,31.1,8.514,13367.565,266.591,12.71,0.757,0
110,167,641,24310,2,241,0,0,61.11,6825442,594.561,31.1,8.514,13367.565,266.591,12.71,0.757,0
110,168,547,24857,5,246,0,0,61.11,6825442,594.561,31.1,8.514,13367.565,266.591,12.71,0.757,0
110,169,592,25449,6,252,0,0,61.11,6825442,594.561,31.1,8.514,13367.565,266.591,12.71,0.757,0
110,170,634,26083,7,259,0,0,61.11,6825442,594.561,31.1,8.514,13367.565,266.591,12.71,0.757,0
110,171,685,26768,4,263,0,0,61.11,6825442,594.561,31.1,8.514,13367.565,266.591,12.71,0.757,0
110,172,750,27518,18,281,0,0,61.11,6825442,594.561,31.1,8.514,13367.565,266.591,12.71,0.757,0
110,173,779,28297,5,286,0,0,61.11,6825442,594.561,31.1,8.514,13367.565,266.591,12.71,0.757,0
110,174,1006,29303,11,297,0,0,61.11,6825442,594.561,31.1,8.514,13367.565,266.591,12.71,0.757,0
110,175,684,29987,10,307,0,0,61.11,6825442,594.561,31.1,8.514,13367.565,266.591,12.71,0.757,0
110,176,865,30852,8,315,0,0,61.11,6825442,594.561,31.1,8.514,13367.565,266.591,12.71,0.757,0
110,177,940,31792,13,328,0,0,61.11,6825442,594.561,31.1,8.514,13367.565,266.591,12.71,0.757,0
110,178,1027,32819,1,329,0,0,61.11,6825442,594.561,31.1,8.514,13367.565,266.591,12.71,0.757,0
110,179,1143,33962,4,333,0,0,61.11,6825442,594.561,31.1,8.514,13367.565,266.591,12.71,0.757,0
110,180,1280,35242,7,340,0,0,61.11,6825442,594.561,31.1,8.514,13367.565,266.591,12.71,0.757,0
110,181,1012,36254,7,347,0,0,59.26,6825442,594.561,31.1,8.514,13367.565,266.591,12.71,0.757,0
110,182,1018,37272,4,351,0,0,59.26,6825442,594.561,31.1,8.514,13367.565,266.591,12.71,0.757,0
110,183,1105,38377,10,361,0,0,59.26,6825442,594.561,31.1,8.514,13367.565,266.591,12.71,0.757,0
110,184,1257,39634,6,367,0,0,59.26,6825442,594.561,31.1,8.514,13367.565,266.591,12.71,0.757,0
110,185,1248,40882,7,374,0,0,59.26,6825442,594.561,31.1,8.514,13367.565,266.591,12.71,0.757,0
110,186,1291,42173,12,386,0,0,59.26,6825442,594.561,31.1,8.514,13367.565,266.591,12.71,0.757,0
110,187,1321,43494,12,398,0,0,59.26,6825442,594.561,31.1,8.514,13367.565,266.591,12.71,0.757,0
110,188,988,44482,8,406,0,0,59.26,6825442,594.561,31.1,8.514,13367.565,266.591,12.71,0.757,0
110,189,1175,45657,8,414,0,0,59.26,6825442,594.561,31.1,8.514,13367.565,266.591,12.71,0.757,0
110,190,1261,46918,10,424,0,0,59.26,6825442,594.561,31.1,8.514,13367.565,266.591,12.71,0.757,0
110,191,1459,48377,9,433,0,0,59.26,6825442,594.561,31.1,8.514,13367.565,266.591,12.71,0.757,0
110,192,1367,49744,6,439,0,0,59.26,6825442,594.561,31.1,8.514,13367.565,266.591,12.71,0.757,0
110,193,1426,51170,11,450,0,0,59.26,6825442,594.561,31.1,8.514,13367.565,266.591,12.71,0.757,0
110,194,1388,52558,5,455,0,0,59.26,6825442,594.561,31.1,8.514,13367.565,266.591,12.71,0.757,0
110,195,0,52558,0,455,0,0,59.26,6825442,594.561,31.1,8.514,13367.565,266.591,12.71,0.757,0
110,196,2066,54624,11,466,0,0,59.26,6825442,594.561,31.1,8.514,13367.565,266.591,12.71,0.757,0
110,197,1245,55869,13,479,0,0,59.26,6825442,594.561,31.1,8.514,13367.565,266.591,12.71,0.757,0
110,198,1377,57246,20,499,0,0,59.26,6825442,594.561,31.1,8.514,13367.565,266.591,12.71,0.757,0
110,199,1499,58745,2,501,0,0,59.26,6825442,594.561,31.1,8.514,13367.565,266.591,12.71,0.757,0
110,200,1368,60113,8,509,0,0,59.26,6825442,594.561,31.1,8.514,13367.565,266.591,12.71,0.757,0
110,201,1171,61284,8,517,0,0,59.26,6825442,594.561,31.1,8.514,13367.565,266.591,12.71,0.757,0
110,202,1002,62286,3,520,0,0,59.26,6825442,594.561,31.1,8.514,13367.565,266.591,12.71,0.757,0
110,203,658,62944,6,526,0,0,59.26,6825442,594.561,31.1,8.514,13367.565,266.591,12.71,0.757,0
110,204,1392,64336,5,531,0,0,59.26,6825442,594.561,31.1,8.514,13367.565,266.591,12.71,0.757,0
112,1,0,3,0,0,0,0,79.63,5057677,49.127,19.2,3.057,752.788,272.509,2.42,0.435,0
112,2,3,6,0,0,0,0,79.63,5057677,49.127,19.2,3.057,752.788,272.509,2.42,0.435,0
112,3,0,6,0,0,0,0,79.63,5057677,49.127,19.2,3.057,752.788,272.509,2.42,0.435,0
112,4,1,7,0,0,0,0,79.63,5057677,49.127,19.2,3.057,752.788,272.509,2.42,0.435,0
112,5,3,10,1,1,0,0,79.63,5057677,49.127,19.2,3.057,752.788,272.509,2.42,0.435,0
112,6,3,13,2,3,0,0,79.63,5057677,49.127,19.2,3.057,752.788,272.509,2.42,0.435,0
112,7,1,14,0,3,0,0,79.63,5057677,49.127,19.2,3.057,752.788,272.509,2.42,0.435,0
112,8,0,14,0,3,0,0,81.48,5057677,49.127,19.2,3.057,752.788,272.509,2.42,0.435,0
112,9,17,31,1,4,0,0,81.48,5057677,49.127,19.2,3.057,752.788,272.509,2.42,0.435,0
112,10,0,31,0,4,0,0,84.26,5057677,49.127,19.2,3.057,752.788,272.509,2.42,0.435,0
112,11,6,37,0,4,0,0,84.26,5057677,49.127,19.2,3.057,752.788,272.509,2.42,0.435,0
112,12,11,48,1,5,0,0,87.96,5057677,49.127,19.2,3.057,752.788,272.509,2.42,0.435,0
112,13,2,50,0,5,0,0,87.96,5057677,49.127,19.2,3.057,752.788,272.509,2.42,0.435,0
112,14,9,59,1,6,0,0,87.96,5057677,49.127,19.2,3.057,752.788,272.509,2.42,0.435,0
112,15,0,59,0,6,0,0,87.96,5057677,49.127,19.2,3.057,752.788,272.509,2.42,0.435,0
112,16,0,59,0,6,0,0,87.96,5057677,49.127,19.2,3.057,752.788,272.509,2.42,0.435,0
112,17,14,73,0,6,0,0,87.96,5057677,49.127,19.2,3.057,752.788,272.509,2.42,0.435,0
112,18,3,76,1,7,0,0,87.96,5057677,49.127,19.2,3.057,752.788,272.509,2.42,0.435,0
112,19,5,81,0,7,0,0,87.96,5057677,49.127,19.2,3.057,752.788,272.509,2.42,0.435,0
112,20,10,91,1,8,0,0,87.96,5057677,49.127,19.2,3.057,752.788,272.509,2.42,0.435,0
112,21,8,99,0,8,0,0,87.96,5057677,49.127,19.2,3.057,752.788,272.509,2.42,0.435,0
112,22,2,101,0,8,0,0,87.96,5057677,49.127,19.2,3.057,752.788,272.509,2.42,0.435,0
112,23,0,101,0,8,0,0,87.96,5057677,49.127,19.2,3.057,752.788,272.509,2.42,0.435,0
112,24,0,101,0,8,0,0,87.96,5057677,49.127,19.2,3.057,752.788,272.509,2.42,0.435,0
112,25,16,117,0,8,0,0,87.96,5057677,49.127,19.2,3.057,752.788,272.509,2.42,0.435,0
112,26,3,120,3,11,0,0,87.96,5057677,49.127,19.2,3.057,752.788,272.509,2.42,0.435,0
112,27,4,124,1,12,0,0,87.96,5057677,49.127,19.2,3.057,752.788,272.509,2.42,0.435,0
112,28,9,133,4,16,0,0,87.96,5057677,49.127,19.2,3.057,752.788,272.509,2.42,0.435,0
112,29,8,141,0,16,0,0,87.96,5057677,49.127,19.2,3.057,752.788,272.509,2.42,0.435,0
112,30,0,141,0,16,0,0,87.96,5057677,49.127,19.2,3.057,752.788,272.509,2.42,0.435,0
112,31,0,141,0,16,0,0,87.96,5057677,49.127,19.2,3.057,752.788,272.509,2.42,0.435,0
112,32,11,152,2,18,0,0,87.96,5057677,49.127,19.2,3.057,752.788,272.509,2.42,0.435,0
112,33,2,154,0,18,0,0,87.96,5057677,49.127,19.2,3.057,752.788,272.509,2.42,0.435,0
112,34,4,158,0,18,0,0,87.96,5057677,49.127,19.2,3.057,752.788,272.509,2.42,0.435,0
112,35,8,166,0,18,0,0,87.96,5057677,49.127,19.2,3.057,752.788,272.509,2.42,0.435,0
112,36,4,170,2,20,0,0,87.96,5057677,49.127,19.2,3.057,752.788,272.509,2.42,0.435,0
112,37,8,178,0,20,0,0,87.96,5057677,49.127,19.2,3.057,752.788,272.509,2.42,0.435,0
112,38,11,189,0,20,0,0,87.96,5057677,49.127,19.2,3.057,752.788,272.509,2.42,0.435,0
112,39,10,199,0,20,0,0,87.96,5057677,49.127,19.2,3.057,752.788,272.509,2.42,0.435,0
112,40,0,199,0,20,0,0,87.96,5057677,49.127,19.2,3.057,752.788,272.509,2.42,0.435,0
112,41,0,199,0,20,0,0,87.96,5057677,49.127,19.2,3.057,752.788,272.509,2.42,0.435,0
112,42,12,211,0,20,0,0,87.96,5057677,49.127,19.2,3.057,752.788,272.509,2.42,0.435,0
112,43,1,212,0,20,0,0,87.96,5057677,49.127,19.2,3.057,752.788,272.509,2.42,0.435,0
112,44,1,213,0,20,0,0,87.96,5057677,49.127,19.2,3.057,752.788,272.509,2.42,0.435,0
112,45,2,215,0,20,0,0,87.96,5057677,49.127,19.2,3.057,752.788,272.509,2.42,0.435,0
112,46,4,219,0,20,0,0,87.96,5057677,49.127,19.2,3.057,752.788,272.509,2.42,0.435,0
112,47,4,223,0,20,0,0,87.96,5057677,49.127,19.2,3.057,752.788,272.509,2.42,0.435,0
112,48,3,226,1,21,0,0,87.96,5057677,49.127,19.2,3.057,752.788,272.509,2.42,0.435,0
112,49,3,229,1,22,0,0,87.96,5057677,49.127,19.2,3.057,752.788,272.509,2.42,0.435,0
112,50,4,233,1,23,0,0,87.96,5057677,49.127,19.2,3.057,752.788,272.509,2.42,0.435,0
112,51,5,238,0,23,0,0,87.96,5057677,49.127,19.2,3.057,752.788,272.509,2.42,0.435,0
112,52,2,240,0,23,0,0,87.96,5057677,49.127,19.2,3.057,752.788,272.509,2.42,0.435,0
112,53,9,249,1,24,0,0,84.26,5057677,49.127,19.2,3.057,752.788,272.509,2.42,0.435,0
112,54,6,255,2,26,0,0,84.26,5057677,49.127,19.2,3.057,752.788,272.509,2.42,0.435,0
112,55,10,265,0,26,0,0,84.26,5057677,49.127,19.2,3.057,752.788,272.509,2.42,0.435,0
112,56,0,265,0,26,0,0,84.26,5057677,49.127,19.2,3.057,752.788,272.509,2.42,0.435,0
112,57,1,266,0,26,0,0,84.26,5057677,49.127,19.2,3.057,752.788,272.509,2.42,0.435,0
112,58,0,266,1,27,0,0,84.26,5057677,49.127,19.2,3.057,752.788,272.509,2.42,0.435,0
112,59,3,269,0,27,0,0,84.26,5057677,49.127,19.2,3.057,752.788,272.509,2.42,0.435,0
112,60,4,273,0,27,0,0,84.26,5057677,49.127,19.2,3.057,752.788,272.509,2.42,0.435,0
112,61,7,280,0,27,0,0,84.26,5057677,49.127,19.2,3.057,752.788,272.509,2.42,0.435,0
112,62,8,288,0,27,0,0,84.26,5057677,49.127,19.2,3.057,752.788,272.509,2.42,0.435,0
112,63,8,296,0,27,0,0,84.26,5057677,49.127,19.2,3.057,752.788,272.509,2.42,0.435,0
112,64,15,311,1,28,0,0,84.26,5057677,49.127,19.2,3.057,752.788,272.509,2.42,0.435,0
112,65,5,316,0,28,0,0,87.04,5057677,49.127,19.2,3.057,752.788,272.509,2.42,0.435,0
112,66,5,321,0,28,0,0,79.63,5057677,49.127,19.2,3.057,752.788,272.509,2.42,0.435,0
112,67,13,334,2,30,0,0,79.63,5057677,49.127,19.2,3.057,752.788,272.509,2.42,0.435,0
112,68,11,345,0,30,0,0,79.63,5057677,49.127,19.2,3.057,752.788,272.509,2.42,0.435,0
112,69,14,359,0,30,0,0,79.63,5057677,49.127,19.2,3.057,752.788,272.509,2.42,0.435,0
112,70,11,370,0,30,0,0,79.63,5057677,49.127,19.2,3.057,752.788,272.509,2.42,0.435,0
112,71,13,383,1,31,0,0,79.63,5057677,49.127,19.2,3.057,752.788,272.509,2.42,0.435,0
112,72,14,397,0,31,0,0,79.63,5057677,49.127,19.2,3.057,752.788,272.509,2.42,0.435,0
112,73,13,410,0,31,0,0,79.63,5057677,49.127,19.2,3.057,752.788,272.509,2.42,0.435,0
112,74,11,421,1,32,0,0,79.63,5057677,49.127,19.2,3.057,752.788,272.509,2.42,0.435,0
112,75,25,446,0,32,0,0,79.63,5057677,49.127,19.2,3.057,752.788,272.509,2.42,0.435,0
112,76,12,458,0,32,0,0,79.63,5057677,49.127,19.2,3.057,752.788,272.509,2.42,0.435,0
112,77,40,498,1,33,0,0,79.63,5057677,49.127,19.2,3.057,752.788,272.509,2.42,0.435,0
112,78,11,509,0,33,0,0,79.63,5057677,49.127,19.2,3.057,752.788,272.509,2.42,0.435,0
112,79,0,509,0,33,0,0,79.63,5057677,49.127,19.2,3.057,752.788,272.509,2.42,0.435,0
112,80,33,542,0,33,0,0,79.63,5057677,49.127,19.2,3.057,752.788,272.509,2.42,0.435,0
112,81,39,581,0,33,0,0,79.63,5057677,49.127,19.2,3.057,752.788,272.509,2.42,0.435,0
112,82,20,601,0,33,0,0,79.63,5057677,49.127,19.2,3.057,752.788,272.509,2.42,0.435,0
112,83,25,626,1,34,0,0,79.63,5057677,49.127,19.2,3.057,752.788,272.509,2.42,0.435,0
112,84,24,650,0,34,0,0,79.63,5057677,49.127,19.2,3.057,752.788,272.509,2.42,0.435,0
112,85,2,652,0,34,0,0,79.63,5057677,49.127,19.2,3.057,752.788,272.509,2.42,0.435,0
112,86,10,662,0,34,0,0,79.63,5057677,49.127,19.2,3.057,752.788,272.509,2.42,0.435,0
112,87,19,681,0,34,0,0,79.63,5057677,49.127,19.2,3.057,752.788,272.509,2.42,0.435,0
112,88,3,684,0,34,0,0,79.63,5057677,49.127,19.2,3.057,752.788,272.509,2.42,0.435,0
112,89,45,729,0,34,0,0,79.63,5057677,49.127,19.2,3.057,752.788,272.509,2.42,0.435,0
112,90,39,768,0,34,0,0,75.93,5057677,49.127,19.2,3.057,752.788,272.509,2.42,0.435,0
112,91,2,770,2,36,0,0,75.93,5057677,49.127,19.2,3.057,752.788,272.509,2.42,0.435,0
112,92,10,780,0,36,0,0,75.93,5057677,49.127,19.2,3.057,752.788,272.509,2.42,0.435,0
112,93,24,804,1,37,0,0,75.93,5057677,49.127,19.2,3.057,752.788,272.509,2.42,0.435,0
112,94,15,819,0,37,0,0,75.93,5057677,49.127,19.2,3.057,752.788,272.509,2.42,0.435,0
112,95,14,833,0,37,0,0,75.93,5057677,49.127,19.2,3.057,752.788,272.509,2.42,0.435,0
112,96,36,869,0,37,0,0,75.93,5057677,49.127,19.2,3.057,752.788,272.509,2.42,0.435,0
112,97,5,874,0,37,0,0,75.93,5057677,49.127,19.2,3.057,752.788,272.509,2.42,0.435,0
112,98,17,891,2,39,0,0,75.93,5057677,49.127,19.2,3.057,752.788,272.509,2.42,0.435,0
112,99,26,917,2,41,0,0,75.93,5057677,49.127,19.2,3.057,752.788,272.509,2.42,0.435,0
112,100,9,926,0,41,0,0,73.15,5057677,49.127,19.2,3.057,752.788,272.509,2.42,0.435,0
112,101,31,957,1,42,0,0,73.15,5057677,49.127,19.2,3.057,752.788,272.509,2.42,0.435,0
112,102,6,963,5,47,0,0,73.15,5057677,49.127,19.2,3.057,752.788,272.509,2.42,0.435,0
112,103,35,998,0,47,0,0,73.15,5057677,49.127,19.2,3.057,752.788,272.509,2.42,0.435,0
112,104,12,1010,4,51,0,0,73.15,5057677,49.127,19.2,3.057,752.788,272.509,2.42,0.435,0
112,105,14,1024,0,51,0,0,73.15,5057677,49.127,19.2,3.057,752.788,272.509,2.42,0.435,0
112,106,0,1024,0,51,0,0,73.15,5057677,49.127,19.2,3.057,752.788,272.509,2.42,0.435,0
112,107,32,1056,15,66,0,0,73.15,5057677,49.127,19.2,3.057,752.788,272.509,2.42,0.435,0
112,108,14,1070,2,68,0,0,67.59,5057677,49.127,19.2,3.057,752.788,272.509,2.42,0.435,0
112,109,15,1085,1,69,0,0,67.59,5057677,49.127,19.2,3.057,752.788,272.509,2.42,0.435,0
112,110,3,1088,1,70,0,0,67.59,5057677,49.127,19.2,3.057,752.788,272.509,2.42,0.435,0
112,111,3,1091,0,70,0,0,67.59,5057677,49.127,19.2,3.057,752.788,272.509,2.42,0.435,0
112,112,16,1107,0,70,0,0,67.59,5057677,49.127,19.2,3.057,752.788,272.509,2.42,0.435,0
112,113,1,1108,0,70,0,0,67.59,5057677,49.127,19.2,3.057,752.788,272.509,2.42,0.435,0
112,114,6,1114,0,70,0,0,64.81,5057677,49.127,19.2,3.057,752.788,272.509,2.42,0.435,0
112,115,3,1117,1,71,0,0,64.81,5057677,49.127,19.2,3.057,752.788,272.509,2.42,0.435,0
112,116,18,1135,0,71,0,0,64.81,5057677,49.127,19.2,3.057,752.788,272.509,2.42,0.435,0
112,117,20,1155,0,71,0,0,64.81,5057677,49.127,19.2,3.057,752.788,272.509,2.42,0.435,0
112,118,7,1162,1,72,0,0,64.81,5057677,49.127,19.2,3.057,752.788,272.509,2.42,0.435,0
112,119,5,1167,0,72,0,0,64.81,5057677,49.127,19.2,3.057,752.788,272.509,2.42,0.435,0
112,120,10,1177,0,72,0,0,64.81,5057677,49.127,19.2,3.057,752.788,272.509,2.42,0.435,0
112,121,2,1179,0,72,0,0,64.81,5057677,49.127,19.2,3.057,752.788,272.509,2.42,0.435,0
112,122,2,1181,1,73,0,0,64.81,5057677,49.127,19.2,3.057,752.788,272.509,2.42,0.435,0
112,123,5,1186,2,75,0,0,64.81,5057677,49.127,19.2,3.057,752.788,272.509,2.42,0.435,0
112,124,3,1189,0,75,0,0,64.81,5057677,49.127,19.2,3.057,752.788,272.509,2.42,0.435,0
112,125,18,1207,2,77,0,0,64.81,5057677,49.127,19.2,3.057,752.788,272.509,2.42,0.435,0
112,126,7,1214,1,78,0,0,64.81,5057677,49.127,19.2,3.057,752.788,272.509,2.42,0.435,0
112,127,2,1216,0,78,0,0,64.81,5057677,49.127,19.2,3.057,752.788,272.509,2.42,0.435,0
112,128,5,1221,0,78,0,0,64.81,5057677,49.127,19.2,3.057,752.788,272.509,2.42,0.435,0
112,129,3,1224,0,78,0,0,64.81,5057677,49.127,19.2,3.057,752.788,272.509,2.42,0.435,0
112,130,6,1230,0,78,0,0,64.81,5057677,49.127,19.2,3.057,752.788,272.509,2.42,0.435,0
112,131,4,1234,1,79,0,0,64.81,5057677,49.127,19.2,3.057,752.788,272.509,2.42,0.435,0
112,132,3,1237,0,79,0,0,64.81,5057677,49.127,19.2,3.057,752.788,272.509,2.42,0.435,0
112,133,3,1240,0,79,0,0,64.81,5057677,49.127,19.2,3.057,752.788,272.509,2.42,0.435,0
112,134,10,1250,2,81,0,0,64.81,5057677,49.127,19.2,3.057,752.788,272.509,2.42,0.435,0
112,135,2,1252,1,82,0,0,64.81,5057677,49.127,19.2,3.057,752.788,272.509,2.42,0.435,0
112,136,0,1252,0,82,0,0,64.81,5057677,49.127,19.2,3.057,752.788,272.509,2.42,0.435,0
112,137,0,1252,0,82,0,0,64.81,5057677,49.127,19.2,3.057,752.788,272.509,2.42,0.435,0
112,138,5,1257,0,82,0,0,64.81,5057677,49.127,19.2,3.057,752.788,272.509,2.42,0.435,0
112,139,0,1257,0,82,0,0,64.81,5057677,49.127,19.2,3.057,752.788,272.509,2.42,0.435,0
112,140,20,1277,0,82,0,0,64.81,5057677,49.127,19.2,3.057,752.788,272.509,2.42,0.435,0
112,141,5,1282,0,82,0,0,64.81,5057677,49.127,19.2,3.057,752.788,272.509,2.42,0.435,0
112,142,0,1282,0,82,0,0,64.81,5057677,49.127,19.2,3.057,752.788,272.509,2.42,0.435,0
112,143,2,1284,0,82,0,0,64.81,5057677,49.127,19.2,3.057,752.788,272.509,2.42,0.435,0
112,144,1,1285,0,82,0,0,64.81,5057677,49.127,19.2,3.057,752.788,272.509,2.42,0.435,0
112,145,1,1286,0,82,0,0,64.81,5057677,49.127,19.2,3.057,752.788,272.509,2.42,0.435,0
112,146,0,1286,0,82,0,0,64.81,5057677,49.127,19.2,3.057,752.788,272.509,2.42,0.435,0
112,147,4,1290,0,82,0,0,64.81,5057677,49.127,19.2,3.057,752.788,272.509,2.42,0.435,0
112,148,5,1295,0,82,0,0,64.81,5057677,49.127,19.2,3.057,752.788,272.509,2.42,0.435,0
112,149,3,1298,0,82,0,0,64.81,5057677,49.127,19.2,3.057,752.788,272.509,2.42,0.435,0
112,150,0,1298,0,82,0,0,64.81,5057677,49.127,19.2,3.057,752.788,272.509,2.42,0.435,0
112,151,0,1298,0,82,0,0,64.81,5057677,49.127,19.2,3.057,752.788,272.509,2.42,0.435,0
112,152,6,1304,0,82,0,0,64.81,5057677,49.127,19.2,3.057,752.788,272.509,2.42,0.435,0
112,153,0,1304,0,82,0,0,60.19,5057677,49.127,19.2,3.057,752.788,272.509,2.42,0.435,0
112,154,0,1304,0,82,0,0,60.19,5057677,49.127,19.2,3.057,752.788,272.509,2.42,0.435,0
112,155,1,1305,0,82,0,0,60.19,5057677,49.127,19.2,3.057,752.788,272.509,2.42,0.435,0
112,156,0,1305,0,82,0,0,60.19,5057677,49.127,19.2,3.057,752.788,272.509,2.42,0.435,0
112,157,1,1306,0,82,0,0,60.19,5057677,49.127,19.2,3.057,752.788,272.509,2.42,0.435,0
112,158,0,1306,0,82,0,0,60.19,5057677,49.127,19.2,3.057,752.788,272.509,2.42,0.435,0
112,159,0,1306,0,82,0,0,60.19,5057677,49.127,19.2,3.057,752.788,272.509,2.42,0.435,0
112,160,1,1307,0,82,0,0,60.19,5057677,49.127,19.2,3.057,752.788,272.509,2.42,0.435,0
112,161,4,1311,0,82,0,0,60.19,5057677,49.127,19.2,3.057,752.788,272.509,2.42,0.435,0
112,162,0,1311,0,82,0,0,60.19,5057677,49.127,19.2,3.057,752.788,272.509,2.42,0.435,0
112,163,2,1313,0,82,0,0,60.19,5057677,49.127,19.2,3.057,752.788,272.509,2.42,0.435,0
112,164,2,1315,0,82,0,0,60.19,5057677,49.127,19.2,3.057,752.788,272.509,2.42,0.435,0
112,165,0,1315,0,82,0,0,60.19,5057677,49.127,19.2,3.057,752.788,272.509,2.42,0.435,0
112,166,1,1316,0,82,0,0,60.19,5057677,49.127,19.2,3.057,752.788,272.509,2.42,0.435,0
112,167,3,1319,0,82,0,0,60.19,5057677,49.127,19.2,3.057,752.788,272.509,2.42,0.435,0
112,168,2,1321,0,82,0,0,60.19,5057677,49.127,19.2,3.057,752.788,272.509,2.42,0.435,0
112,169,6,1327,0,82,0,0,60.19,5057677,49.127,19.2,3.057,752.788,272.509,2.42,0.435,0
112,170,5,1332,0,82,0,0,60.19,5057677,49.127,19.2,3.057,752.788,272.509,2.42,0.435,0
112,171,1,1333,0,82,0,0,60.19,5057677,49.127,19.2,3.057,752.788,272.509,2.42,0.435,0
112,172,1,1334,0,82,0,0,60.19,5057677,49.127,19.2,3.057,752.788,272.509,2.42,0.435,0
112,173,1,1335,0,82,0,0,60.19,5057677,49.127,19.2,3.057,752.788,272.509,2.42,0.435,0
112,174,0,1335,0,82,0,0,60.19,5057677,49.127,19.2,3.057,752.788,272.509,2.42,0.435,0
112,175,1,1336,0,82,0,0,60.19,5057677,49.127,19.2,3.057,752.788,272.509,2.42,0.435,0
112,176,0,1336,0,82,0,0,60.19,5057677,49.127,19.2,3.057,752.788,272.509,2.42,0.435,0
112,177,1,1337,0,82,0,0,60.19,5057677,49.127,19.2,3.057,752.788,272.509,2.42,0.435,0
112,178,1,1338,0,82,0,0,60.19,5057677,49.127,19.2,3.057,752.788,272.509,2.42,0.435,0
112,179,0,1338,0,82,0,0,60.19,5057677,49.127,19.2,3.057,752.788,272.509,2.42,0.435,0
112,180,0,1338,0,82,0,0,60.19,5057677,49.127,19.2,3.057,752.788,272.509,2.42,0.435,0
112,181,1,1339,0,82,0,0,60.19,5057677,49.127,19.2,3.057,752.788,272.509,2.42,0.435,0
112,182,3,1342,0,82,0,0,60.19,5057677,49.127,19.2,3.057,752.788,272.509,2.42,0.435,0
112,183,1,1343,0,82,0,0,60.19,5057677,49.127,19.2,3.057,752.788,272.509,2.42,0.435,0
112,184,0,1343,0,82,0,0,60.19,5057677,49.127,19.2,3.057,752.788,272.509,2.42,0.435,0
112,185,0,1343,0,82,0,0,60.19,5057677,49.127,19.2,3.057,752.788,272.509,2.42,0.435,0
112,186,3,1346,0,82,0,0,60.19,5057677,49.127,19.2,3.057,752.788,272.509,2.42,0.435,0
112,187,1,1347,0,82,0,0,60.19,5057677,49.127,19.2,3.057,752.788,272.509,2.42,0.435,0
112,188,1,1348,0,82,0,0,60.19,5057677,49.127,19.2,3.057,752.788,272.509,2.42,0.435,0
112,189,6,1354,0,82,0,0,60.19,5057677,49.127,19.2,3.057,752.788,272.509,2.42,0.435,0
112,190,0,1354,0,82,0,0,60.19,5057677,49.127,19.2,3.057,752.788,272.509,2.42,0.435,0
112,191,1,1355,0,82,0,0,57.41,5057677,49.127,19.2,3.057,752.788,272.509,2.42,0.435,0
112,192,5,1360,0,82,0,0,57.41,5057677,49.127,19.2,3.057,752.788,272.509,2.42,0.435,0
112,193,0,1360,0,82,0,0,57.41,5057677,49.127,19.2,3.057,752.788,272.509,2.42,0.435,0
112,194,3,1363,0,82,0,0,57.41,5057677,49.127,19.2,3.057,752.788,272.509,2.42,0.435,0
112,195,0,1363,0,82,0,0,57.41,5057677,49.127,19.2,3.057,752.788,272.509,2.42,0.435,0
112,196,8,1371,0,82,0,0,57.41,5057677,49.127,19.2,3.057,752.788,272.509,2.42,0.435,0
112,197,0,1371,0,82,0,0,57.41,5057677,49.127,19.2,3.057,752.788,272.509,2.42,0.435,0
112,198,1,1372,0,82,0,0,57.41,5057677,49.127,19.2,3.057,752.788,272.509,2.42,0.435,0
112,199,2,1374,0,82,0,0,57.41,5057677,49.127,19.2,3.057,752.788,272.509,2.42,0.435,0
112,200,3,1377,0,82,0,0,57.41,5057677,49.127,19.2,3.057,752.788,272.509,2.42,0.435,0
112,201,0,1377,0,82,0,0,57.41,5057677,49.127,19.2,3.057,752.788,272.509,2.42,0.435,0
112,202,0,1377,0,82,0,0,57.41,5057677,49.127,19.2,3.057,752.788,272.509,2.42,0.435,0
112,203,4,1381,0,82,0,0,57.41,5057677,49.127,19.2,3.057,752.788,272.509,2.42,0.435,0
112,204,3,1384,0,82,0,0,57.41,5057677,49.127,19.2,3.057,752.788,272.509,2.42,0.435,0
113,1,2,10,0,0,14,130,90.74,6871287,3.623,29,4.424,17881.509,341.862,10.43,0.706,0
113,2,0,10,0,0,0,130,90.74,6871287,3.623,29,4.424,17881.509,341.862,10.43,0.706,0
113,3,1,11,1,1,14,144,90.74,6871287,3.623,29,4.424,17881.509,341.862,10.43,0.706,0
113,4,0,11,0,1,30,174,90.74,6871287,3.623,29,4.424,17881.509,341.862,10.43,0.706,0
113,5,7,18,0,1,18,192,90.74,6871287,3.623,29,4.424,17881.509,341.862,10.43,0.706,0
113,6,0,18,0,1,13,205,90.74,6871287,3.623,29,4.424,17881.509,341.862,10.43,0.706,0
113,7,0,18,0,1,27,232,90.74,6871287,3.623,29,4.424,17881.509,341.862,10.43,0.706,0
113,8,1,19,0,1,19,251,88.89,6871287,3.623,29,4.424,17881.509,341.862,10.43,0.706,0
113,9,2,21,0,1,116,367,88.89,6871287,3.623,29,4.424,17881.509,341.862,10.43,0.706,0
113,10,3,24,0,1,15,382,88.89,6871287,3.623,29,4.424,17881.509,341.862,10.43,0.706,0
113,11,0,24,0,1,16,398,88.89,6871287,3.623,29,4.424,17881.509,341.862,10.43,0.706,0
113,12,1,25,0,1,11,409,88.89,6871287,3.623,29,4.424,17881.509,341.862,10.43,0.706,0
113,13,0,25,0,1,9,418,88.89,6871287,3.623,29,4.424,17881.509,341.862,10.43,0.706,0
113,14,1,26,0,1,16,434,88.89,6871287,3.623,29,4.424,17881.509,341.862,10.43,0.706,0
113,15,9,35,0,1,49,483,88.89,6871287,3.623,29,4.424,17881.509,341.862,10.43,0.706,0
113,16,13,48,0,1,64,547,96.3,6871287,3.623,29,4.424,17881.509,341.862,10.43,0.706,0
113,17,1,49,0,1,64,611,100,6871287,3.623,29,4.424,17881.509,341.862,10.43,0.706,0
113,18,0,49,0,1,8,619,100,6871287,3.623,29,4.424,17881.509,341.862,10.43,0.706,0
113,19,0,49,0,1,25,644,100,6871287,3.623,29,4.424,17881.509,341.862,10.43,0.706,0
113,20,0,49,0,1,58,702,100,6871287,3.623,29,4.424,17881.509,341.862,10.43,0.706,0
113,21,2,51,0,1,83,785,100,6871287,3.623,29,4.424,17881.509,341.862,10.43,0.706,0
113,22,0,51,0,1,97,882,100,6871287,3.623,29,4.424,17881.509,341.862,10.43,0.706,0
113,23,8,59,0,1,156,1038,100,6871287,3.623,29,4.424,17881.509,341.862,10.43,0.706,0
113,24,1,60,1,2,82,1120,100,6871287,3.623,29,4.424,17881.509,341.862,10.43,0.706,0
113,25,1,61,0,2,42,1162,100,6871287,3.623,29,4.424,17881.509,341.862,10.43,0.706,0
113,26,0,61,0,2,162,1324,100,6871287,3.623,29,4.424,17881.509,341.862,10.43,0.706,0
113,27,0,61,0,2,82,1406,100,6871287,3.623,29,4.424,17881.509,341.862,10.43,0.706,0
113,28,0,61,0,2,97,1503,100,6871287,3.623,29,4.424,17881.509,341.862,10.43,0.706,0
113,29,0,61,0,2,55,1558,100,6871287,3.623,29,4.424,17881.509,341.862,10.43,0.706,0
113,30,0,61,0,2,92,1650,100,6871287,3.623,29,4.424,17881.509,341.862,10.43,0.706,0
113,31,0,61,1,3,148,1798,100,6871287,3.623,29,4.424,17881.509,341.862,10.43,0.706,0
113,32,2,63,0,3,58,1856,100,6871287,3.623,29,4.424,17881.509,341.862,10.43,0.706,0
113,33,0,63,0,3,47,1903,100,6871287,3.623,29,4.424,17881.509,341.862,10.43,0.706,0
113,34,0,63,0,3,136,2039,100,6871287,3.623,29,4.424,17881.509,341.862,10.43,0.706,0
113,35,0,63,0,3,168,2207,100,6871287,3.623,29,4.424,17881.509,341.862,10.43,0.706,0
113,36,0,63,0,3,254,2461,100,6871287,3.623,29,4.424,17881.509,341.862,10.43,0.706,0
113,37,1,64,0,3,68,2529,100,6871287,3.623,29,4.424,17881.509,341.862,10.43,0.706,0
113,38,0,64,0,3,144,2673,100,6871287,3.623,29,4.424,17881.509,341.862,10.43,0.706,0
113,39,0,64,0,3,121,2794,100,6871287,3.623,29,4.424,17881.509,341.862,10.43,0.706,0
113,40,0,64,0,3,77,2871,100,6871287,3.623,29,4.424,17881.509,341.862,10.43,0.706,0
113,41,0,64,0,3,83,2954,100,6871287,3.623,29,4.424,17881.509,341.862,10.43,0.706,0
113,42,0,64,0,3,100,3054,100,6871287,3.623,29,4.424,17881.509,341.862,10.43,0.706,0
113,43,0,64,0,3,120,3174,100,6871287,3.623,29,4.424,17881.509,341.862,10.43,0.706,0
113,44,0,64,0,3,56,3230,100,6871287,3.623,29,4.424,17881.509,341.862,10.43,0.706,0
113,45,0,64,0,3,95,3325,100,6871287,3.623,29,4.424,17881.509,341.862,10.43,0.706,0
113,46,0,64,0,3,56,3381,100,6871287,3.623,29,4.424,17881.509,341.862,10.43,0.706,0
113,47,1,65,0,3,43,3424,100,6871287,3.623,29,4.424,17881.509,341.862,10.43,0.706,0
113,48,0,65,0,3,178,3602,100,6871287,3.623,29,4.424,17881.509,341.862,10.43,0.706,0
113,49,0,65,0,3,200,3802,100,6871287,3.623,29,4.424,17881.509,341.862,10.43,0.706,0
113,50,3,68,0,3,241,4043,100,6871287,3.623,29,4.424,17881.509,341.862,10.43,0.706,0
113,51,1,69,0,3,326,4369,100,6871287,3.623,29,4.424,17881.509,341.862,10.43,0.706,0
113,52,2,71,0,3,238,4607,100,6871287,3.623,29,4.424,17881.509,341.862,10.43,0.706,0
113,53,1,72,0,3,152,4759,100,6871287,3.623,29,4.424,17881.509,341.862,10.43,0.706,0
113,54,3,75,0,3,413,5172,100,6871287,3.623,29,4.424,17881.509,341.862,10.43,0.706,0
113,55,0,75,0,3,123,5295,100,6871287,3.623,29,4.424,17881.509,341.862,10.43,0.706,0
113,56,0,75,0,3,66,5361,100,6871287,3.623,29,4.424,17881.509,341.862,10.43,0.706,0
113,57,2,77,0,3,333,5694,100,6871287,3.623,29,4.424,17881.509,341.862,10.43,0.706,0
113,58,22,99,1,4,269,5963,96.3,6871287,3.623,29,4.424,17881.509,341.862,10.43,0.706,0
113,59,6,105,1,5,423,6386,96.3,6871287,3.623,29,4.424,17881.509,341.862,10.43,0.706,0
113,60,13,118,0,5,322,6708,96.3,6871287,3.623,29,4.424,17881.509,341.862,10.43,0.706,0
113,61,12,130,0,5,475,7183,96.3,6871287,3.623,29,4.424,17881.509,341.862,10.43,0.706,0
113,62,26,156,0,5,658,7841,96.3,6871287,3.623,29,4.424,17881.509,341.862,10.43,0.706,0
113,63,12,168,0,5,504,8345,96.3,6871287,3.623,29,4.424,17881.509,341.862,10.43,0.706,0
113,64,14,182,0,5,612,8957,96.3,6871287,3.623,29,4.424,17881.509,341.862,10.43,0.706,0
113,65,14,196,0,5,648,9605,96.3,6871287,3.623,29,4.424,17881.509,341.862,10.43,0.706,0
113,66,0,196,0,5,635,10240,96.3,6871287,3.623,29,4.424,17881.509,341.862,10.43,0.706,0
113,67,43,239,0,5,396,10636,96.3,6871287,3.623,29,4.424,17881.509,341.862,10.43,0.706,0
113,68,17,256,0,5,370,11006,96.3,6871287,3.623,29,4.424,17881.509,341.862,10.43,0.706,0
113,69,0,256,0,5,887,11893,96.3,6871287,3.623,29,4.424,17881.509,341.862,10.43,0.706,0
113,70,14,270,0,5,540,12433,96.3,6871287,3.623,29,4.424,17881.509,341.862,10.43,0.706,0
113,71,62,332,0,5,683,13116,96.3,6871287,3.623,29,4.424,17881.509,341.862,10.43,0.706,0
113,72,46,378,0,5,1140,14256,96.3,6871287,3.623,29,4.424,17881.509,341.862,10.43,0.706,0
113,73,15,393,0,5,687,14943,96.3,6871287,3.623,29,4.424,17881.509,341.862,10.43,0.706,0
113,74,16,409,1,6,830,15773,96.3,6871287,3.623,29,4.424,17881.509,341.862,10.43,0.706,0
113,75,9,418,2,8,1107,16880,96.3,6871287,3.623,29,4.424,17881.509,341.862,10.43,0.706,0
113,76,0,418,0,8,671,17551,96.3,6871287,3.623,29,4.424,17881.509,341.862,10.43,0.706,0
113,77,49,467,2,10,1038,18589,96.3,6871287,3.623,29,4.424,17881.509,341.862,10.43,0.706,0
113,78,0,467,0,10,571,19160,96.3,6871287,3.623,29,4.424,17881.509,341.862,10.43,0.706,0
113,79,0,467,0,10,1358,20518,96.3,6871287,3.623,29,4.424,17881.509,341.862,10.43,0.706,0
113,80,33,500,0,10,825,21343,96.3,6871287,3.623,29,4.424,17881.509,341.862,10.43,0.706,0
113,81,10,510,0,10,974,22317,96.3,6871287,3.623,29,4.424,17881.509,341.862,10.43,0.706,0
113,82,10,520,0,10,704,23021,96.3,6871287,3.623,29,4.424,17881.509,341.862,10.43,0.706,0
113,83,24,544,0,10,1055,24076,96.3,6871287,3.623,29,4.424,17881.509,341.862,10.43,0.706,0
113,84,27,571,0,10,775,24851,96.3,6871287,3.623,29,4.424,17881.509,341.862,10.43,0.706,0
113,85,68,639,7,17,1005,25856,96.3,6871287,3.623,29,4.424,17881.509,341.862,10.43,0.706,0
113,86,0,639,1,18,786,26642,96.3,6871287,3.623,29,4.424,17881.509,341.862,10.43,0.706,0
113,87,59,698,0,18,476,27118,96.3,6871287,3.623,29,4.424,17881.509,341.862,10.43,0.706,0
113,88,0,698,0,18,1062,28180,94.44,6871287,3.623,29,4.424,17881.509,341.862,10.43,0.706,0
113,89,15,713,0,18,922,29102,94.44,6871287,3.623,29,4.424,17881.509,341.862,10.43,0.706,0
113,90,49,762,3,21,704,29806,94.44,6871287,3.623,29,4.424,17881.509,341.862,10.43,0.706,0
113,91,0,762,0,21,480,30286,94.44,6871287,3.623,29,4.424,17881.509,341.862,10.43,0.706,0
113,92,62,824,3,24,788,31074,94.44,6871287,3.623,29,4.424,17881.509,341.862,10.43,0.706,0
113,93,34,858,0,24,787,31861,94.44,6871287,3.623,29,4.424,17881.509,341.862,10.43,0.706,0
113,94,33,891,2,26,452,32313,94.44,6871287,3.623,29,4.424,17881.509,341.862,10.43,0.706,0
113,95,27,918,1,27,497,32810,94.44,6871287,3.623,29,4.424,17881.509,341.862,10.43,0.706,0
113,96,71,989,0,27,632,33442,94.44,6871287,3.623,29,4.424,17881.509,341.862,10.43,0.706,0
113,97,0,989,0,27,672,34114,94.44,6871287,3.623,29,4.424,17881.509,341.862,10.43,0.706,0
113,98,57,1046,5,32,625,34739,90.74,6871287,3.623,29,4.424,17881.509,341.862,10.43,0.706,0
113,99,136,1182,3,35,1205,35944,90.74,6871287,3.623,29,4.424,17881.509,341.862,10.43,0.706,0
113,100,0,1182,0,35,764,36708,90.74,6871287,3.623,29,4.424,17881.509,341.862,10.43,0.706,0
113,101,86,1268,1,36,629,37337,90.74,6871287,3.623,29,4.424,17881.509,341.862,10.43,0.706,0
113,102,74,1342,2,38,1244,38581,90.74,6871287,3.623,29,4.424,17881.509,341.862,10.43,0.706,0
113,103,47,1389,0,38,1232,39813,90.74,6871287,3.623,29,4.424,17881.509,341.862,10.43,0.706,0
113,104,44,1433,1,39,829,40642,90.74,6871287,3.623,29,4.424,17881.509,341.862,10.43,0.706,0
113,105,79,1512,1,40,0,40642,90.74,6871287,3.623,29,4.424,17881.509,341.862,10.43,0.706,0
113,106,51,1563,2,42,952,41594,90.74,6871287,3.623,29,4.424,17881.509,341.862,10.43,0.706,0
113,107,26,1589,1,43,0,41594,90.74,6871287,3.623,29,4.424,17881.509,341.862,10.43,0.706,0
113,108,63,1652,3,46,1184,42778,90.74,6871287,3.623,29,4.424,17881.509,341.862,10.43,0.706,0
113,109,52,1704,1,47,936,43714,90.74,6871287,3.623,29,4.424,17881.509,341.862,10.43,0.706,0
113,110,87,1791,1,48,914,44628,90.74,6871287,3.623,29,4.424,17881.509,341.862,10.43,0.706,0
113,111,75,1866,0,48,1179,45807,90.74,6871287,3.623,29,4.424,17881.509,341.862,10.43,0.706,0
113,112,94,1960,1,49,1117,46924,90.74,6871287,3.623,29,4.424,17881.509,341.862,10.43,0.706,0
113,113,128,2088,1,50,1732,48656,90.74,6871287,3.623,29,4.424,17881.509,341.862,10.43,0.706,0
113,114,88,2176,3,53,1304,49960,90.74,6871287,3.623,29,4.424,17881.509,341.862,10.43,0.706,0
113,115,138,2314,3,56,1473,51433,90.74,6871287,3.623,29,4.424,17881.509,341.862,10.43,0.706,0
113,116,111,2425,1,57,1074,52507,90.74,6871287,3.623,29,4.424,17881.509,341.862,10.43,0.706,0
113,117,122,2547,1,58,1908,54415,90.74,6871287,3.623,29,4.424,17881.509,341.862,10.43,0.706,0
113,118,0,2547,0,58,1931,56346,87.96,6871287,3.623,29,4.424,17881.509,341.862,10.43,0.706,0
113,119,280,2827,6,64,1859,58205,87.96,6871287,3.623,29,4.424,17881.509,341.862,10.43,0.706,0
113,120,0,2827,0,64,1253,59458,87.96,6871287,3.623,29,4.424,17881.509,341.862,10.43,0.706,0
113,121,190,3017,3,67,933,60391,87.96,6871287,3.623,29,4.424,17881.509,341.862,10.43,0.706,0
113,122,205,3222,4,71,1152,61543,87.96,6871287,3.623,29,4.424,17881.509,341.862,10.43,0.706,0
113,123,0,3222,0,71,929,62472,87.96,6871287,3.623,29,4.424,17881.509,341.862,10.43,0.706,0
113,124,399,3621,3,74,907,63379,87.96,6871287,3.623,29,4.424,17881.509,341.862,10.43,0.706,0
113,125,70,3691,6,80,1157,64536,87.96,6871287,3.623,29,4.424,17881.509,341.862,10.43,0.706,0
113,126,372,4063,13,93,1090,65626,87.96,6871287,3.623,29,4.424,17881.509,341.862,10.43,0.706,0
113,127,0,4063,0,93,1618,67244,87.96,6871287,3.623,29,4.424,17881.509,341.862,10.43,0.706,0
113,128,161,4224,3,96,2144,69388,87.96,6871287,3.623,29,4.424,17881.509,341.862,10.43,0.706,0
113,129,251,4475,3,99,1373,70761,87.96,6871287,3.623,29,4.424,17881.509,341.862,10.43,0.706,0
113,130,604,5079,9,108,1003,71764,87.96,6871287,3.623,29,4.424,17881.509,341.862,10.43,0.706,0
113,131,0,5079,0,108,1155,72919,87.96,6871287,3.623,29,4.424,17881.509,341.862,10.43,0.706,0
113,132,153,5232,5,113,2345,75264,87.96,6871287,3.623,29,4.424,17881.509,341.862,10.43,0.706,0
113,133,309,5541,7,120,2626,77890,87.96,6871287,3.623,29,4.424,17881.509,341.862,10.43,0.706,0
113,134,388,5929,5,125,2672,80562,87.96,6871287,3.623,29,4.424,17881.509,341.862,10.43,0.706,0
113,135,373,6302,7,132,2338,82900,87.96,6871287,3.623,29,4.424,17881.509,341.862,10.43,0.706,0
113,136,748,7050,3,135,2601,85501,87.96,6871287,3.623,29,4.424,17881.509,341.862,10.43,0.706,0
113,137,277,7327,4,139,3210,88711,87.96,6871287,3.623,29,4.424,17881.509,341.862,10.43,0.706,0
113,138,411,7738,6,145,2923,91634,87.96,6871287,3.623,29,4.424,17881.509,341.862,10.43,0.706,0
113,139,0,7738,0,145,2995,94629,87.96,6871287,3.623,29,4.424,17881.509,341.862,10.43,0.706,0
113,140,841,8579,12,157,3432,98061,87.96,6871287,3.623,29,4.424,17881.509,341.862,10.43,0.706,0
113,141,0,8579,0,157,3002,101063,87.96,6871287,3.623,29,4.424,17881.509,341.862,10.43,0.706,0
113,142,489,9068,7,164,2797,103860,87.96,6871287,3.623,29,4.424,17881.509,341.862,10.43,0.706,0
113,143,395,9463,5,169,2562,106422,87.96,6871287,3.623,29,4.424,17881.509,341.862,10.43,0.706,0
113,144,244,9707,4,173,2340,108762,87.96,6871287,3.623,29,4.424,17881.509,341.862,10.43,0.706,0
113,145,414,10121,7,180,2673,111435,87.96,6871287,3.623,29,4.424,17881.509,341.862,10.43,0.706,0
113,146,316,10437,8,188,2388,113823,87.96,6871287,3.623,29,4.424,17881.509,341.862,10.43,0.706,0
113,147,572,11009,11,199,2647,116470,87.96,6871287,3.623,29,4.424,17881.509,341.862,10.43,0.706,0
113,148,272,11281,4,203,2451,118921,89.81,6871287,3.623,29,4.424,17881.509,341.862,10.43,0.706,0
113,149,553,11834,7,210,3114,122035,89.81,6871287,3.623,29,4.424,17881.509,341.862,10.43,0.706,0
113,150,440,12274,9,219,1481,123516,89.81,6871287,3.623,29,4.424,17881.509,341.862,10.43,0.706,0
113,151,355,12629,7,226,2241,125757,89.81,6871287,3.623,29,4.424,17881.509,341.862,10.43,0.706,0
113,152,329,12958,5,231,2991,128748,89.81,6871287,3.623,29,4.424,17881.509,341.862,10.43,0.706,0
113,153,465,13423,1,232,2878,131626,89.81,6871287,3.623,29,4.424,17881.509,341.862,10.43,0.706,0
113,154,543,13966,5,237,3255,134881,86.11,6871287,3.623,29,4.424,17881.509,341.862,10.43,0.706,0
113,155,658,14624,5,242,3606,138487,86.11,6871287,3.623,29,4.424,17881.509,341.862,10.43,0.706,0
113,156,532,15156,8,250,3812,142299,86.11,6871287,3.623,29,4.424,17881.509,341.862,10.43,0.706,0
113,157,617,15773,4,254,3382,145681,86.11,6871287,3.623,29,4.424,17881.509,341.862,10.43,0.706,0
113,158,672,16445,8,262,2756,148437,86.11,6871287,3.623,29,4.424,17881.509,341.862,10.43,0.706,0
113,159,649,17094,10,272,4291,152728,86.11,6871287,3.623,29,4.424,17881.509,341.862,10.43,0.706,0
113,160,655,17749,13,285,3816,156544,86.11,6871287,3.623,29,4.424,17881.509,341.862,10.43,0.706,0
113,161,1084,18833,11,296,3918,160462,86.11,6871287,3.623,29,4.424,17881.509,341.862,10.43,0.706,0
113,162,750,19583,18,314,2695,163157,86.11,6871287,3.623,29,4.424,17881.509,341.862,10.43,0.706,0
113,163,879,20462,10,324,4009,167166,86.11,6871287,3.623,29,4.424,17881.509,341.862,10.43,0.706,0
113,164,477,20939,15,339,1999,169165,86.11,6871287,3.623,29,4.424,17881.509,341.862,10.43,0.706,0
113,165,969,21908,13,352,2725,171890,86.11,6871287,3.623,29,4.424,17881.509,341.862,10.43,0.706,0
113,166,440,22348,2,354,3494,175384,86.11,6871287,3.623,29,4.424,17881.509,341.862,10.43,0.706,0
113,167,433,22781,8,362,3137,178521,86.11,6871287,3.623,29,4.424,17881.509,341.862,10.43,0.706,0
113,168,734,23515,6,368,5087,183608,86.11,6871287,3.623,29,4.424,17881.509,341.862,10.43,0.706,0
113,169,629,24144,15,383,3971,187579,86.11,6871287,3.623,29,4.424,17881.509,341.862,10.43,0.706,0
113,170,792,24936,11,394,3217,190796,86.11,6871287,3.623,29,4.424,17881.509,341.862,10.43,0.706,0
113,171,886,25822,15,409,3318,194114,86.11,6871287,3.623,29,4.424,17881.509,341.862,10.43,0.706,0
113,172,616,26438,13,422,3461,197575,86.11,6871287,3.623,29,4.424,17881.509,341.862,10.43,0.706,0
113,173,796,27234,8,430,0,197575,86.11,6871287,3.623,29,4.424,17881.509,341.862,10.43,0.706,0
113,174,715,27949,8,438,0,197575,86.11,6871287,3.623,29,4.424,17881.509,341.862,10.43,0.706,0
113,175,847,28796,16,454,0,197575,86.11,6871287,3.623,29,4.424,17881.509,341.862,10.43,0.706,0
113,176,650,29446,10,464,0,197575,86.11,6871287,3.623,29,4.424,17881.509,341.862,10.43,0.706,0
113,177,651,30097,9,473,0,197575,86.11,6871287,3.623,29,4.424,17881.509,341.862,10.43,0.706,0
113,178,535,30632,1,474,0,197575,86.11,6871287,3.623,29,4.424,17881.509,341.862,10.43,0.706,0
113,179,658,31290,17,491,0,197575,86.11,6871287,3.623,29,4.424,17881.509,341.862,10.43,0.706,0
113,180,538,31828,8,499,0,197575,86.11,6871287,3.623,29,4.424,17881.509,341.862,10.43,0.706,0
113,181,536,32364,21,520,0,197575,86.11,6871287,3.623,29,4.424,17881.509,341.862,10.43,0.706,0
113,182,849,33213,7,527,0,197575,86.11,6871287,3.623,29,4.424,17881.509,341.862,10.43,0.706,0
113,183,801,34014,13,540,0,197575,86.11,6871287,3.623,29,4.424,17881.509,341.862,10.43,0.706,0
113,184,511,34525,11,551,0,197575,86.11,6871287,3.623,29,4.424,17881.509,341.862,10.43,0.706,0
113,185,683,35208,8,559,0,197575,86.11,6871287,3.623,29,4.424,17881.509,341.862,10.43,0.706,0
113,186,509,35717,11,570,0,197575,86.11,6871287,3.623,29,4.424,17881.509,341.862,10.43,0.706,0
113,187,370,36087,8,578,0,197575,85.19,6871287,3.623,29,4.424,17881.509,341.862,10.43,0.706,0
113,188,722,36809,14,592,0,197575,85.19,6871287,3.623,29,4.424,17881.509,341.862,10.43,0.706,0
113,189,628,37437,4,596,0,197575,85.19,6871287,3.623,29,4.424,17881.509,341.862,10.43,0.706,0
113,190,1031,38468,6,602,0,197575,85.19,6871287,3.623,29,4.424,17881.509,341.862,10.43,0.706,0
113,191,1045,39513,6,608,0,197575,83.33,6871287,3.623,29,4.424,17881.509,341.862,10.43,0.706,0
113,192,779,40292,8,616,0,197575,83.33,6871287,3.623,29,4.424,17881.509,341.862,10.43,0.706,0
113,193,1076,41368,5,621,0,197575,83.33,6871287,3.623,29,4.424,17881.509,341.862,10.43,0.706,0
113,194,318,41686,2,623,0,197575,80.56,6871287,3.623,29,4.424,17881.509,341.862,10.43,0.706,0
113,195,1026,42712,8,631,0,197575,80.56,6871287,3.623,29,4.424,17881.509,341.862,10.43,0.706,0
113,196,1109,43821,13,644,0,197575,80.56,6871287,3.623,29,4.424,17881.509,341.862,10.43,0.706,0
113,197,1164,44985,12,656,0,197575,80.56,6871287,3.623,29,4.424,17881.509,341.862,10.43,0.706,0
113,198,836,45821,13,669,0,197575,80.56,6871287,3.623,29,4.424,17881.509,341.862,10.43,0.706,0
113,199,855,46676,12,681,0,197575,80.56,6871287,3.623,29,4.424,17881.509,341.862,10.43,0.706,0
113,200,1169,47845,18,699,0,197575,80.56,6871287,3.623,29,4.424,17881.509,341.862,10.43,0.706,0
113,201,0,47845,0,699,0,197575,80.56,6871287,3.623,29,4.424,17881.509,341.862,10.43,0.706,0
113,202,945,48790,26,725,0,197575,80.56,6871287,3.623,29,4.424,17881.509,341.862,10.43,0.706,0
113,203,1159,49949,7,732,0,197575,80.56,6871287,3.623,29,4.424,17881.509,341.862,10.43,0.706,0
113,204,957,50906,14,746,0,197575,80.56,6871287,3.623,29,4.424,17881.509,341.862,10.43,0.706,0
115,1,49,533,0,7,0,12574,81.48,2722291,45.135,43.5,19.002,29524.265,342.989,3.67,0.858,0
115,2,48,581,1,8,3049,15623,81.48,2722291,45.135,43.5,19.002,29524.265,342.989,3.67,0.858,0
115,3,68,649,1,9,2809,18432,81.48,2722291,45.135,43.5,19.002,29524.265,342.989,3.67,0.858,0
115,4,122,771,0,9,2944,21376,81.48,2722291,45.135,43.5,19.002,29524.265,342.989,3.67,0.858,0
115,5,0,771,0,9,2269,23645,81.48,2722291,45.135,43.5,19.002,29524.265,342.989,3.67,0.858,0
115,6,40,811,4,13,1954,25599,81.48,2722291,45.135,43.5,19.002,29524.265,342.989,3.67,0.858,0
115,7,32,843,1,14,2208,27807,81.48,2722291,45.135,43.5,19.002,29524.265,342.989,3.67,0.858,0
115,8,37,880,1,15,0,27807,81.48,2722291,45.135,43.5,19.002,29524.265,342.989,3.67,0.858,0
115,9,32,912,0,15,0,32809,81.48,2722291,45.135,43.5,19.002,29524.265,342.989,3.67,0.858,0
115,10,43,955,0,15,3242,36051,87.04,2722291,45.135,43.5,19.002,29524.265,342.989,3.67,0.858,0
115,11,44,999,2,17,2421,38472,87.04,2722291,45.135,43.5,19.002,29524.265,342.989,3.67,0.858,0
115,12,54,1053,6,23,0,38472,87.04,2722291,45.135,43.5,19.002,29524.265,342.989,3.67,0.858,0
115,13,9,1062,1,24,0,41503,87.04,2722291,45.135,43.5,19.002,29524.265,342.989,3.67,0.858,0
115,14,8,1070,0,24,1187,42690,81.48,2722291,45.135,43.5,19.002,29524.265,342.989,3.67,0.858,0
115,15,0,1070,0,24,1987,44677,81.48,2722291,45.135,43.5,19.002,29524.265,342.989,3.67,0.858,0
115,16,21,1091,5,29,3860,48537,81.48,2722291,45.135,43.5,19.002,29524.265,342.989,3.67,0.858,0
115,17,58,1149,3,32,4564,53101,81.48,2722291,45.135,43.5,19.002,29524.265,342.989,3.67,0.858,0
115,18,90,1239,1,33,5715,58816,81.48,2722291,45.135,43.5,19.002,29524.265,342.989,3.67,0.858,0
115,19,59,1298,0,33,5219,64035,81.48,2722291,45.135,43.5,19.002,29524.265,342.989,3.67,0.858,0
115,20,28,1326,3,36,2317,66352,81.48,2722291,45.135,43.5,19.002,29524.265,342.989,3.67,0.858,0
115,21,24,1350,1,37,4401,70753,81.48,2722291,45.135,43.5,19.002,29524.265,342.989,3.67,0.858,0
115,22,20,1370,1,38,6040,76793,81.48,2722291,45.135,43.5,19.002,29524.265,342.989,3.67,0.858,0
115,23,28,1398,0,38,6798,83591,81.48,2722291,45.135,43.5,19.002,29524.265,342.989,3.67,0.858,0
115,24,12,1410,2,40,7401,90992,81.48,2722291,45.135,43.5,19.002,29524.265,342.989,3.67,0.858,0
115,25,0,1410,0,40,7956,98948,81.48,2722291,45.135,43.5,19.002,29524.265,342.989,3.67,0.858,0
115,26,16,1426,1,41,5540,104488,81.48,2722291,45.135,43.5,19.002,29524.265,342.989,3.67,0.858,0
115,27,12,1438,0,41,2287,106775,77.78,2722291,45.135,43.5,19.002,29524.265,342.989,3.67,0.858,0
115,28,11,1449,0,41,5034,111809,77.78,2722291,45.135,43.5,19.002,29524.265,342.989,3.67,0.858,0
115,29,-105,1344,3,44,6392,118201,77.78,2722291,45.135,43.5,19.002,29524.265,342.989,3.67,0.858,0
115,30,31,1375,1,45,7354,125555,77.78,2722291,45.135,43.5,19.002,29524.265,342.989,3.67,0.858,0
115,31,10,1385,0,45,7213,132768,77.78,2722291,45.135,43.5,19.002,29524.265,342.989,3.67,0.858,0
115,32,14,1399,0,45,5502,138270,77.78,2722291,45.135,43.5,19.002,29524.265,342.989,3.67,0.858,0
115,33,7,1406,1,46,3408,141678,77.78,2722291,45.135,43.5,19.002,29524.265,342.989,3.67,0.858,0
115,34,4,1410,0,46,2351,144029,77.78,2722291,45.135,43.5,19.002,29524.265,342.989,3.67,0.858,0
115,35,9,1419,0,46,5077,149106,77.78,2722291,45.135,43.5,19.002,29524.265,342.989,3.67,0.858,0
115,36,4,1423,0,46,7387,156493,77.78,2722291,45.135,43.5,19.002,29524.265,342.989,3.67,0.858,0
115,37,5,1428,2,48,7595,164088,77.78,2722291,45.135,43.5,19.002,29524.265,342.989,3.67,0.858,0
115,38,5,1433,1,49,8103,172191,77.78,2722291,45.135,43.5,19.002,29524.265,342.989,3.67,0.858,0
115,39,3,1436,0,49,8141,180332,77.78,2722291,45.135,43.5,19.002,29524.265,342.989,3.67,0.858,0
115,40,8,1444,1,50,3581,183913,77.78,2722291,45.135,43.5,19.002,29524.265,342.989,3.67,0.858,0
115,41,35,1479,0,50,2652,186565,75,2722291,45.135,43.5,19.002,29524.265,342.989,3.67,0.858,0
115,42,6,1485,0,50,5821,192386,75,2722291,45.135,43.5,19.002,29524.265,342.989,3.67,0.858,0
115,43,6,1491,0,50,7878,200264,75,2722291,45.135,43.5,19.002,29524.265,342.989,3.67,0.858,0
115,44,14,1505,4,54,7989,208253,75,2722291,45.135,43.5,19.002,29524.265,342.989,3.67,0.858,0
115,45,6,1511,0,54,7994,216247,75,2722291,45.135,43.5,19.002,29524.265,342.989,3.67,0.858,0
115,46,12,1523,0,54,7793,224040,75,2722291,45.135,43.5,19.002,29524.265,342.989,3.67,0.858,0
115,47,11,1534,1,55,4686,228726,75,2722291,45.135,43.5,19.002,29524.265,342.989,3.67,0.858,0
115,48,7,1541,1,56,0,228726,71.3,2722291,45.135,43.5,19.002,29524.265,342.989,3.67,0.858,0
115,49,6,1547,3,59,0,237600,71.3,2722291,45.135,43.5,19.002,29524.265,342.989,3.67,0.858,0
115,50,15,1562,1,60,7980,245580,71.3,2722291,45.135,43.5,19.002,29524.265,342.989,3.67,0.858,0
115,51,15,1577,0,60,0,245580,71.3,2722291,45.135,43.5,19.002,29524.265,342.989,3.67,0.858,0
115,52,17,1594,1,61,0,259043,71.3,2722291,45.135,43.5,19.002,29524.265,342.989,3.67,0.858,0
115,53,10,1604,0,61,5839,264882,71.3,2722291,45.135,43.5,19.002,29524.265,342.989,3.67,0.858,0
115,54,12,1616,2,63,0,264882,71.3,2722291,45.135,43.5,19.002,29524.265,342.989,3.67,0.858,0
115,55,7,1623,0,63,0,269889,71.3,2722291,45.135,43.5,19.002,29524.265,342.989,3.67,0.858,0
115,56,12,1635,0,63,5169,275058,71.3,2722291,45.135,43.5,19.002,29524.265,342.989,3.67,0.858,0
115,57,4,1639,2,65,6174,281232,71.3,2722291,45.135,43.5,19.002,29524.265,342.989,3.67,0.858,0
115,58,8,1647,1,66,6750,287982,71.3,2722291,45.135,43.5,19.002,29524.265,342.989,3.67,0.858,0
115,59,9,1656,2,68,6109,294091,71.3,2722291,45.135,43.5,19.002,29524.265,342.989,3.67,0.858,0
115,60,6,1662,0,68,0,294091,63.89,2722291,45.135,43.5,19.002,29524.265,342.989,3.67,0.858,0
115,61,8,1670,2,70,0,302859,63.89,2722291,45.135,43.5,19.002,29524.265,342.989,3.67,0.858,0
115,62,5,1675,0,70,1995,304854,52.78,2722291,45.135,43.5,19.002,29524.265,342.989,3.67,0.858,0
115,63,3,1678,0,70,4871,309725,52.78,2722291,45.135,43.5,19.002,29524.265,342.989,3.67,0.858,0
115,64,4,1682,1,71,5387,315112,52.78,2722291,45.135,43.5,19.002,29524.265,342.989,3.67,0.858,0
115,65,2,1684,0,71,5928,321040,52.78,2722291,45.135,43.5,19.002,29524.265,342.989,3.67,0.858,0
115,66,3,1687,0,71,5254,326294,52.78,2722291,45.135,43.5,19.002,29524.265,342.989,3.67,0.858,0
115,67,7,1694,0,71,0,326294,52.78,2722291,45.135,43.5,19.002,29524.265,342.989,3.67,0.858,0
115,68,11,1705,0,71,0,326294,52.78,2722291,45.135,43.5,19.002,29524.265,342.989,3.67,0.858,0
115,69,9,1714,0,71,0,335686,52.78,2722291,45.135,43.5,19.002,29524.265,342.989,3.67,0.858,0
115,70,6,1720,0,71,4387,340073,52.78,2722291,45.135,43.5,19.002,29524.265,342.989,3.67,0.858,0
115,71,7,1727,1,72,5319,345392,52.78,2722291,45.135,43.5,19.002,29524.265,342.989,3.67,0.858,0
115,72,6,1733,2,74,5396,350788,52.78,2722291,45.135,43.5,19.002,29524.265,342.989,3.67,0.858,0
115,73,19,1752,0,74,5274,356062,52.78,2722291,45.135,43.5,19.002,29524.265,342.989,3.67,0.858,0
115,74,4,1756,0,74,4608,360670,52.78,2722291,45.135,43.5,19.002,29524.265,342.989,3.67,0.858,0
115,75,7,1763,1,75,2858,363528,52.78,2722291,45.135,43.5,19.002,29524.265,342.989,3.67,0.858,0
115,76,5,1768,0,75,1608,365136,52.78,2722291,45.135,43.5,19.002,29524.265,342.989,3.67,0.858,0
115,77,5,1773,1,76,4410,369546,52.78,2722291,45.135,43.5,19.002,29524.265,342.989,3.67,0.858,0
115,78,3,1776,0,76,6026,375572,30.56,2722291,45.135,43.5,19.002,29524.265,342.989,3.67,0.858,0
115,79,2,1778,0,76,5653,381225,30.56,2722291,45.135,43.5,19.002,29524.265,342.989,3.67,0.858,0
115,80,6,1784,0,76,4969,386194,30.56,2722291,45.135,43.5,19.002,29524.265,342.989,3.67,0.858,0
115,81,8,1792,0,76,4263,390457,30.56,2722291,45.135,43.5,19.002,29524.265,342.989,3.67,0.858,0
115,82,3,1795,0,76,2096,392553,30.56,2722291,45.135,43.5,19.002,29524.265,342.989,3.67,0.858,0
115,83,3,1798,0,76,1912,394465,30.56,2722291,45.135,43.5,19.002,29524.265,342.989,3.67,0.858,0
115,84,3,1801,0,76,3952,398417,30.56,2722291,45.135,43.5,19.002,29524.265,342.989,3.67,0.858,0
115,85,2,1803,1,77,5424,403841,30.56,2722291,45.135,43.5,19.002,29524.265,342.989,3.67,0.858,0
115,86,1,1804,1,78,2716,406557,30.56,2722291,45.135,43.5,19.002,29524.265,342.989,3.67,0.858,0
115,87,2,1806,0,78,4310,410867,30.56,2722291,45.135,43.5,19.002,29524.265,342.989,3.67,0.858,0
115,88,2,1808,0,78,3925,414792,30.56,2722291,45.135,43.5,19.002,29524.265,342.989,3.67,0.858,0
115,89,5,1813,0,78,1947,416739,30.56,2722291,45.135,43.5,19.002,29524.265,342.989,3.67,0.858,0
115,90,3,1816,0,78,1629,418368,27.78,2722291,45.135,43.5,19.002,29524.265,342.989,3.67,0.858,0
115,91,0,1816,0,78,4472,422840,27.78,2722291,45.135,43.5,19.002,29524.265,342.989,3.67,0.858,0
115,92,1,1817,0,78,5398,428238,27.78,2722291,45.135,43.5,19.002,29524.265,342.989,3.67,0.858,0
115,93,1,1818,0,78,4219,432457,27.78,2722291,45.135,43.5,19.002,29524.265,342.989,3.67,0.858,0
115,94,7,1825,0,78,4222,436679,27.78,2722291,45.135,43.5,19.002,29524.265,342.989,3.67,0.858,0
115,95,3,1828,1,79,0,436679,27.78,2722291,45.135,43.5,19.002,29524.265,342.989,3.67,0.858,0
115,96,3,1831,0,79,0,436679,27.78,2722291,45.135,43.5,19.002,29524.265,342.989,3.67,0.858,0
115,97,5,1836,0,79,0,436679,27.78,2722291,45.135,43.5,19.002,29524.265,342.989,3.67,0.858,0
115,98,5,1841,0,79,0,444407,27.78,2722291,45.135,43.5,19.002,29524.265,342.989,3.67,0.858,0
115,99,3,1844,0,79,3587,447994,27.78,2722291,45.135,43.5,19.002,29524.265,342.989,3.67,0.858,0
115,100,10,1854,0,79,3993,451987,27.78,2722291,45.135,43.5,19.002,29524.265,342.989,3.67,0.858,0
115,101,3,1857,0,79,3846,455833,27.78,2722291,45.135,43.5,19.002,29524.265,342.989,3.67,0.858,0
115,102,4,1861,0,79,0,455833,27.78,2722291,45.135,43.5,19.002,29524.265,342.989,3.67,0.858,0
115,103,4,1865,0,79,0,455833,27.78,2722291,45.135,43.5,19.002,29524.265,342.989,3.67,0.858,0
115,104,4,1869,0,79,0,461666,27.78,2722291,45.135,43.5,19.002,29524.265,342.989,3.67,0.858,0
115,105,5,1874,0,79,3730,465396,27.78,2722291,45.135,43.5,19.002,29524.265,342.989,3.67,0.858,0
115,106,1,1875,0,79,0,465396,27.78,2722291,45.135,43.5,19.002,29524.265,342.989,3.67,0.858,0
115,107,7,1882,0,79,0,472804,27.78,2722291,45.135,43.5,19.002,29524.265,342.989,3.67,0.858,0
115,108,20,1902,0,79,3317,476121,27.78,2722291,45.135,43.5,19.002,29524.265,342.989,3.67,0.858,0
115,109,6,1908,0,79,0,476121,27.78,2722291,45.135,43.5,19.002,29524.265,342.989,3.67,0.858,0
115,110,7,1915,1,80,0,476121,27.78,2722291,45.135,43.5,19.002,29524.265,342.989,3.67,0.858,0
115,111,17,1932,0,80,0,482607,27.78,2722291,45.135,43.5,19.002,29524.265,342.989,3.67,0.858,0
115,112,15,1947,0,80,3617,486224,27.78,2722291,45.135,43.5,19.002,29524.265,342.989,3.67,0.858,0
115,113,2,1949,0,80,3645,489869,27.78,2722291,45.135,43.5,19.002,29524.265,342.989,3.67,0.858,0
115,114,11,1960,0,80,3996,493865,27.78,2722291,45.135,43.5,19.002,29524.265,342.989,3.67,0.858,0
115,115,0,1960,0,80,3380,497245,27.78,2722291,45.135,43.5,19.002,29524.265,342.989,3.67,0.858,0
115,116,26,1986,0,80,0,497245,27.78,2722291,45.135,43.5,19.002,29524.265,342.989,3.67,0.858,0
115,117,15,2001,0,80,0,497245,27.78,2722291,45.135,43.5,19.002,29524.265,342.989,3.67,0.858,0
115,118,7,2008,0,80,0,507420,30.56,2722291,45.135,43.5,19.002,29524.265,342.989,3.67,0.858,0
115,119,11,2019,0,80,4042,511462,30.56,2722291,45.135,43.5,19.002,29524.265,342.989,3.67,0.858,0
115,120,8,2027,0,80,4335,515797,30.56,2722291,45.135,43.5,19.002,29524.265,342.989,3.67,0.858,0
115,121,16,2043,0,80,4132,519929,30.56,2722291,45.135,43.5,19.002,29524.265,342.989,3.67,0.858,0
115,122,19,2062,0,80,0,519929,30.56,2722291,45.135,43.5,19.002,29524.265,342.989,3.67,0.858,0
115,123,13,2075,0,80,0,519929,30.56,2722291,45.135,43.5,19.002,29524.265,342.989,3.67,0.858,0
115,124,18,2093,0,80,0,527729,30.56,2722291,45.135,43.5,19.002,29524.265,342.989,3.67,0.858,0
115,125,17,2110,0,80,3789,531518,30.56,2722291,45.135,43.5,19.002,29524.265,342.989,3.67,0.858,0
115,126,10,2120,0,80,4859,536377,30.56,2722291,45.135,43.5,19.002,29524.265,342.989,3.67,0.858,0
115,127,17,2137,0,80,0,536377,30.56,2722291,45.135,43.5,19.002,29524.265,342.989,3.67,0.858,0
115,128,10,2147,1,81,0,540784,30.56,2722291,45.135,43.5,19.002,29524.265,342.989,3.67,0.858,0
115,129,24,2171,0,81,4578,545362,19.44,2722291,45.135,43.5,19.002,29524.265,342.989,3.67,0.858,0
115,130,23,2194,0,81,0,545362,19.44,2722291,45.135,43.5,19.002,29524.265,342.989,3.67,0.858,0
115,131,37,2231,0,81,0,545362,19.44,2722291,45.135,43.5,19.002,29524.265,342.989,3.67,0.858,0
115,132,21,2252,0,81,0,553388,19.44,2722291,45.135,43.5,19.002,29524.265,342.989,3.67,0.858,0
115,133,13,2265,0,81,0,553388,19.44,2722291,45.135,43.5,19.002,29524.265,342.989,3.67,0.858,0
115,134,18,2283,0,81,0,561555,19.44,2722291,45.135,43.5,19.002,29524.265,342.989,3.67,0.858,0
115,135,26,2309,0,81,4227,565782,19.44,2722291,45.135,43.5,19.002,29524.265,342.989,3.67,0.858,0
115,136,21,2330,0,81,4875,570657,19.44,2722291,45.135,43.5,19.002,29524.265,342.989,3.67,0.858,0
115,137,22,2352,0,81,0,570657,19.44,2722291,45.135,43.5,19.002,29524.265,342.989,3.67,0.858,0
115,138,34,2386,0,81,0,570657,19.44,2722291,45.135,43.5,19.002,29524.265,342.989,3.67,0.858,0
115,139,30,2416,0,81,0,580453,19.44,2722291,45.135,43.5,19.002,29524.265,342.989,3.67,0.858,0
115,140,20,2436,0,81,4188,584641,19.44,2722291,45.135,43.5,19.002,29524.265,342.989,3.67,0.858,0
115,141,38,2474,0,81,4864,589505,19.44,2722291,45.135,43.5,19.002,29524.265,342.989,3.67,0.858,0
115,142,22,2496,0,81,4973,594478,19.44,2722291,45.135,43.5,19.002,29524.265,342.989,3.67,0.858,0
115,143,32,2528,1,82,5035,599513,19.44,2722291,45.135,43.5,19.002,29524.265,342.989,3.67,0.858,0
115,144,36,2564,1,83,0,599513,19.44,2722291,45.135,43.5,19.002,29524.265,342.989,3.67,0.858,0
115,145,30,2594,1,84,0,599513,19.44,2722291,45.135,43.5,19.002,29524.265,342.989,3.67,0.858,0
115,146,41,2635,0,84,0,608767,19.44,2722291,45.135,43.5,19.002,29524.265,342.989,3.67,0.858,0
115,147,38,2673,1,85,4557,613324,19.44,2722291,45.135,43.5,19.002,29524.265,342.989,3.67,0.858,0
115,148,21,2694,0,85,5081,618405,19.44,2722291,45.135,43.5,19.002,29524.265,342.989,3.67,0.858,0
115,149,32,2726,0,85,5436,623841,19.44,2722291,45.135,43.5,19.002,29524.265,342.989,3.67,0.858,0
115,150,36,2762,0,85,5602,629443,19.44,2722291,45.135,43.5,19.002,29524.265,342.989,3.67,0.858,0
115,151,48,2810,1,86,0,629443,19.44,2722291,45.135,43.5,19.002,29524.265,342.989,3.67,0.858,0
115,152,29,2839,0,86,0,629443,19.44,2722291,45.135,43.5,19.002,29524.265,342.989,3.67,0.858,0
115,153,35,2874,0,86,0,639044,19.44,2722291,45.135,43.5,19.002,29524.265,342.989,3.67,0.858,0
115,154,32,2906,0,86,4660,643704,19.44,2722291,45.135,43.5,19.002,29524.265,342.989,3.67,0.858,0
115,155,23,2929,0,86,5159,648863,19.44,2722291,45.135,43.5,19.002,29524.265,342.989,3.67,0.858,0
115,156,29,2958,0,86,4881,653744,19.44,2722291,45.135,43.5,19.002,29524.265,342.989,3.67,0.858,0
115,157,20,2978,0,86,4918,658662,19.44,2722291,45.135,43.5,19.002,29524.265,342.989,3.67,0.858,0
115,158,26,3004,0,86,0,658662,19.44,2722291,45.135,43.5,19.002,29524.265,342.989,3.67,0.858,0
115,159,36,3040,0,86,0,658662,19.44,2722291,45.135,43.5,19.002,29524.265,342.989,3.67,0.858,0
115,160,43,3083,0,86,0,666930,19.44,2722291,45.135,43.5,19.002,29524.265,342.989,3.67,0.858,0
115,161,17,3100,0,86,4367,671297,19.44,2722291,45.135,43.5,19.002,29524.265,342.989,3.67,0.858,0
115,162,31,3131,0,86,5303,676600,19.44,2722291,45.135,43.5,19.002,29524.265,342.989,3.67,0.858,0
115,163,32,3163,0,86,5497,682097,19.44,2722291,45.135,43.5,19.002,29524.265,342.989,3.67,0.858,0
115,164,36,3199,0,86,5021,687118,19.44,2722291,45.135,43.5,19.002,29524.265,342.989,3.67,0.858,0
115,165,44,3243,0,86,0,687118,19.44,2722291,45.135,43.5,19.002,29524.265,342.989,3.67,0.858,0
115,166,53,3296,0,86,0,687118,19.44,2722291,45.135,43.5,19.002,29524.265,342.989,3.67,0.858,0
115,167,39,3335,1,87,0,695521,19.44,2722291,45.135,43.5,19.002,29524.265,342.989,3.67,0.858,0
115,168,51,3386,0,87,4619,700140,19.44,2722291,45.135,43.5,19.002,29524.265,342.989,3.67,0.858,0
115,169,56,3442,0,87,6079,706219,19.44,2722291,45.135,43.5,19.002,29524.265,342.989,3.67,0.858,0
115,170,0,3442,0,87,4889,711108,19.44,2722291,45.135,43.5,19.002,29524.265,342.989,3.67,0.858,0
115,171,62,3504,0,87,5864,716972,19.44,2722291,45.135,43.5,19.002,29524.265,342.989,3.67,0.858,0
115,172,61,3565,0,87,0,716972,19.44,2722291,45.135,43.5,19.002,29524.265,342.989,3.67,0.858,0
115,173,99,3664,0,87,0,716972,19.44,2722291,45.135,43.5,19.002,29524.265,342.989,3.67,0.858,0
115,174,80,3744,0,87,0,726496,19.44,2722291,45.135,43.5,19.002,29524.265,342.989,3.67,0.858,0
115,175,70,3814,0,87,5416,731912,19.44,2722291,45.135,43.5,19.002,29524.265,342.989,3.67,0.858,0
115,176,45,3859,0,87,5649,737561,19.44,2722291,45.135,43.5,19.002,29524.265,342.989,3.67,0.858,0
115,177,73,3932,0,87,6613,744174,19.44,2722291,45.135,43.5,19.002,29524.265,342.989,3.67,0.858,0
115,178,138,4070,2,89,6028,750202,19.44,2722291,45.135,43.5,19.002,29524.265,342.989,3.67,0.858,0
115,179,114,4184,0,89,0,750202,19.44,2722291,45.135,43.5,19.002,29524.265,342.989,3.67,0.858,0
115,180,111,4295,0,89,0,750202,19.44,2722291,45.135,43.5,19.002,29524.265,342.989,3.67,0.858,0
115,181,90,4385,2,91,0,761616,19.44,2722291,45.135,43.5,19.002,29524.265,342.989,3.67,0.858,0
115,182,105,4490,1,92,6378,767994,19.44,2722291,45.135,43.5,19.002,29524.265,342.989,3.67,0.858,0
115,183,88,4578,0,92,6993,774987,19.44,2722291,45.135,43.5,19.002,29524.265,342.989,3.67,0.858,0
115,184,115,4693,0,92,6973,781960,22.22,2722291,45.135,43.5,19.002,29524.265,342.989,3.67,0.858,0
115,185,91,4784,0,92,6424,788384,22.22,2722291,45.135,43.5,19.002,29524.265,342.989,3.67,0.858,0
115,186,172,4956,1,93,0,788384,22.22,2722291,45.135,43.5,19.002,29524.265,342.989,3.67,0.858,0
115,187,125,5081,1,94,0,788384,22.22,2722291,45.135,43.5,19.002,29524.265,342.989,3.67,0.858,0
115,188,104,5185,0,94,0,801362,22.22,2722291,45.135,43.5,19.002,29524.265,342.989,3.67,0.858,0
115,189,100,5285,0,94,6621,807983,22.22,2722291,45.135,43.5,19.002,29524.265,342.989,3.67,0.858,0
115,190,81,5366,5,99,7277,815260,22.22,2722291,45.135,43.5,19.002,29524.265,342.989,3.67,0.858,0
115,191,117,5483,2,101,7915,823175,22.22,2722291,45.135,43.5,19.002,29524.265,342.989,3.67,0.858,0
115,192,142,5625,1,102,7499,830674,48.61,2722291,45.135,43.5,19.002,29524.265,342.989,3.67,0.858,0
115,193,133,5758,1,103,0,830674,48.61,2722291,45.135,43.5,19.002,29524.265,342.989,3.67,0.858,0
115,194,205,5963,0,103,0,830674,48.61,2722291,45.135,43.5,19.002,29524.265,342.989,3.67,0.858,0
115,195,159,6122,0,103,0,844742,48.61,2722291,45.135,43.5,19.002,29524.265,342.989,3.67,0.858,0
115,196,126,6248,0,103,7266,852008,48.61,2722291,45.135,43.5,19.002,29524.265,342.989,3.67,0.858,0
115,197,118,6366,3,106,8139,860147,48.61,2722291,45.135,43.5,19.002,29524.265,342.989,3.67,0.858,0
115,198,139,6505,3,109,8623,868770,48.61,2722291,45.135,43.5,19.002,29524.265,342.989,3.67,0.858,0
115,199,255,6760,1,110,8628,877398,48.61,2722291,45.135,43.5,19.002,29524.265,342.989,3.67,0.858,0
115,200,281,7041,2,112,0,877398,48.61,2722291,45.135,43.5,19.002,29524.265,342.989,3.67,0.858,0
115,201,0,7041,0,112,0,877398,48.61,2722291,45.135,43.5,19.002,29524.265,342.989,3.67,0.858,0
115,202,685,7726,1,113,0,893014,48.61,2722291,45.135,43.5,19.002,29524.265,342.989,3.67,0.858,0
115,203,0,7726,0,113,12915,905929,48.61,2722291,45.135,43.5,19.002,29524.265,342.989,3.67,0.858,0
115,204,513,8239,7,120,0,905929,48.61,2722291,45.135,43.5,19.002,29524.265,342.989,3.67,0.858,0
116,1,190,2178,1,23,1180,17606,79.63,625976,231.447,39.7,14.312,94277.965,128.275,4.42,0.904,0
116,2,141,2319,6,29,1341,18947,79.63,625976,231.447,39.7,14.312,94277.965,128.275,4.42,0.904,0
116,3,168,2487,1,30,1213,20160,79.63,625976,231.447,39.7,14.312,94277.965,128.275,4.42,0.904,0
116,4,125,2612,1,31,824,20984,79.63,625976,231.447,39.7,14.312,94277.965,128.275,4.42,0.904,0
116,5,117,2729,0,31,551,21535,79.63,625976,231.447,39.7,14.312,94277.965,128.275,4.42,0.904,0
116,6,75,2804,5,36,1050,22585,79.63,625976,231.447,39.7,14.312,94277.965,128.275,4.42,0.904,0
116,7,39,2843,5,41,1020,23605,79.63,625976,231.447,39.7,14.312,94277.965,128.275,4.42,0.904,0
116,8,127,2970,3,44,932,24537,79.63,625976,231.447,39.7,14.312,94277.965,128.275,4.42,0.904,0
116,9,64,3034,2,46,863,25400,79.63,625976,231.447,39.7,14.312,94277.965,128.275,4.42,0.904,0
116,10,81,3115,6,52,691,26091,79.63,625976,231.447,39.7,14.312,94277.965,128.275,4.42,0.904,0
116,11,108,3223,2,54,309,26400,79.63,625976,231.447,39.7,14.312,94277.965,128.275,4.42,0.904,0
116,12,47,3270,8,62,208,26608,79.63,625976,231.447,39.7,14.312,94277.965,128.275,4.42,0.904,0
116,13,11,3281,4,66,82,26690,79.63,625976,231.447,39.7,14.312,94277.965,128.275,4.42,0.904,0
116,14,11,3292,1,67,1373,28063,79.63,625976,231.447,39.7,14.312,94277.965,128.275,4.42,0.904,0
116,15,15,3307,0,67,844,28907,79.63,625976,231.447,39.7,14.312,94277.965,128.275,4.42,0.904,0
116,16,66,3373,2,69,958,29865,79.63,625976,231.447,39.7,14.312,94277.965,128.275,4.42,0.904,0
116,17,71,3444,0,69,1032,30897,79.63,625976,231.447,39.7,14.312,94277.965,128.275,4.42,0.904,0
116,18,36,3480,3,72,528,31425,79.63,625976,231.447,39.7,14.312,94277.965,128.275,4.42,0.904,0
116,19,57,3537,0,72,191,31616,79.63,625976,231.447,39.7,14.312,94277.965,128.275,4.42,0.904,0
116,20,13,3550,1,73,932,32548,70.37,625976,231.447,39.7,14.312,94277.965,128.275,4.42,0.904,0
116,21,8,3558,2,75,752,33300,70.37,625976,231.447,39.7,14.312,94277.965,128.275,4.42,0.904,0
116,22,60,3618,3,78,1140,34440,70.37,625976,231.447,39.7,14.312,94277.965,128.275,4.42,0.904,0
116,23,36,3654,2,80,790,35230,70.37,625976,231.447,39.7,14.312,94277.965,128.275,4.42,0.904,0
116,24,11,3665,3,83,1312,36542,70.37,625976,231.447,39.7,14.312,94277.965,128.275,4.42,0.904,0
116,25,30,3695,2,85,607,37149,70.37,625976,231.447,39.7,14.312,94277.965,128.275,4.42,0.904,0
116,26,16,3711,0,85,132,37281,70.37,625976,231.447,39.7,14.312,94277.965,128.275,4.42,0.904,0
116,27,12,3723,3,88,760,38041,70.37,625976,231.447,39.7,14.312,94277.965,128.275,4.42,0.904,0
116,28,6,3729,0,88,1724,39765,70.37,625976,231.447,39.7,14.312,94277.965,128.275,4.42,0.904,0
116,29,12,3741,1,89,1886,41651,70.37,625976,231.447,39.7,14.312,94277.965,128.275,4.42,0.904,0
116,30,28,3769,0,89,1968,43619,70.37,625976,231.447,39.7,14.312,94277.965,128.275,4.42,0.904,0
116,31,15,3784,1,90,1393,45012,70.37,625976,231.447,39.7,14.312,94277.965,128.275,4.42,0.904,0
116,32,18,3802,2,92,696,45708,70.37,625976,231.447,39.7,14.312,94277.965,128.275,4.42,0.904,0
116,33,10,3812,0,92,237,45945,70.37,625976,231.447,39.7,14.312,94277.965,128.275,4.42,0.904,0
116,34,12,3824,4,96,1037,46982,70.37,625976,231.447,39.7,14.312,94277.965,128.275,4.42,0.904,0
116,35,4,3828,0,96,1279,48261,70.37,625976,231.447,39.7,14.312,94277.965,128.275,4.42,0.904,0
116,36,12,3840,0,96,1433,49694,70.37,625976,231.447,39.7,14.312,94277.965,128.275,4.42,0.904,0
116,37,11,3851,2,98,1319,51013,70.37,625976,231.447,39.7,14.312,94277.965,128.275,4.42,0.904,0
116,38,8,3859,2,100,1319,52332,70.37,625976,231.447,39.7,14.312,94277.965,128.275,4.42,0.904,0
116,39,12,3871,0,100,733,53065,70.37,625976,231.447,39.7,14.312,94277.965,128.275,4.42,0.904,0
116,40,6,3877,1,101,212,53277,70.37,625976,231.447,39.7,14.312,94277.965,128.275,4.42,0.904,0
116,41,9,3886,0,101,1050,54327,56.48,625976,231.447,39.7,14.312,94277.965,128.275,4.42,0.904,0
116,42,2,3888,0,101,1393,55720,56.48,625976,231.447,39.7,14.312,94277.965,128.275,4.42,0.904,0
116,43,6,3894,1,102,1207,56927,56.48,625976,231.447,39.7,14.312,94277.965,128.275,4.42,0.904,0
116,44,10,3904,1,103,1293,58220,56.48,625976,231.447,39.7,14.312,94277.965,128.275,4.42,0.904,0
116,45,11,3915,0,103,1275,59495,56.48,625976,231.447,39.7,14.312,94277.965,128.275,4.42,0.904,0
116,46,8,3923,1,104,1017,60512,56.48,625976,231.447,39.7,14.312,94277.965,128.275,4.42,0.904,0
116,47,7,3930,0,104,150,60662,56.48,625976,231.447,39.7,14.312,94277.965,128.275,4.42,0.904,0
116,48,15,3945,3,107,997,61659,56.48,625976,231.447,39.7,14.312,94277.965,128.275,4.42,0.904,0
116,49,2,3947,0,107,1070,62729,56.48,625976,231.447,39.7,14.312,94277.965,128.275,4.42,0.904,0
116,50,11,3958,2,109,1513,64242,56.48,625976,231.447,39.7,14.312,94277.965,128.275,4.42,0.904,0
116,51,13,3971,0,109,788,65030,56.48,625976,231.447,39.7,14.312,94277.965,128.275,4.42,0.904,0
116,52,9,3980,0,109,1202,66232,56.48,625976,231.447,39.7,14.312,94277.965,128.275,4.42,0.904,0
116,53,1,3981,0,109,1212,67444,56.48,625976,231.447,39.7,14.312,94277.965,128.275,4.42,0.904,0
116,54,9,3990,0,109,94,67538,56.48,625976,231.447,39.7,14.312,94277.965,128.275,4.42,0.904,0
116,55,2,3992,1,110,945,68483,43.52,625976,231.447,39.7,14.312,94277.965,128.275,4.42,0.904,0
116,56,1,3993,0,110,1330,69813,43.52,625976,231.447,39.7,14.312,94277.965,128.275,4.42,0.904,0
116,57,2,3995,0,110,1205,71018,43.52,625976,231.447,39.7,14.312,94277.965,128.275,4.42,0.904,0
116,58,6,4001,0,110,2001,73019,43.52,625976,231.447,39.7,14.312,94277.965,128.275,4.42,0.904,0
116,59,7,4008,0,110,2204,75223,43.52,625976,231.447,39.7,14.312,94277.965,128.275,4.42,0.904,0
116,60,4,4012,0,110,2016,77239,43.52,625976,231.447,39.7,14.312,94277.965,128.275,4.42,0.904,0
116,61,4,4016,0,110,192,77431,43.52,625976,231.447,39.7,14.312,94277.965,128.275,4.42,0.904,0
116,62,2,4018,0,110,421,77852,43.52,625976,231.447,39.7,14.312,94277.965,128.275,4.42,0.904,0
116,63,1,4019,0,110,1592,79444,43.52,625976,231.447,39.7,14.312,94277.965,128.275,4.42,0.904,0
116,64,1,4020,0,110,1744,81188,43.52,625976,231.447,39.7,14.312,94277.965,128.275,4.42,0.904,0
116,65,0,4020,0,110,1678,82866,43.52,625976,231.447,39.7,14.312,94277.965,128.275,4.42,0.904,0
116,66,7,4027,0,110,2873,85739,43.52,625976,231.447,39.7,14.312,94277.965,128.275,4.42,0.904,0
116,67,5,4032,0,110,1823,87562,43.52,625976,231.447,39.7,14.312,94277.965,128.275,4.42,0.904,0
116,68,3,4035,0,110,506,88068,43.52,625976,231.447,39.7,14.312,94277.965,128.275,4.42,0.904,0
116,69,4,4039,0,110,2245,90313,43.52,625976,231.447,39.7,14.312,94277.965,128.275,4.42,0.904,0
116,70,1,4040,0,110,2604,92917,43.52,625976,231.447,39.7,14.312,94277.965,128.275,4.42,0.904,0
116,71,6,4046,0,110,4490,97407,43.52,625976,231.447,39.7,14.312,94277.965,128.275,4.42,0.904,0
116,72,3,4049,0,110,4027,101434,37.96,625976,231.447,39.7,14.312,94277.965,128.275,4.42,0.904,0
116,73,3,4052,0,110,5950,107384,37.96,625976,231.447,39.7,14.312,94277.965,128.275,4.42,0.904,0
116,74,3,4055,0,110,3371,110755,37.96,625976,231.447,39.7,14.312,94277.965,128.275,4.42,0.904,0
116,75,8,4063,0,110,667,111422,37.96,625976,231.447,39.7,14.312,94277.965,128.275,4.42,0.904,0
116,76,7,4070,0,110,4787,116209,37.96,625976,231.447,39.7,14.312,94277.965,128.275,4.42,0.904,0
116,77,2,4072,0,110,4841,121050,37.96,625976,231.447,39.7,14.312,94277.965,128.275,4.42,0.904,0
116,78,3,4075,0,110,6245,127295,37.96,625976,231.447,39.7,14.312,94277.965,128.275,4.42,0.904,0
116,79,10,4085,0,110,6162,133457,37.96,625976,231.447,39.7,14.312,94277.965,128.275,4.42,0.904,0
116,80,6,4091,0,110,6800,140257,37.96,625976,231.447,39.7,14.312,94277.965,128.275,4.42,0.904,0
116,81,8,4099,0,110,5403,145660,37.96,625976,231.447,39.7,14.312,94277.965,128.275,4.42,0.904,0
116,82,6,4105,0,110,504,146164,37.96,625976,231.447,39.7,14.312,94277.965,128.275,4.42,0.904,0
116,83,15,4120,0,110,6064,152228,37.96,625976,231.447,39.7,14.312,94277.965,128.275,4.42,0.904,0
116,84,1,4121,0,110,139,152367,37.96,625976,231.447,39.7,14.312,94277.965,128.275,4.42,0.904,0
116,85,12,4133,0,110,4684,157051,37.96,625976,231.447,39.7,14.312,94277.965,128.275,4.42,0.904,0
116,86,7,4140,0,110,5288,162339,37.96,625976,231.447,39.7,14.312,94277.965,128.275,4.42,0.904,0
116,87,11,4151,0,110,6149,168488,24.07,625976,231.447,39.7,14.312,94277.965,128.275,4.42,0.904,0
116,88,22,4173,0,110,5535,174023,24.07,625976,231.447,39.7,14.312,94277.965,128.275,4.42,0.904,0
116,89,44,4217,0,110,931,174954,24.07,625976,231.447,39.7,14.312,94277.965,128.275,4.42,0.904,0
116,90,25,4242,0,110,8645,183599,24.07,625976,231.447,39.7,14.312,94277.965,128.275,4.42,0.904,0
116,91,14,4256,0,110,7741,191340,24.07,625976,231.447,39.7,14.312,94277.965,128.275,4.42,0.904,0
116,92,43,4299,0,110,10178,201518,24.07,625976,231.447,39.7,14.312,94277.965,128.275,4.42,0.904,0
116,93,46,4345,0,110,11097,212615,24.07,625976,231.447,39.7,14.312,94277.965,128.275,4.42,0.904,0
116,94,50,4395,0,110,10546,223161,24.07,625976,231.447,39.7,14.312,94277.965,128.275,4.42,0.904,0
116,95,52,4447,0,110,7803,230964,24.07,625976,231.447,39.7,14.312,94277.965,128.275,4.42,0.904,0
116,96,29,4476,0,110,1013,231977,24.07,625976,231.447,39.7,14.312,94277.965,128.275,4.42,0.904,0
116,97,46,4522,0,110,9989,241966,24.07,625976,231.447,39.7,14.312,94277.965,128.275,4.42,0.904,0
116,98,20,4542,0,110,9517,251483,24.07,625976,231.447,39.7,14.312,94277.965,128.275,4.42,0.904,0
116,99,61,4603,0,110,11344,262827,24.07,625976,231.447,39.7,14.312,94277.965,128.275,4.42,0.904,0
116,100,47,4650,0,110,11054,273881,24.07,625976,231.447,39.7,14.312,94277.965,128.275,4.42,0.904,0
116,101,69,4719,0,110,5372,279253,24.07,625976,231.447,39.7,14.312,94277.965,128.275,4.42,0.904,0
116,102,58,4777,0,110,7727,286980,24.07,625976,231.447,39.7,14.312,94277.965,128.275,4.42,0.904,0
116,103,65,4842,0,110,4537,291517,24.07,625976,231.447,39.7,14.312,94277.965,128.275,4.42,0.904,0
116,104,83,4925,1,111,10412,301929,24.07,625976,231.447,39.7,14.312,94277.965,128.275,4.42,0.904,0
116,105,31,4956,0,111,11533,313462,24.07,625976,231.447,39.7,14.312,94277.965,128.275,4.42,0.904,0
116,106,100,5056,0,111,14302,327764,24.07,625976,231.447,39.7,14.312,94277.965,128.275,4.42,0.904,0
116,107,0,5056,0,111,13366,341130,11.11,625976,231.447,39.7,14.312,94277.965,128.275,4.42,0.904,0
116,108,66,5122,0,111,14350,355480,11.11,625976,231.447,39.7,14.312,94277.965,128.275,4.42,0.904,0
116,109,163,5285,0,111,12638,368118,11.11,625976,231.447,39.7,14.312,94277.965,128.275,4.42,0.904,0
116,110,124,5409,0,111,3067,371185,19.44,625976,231.447,39.7,14.312,94277.965,128.275,4.42,0.904,0
116,111,74,5483,0,111,9684,380869,19.44,625976,231.447,39.7,14.312,94277.965,128.275,4.42,0.904,0
116,112,122,5605,0,111,16247,397116,19.44,625976,231.447,39.7,14.312,94277.965,128.275,4.42,0.904,0
116,113,120,5725,0,111,7074,404190,19.44,625976,231.447,39.7,14.312,94277.965,128.275,4.42,0.904,0
116,114,129,5854,0,111,15161,419351,19.44,625976,231.447,39.7,14.312,94277.965,128.275,4.42,0.904,0
116,115,98,5952,1,112,10514,429865,19.44,625976,231.447,39.7,14.312,94277.965,128.275,4.42,0.904,0
116,116,104,6056,0,112,6065,435930,19.44,625976,231.447,39.7,14.312,94277.965,128.275,4.42,0.904,0
116,117,133,6189,0,112,1054,436984,19.44,625976,231.447,39.7,14.312,94277.965,128.275,4.42,0.904,0
116,118,83,6272,0,112,14305,451289,19.44,625976,231.447,39.7,14.312,94277.965,128.275,4.42,0.904,0
116,119,49,6321,0,112,8398,459687,22.22,625976,231.447,39.7,14.312,94277.965,128.275,4.42,0.904,0
116,120,54,6375,1,113,6668,466355,22.22,625976,231.447,39.7,14.312,94277.965,128.275,4.42,0.904,0
116,121,158,6533,1,114,9701,476056,22.22,625976,231.447,39.7,14.312,94277.965,128.275,4.42,0.904,0
116,122,83,6616,0,114,8648,484704,22.22,625976,231.447,39.7,14.312,94277.965,128.275,4.42,0.904,0
116,123,79,6695,0,114,6160,490864,22.22,625976,231.447,39.7,14.312,94277.965,128.275,4.42,0.904,0
116,124,0,6695,0,114,860,491724,22.22,625976,231.447,39.7,14.312,94277.965,128.275,4.42,0.904,0
116,125,0,6695,3,117,6198,497922,22.22,625976,231.447,39.7,14.312,94277.965,128.275,4.42,0.904,0
116,126,169,6864,1,118,7773,505695,22.22,625976,231.447,39.7,14.312,94277.965,128.275,4.42,0.904,0
116,127,53,6917,0,118,10009,515704,22.22,625976,231.447,39.7,14.312,94277.965,128.275,4.42,0.904,0
116,128,90,7007,0,118,6174,521878,22.22,625976,231.447,39.7,14.312,94277.965,128.275,4.42,0.904,0
116,129,66,7073,1,119,6886,528764,31.48,625976,231.447,39.7,14.312,94277.965,128.275,4.42,0.904,0
116,130,40,7113,0,119,5873,534637,31.48,625976,231.447,39.7,14.312,94277.965,128.275,4.42,0.904,0
116,131,0,7113,0,119,345,534982,31.48,625976,231.447,39.7,14.312,94277.965,128.275,4.42,0.904,0
116,132,0,7113,0,119,5518,540500,31.48,625976,231.447,39.7,14.312,94277.965,128.275,4.42,0.904,0
116,133,103,7216,2,121,6574,547074,31.48,625976,231.447,39.7,14.312,94277.965,128.275,4.42,0.904,0
116,134,26,7242,1,122,4742,551816,34.26,625976,231.447,39.7,14.312,94277.965,128.275,4.42,0.904,0
116,135,58,7300,0,122,4624,556440,34.26,625976,231.447,39.7,14.312,94277.965,128.275,4.42,0.904,0
116,136,68,7368,0,122,8400,564840,34.26,625976,231.447,39.7,14.312,94277.965,128.275,4.42,0.904,0
116,137,37,7405,0,122,2537,567377,34.26,625976,231.447,39.7,14.312,94277.965,128.275,4.42,0.904,0
116,138,34,7439,1,123,483,567860,34.26,625976,231.447,39.7,14.312,94277.965,128.275,4.42,0.904,0
116,139,0,7439,0,123,3416,571276,34.26,625976,231.447,39.7,14.312,94277.965,128.275,4.42,0.904,0
116,140,30,7469,1,124,5593,576869,34.26,625976,231.447,39.7,14.312,94277.965,128.275,4.42,0.904,0
116,141,30,7499,0,124,8587,585456,34.26,625976,231.447,39.7,14.312,94277.965,128.275,4.42,0.904,0
116,142,67,7566,0,124,4965,590421,34.26,625976,231.447,39.7,14.312,94277.965,128.275,4.42,0.904,0
116,143,71,7637,0,124,7839,598260,39.81,625976,231.447,39.7,14.312,94277.965,128.275,4.42,0.904,0
116,144,67,7704,0,124,5567,603827,39.81,625976,231.447,39.7,14.312,94277.965,128.275,4.42,0.904,0
116,145,0,7704,0,124,989,604816,39.81,625976,231.447,39.7,14.312,94277.965,128.275,4.42,0.904,0
116,146,0,7704,0,124,2781,607597,39.81,625976,231.447,39.7,14.312,94277.965,128.275,4.42,0.904,0
116,147,90,7794,0,124,6717,614314,43.52,625976,231.447,39.7,14.312,94277.965,128.275,4.42,0.904,0
116,148,44,7838,0,124,5954,620268,43.52,625976,231.447,39.7,14.312,94277.965,128.275,4.42,0.904,0
116,149,90,7928,0,124,8108,628376,43.52,625976,231.447,39.7,14.312,94277.965,128.275,4.42,0.904,0
116,150,-1385,6543,0,124,6884,635260,43.52,625976,231.447,39.7,14.312,94277.965,128.275,4.42,0.904,0
116,151,37,6580,0,124,6642,641902,43.52,625976,231.447,39.7,14.312,94277.965,128.275,4.42,0.904,0
116,152,0,6580,0,124,947,642849,43.52,625976,231.447,39.7,14.312,94277.965,128.275,4.42,0.904,0
116,153,45,6625,0,124,5260,648109,43.52,625976,231.447,39.7,14.312,94277.965,128.275,4.42,0.904,0
116,154,52,6677,0,124,10038,658147,43.52,625976,231.447,39.7,14.312,94277.965,128.275,4.42,0.904,0
116,155,0,6677,0,124,7582,665729,43.52,625976,231.447,39.7,14.312,94277.965,128.275,4.42,0.904,0
116,156,68,6745,0,124,7412,673141,43.52,625976,231.447,39.7,14.312,94277.965,128.275,4.42,0.904,0
116,157,0,6745,0,124,9248,682389,43.52,625976,231.447,39.7,14.312,94277.965,128.275,4.42,0.904,0
116,158,109,6854,0,124,7385,689774,43.52,625976,231.447,39.7,14.312,94277.965,128.275,4.42,0.904,0
116,159,0,6854,0,124,1145,690919,43.52,625976,231.447,39.7,14.312,94277.965,128.275,4.42,0.904,0
116,160,42,6896,0,124,5161,696080,43.52,625976,231.447,39.7,14.312,94277.965,128.275,4.42,0.904,0
116,161,54,6950,0,124,10033,706113,43.52,625976,231.447,39.7,14.312,94277.965,128.275,4.42,0.904,0
116,162,24,6974,0,124,7764,713877,43.52,625976,231.447,39.7,14.312,94277.965,128.275,4.42,0.904,0
116,163,49,7023,0,124,8881,722758,43.52,625976,231.447,39.7,14.312,94277.965,128.275,4.42,0.904,0
116,164,65,7088,0,124,10012,732770,43.52,625976,231.447,39.7,14.312,94277.965,128.275,4.42,0.904,0
116,165,71,7159,0,124,7863,740633,43.52,625976,231.447,39.7,14.312,94277.965,128.275,4.42,0.904,0
116,166,0,7159,0,124,1397,742030,40.74,625976,231.447,39.7,14.312,94277.965,128.275,4.42,0.904,0
116,167,35,7194,0,124,7767,749797,40.74,625976,231.447,39.7,14.312,94277.965,128.275,4.42,0.904,0
116,168,50,7244,0,124,10583,760380,40.74,625976,231.447,39.7,14.312,94277.965,128.275,4.42,0.904,0
116,169,40,7284,0,124,9008,769388,40.74,625976,231.447,39.7,14.312,94277.965,128.275,4.42,0.904,0
116,170,110,7394,0,124,4216,773604,40.74,625976,231.447,39.7,14.312,94277.965,128.275,4.42,0.904,0
116,171,147,7541,0,124,4704,778308,40.74,625976,231.447,39.7,14.312,94277.965,128.275,4.42,0.904,0
116,172,177,7718,0,124,3689,781997,40.74,625976,231.447,39.7,14.312,94277.965,128.275,4.42,0.904,0
116,173,0,7718,0,124,838,782835,40.74,625976,231.447,39.7,14.312,94277.965,128.275,4.42,0.904,0
116,174,86,7804,0,124,6461,789296,40.74,625976,231.447,39.7,14.312,94277.965,128.275,4.42,0.904,0
116,175,112,7916,0,124,6176,795472,40.74,625976,231.447,39.7,14.312,94277.965,128.275,4.42,0.904,0
116,176,100,8016,0,124,6136,801608,40.74,625976,231.447,39.7,14.312,94277.965,128.275,4.42,0.904,0
116,177,74,8090,0,124,6097,807705,40.74,625976,231.447,39.7,14.312,94277.965,128.275,4.42,0.904,0
116,178,68,8158,0,124,6119,813824,40.74,625976,231.447,39.7,14.312,94277.965,128.275,4.42,0.904,0
116,179,75,8233,0,124,5341,819165,43.52,625976,231.447,39.7,14.312,94277.965,128.275,4.42,0.904,0
116,180,78,8311,0,124,708,819873,43.52,625976,231.447,39.7,14.312,94277.965,128.275,4.42,0.904,0
116,181,46,8357,0,124,5470,825343,43.52,625976,231.447,39.7,14.312,94277.965,128.275,4.42,0.904,0
116,182,19,8376,0,124,7136,832479,43.52,625976,231.447,39.7,14.312,94277.965,128.275,4.42,0.904,0
116,183,55,8431,0,124,6086,838565,43.52,625976,231.447,39.7,14.312,94277.965,128.275,4.42,0.904,0
116,184,78,8509,0,124,7108,845673,43.52,625976,231.447,39.7,14.312,94277.965,128.275,4.42,0.904,0
116,185,86,8595,1,125,6461,852134,43.52,625976,231.447,39.7,14.312,94277.965,128.275,4.42,0.904,0
116,186,114,8709,0,125,5538,857672,43.52,625976,231.447,39.7,14.312,94277.965,128.275,4.42,0.904,0
116,187,0,8709,0,125,1013,858685,43.52,625976,231.447,39.7,14.312,94277.965,128.275,4.42,0.904,0
116,188,0,8709,0,125,5310,863995,43.52,625976,231.447,39.7,14.312,94277.965,128.275,4.42,0.904,0
116,189,216,8925,2,127,6670,870665,43.52,625976,231.447,39.7,14.312,94277.965,128.275,4.42,0.904,0
116,190,54,8979,1,128,6900,877565,43.52,625976,231.447,39.7,14.312,94277.965,128.275,4.42,0.904,0
116,191,140,9119,0,128,7804,885369,43.52,625976,231.447,39.7,14.312,94277.965,128.275,4.42,0.904,0
116,192,100,9219,1,129,6990,892359,43.52,625976,231.447,39.7,14.312,94277.965,128.275,4.42,0.904,0
116,193,141,9360,1,130,5298,897657,43.52,625976,231.447,39.7,14.312,94277.965,128.275,4.42,0.904,0
116,194,0,9360,0,130,803,898460,43.52,625976,231.447,39.7,14.312,94277.965,128.275,4.42,0.904,0
116,195,0,9360,0,130,6653,905113,43.52,625976,231.447,39.7,14.312,94277.965,128.275,4.42,0.904,0
116,196,371,9731,3,133,7453,912566,43.52,625976,231.447,39.7,14.312,94277.965,128.275,4.42,0.904,0
116,197,109,9840,0,133,6780,919346,43.52,625976,231.447,39.7,14.312,94277.965,128.275,4.42,0.904,0
116,198,190,10030,0,133,8655,928001,43.52,625976,231.447,39.7,14.312,94277.965,128.275,4.42,0.904,0
116,199,214,10244,0,133,8247,936248,43.52,625976,231.447,39.7,14.312,94277.965,128.275,4.42,0.904,0
116,200,227,10471,0,133,8622,944870,43.52,625976,231.447,39.7,14.312,94277.965,128.275,4.42,0.904,0
116,201,0,10471,0,133,0,944870,43.52,625976,231.447,39.7,14.312,94277.965,128.275,4.42,0.904,0
116,202,175,10646,0,133,0,944870,43.52,625976,231.447,39.7,14.312,94277.965,128.275,4.42,0.904,0
116,203,242,10888,0,133,0,944870,43.52,625976,231.447,39.7,14.312,94277.965,128.275,4.42,0.904,0
116,204,353,11241,3,136,0,944870,43.52,625976,231.447,39.7,14.312,94277.965,128.275,4.42,0.904,0
117,1,44,329,2,9,0,0,0,2083380,82.6,39.1,13.26,13111.214,322.688,10.08,0.757,0
117,2,25,354,1,10,0,0,0,2083380,82.6,39.1,13.26,13111.214,322.688,10.08,0.757,0
117,3,0,354,1,11,0,0,0,2083380,82.6,39.1,13.26,13111.214,322.688,10.08,0.757,0
117,4,76,430,1,12,0,0,0,2083380,82.6,39.1,13.26,13111.214,322.688,10.08,0.757,0
117,5,53,483,5,17,0,0,0,2083380,82.6,39.1,13.26,13111.214,322.688,10.08,0.757,0
117,6,0,483,0,17,0,0,0,2083380,82.6,39.1,13.26,13111.214,322.688,10.08,0.757,0
117,7,87,570,4,21,0,0,0,2083380,82.6,39.1,13.26,13111.214,322.688,10.08,0.757,0
117,8,29,599,5,26,0,0,0,2083380,82.6,39.1,13.26,13111.214,322.688,10.08,0.757,0
117,9,18,617,4,30,0,0,0,2083380,82.6,39.1,13.26,13111.214,322.688,10.08,0.757,0
117,10,46,663,2,32,0,0,0,2083380,82.6,39.1,13.26,13111.214,322.688,10.08,0.757,0
117,11,48,711,0,32,0,0,0,2083380,82.6,39.1,13.26,13111.214,322.688,10.08,0.757,0
117,12,49,760,2,34,0,0,0,2083380,82.6,39.1,13.26,13111.214,322.688,10.08,0.757,0
117,13,68,828,0,34,0,0,0,2083380,82.6,39.1,13.26,13111.214,322.688,10.08,0.757,0
117,14,26,854,4,38,0,0,0,2083380,82.6,39.1,13.26,13111.214,322.688,10.08,0.757,0
117,15,54,908,6,44,0,0,0,2083380,82.6,39.1,13.26,13111.214,322.688,10.08,0.757,0
117,16,66,974,1,45,0,0,0,2083380,82.6,39.1,13.26,13111.214,322.688,10.08,0.757,0
117,17,107,1081,1,46,0,0,0,2083380,82.6,39.1,13.26,13111.214,322.688,10.08,0.757,0
117,18,36,1117,3,49,0,0,0,2083380,82.6,39.1,13.26,13111.214,322.688,10.08,0.757,0
117,19,53,1170,0,49,0,0,0,2083380,82.6,39.1,13.26,13111.214,322.688,10.08,0.757,0
117,20,37,1207,2,51,0,0,0,2083380,82.6,39.1,13.26,13111.214,322.688,10.08,0.757,0
117,21,18,1225,3,54,0,0,0,2083380,82.6,39.1,13.26,13111.214,322.688,10.08,0.757,0
117,22,6,1231,1,55,0,0,0,2083380,82.6,39.1,13.26,13111.214,322.688,10.08,0.757,0
117,23,28,1259,1,56,0,0,0,2083380,82.6,39.1,13.26,13111.214,322.688,10.08,0.757,0
117,24,41,1300,0,56,0,0,0,2083380,82.6,39.1,13.26,13111.214,322.688,10.08,0.757,0
117,25,26,1326,1,57,0,0,0,2083380,82.6,39.1,13.26,13111.214,322.688,10.08,0.757,0
117,26,41,1367,2,59,0,0,0,2083380,82.6,39.1,13.26,13111.214,322.688,10.08,0.757,0
117,27,19,1386,2,61,0,0,0,2083380,82.6,39.1,13.26,13111.214,322.688,10.08,0.757,0
117,28,13,1399,4,65,0,0,0,2083380,82.6,39.1,13.26,13111.214,322.688,10.08,0.757,0
117,29,22,1421,6,71,0,0,0,2083380,82.6,39.1,13.26,13111.214,322.688,10.08,0.757,0
117,30,21,1442,2,73,0,0,0,2083380,82.6,39.1,13.26,13111.214,322.688,10.08,0.757,0
117,31,23,1465,4,77,0,0,0,2083380,82.6,39.1,13.26,13111.214,322.688,10.08,0.757,0
117,32,29,1494,4,81,0,0,0,2083380,82.6,39.1,13.26,13111.214,322.688,10.08,0.757,0
117,33,12,1506,1,82,0,0,0,2083380,82.6,39.1,13.26,13111.214,322.688,10.08,0.757,0
117,34,5,1511,2,84,0,0,0,2083380,82.6,39.1,13.26,13111.214,322.688,10.08,0.757,0
117,35,7,1518,1,85,0,0,0,2083380,82.6,39.1,13.26,13111.214,322.688,10.08,0.757,0
117,36,8,1526,1,86,0,0,0,2083380,82.6,39.1,13.26,13111.214,322.688,10.08,0.757,0
117,37,13,1539,2,88,0,0,0,2083380,82.6,39.1,13.26,13111.214,322.688,10.08,0.757,0
117,38,33,1572,1,89,0,0,0,2083380,82.6,39.1,13.26,13111.214,322.688,10.08,0.757,0
117,39,14,1586,1,90,0,0,0,2083380,82.6,39.1,13.26,13111.214,322.688,10.08,0.757,0
117,40,36,1622,1,91,0,0,0,2083380,82.6,39.1,13.26,13111.214,322.688,10.08,0.757,0
117,41,20,1642,0,91,0,0,0,2083380,82.6,39.1,13.26,13111.214,322.688,10.08,0.757,0
117,42,22,1664,0,91,0,0,0,2083380,82.6,39.1,13.26,13111.214,322.688,10.08,0.757,0
117,43,10,1674,1,92,0,0,0,2083380,82.6,39.1,13.26,13111.214,322.688,10.08,0.757,0
117,44,20,1694,3,95,0,0,0,2083380,82.6,39.1,13.26,13111.214,322.688,10.08,0.757,0
117,45,29,1723,0,95,0,0,0,2083380,82.6,39.1,13.26,13111.214,322.688,10.08,0.757,0
117,46,17,1740,2,97,0,0,0,2083380,82.6,39.1,13.26,13111.214,322.688,10.08,0.757,0
117,47,22,1762,1,98,0,0,0,2083380,82.6,39.1,13.26,13111.214,322.688,10.08,0.757,0
117,48,30,1792,3,101,0,0,0,2083380,82.6,39.1,13.26,13111.214,322.688,10.08,0.757,0
117,49,25,1817,3,104,0,0,0,2083380,82.6,39.1,13.26,13111.214,322.688,10.08,0.757,0
117,50,22,1839,2,106,0,0,0,2083380,82.6,39.1,13.26,13111.214,322.688,10.08,0.757,0
117,51,19,1858,4,110,0,0,0,2083380,82.6,39.1,13.26,13111.214,322.688,10.08,0.757,0
117,52,40,1898,1,111,0,0,0,2083380,82.6,39.1,13.26,13111.214,322.688,10.08,0.757,0
117,53,23,1921,1,112,0,0,0,2083380,82.6,39.1,13.26,13111.214,322.688,10.08,0.757,0
117,54,20,1941,1,113,0,0,0,2083380,82.6,39.1,13.26,13111.214,322.688,10.08,0.757,0
117,55,37,1978,0,113,0,0,0,2083380,82.6,39.1,13.26,13111.214,322.688,10.08,0.757,0
117,56,21,1999,0,113,0,0,0,2083380,82.6,39.1,13.26,13111.214,322.688,10.08,0.757,0
117,57,16,2015,3,116,0,0,0,2083380,82.6,39.1,13.26,13111.214,322.688,10.08,0.757,0
117,58,25,2040,3,119,0,0,0,2083380,82.6,39.1,13.26,13111.214,322.688,10.08,0.757,0
117,59,38,2078,3,122,0,0,0,2083380,82.6,39.1,13.26,13111.214,322.688,10.08,0.757,0
117,60,52,2130,4,126,0,0,0,2083380,82.6,39.1,13.26,13111.214,322.688,10.08,0.757,0
117,61,34,2164,5,131,0,0,0,2083380,82.6,39.1,13.26,13111.214,322.688,10.08,0.757,0
117,62,62,2226,2,133,0,0,0,2083380,82.6,39.1,13.26,13111.214,322.688,10.08,0.757,0
117,63,89,2315,7,140,0,0,0,2083380,82.6,39.1,13.26,13111.214,322.688,10.08,0.757,0
117,64,76,2391,1,141,0,0,0,2083380,82.6,39.1,13.26,13111.214,322.688,10.08,0.757,0
117,65,101,2492,4,145,0,0,0,2083380,82.6,39.1,13.26,13111.214,322.688,10.08,0.757,0
117,66,120,2612,2,147,0,0,0,2083380,82.6,39.1,13.26,13111.214,322.688,10.08,0.757,0
117,67,180,2792,2,149,0,0,0,2083380,82.6,39.1,13.26,13111.214,322.688,10.08,0.757,0
117,68,125,2917,2,151,0,0,0,2083380,82.6,39.1,13.26,13111.214,322.688,10.08,0.757,0
117,69,111,3028,2,153,0,0,0,2083380,82.6,39.1,13.26,13111.214,322.688,10.08,0.757,0
117,70,127,3155,3,156,0,0,0,2083380,82.6,39.1,13.26,13111.214,322.688,10.08,0.757,0
117,71,87,3242,1,157,0,0,0,2083380,82.6,39.1,13.26,13111.214,322.688,10.08,0.757,0
117,72,125,3367,7,164,0,0,0,2083380,82.6,39.1,13.26,13111.214,322.688,10.08,0.757,0
117,73,175,3542,5,169,0,0,0,2083380,82.6,39.1,13.26,13111.214,322.688,10.08,0.757,0
117,74,164,3706,2,171,0,0,0,2083380,82.6,39.1,13.26,13111.214,322.688,10.08,0.757,0
117,75,196,3902,8,179,0,0,0,2083380,82.6,39.1,13.26,13111.214,322.688,10.08,0.757,0
117,76,155,4057,9,188,0,0,0,2083380,82.6,39.1,13.26,13111.214,322.688,10.08,0.757,0
117,77,100,4157,5,193,0,0,0,2083380,82.6,39.1,13.26,13111.214,322.688,10.08,0.757,0
117,78,132,4289,8,201,0,0,0,2083380,82.6,39.1,13.26,13111.214,322.688,10.08,0.757,0
117,79,193,4482,9,210,0,0,0,2083380,82.6,39.1,13.26,13111.214,322.688,10.08,0.757,0
117,80,182,4664,6,216,0,0,0,2083380,82.6,39.1,13.26,13111.214,322.688,10.08,0.757,0
117,81,156,4820,6,222,0,0,0,2083380,82.6,39.1,13.26,13111.214,322.688,10.08,0.757,0
117,82,185,5005,11,233,0,0,0,2083380,82.6,39.1,13.26,13111.214,322.688,10.08,0.757,0
117,83,101,5106,5,238,0,0,0,2083380,82.6,39.1,13.26,13111.214,322.688,10.08,0.757,0
117,84,90,5196,9,247,0,0,0,2083380,82.6,39.1,13.26,13111.214,322.688,10.08,0.757,0
117,85,118,5314,4,251,0,0,0,2083380,82.6,39.1,13.26,13111.214,322.688,10.08,0.757,0
117,86,136,5450,8,259,0,0,0,2083380,82.6,39.1,13.26,13111.214,322.688,10.08,0.757,0
117,87,153,5603,6,265,0,0,0,2083380,82.6,39.1,13.26,13111.214,322.688,10.08,0.757,0
117,88,163,5766,3,268,0,0,0,2083380,82.6,39.1,13.26,13111.214,322.688,10.08,0.757,0
117,89,150,5916,9,277,0,0,0,2083380,82.6,39.1,13.26,13111.214,322.688,10.08,0.757,0
117,90,176,6092,9,286,0,0,0,2083380,82.6,39.1,13.26,13111.214,322.688,10.08,0.757,0
117,91,132,6224,12,298,0,0,0,2083380,82.6,39.1,13.26,13111.214,322.688,10.08,0.757,0
117,92,126,6350,4,302,0,0,0,2083380,82.6,39.1,13.26,13111.214,322.688,10.08,0.757,0
117,93,120,6470,4,306,0,0,0,2083380,82.6,39.1,13.26,13111.214,322.688,10.08,0.757,0
117,94,173,6643,15,321,0,0,0,2083380,82.6,39.1,13.26,13111.214,322.688,10.08,0.757,0
117,95,0,6643,0,321,0,0,0,2083380,82.6,39.1,13.26,13111.214,322.688,10.08,0.757,0
117,96,289,6932,13,334,0,0,0,2083380,82.6,39.1,13.26,13111.214,322.688,10.08,0.757,0
117,97,114,7046,7,341,0,0,0,2083380,82.6,39.1,13.26,13111.214,322.688,10.08,0.757,0
117,98,76,7122,5,346,0,0,0,2083380,82.6,39.1,13.26,13111.214,322.688,10.08,0.757,0
117,99,118,7240,5,351,0,0,0,2083380,82.6,39.1,13.26,13111.214,322.688,10.08,0.757,0
117,100,161,7401,8,359,0,0,0,2083380,82.6,39.1,13.26,13111.214,322.688,10.08,0.757,0
117,101,166,7567,2,361,0,0,0,2083380,82.6,39.1,13.26,13111.214,322.688,10.08,0.757,0
117,102,203,7770,6,367,0,0,0,2083380,82.6,39.1,13.26,13111.214,322.688,10.08,0.757,0
117,103,197,7967,8,375,0,0,0,2083380,82.6,39.1,13.26,13111.214,322.688,10.08,0.757,0
117,104,144,8111,7,382,0,0,0,2083380,82.6,39.1,13.26,13111.214,322.688,10.08,0.757,0
117,105,86,8197,3,385,0,0,0,2083380,82.6,39.1,13.26,13111.214,322.688,10.08,0.757,0
117,106,131,8328,4,389,0,0,0,2083380,82.6,39.1,13.26,13111.214,322.688,10.08,0.757,0
117,107,194,8522,4,393,0,0,0,2083380,82.6,39.1,13.26,13111.214,322.688,10.08,0.757,0
117,108,90,8612,8,401,0,0,0,2083380,82.6,39.1,13.26,13111.214,322.688,10.08,0.757,0
117,109,160,8772,5,406,0,0,0,2083380,82.6,39.1,13.26,13111.214,322.688,10.08,0.757,0
117,110,237,9009,8,414,0,0,0,2083380,82.6,39.1,13.26,13111.214,322.688,10.08,0.757,0
117,111,123,9132,8,422,0,0,0,2083380,82.6,39.1,13.26,13111.214,322.688,10.08,0.757,0
117,112,117,9249,10,432,0,0,0,2083380,82.6,39.1,13.26,13111.214,322.688,10.08,0.757,0
117,113,163,9412,0,432,0,0,0,2083380,82.6,39.1,13.26,13111.214,322.688,10.08,0.757,0
117,114,135,9547,10,442,0,0,0,2083380,82.6,39.1,13.26,13111.214,322.688,10.08,0.757,0
117,115,122,9669,3,445,0,0,0,2083380,82.6,39.1,13.26,13111.214,322.688,10.08,0.757,0
117,116,128,9797,6,451,0,0,0,2083380,82.6,39.1,13.26,13111.214,322.688,10.08,0.757,0
117,117,137,9934,9,460,0,0,0,2083380,82.6,39.1,13.26,13111.214,322.688,10.08,0.757,0
117,118,152,10086,0,460,0,0,0,2083380,82.6,39.1,13.26,13111.214,322.688,10.08,0.757,0
117,119,128,10214,6,466,0,0,0,2083380,82.6,39.1,13.26,13111.214,322.688,10.08,0.757,0
117,120,102,10316,5,471,0,0,0,2083380,82.6,39.1,13.26,13111.214,322.688,10.08,0.757,0
117,121,188,10504,5,476,0,0,0,2083380,82.6,39.1,13.26,13111.214,322.688,10.08,0.757,0
117,122,119,10623,4,480,0,0,0,2083380,82.6,39.1,13.26,13111.214,322.688,10.08,0.757,0
117,123,139,10762,6,486,0,0,0,2083380,82.6,39.1,13.26,13111.214,322.688,10.08,0.757,0
117,124,138,10900,7,493,0,0,0,2083380,82.6,39.1,13.26,13111.214,322.688,10.08,0.757,0
117,125,154,11054,4,497,0,0,0,2083380,82.6,39.1,13.26,13111.214,322.688,10.08,0.757,0
117,126,86,11140,3,500,0,0,0,2083380,82.6,39.1,13.26,13111.214,322.688,10.08,0.757,0
117,127,0,11140,0,500,0,0,0,2083380,82.6,39.1,13.26,13111.214,322.688,10.08,0.757,0
117,128,61,11201,5,505,0,0,0,2083380,82.6,39.1,13.26,13111.214,322.688,10.08,0.757,0
117,129,88,11289,6,511,0,0,0,2083380,82.6,39.1,13.26,13111.214,322.688,10.08,0.757,0
117,130,282,11571,8,519,0,0,0,2083380,82.6,39.1,13.26,13111.214,322.688,10.08,0.757,0
117,131,200,11771,4,523,0,0,0,2083380,82.6,39.1,13.26,13111.214,322.688,10.08,0.757,0
117,132,85,11856,4,527,0,0,0,2083380,82.6,39.1,13.26,13111.214,322.688,10.08,0.757,0
117,133,109,11965,1,528,0,0,0,2083380,82.6,39.1,13.26,13111.214,322.688,10.08,0.757,0
117,134,0,11965,0,528,0,0,0,2083380,82.6,39.1,13.26,13111.214,322.688,10.08,0.757,0
117,135,252,12217,2,530,0,0,0,2083380,82.6,39.1,13.26,13111.214,322.688,10.08,0.757,0
117,136,140,12357,2,532,0,0,0,2083380,82.6,39.1,13.26,13111.214,322.688,10.08,0.757,0
117,137,189,12546,3,535,0,0,0,2083380,82.6,39.1,13.26,13111.214,322.688,10.08,0.757,0
117,138,107,12653,4,539,0,0,0,2083380,82.6,39.1,13.26,13111.214,322.688,10.08,0.757,0
117,139,86,12739,5,544,0,0,0,2083380,82.6,39.1,13.26,13111.214,322.688,10.08,0.757,0
117,140,35,12774,1,545,0,0,0,2083380,82.6,39.1,13.26,13111.214,322.688,10.08,0.757,0
117,141,103,12877,3,548,0,0,0,2083380,82.6,39.1,13.26,13111.214,322.688,10.08,0.757,0
117,142,108,12985,2,550,0,0,0,2083380,82.6,39.1,13.26,13111.214,322.688,10.08,0.757,0
117,143,0,12985,0,550,0,0,0,2083380,82.6,39.1,13.26,13111.214,322.688,10.08,0.757,0
117,144,233,13218,6,556,0,0,0,2083380,82.6,39.1,13.26,13111.214,322.688,10.08,0.757,0
117,145,0,13218,0,556,0,0,0,2083380,82.6,39.1,13.26,13111.214,322.688,10.08,0.757,0
117,146,296,13514,7,563,0,0,0,2083380,82.6,39.1,13.26,13111.214,322.688,10.08,0.757,0
117,147,81,13595,1,564,0,0,0,2083380,82.6,39.1,13.26,13111.214,322.688,10.08,0.757,0
117,148,78,13673,4,568,0,0,0,2083380,82.6,39.1,13.26,13111.214,322.688,10.08,0.757,0
117,149,126,13799,5,573,0,0,0,2083380,82.6,39.1,13.26,13111.214,322.688,10.08,0.757,0
117,150,128,13927,11,584,0,0,0,2083380,82.6,39.1,13.26,13111.214,322.688,10.08,0.757,0
117,151,0,13927,0,584,0,0,0,2083380,82.6,39.1,13.26,13111.214,322.688,10.08,0.757,0
117,152,0,13927,0,584,0,0,0,2083380,82.6,39.1,13.26,13111.214,322.688,10.08,0.757,0
117,153,0,13927,0,584,0,0,0,2083380,82.6,39.1,13.26,13111.214,322.688,10.08,0.757,0
117,154,403,14330,16,600,0,0,0,2083380,82.6,39.1,13.26,13111.214,322.688,10.08,0.757,0
117,155,11,14341,3,603,0,0,0,2083380,82.6,39.1,13.26,13111.214,322.688,10.08,0.757,0
117,156,114,14455,1,604,0,0,0,2083380,82.6,39.1,13.26,13111.214,322.688,10.08,0.757,0
117,157,145,14600,2,606,0,0,0,2083380,82.6,39.1,13.26,13111.214,322.688,10.08,0.757,0
117,158,162,14762,0,606,0,0,0,2083380,82.6,39.1,13.26,13111.214,322.688,10.08,0.757,0
117,159,0,14762,0,606,0,0,0,2083380,82.6,39.1,13.26,13111.214,322.688,10.08,0.757,0
117,160,0,14762,0,606,0,0,0,2083380,82.6,39.1,13.26,13111.214,322.688,10.08,0.757,0
117,161,328,15090,11,617,0,0,0,2083380,82.6,39.1,13.26,13111.214,322.688,10.08,0.757,0
117,162,37,15127,6,623,0,0,0,2083380,82.6,39.1,13.26,13111.214,322.688,10.08,0.757,0
117,163,99,15226,8,631,0,0,0,2083380,82.6,39.1,13.26,13111.214,322.688,10.08,0.757,0
117,164,67,15293,3,634,0,0,0,2083380,82.6,39.1,13.26,13111.214,322.688,10.08,0.757,0
117,165,121,15414,3,637,0,0,0,2083380,82.6,39.1,13.26,13111.214,322.688,10.08,0.757,0
117,166,141,15555,5,642,0,0,0,2083380,82.6,39.1,13.26,13111.214,322.688,10.08,0.757,0
117,167,139,15694,4,646,0,0,0,2083380,82.6,39.1,13.26,13111.214,322.688,10.08,0.757,0
117,168,97,15791,2,648,0,0,0,2083380,82.6,39.1,13.26,13111.214,322.688,10.08,0.757,0
117,169,134,15925,13,661,0,0,0,2083380,82.6,39.1,13.26,13111.214,322.688,10.08,0.757,0
117,170,163,16088,7,668,0,0,0,2083380,82.6,39.1,13.26,13111.214,322.688,10.08,0.757,0
117,171,186,16274,7,675,0,0,0,2083380,82.6,39.1,13.26,13111.214,322.688,10.08,0.757,0
117,172,143,16417,8,683,0,0,0,2083380,82.6,39.1,13.26,13111.214,322.688,10.08,0.757,0
117,173,140,16557,6,689,0,0,0,2083380,82.6,39.1,13.26,13111.214,322.688,10.08,0.757,0
117,174,178,16735,4,693,0,0,0,2083380,82.6,39.1,13.26,13111.214,322.688,10.08,0.757,0
117,175,45,16780,7,700,0,0,0,2083380,82.6,39.1,13.26,13111.214,322.688,10.08,0.757,0
117,176,87,16867,5,705,0,0,0,2083380,82.6,39.1,13.26,13111.214,322.688,10.08,0.757,0
117,177,182,17049,5,710,0,0,0,2083380,82.6,39.1,13.26,13111.214,322.688,10.08,0.757,0
117,178,151,17200,2,712,0,0,0,2083380,82.6,39.1,13.26,13111.214,322.688,10.08,0.757,0
117,179,143,17343,9,721,0,0,0,2083380,82.6,39.1,13.26,13111.214,322.688,10.08,0.757,0
117,180,140,17483,1,722,0,0,0,2083380,82.6,39.1,13.26,13111.214,322.688,10.08,0.757,0
117,181,146,17629,3,725,0,0,0,2083380,82.6,39.1,13.26,13111.214,322.688,10.08,0.757,0
117,182,45,17674,4,729,0,0,0,2083380,82.6,39.1,13.26,13111.214,322.688,10.08,0.757,0
117,183,112,17786,8,737,0,0,0,2083380,82.6,39.1,13.26,13111.214,322.688,10.08,0.757,0
117,184,191,17977,2,739,0,0,0,2083380,82.6,39.1,13.26,13111.214,322.688,10.08,0.757,0
117,185,161,18138,4,743,0,0,0,2083380,82.6,39.1,13.26,13111.214,322.688,10.08,0.757,0
117,186,225,18363,6,749,0,0,0,2083380,82.6,39.1,13.26,13111.214,322.688,10.08,0.757,0
117,187,239,18602,4,753,0,0,0,2083380,82.6,39.1,13.26,13111.214,322.688,10.08,0.757,0
117,188,0,18602,0,753,0,0,0,2083380,82.6,39.1,13.26,13111.214,322.688,10.08,0.757,0
117,189,271,18873,7,760,0,0,0,2083380,82.6,39.1,13.26,13111.214,322.688,10.08,0.757,0
117,190,224,19097,8,768,0,0,0,2083380,82.6,39.1,13.26,13111.214,322.688,10.08,0.757,0
117,191,316,19413,4,772,0,0,0,2083380,82.6,39.1,13.26,13111.214,322.688,10.08,0.757,0
117,192,364,19777,3,775,0,0,0,2083380,82.6,39.1,13.26,13111.214,322.688,10.08,0.757,0
117,193,386,20163,6,781,0,0,0,2083380,82.6,39.1,13.26,13111.214,322.688,10.08,0.757,0
117,194,392,20555,4,785,0,0,0,2083380,82.6,39.1,13.26,13111.214,322.688,10.08,0.757,0
117,195,382,20937,7,792,0,0,0,2083380,82.6,39.1,13.26,13111.214,322.688,10.08,0.757,0
117,196,176,21113,5,797,0,0,0,2083380,82.6,39.1,13.26,13111.214,322.688,10.08,0.757,0
117,197,80,21193,3,800,0,0,0,2083380,82.6,39.1,13.26,13111.214,322.688,10.08,0.757,0
117,198,443,21636,9,809,0,0,0,2083380,82.6,39.1,13.26,13111.214,322.688,10.08,0.757,0
117,199,534,22170,6,815,0,0,0,2083380,82.6,39.1,13.26,13111.214,322.688,10.08,0.757,0
117,200,437,22607,6,821,0,0,0,2083380,82.6,39.1,13.26,13111.214,322.688,10.08,0.757,0
117,201,594,23201,3,824,0,0,0,2083380,82.6,39.1,13.26,13111.214,322.688,10.08,0.757,0
117,202,427,23628,10,834,0,0,0,2083380,82.6,39.1,13.26,13111.214,322.688,10.08,0.757,0
117,203,160,23788,12,846,0,0,0,2083380,82.6,39.1,13.26,13111.214,322.688,10.08,0.757,0
117,204,408,24196,4,850,0,0,0,2083380,82.6,39.1,13.26,13111.214,322.688,10.08,0.757,0
118,1,2,46,0,0,0,0,91.67,27691019,43.951,19.6,2.929,1416.44,405.994,3.94,0.519,4
118,2,8,54,0,0,0,0,91.67,27691019,43.951,19.6,2.929,1416.44,405.994,3.94,0.519,4
118,3,5,59,0,0,0,0,91.67,27691019,43.951,19.6,2.929,1416.44,405.994,3.94,0.519,4
118,4,6,65,0,0,0,0,91.67,27691019,43.951,19.6,2.929,1416.44,405.994,3.94,0.519,4
118,5,6,71,0,0,0,0,95.37,27691019,43.951,19.6,2.929,1416.44,405.994,3.94,0.519,4
118,6,1,72,0,0,0,0,95.37,27691019,43.951,19.6,2.929,1416.44,405.994,3.94,0.519,4
118,7,5,77,0,0,0,0,95.37,27691019,43.951,19.6,2.929,1416.44,405.994,3.94,0.519,4
118,8,8,85,0,0,0,0,95.37,27691019,43.951,19.6,2.929,1416.44,405.994,3.94,0.519,4
118,9,8,93,0,0,0,0,95.37,27691019,43.951,19.6,2.929,1416.44,405.994,3.94,0.519,4
118,10,0,93,0,0,0,0,95.37,27691019,43.951,19.6,2.929,1416.44,405.994,3.94,0.519,4
118,11,9,102,0,0,0,0,95.37,27691019,43.951,19.6,2.929,1416.44,405.994,3.94,0.519,4
118,12,0,102,0,0,0,0,95.37,27691019,43.951,19.6,2.929,1416.44,405.994,3.94,0.519,4
118,13,4,106,0,0,0,0,95.37,27691019,43.951,19.6,2.929,1416.44,405.994,3.94,0.519,4
118,14,0,106,0,0,0,0,95.37,27691019,43.951,19.6,2.929,1416.44,405.994,3.94,0.519,4
118,15,2,108,0,0,0,0,95.37,27691019,43.951,19.6,2.929,1416.44,405.994,3.94,0.519,4
118,16,2,110,0,0,0,0,95.37,27691019,43.951,19.6,2.929,1416.44,405.994,3.94,0.519,4
118,17,1,111,0,0,0,0,95.37,27691019,43.951,19.6,2.929,1416.44,405.994,3.94,0.519,4
118,18,6,117,0,0,0,0,95.37,27691019,43.951,19.6,2.929,1416.44,405.994,3.94,0.519,4
118,19,0,117,0,0,0,0,95.37,27691019,43.951,19.6,2.929,1416.44,405.994,3.94,0.519,4
118,20,4,121,0,0,0,0,72.22,27691019,43.951,19.6,2.929,1416.44,405.994,3.94,0.519,4
118,21,0,121,0,0,0,0,72.22,27691019,43.951,19.6,2.929,1416.44,405.994,3.94,0.519,4
118,22,0,121,0,0,0,0,70.37,27691019,43.951,19.6,2.929,1416.44,405.994,3.94,0.519,4
118,23,0,121,0,0,0,0,70.37,27691019,43.951,19.6,2.929,1416.44,405.994,3.94,0.519,4
118,24,0,121,0,0,0,0,70.37,27691019,43.951,19.6,2.929,1416.44,405.994,3.94,0.519,4
118,25,1,122,0,0,0,0,70.37,27691019,43.951,19.6,2.929,1416.44,405.994,3.94,0.519,4
118,26,2,124,0,0,0,0,70.37,27691019,43.951,19.6,2.929,1416.44,405.994,3.94,0.519,4
118,27,0,124,0,0,0,0,67.59,27691019,43.951,19.6,2.929,1416.44,405.994,3.94,0.519,4
118,28,4,128,0,0,0,3065,67.59,27691019,43.951,19.6,2.929,1416.44,405.994,3.94,0.519,4
118,29,0,128,0,0,42,3107,67.59,27691019,43.951,19.6,2.929,1416.44,405.994,3.94,0.519,4
118,30,0,128,0,0,121,3228,67.59,27691019,43.951,19.6,2.929,1416.44,405.994,3.94,0.519,4
118,31,4,132,0,0,72,3300,67.59,27691019,43.951,19.6,2.929,1416.44,405.994,3.94,0.519,4
118,32,3,135,0,0,0,3300,67.59,27691019,43.951,19.6,2.929,1416.44,405.994,3.94,0.519,4
118,33,0,135,0,0,0,3300,67.59,27691019,43.951,19.6,2.929,1416.44,405.994,3.94,0.519,4
118,34,14,149,0,0,0,3300,67.59,27691019,43.951,19.6,2.929,1416.44,405.994,3.94,0.519,4
118,35,0,149,0,0,0,3861,67.59,27691019,43.951,19.6,2.929,1416.44,405.994,3.94,0.519,4
118,36,9,158,0,0,0,3861,67.59,27691019,43.951,19.6,2.929,1416.44,405.994,3.94,0.519,4
118,37,0,158,0,0,0,3968,67.59,27691019,43.951,19.6,2.929,1416.44,405.994,3.94,0.519,4
118,38,11,169,0,0,0,3968,67.59,27691019,43.951,19.6,2.929,1416.44,405.994,3.94,0.519,4
118,39,0,169,0,0,0,3968,67.59,27691019,43.951,19.6,2.929,1416.44,405.994,3.94,0.519,4
118,40,0,169,0,0,0,4481,67.59,27691019,43.951,19.6,2.929,1416.44,405.994,3.94,0.519,4
118,41,2,171,0,0,984,5465,67.59,27691019,43.951,19.6,2.929,1416.44,405.994,3.94,0.519,4
118,42,15,186,0,0,0,5465,70.37,27691019,43.951,19.6,2.929,1416.44,405.994,3.94,0.519,4
118,43,6,192,0,0,0,5465,70.37,27691019,43.951,19.6,2.929,1416.44,405.994,3.94,0.519,4
118,44,20,212,0,0,0,5465,70.37,27691019,43.951,19.6,2.929,1416.44,405.994,3.94,0.519,4
118,45,18,230,0,0,0,5465,70.37,27691019,43.951,19.6,2.929,1416.44,405.994,3.94,0.519,4
118,46,8,238,0,0,0,5465,70.37,27691019,43.951,19.6,2.929,1416.44,405.994,3.94,0.519,4
118,47,45,283,0,0,0,5465,70.37,27691019,43.951,19.6,2.929,1416.44,405.994,3.94,0.519,4
118,48,21,304,1,1,0,5465,70.37,27691019,43.951,19.6,2.929,1416.44,405.994,3.94,0.519,4
118,49,18,322,0,1,0,5465,70.37,27691019,43.951,19.6,2.929,1416.44,405.994,3.94,0.519,4
118,50,4,326,1,2,0,5465,70.37,27691019,43.951,19.6,2.929,1416.44,405.994,3.94,0.519,4
118,51,45,371,0,2,0,5465,70.37,27691019,43.951,19.6,2.929,1416.44,405.994,3.94,0.519,4
118,52,34,405,0,2,0,5465,70.37,27691019,43.951,19.6,2.929,1416.44,405.994,3.94,0.519,4
118,53,43,448,0,2,0,5465,70.37,27691019,43.951,19.6,2.929,1416.44,405.994,3.94,0.519,4
118,54,0,448,0,2,0,5465,70.37,27691019,43.951,19.6,2.929,1416.44,405.994,3.94,0.519,4
118,55,79,527,0,2,0,5465,70.37,27691019,43.951,19.6,2.929,1416.44,405.994,3.94,0.519,4
118,56,15,542,0,2,0,5465,70.37,27691019,43.951,19.6,2.929,1416.44,405.994,3.94,0.519,4
118,57,44,586,0,2,0,9681,70.37,27691019,43.951,19.6,2.929,1416.44,405.994,3.94,0.519,4
118,58,26,612,0,2,167,9848,70.37,27691019,43.951,19.6,2.929,1416.44,405.994,3.94,0.519,4
118,59,44,656,0,2,401,10249,70.37,27691019,43.951,19.6,2.929,1416.44,405.994,3.94,0.519,4
118,60,42,698,3,5,0,10249,70.37,27691019,43.951,19.6,2.929,1416.44,405.994,3.94,0.519,4
118,61,60,758,1,6,0,11311,70.37,27691019,43.951,19.6,2.929,1416.44,405.994,3.94,0.519,4
118,62,13,771,0,6,0,11311,70.37,27691019,43.951,19.6,2.929,1416.44,405.994,3.94,0.519,4
118,63,55,826,0,6,0,11954,70.37,27691019,43.951,19.6,2.929,1416.44,405.994,3.94,0.519,4
118,64,19,845,0,6,0,11954,70.37,27691019,43.951,19.6,2.929,1416.44,405.994,3.94,0.519,4
118,65,63,908,0,6,0,11954,70.37,27691019,43.951,19.6,2.929,1416.44,405.994,3.94,0.519,4
118,66,49,957,1,7,0,11954,70.37,27691019,43.951,19.6,2.929,1416.44,405.994,3.94,0.519,4
118,67,18,975,0,7,0,11954,70.37,27691019,43.951,19.6,2.929,1416.44,405.994,3.94,0.519,4
118,68,51,1026,1,8,0,13608,70.37,27691019,43.951,19.6,2.929,1416.44,405.994,3.94,0.519,4
118,69,26,1052,1,9,0,13608,70.37,27691019,43.951,19.6,2.929,1416.44,405.994,3.94,0.519,4
118,70,42,1094,0,9,0,13608,70.37,27691019,43.951,19.6,2.929,1416.44,405.994,3.94,0.519,4
118,71,44,1138,0,9,0,13608,70.37,27691019,43.951,19.6,2.929,1416.44,405.994,3.94,0.519,4
118,72,24,1162,1,10,0,13608,70.37,27691019,43.951,19.6,2.929,1416.44,405.994,3.94,0.519,4
118,73,41,1203,0,10,0,13608,70.37,27691019,43.951,19.6,2.929,1416.44,405.994,3.94,0.519,4
118,74,27,1230,0,10,0,13608,70.37,27691019,43.951,19.6,2.929,1416.44,405.994,3.94,0.519,4
118,75,22,1252,0,10,0,13608,70.37,27691019,43.951,19.6,2.929,1416.44,405.994,3.94,0.519,4
118,76,20,1272,0,10,0,15981,70.37,27691019,43.951,19.6,2.929,1416.44,405.994,3.94,0.519,4
118,77,18,1290,0,10,0,15981,70.37,27691019,43.951,19.6,2.929,1416.44,405.994,3.94,0.519,4
118,78,27,1317,2,12,0,16402,70.37,27691019,43.951,19.6,2.929,1416.44,405.994,3.94,0.519,4
118,79,61,1378,0,12,0,16402,70.37,27691019,43.951,19.6,2.929,1416.44,405.994,3.94,0.519,4
118,80,25,1403,1,13,0,17905,70.37,27691019,43.951,19.6,2.929,1416.44,405.994,3.94,0.519,4
118,81,40,1443,0,13,0,17905,70.37,27691019,43.951,19.6,2.929,1416.44,405.994,3.94,0.519,4
118,82,60,1503,0,13,0,18119,70.37,27691019,43.951,19.6,2.929,1416.44,405.994,3.94,0.519,4
118,83,93,1596,1,14,622,18741,70.37,27691019,43.951,19.6,2.929,1416.44,405.994,3.94,0.519,4
118,84,44,1640,1,15,0,18741,70.37,27691019,43.951,19.6,2.929,1416.44,405.994,3.94,0.519,4
118,85,84,1724,0,15,0,19392,70.37,27691019,43.951,19.6,2.929,1416.44,405.994,3.94,0.519,4
118,86,63,1787,1,16,0,19392,70.37,27691019,43.951,19.6,2.929,1416.44,405.994,3.94,0.519,4
118,87,42,1829,0,16,0,20066,70.37,27691019,43.951,19.6,2.929,1416.44,405.994,3.94,0.519,4
118,88,93,1922,0,16,0,20066,68.98,27691019,43.951,19.6,2.929,1416.44,405.994,3.94,0.519,4
118,89,83,2005,0,16,0,20964,68.98,27691019,43.951,19.6,2.929,1416.44,405.994,3.94,0.519,4
118,90,73,2078,2,18,480,21444,68.98,27691019,43.951,19.6,2.929,1416.44,405.994,3.94,0.519,4
118,91,60,2138,2,20,0,21444,68.98,27691019,43.951,19.6,2.929,1416.44,405.994,3.94,0.519,4
118,92,76,2214,0,20,0,21444,68.98,27691019,43.951,19.6,2.929,1416.44,405.994,3.94,0.519,4
118,93,89,2303,2,22,0,21444,68.98,27691019,43.951,19.6,2.929,1416.44,405.994,3.94,0.519,4
118,94,100,2403,2,24,0,23244,68.98,27691019,43.951,19.6,2.929,1416.44,405.994,3.94,0.519,4
118,95,109,2512,2,26,0,23244,68.98,27691019,43.951,19.6,2.929,1416.44,405.994,3.94,0.519,4
118,96,216,2728,3,29,0,23244,68.98,27691019,43.951,19.6,2.929,1416.44,405.994,3.94,0.519,4
118,97,0,2728,0,29,0,25286,68.98,27691019,43.951,19.6,2.929,1416.44,405.994,3.94,0.519,4
118,98,522,3250,4,33,0,25286,68.98,27691019,43.951,19.6,2.929,1416.44,405.994,3.94,0.519,4
118,99,222,3472,0,33,0,25286,68.98,27691019,43.951,19.6,2.929,1416.44,405.994,3.94,0.519,4
118,100,101,3573,0,33,0,25286,68.98,27691019,43.951,19.6,2.929,1416.44,405.994,3.94,0.519,4
118,101,209,3782,0,33,0,27504,68.98,27691019,43.951,19.6,2.929,1416.44,405.994,3.94,0.519,4
118,102,361,4143,1,34,0,27504,68.98,27691019,43.951,19.6,2.929,1416.44,405.994,3.94,0.519,4
118,103,435,4578,0,34,0,27504,68.98,27691019,43.951,19.6,2.929,1416.44,405.994,3.94,0.519,4
118,104,289,4867,1,35,0,27504,68.98,27691019,43.951,19.6,2.929,1416.44,405.994,3.94,0.519,4
118,105,213,5080,2,37,0,27504,68.98,27691019,43.951,19.6,2.929,1416.44,405.994,3.94,0.519,4
118,106,263,5343,2,39,0,30530,68.98,27691019,43.951,19.6,2.929,1416.44,405.994,3.94,0.519,4
118,107,262,5605,4,43,766,31296,68.98,27691019,43.951,19.6,2.929,1416.44,405.994,3.94,0.519,4
118,108,484,6089,10,53,0,31296,68.98,27691019,43.951,19.6,2.929,1416.44,405.994,3.94,0.519,4
118,109,378,6467,1,54,0,31296,68.98,27691019,43.951,19.6,2.929,1416.44,405.994,3.94,0.519,4
118,110,382,6849,1,55,0,32851,68.98,27691019,43.951,19.6,2.929,1416.44,405.994,3.94,0.519,4
118,111,200,7049,4,59,0,32851,68.98,27691019,43.951,19.6,2.929,1416.44,405.994,3.94,0.519,4
118,112,104,7153,3,62,0,32851,68.98,27691019,43.951,19.6,2.929,1416.44,405.994,3.94,0.519,4
118,113,395,7548,3,65,0,32851,68.98,27691019,43.951,19.6,2.929,1416.44,405.994,3.94,0.519,4
118,114,614,8162,4,69,0,32851,68.98,27691019,43.951,19.6,2.929,1416.44,405.994,3.94,0.519,4
118,115,219,8381,1,70,0,36773,68.98,27691019,43.951,19.6,2.929,1416.44,405.994,3.94,0.519,4
118,116,360,8741,6,76,372,37145,68.98,27691019,43.951,19.6,2.929,1416.44,405.994,3.94,0.519,4
118,117,125,8866,2,78,776,37921,68.98,27691019,43.951,19.6,2.929,1416.44,405.994,3.94,0.519,4
118,118,429,9295,7,85,0,37921,68.98,27691019,43.951,19.6,2.929,1416.44,405.994,3.94,0.519,4
118,119,395,9690,6,91,0,37921,68.98,27691019,43.951,19.6,2.929,1416.44,405.994,3.94,0.519,4
118,120,414,10104,2,93,0,39864,68.98,27691019,43.951,19.6,2.929,1416.44,405.994,3.94,0.519,4
118,121,213,10317,6,99,905,40769,68.98,27691019,43.951,19.6,2.929,1416.44,405.994,3.94,0.519,4
118,122,431,10748,6,105,0,40769,68.98,27691019,43.951,19.6,2.929,1416.44,405.994,3.94,0.519,4
118,123,120,10868,1,106,0,40769,68.98,27691019,43.951,19.6,2.929,1416.44,405.994,3.94,0.519,4
118,124,405,11273,1,107,0,40769,68.98,27691019,43.951,19.6,2.929,1416.44,405.994,3.94,0.519,4
118,125,255,11528,7,114,0,40769,68.98,27691019,43.951,19.6,2.929,1416.44,405.994,3.94,0.519,4
118,126,132,11660,4,118,0,44805,68.98,27691019,43.951,19.6,2.929,1416.44,405.994,3.94,0.519,4
118,127,235,11895,5,123,829,45634,68.98,27691019,43.951,19.6,2.929,1416.44,405.994,3.94,0.519,4
118,128,327,12222,4,127,667,46301,68.98,27691019,43.951,19.6,2.929,1416.44,405.994,3.94,0.519,4
118,129,304,12526,7,134,721,47022,68.98,27691019,43.951,19.6,2.929,1416.44,405.994,3.94,0.519,4
118,130,182,12708,1,135,737,47759,68.98,27691019,43.951,19.6,2.929,1416.44,405.994,3.94,0.519,4
118,131,214,12922,6,141,739,48498,68.98,27691019,43.951,19.6,2.929,1416.44,405.994,3.94,0.519,4
118,132,164,13086,7,148,730,49228,67.59,27691019,43.951,19.6,2.929,1416.44,405.994,3.94,0.519,4
118,133,116,13202,3,151,514,49742,67.59,27691019,43.951,19.6,2.929,1416.44,405.994,3.94,0.519,4
118,134,115,13317,1,152,215,49957,67.59,27691019,43.951,19.6,2.929,1416.44,405.994,3.94,0.519,4
118,135,80,13397,4,156,536,50493,67.59,27691019,43.951,19.6,2.929,1416.44,405.994,3.94,0.519,4
118,136,125,13522,6,162,476,50969,65.74,27691019,43.951,19.6,2.929,1416.44,405.994,3.94,0.519,4
118,137,121,13643,2,164,590,51559,65.74,27691019,43.951,19.6,2.929,1416.44,405.994,3.94,0.519,4
118,138,81,13724,2,166,762,52321,65.74,27691019,43.951,19.6,2.929,1416.44,405.994,3.94,0.519,4
118,139,103,13827,4,170,336,52657,65.74,27691019,43.951,19.6,2.929,1416.44,405.994,3.94,0.519,4
118,140,59,13886,1,171,621,53278,65.74,27691019,43.951,19.6,2.929,1416.44,405.994,3.94,0.519,4
118,141,123,14009,2,173,264,53542,65.74,27691019,43.951,19.6,2.929,1416.44,405.994,3.94,0.519,4
118,142,65,14074,0,173,412,53954,65.74,27691019,43.951,19.6,2.929,1416.44,405.994,3.94,0.519,4
118,143,80,14154,4,177,478,54432,70.37,27691019,43.951,19.6,2.929,1416.44,405.994,3.94,0.519,4
118,144,64,14218,1,178,259,54691,70.37,27691019,43.951,19.6,2.929,1416.44,405.994,3.94,0.519,4
118,145,59,14277,0,178,327,55018,70.37,27691019,43.951,19.6,2.929,1416.44,405.994,3.94,0.519,4
118,146,50,14327,0,178,357,55375,70.37,27691019,43.951,19.6,2.929,1416.44,405.994,3.94,0.519,4
118,147,75,14402,0,178,351,55726,70.37,27691019,43.951,19.6,2.929,1416.44,405.994,3.94,0.519,4
118,148,73,14475,0,178,339,56065,70.37,27691019,43.951,19.6,2.929,1416.44,405.994,3.94,0.519,4
118,149,79,14554,3,181,138,56203,59.26,27691019,43.951,19.6,2.929,1416.44,405.994,3.94,0.519,4
118,150,38,14592,3,184,414,56617,59.26,27691019,43.951,19.6,2.929,1416.44,405.994,3.94,0.519,4
118,151,104,14696,3,187,637,57254,59.26,27691019,43.951,19.6,2.929,1416.44,405.994,3.94,0.519,4
118,152,95,14791,3,190,482,57736,59.26,27691019,43.951,19.6,2.929,1416.44,405.994,3.94,0.519,4
118,153,52,14843,1,191,191,57927,58.33,27691019,43.951,19.6,2.929,1416.44,405.994,3.94,0.519,4
118,154,20,14863,1,192,532,58459,58.33,27691019,43.951,19.6,2.929,1416.44,405.994,3.94,0.519,4
118,155,94,14957,3,195,0,58459,58.33,27691019,43.951,19.6,2.929,1416.44,405.994,3.94,0.519,4
118,156,66,15023,1,196,0,58459,58.33,27691019,43.951,19.6,2.929,1416.44,405.994,3.94,0.519,4
118,157,83,15106,1,197,0,58459,58.33,27691019,43.951,19.6,2.929,1416.44,405.994,3.94,0.519,4
118,158,81,15187,1,198,0,60482,58.33,27691019,43.951,19.6,2.929,1416.44,405.994,3.94,0.519,4
118,159,82,15269,1,199,413,60895,58.33,27691019,43.951,19.6,2.929,1416.44,405.994,3.94,0.519,4
118,160,50,15319,1,200,0,60895,58.33,27691019,43.951,19.6,2.929,1416.44,405.994,3.94,0.519,4
118,161,33,15352,2,202,0,60895,58.33,27691019,43.951,19.6,2.929,1416.44,405.994,3.94,0.519,4
118,162,83,15435,4,206,0,62150,58.33,27691019,43.951,19.6,2.929,1416.44,405.994,3.94,0.519,4
118,163,85,15520,0,206,0,62150,58.33,27691019,43.951,19.6,2.929,1416.44,405.994,3.94,0.519,4
118,164,104,15624,2,208,0,63222,56.48,27691019,43.951,19.6,2.929,1416.44,405.994,3.94,0.519,4
118,165,45,15669,1,209,516,63738,56.48,27691019,43.951,19.6,2.929,1416.44,405.994,3.94,0.519,4
118,166,68,15737,1,210,436,64174,56.48,27691019,43.951,19.6,2.929,1416.44,405.994,3.94,0.519,4
118,167,20,15757,1,211,502,64676,56.48,27691019,43.951,19.6,2.929,1416.44,405.994,3.94,0.519,4
118,168,12,15769,2,213,469,65145,56.48,27691019,43.951,19.6,2.929,1416.44,405.994,3.94,0.519,4
118,169,34,15803,1,214,369,65514,56.48,27691019,43.951,19.6,2.929,1416.44,405.994,3.94,0.519,4
118,170,68,15871,1,215,0,65514,56.48,27691019,43.951,19.6,2.929,1416.44,405.994,3.94,0.519,4
118,171,0,15871,0,215,0,66460,56.48,27691019,43.951,19.6,2.929,1416.44,405.994,3.94,0.519,4
118,172,100,15971,2,217,571,67031,56.48,27691019,43.951,19.6,2.929,1416.44,405.994,3.94,0.519,4
118,173,49,16020,2,219,365,67396,56.48,27691019,43.951,19.6,2.929,1416.44,405.994,3.94,0.519,4
118,174,33,16053,4,223,439,67835,56.48,27691019,43.951,19.6,2.929,1416.44,405.994,3.94,0.519,4
118,175,20,16073,2,225,540,68375,56.48,27691019,43.951,19.6,2.929,1416.44,405.994,3.94,0.519,4
118,176,63,16136,1,226,189,68564,56.48,27691019,43.951,19.6,2.929,1416.44,405.994,3.94,0.519,4
118,177,31,16167,0,226,223,68787,56.48,27691019,43.951,19.6,2.929,1416.44,405.994,3.94,0.519,4
118,178,24,16191,1,227,238,69025,56.48,27691019,43.951,19.6,2.929,1416.44,405.994,3.94,0.519,4
118,179,30,16221,1,228,0,69025,56.48,27691019,43.951,19.6,2.929,1416.44,405.994,3.94,0.519,4
118,180,36,16257,1,229,0,69988,56.48,27691019,43.951,19.6,2.929,1416.44,405.994,3.94,0.519,4
118,181,28,16285,0,229,293,70281,56.48,27691019,43.951,19.6,2.929,1416.44,405.994,3.94,0.519,4
118,182,63,16348,0,229,297,70578,56.48,27691019,43.951,19.6,2.929,1416.44,405.994,3.94,0.519,4
118,183,29,16377,0,229,372,70950,56.48,27691019,43.951,19.6,2.929,1416.44,405.994,3.94,0.519,4
118,184,31,16408,1,230,139,71089,48.15,27691019,43.951,19.6,2.929,1416.44,405.994,3.94,0.519,4
118,185,46,16454,2,232,745,71834,48.15,27691019,43.951,19.6,2.929,1416.44,405.994,3.94,0.519,4
118,186,39,16493,0,232,394,72228,48.15,27691019,43.951,19.6,2.929,1416.44,405.994,3.94,0.519,4
118,187,36,16529,0,232,344,72572,48.15,27691019,43.951,19.6,2.929,1416.44,405.994,3.94,0.519,4
118,188,29,16558,0,232,481,73053,40.74,27691019,43.951,19.6,2.929,1416.44,405.994,3.94,0.519,4
118,189,12,16570,1,233,384,73437,40.74,27691019,43.951,19.6,2.929,1416.44,405.994,3.94,0.519,4
118,190,30,16600,1,234,0,73437,40.74,27691019,43.951,19.6,2.929,1416.44,405.994,3.94,0.519,4
118,191,33,16633,1,235,0,74020,40.74,27691019,43.951,19.6,2.929,1416.44,405.994,3.94,0.519,4
118,192,21,16654,0,235,204,74224,40.74,27691019,43.951,19.6,2.929,1416.44,405.994,3.94,0.519,4
118,193,22,16676,2,237,222,74446,40.74,27691019,43.951,19.6,2.929,1416.44,405.994,3.94,0.519,4
118,194,26,16702,0,237,0,74446,40.74,27691019,43.951,19.6,2.929,1416.44,405.994,3.94,0.519,4
118,195,16,16718,0,237,0,75210,40.74,27691019,43.951,19.6,2.929,1416.44,405.994,3.94,0.519,4
118,196,8,16726,0,237,427,75637,40.74,27691019,43.951,19.6,2.929,1416.44,405.994,3.94,0.519,4
118,197,28,16754,0,237,0,75637,40.74,27691019,43.951,19.6,2.929,1416.44,405.994,3.94,0.519,4
118,198,0,16754,0,237,0,75637,40.74,27691019,43.951,19.6,2.929,1416.44,405.994,3.94,0.519,4
118,199,0,16754,0,237,0,85407,40.74,27691019,43.951,19.6,2.929,1416.44,405.994,3.94,0.519,4
118,200,0,16754,0,237,0,85407,40.74,27691019,43.951,19.6,2.929,1416.44,405.994,3.94,0.519,4
118,201,56,16810,1,238,0,85407,40.74,27691019,43.951,19.6,2.929,1416.44,405.994,3.94,0.519,4
118,202,0,16810,0,238,0,85407,40.74,27691019,43.951,19.6,2.929,1416.44,405.994,3.94,0.519,4
118,203,0,16810,0,238,0,85407,40.74,27691019,43.951,19.6,2.929,1416.44,405.994,3.94,0.519,4
118,204,0,16810,0,238,0,85407,40.74,27691019,43.951,19.6,2.929,1416.44,405.994,3.94,0.519,4
119,1,0,0,0,0,0,86,52.78,19129955,197.519,18.1,2.979,1095.042,227.349,3.94,0.477,0
119,2,0,0,0,0,2,88,52.78,19129955,197.519,18.1,2.979,1095.042,227.349,3.94,0.477,0
119,3,3,3,0,0,5,93,52.78,19129955,197.519,18.1,2.979,1095.042,227.349,3.94,0.477,0
119,4,0,3,0,0,29,122,56.48,19129955,197.519,18.1,2.979,1095.042,227.349,3.94,0.477,0
119,5,1,4,0,0,1,123,56.48,19129955,197.519,18.1,2.979,1095.042,227.349,3.94,0.477,0
119,6,0,4,0,0,20,143,56.48,19129955,197.519,18.1,2.979,1095.042,227.349,3.94,0.477,0
119,7,1,5,0,0,2,145,56.48,19129955,197.519,18.1,2.979,1095.042,227.349,3.94,0.477,0
119,8,3,8,1,1,79,224,56.48,19129955,197.519,18.1,2.979,1095.042,227.349,3.94,0.477,0
119,9,0,8,0,1,7,231,56.48,19129955,197.519,18.1,2.979,1095.042,227.349,3.94,0.477,0
119,10,0,8,0,1,56,287,56.48,19129955,197.519,18.1,2.979,1095.042,227.349,3.94,0.477,0
119,11,1,9,0,1,27,314,56.48,19129955,197.519,18.1,2.979,1095.042,227.349,3.94,0.477,0
119,12,3,12,1,2,0,314,56.48,19129955,197.519,18.1,2.979,1095.042,227.349,3.94,0.477,0
119,13,1,13,0,2,0,343,56.48,19129955,197.519,18.1,2.979,1095.042,227.349,3.94,0.477,0
119,14,3,16,0,2,0,343,56.48,19129955,197.519,18.1,2.979,1095.042,227.349,3.94,0.477,0
119,15,0,16,0,2,0,353,56.48,19129955,197.519,18.1,2.979,1095.042,227.349,3.94,0.477,0
119,16,0,16,0,2,64,417,56.48,19129955,197.519,18.1,2.979,1095.042,227.349,3.94,0.477,0
119,17,0,16,0,2,7,424,56.48,19129955,197.519,18.1,2.979,1095.042,227.349,3.94,0.477,0
119,18,1,17,0,2,5,429,60.19,19129955,197.519,18.1,2.979,1095.042,227.349,3.94,0.477,0
119,19,0,17,0,2,0,429,60.19,19129955,197.519,18.1,2.979,1095.042,227.349,3.94,0.477,0
119,20,0,17,0,2,0,460,60.19,19129955,197.519,18.1,2.979,1095.042,227.349,3.94,0.477,0
119,21,0,17,0,2,59,519,60.19,19129955,197.519,18.1,2.979,1095.042,227.349,3.94,0.477,0
119,22,1,18,0,2,34,553,60.19,19129955,197.519,18.1,2.979,1095.042,227.349,3.94,0.477,0
119,23,5,23,1,3,13,566,60.19,19129955,197.519,18.1,2.979,1095.042,227.349,3.94,0.477,0
119,24,10,33,0,3,51,617,60.19,19129955,197.519,18.1,2.979,1095.042,227.349,3.94,0.477,0
119,25,0,33,0,3,47,664,60.19,19129955,197.519,18.1,2.979,1095.042,227.349,3.94,0.477,0
119,26,0,33,0,3,26,690,60.19,19129955,197.519,18.1,2.979,1095.042,227.349,3.94,0.477,0
119,27,1,34,0,3,13,703,60.19,19129955,197.519,18.1,2.979,1095.042,227.349,3.94,0.477,0
119,28,2,36,0,3,41,744,60.19,19129955,197.519,18.1,2.979,1095.042,227.349,3.94,0.477,0
119,29,0,36,0,3,30,774,60.19,19129955,197.519,18.1,2.979,1095.042,227.349,3.94,0.477,0
119,30,0,36,0,3,57,831,60.19,19129955,197.519,18.1,2.979,1095.042,227.349,3.94,0.477,0
119,31,1,37,0,3,67,898,60.19,19129955,197.519,18.1,2.979,1095.042,227.349,3.94,0.477,0
119,32,0,37,0,3,9,907,60.19,19129955,197.519,18.1,2.979,1095.042,227.349,3.94,0.477,0
119,33,1,38,0,3,8,915,60.19,19129955,197.519,18.1,2.979,1095.042,227.349,3.94,0.477,0
119,34,1,39,0,3,46,961,60.19,19129955,197.519,18.1,2.979,1095.042,227.349,3.94,0.477,0
119,35,2,41,0,3,71,1032,60.19,19129955,197.519,18.1,2.979,1095.042,227.349,3.94,0.477,0
119,36,0,41,0,3,41,1073,60.19,19129955,197.519,18.1,2.979,1095.042,227.349,3.94,0.477,0
119,37,2,43,0,3,79,1152,60.19,19129955,197.519,18.1,2.979,1095.042,227.349,3.94,0.477,0
119,38,0,43,0,3,79,1231,60.19,19129955,197.519,18.1,2.979,1095.042,227.349,3.94,0.477,0
119,39,0,43,0,3,56,1287,60.19,19129955,197.519,18.1,2.979,1095.042,227.349,3.94,0.477,0
119,40,13,56,0,3,50,1337,60.19,19129955,197.519,18.1,2.979,1095.042,227.349,3.94,0.477,0
119,41,0,56,0,3,26,1363,60.19,19129955,197.519,18.1,2.979,1095.042,227.349,3.94,0.477,0
119,42,1,57,0,3,0,1363,60.19,19129955,197.519,18.1,2.979,1095.042,227.349,3.94,0.477,0
119,43,1,58,0,3,0,1621,60.19,19129955,197.519,18.1,2.979,1095.042,227.349,3.94,0.477,0
119,44,5,63,0,3,75,1696,60.19,19129955,197.519,18.1,2.979,1095.042,227.349,3.94,0.477,0
119,45,0,63,0,3,66,1762,60.19,19129955,197.519,18.1,2.979,1095.042,227.349,3.94,0.477,0
119,46,0,63,0,3,41,1803,60.19,19129955,197.519,18.1,2.979,1095.042,227.349,3.94,0.477,0
119,47,2,65,0,3,119,1922,60.19,19129955,197.519,18.1,2.979,1095.042,227.349,3.94,0.477,0
119,48,5,70,0,3,51,1973,60.19,19129955,197.519,18.1,2.979,1095.042,227.349,3.94,0.477,0
119,49,0,70,0,3,122,2095,60.19,19129955,197.519,18.1,2.979,1095.042,227.349,3.94,0.477,0
119,50,1,71,0,3,181,2276,60.19,19129955,197.519,18.1,2.979,1095.042,227.349,3.94,0.477,0
119,51,1,72,0,3,135,2411,60.19,19129955,197.519,18.1,2.979,1095.042,227.349,3.94,0.477,0
119,52,0,72,0,3,193,2604,60.19,19129955,197.519,18.1,2.979,1095.042,227.349,3.94,0.477,0
119,53,10,82,0,3,370,2974,60.19,19129955,197.519,18.1,2.979,1095.042,227.349,3.94,0.477,0
119,54,1,83,1,4,0,2974,60.19,19129955,197.519,18.1,2.979,1095.042,227.349,3.94,0.477,0
119,55,0,83,0,4,0,3372,60.19,19129955,197.519,18.1,2.979,1095.042,227.349,3.94,0.477,0
119,56,18,101,0,4,0,3372,60.19,19129955,197.519,18.1,2.979,1095.042,227.349,3.94,0.477,0
119,57,0,101,0,4,0,3975,60.19,19129955,197.519,18.1,2.979,1095.042,227.349,3.94,0.477,0
119,58,0,101,0,4,336,4311,60.19,19129955,197.519,18.1,2.979,1095.042,227.349,3.94,0.477,0
119,59,102,203,0,4,179,4490,60.19,19129955,197.519,18.1,2.979,1095.042,227.349,3.94,0.477,0
119,60,70,273,0,4,100,4590,60.19,19129955,197.519,18.1,2.979,1095.042,227.349,3.94,0.477,0
119,61,6,279,0,4,557,5147,60.19,19129955,197.519,18.1,2.979,1095.042,227.349,3.94,0.477,0
119,62,5,284,0,4,358,5505,60.19,19129955,197.519,18.1,2.979,1095.042,227.349,3.94,0.477,0
119,63,52,336,0,4,241,5746,60.19,19129955,197.519,18.1,2.979,1095.042,227.349,3.94,0.477,0
119,64,22,358,0,4,154,5900,60.19,19129955,197.519,18.1,2.979,1095.042,227.349,3.94,0.477,0
119,65,11,369,0,4,272,6172,60.19,19129955,197.519,18.1,2.979,1095.042,227.349,3.94,0.477,0
119,66,24,393,0,4,116,6288,60.19,19129955,197.519,18.1,2.979,1095.042,227.349,3.94,0.477,0
119,67,16,409,0,4,135,6423,60.19,19129955,197.519,18.1,2.979,1095.042,227.349,3.94,0.477,0
119,68,0,409,0,4,123,6546,60.19,19129955,197.519,18.1,2.979,1095.042,227.349,3.94,0.477,0
119,69,29,438,0,4,144,6690,60.19,19129955,197.519,18.1,2.979,1095.042,227.349,3.94,0.477,0
119,70,5,443,0,4,95,6785,60.19,19129955,197.519,18.1,2.979,1095.042,227.349,3.94,0.477,0
119,71,12,455,0,4,224,7009,60.19,19129955,197.519,18.1,2.979,1095.042,227.349,3.94,0.477,0
119,72,0,455,0,4,72,7081,60.19,19129955,197.519,18.1,2.979,1095.042,227.349,3.94,0.477,0
119,73,26,481,0,4,922,8003,60.19,19129955,197.519,18.1,2.979,1095.042,227.349,3.94,0.477,0
119,74,0,481,0,4,348,8351,60.19,19129955,197.519,18.1,2.979,1095.042,227.349,3.94,0.477,0
119,75,48,529,1,5,87,8438,60.19,19129955,197.519,18.1,2.979,1095.042,227.349,3.94,0.477,0
119,76,18,547,1,6,204,8642,60.19,19129955,197.519,18.1,2.979,1095.042,227.349,3.94,0.477,0
119,77,9,556,0,6,262,8904,60.19,19129955,197.519,18.1,2.979,1095.042,227.349,3.94,0.477,0
119,78,8,564,0,6,125,9029,60.19,19129955,197.519,18.1,2.979,1095.042,227.349,3.94,0.477,0
119,79,8,572,0,6,446,9475,60.19,19129955,197.519,18.1,2.979,1095.042,227.349,3.94,0.477,0
119,80,20,592,2,8,0,9475,60.19,19129955,197.519,18.1,2.979,1095.042,227.349,3.94,0.477,0
119,81,28,620,0,8,0,9475,60.19,19129955,197.519,18.1,2.979,1095.042,227.349,3.94,0.477,0
119,82,0,620,0,8,0,9475,60.19,19129955,197.519,18.1,2.979,1095.042,227.349,3.94,0.477,0
119,83,110,730,3,11,0,11114,60.19,19129955,197.519,18.1,2.979,1095.042,227.349,3.94,0.477,0
119,84,73,803,0,11,769,11883,60.19,19129955,197.519,18.1,2.979,1095.042,227.349,3.94,0.477,0
119,85,45,848,0,11,235,12118,60.19,19129955,197.519,18.1,2.979,1095.042,227.349,3.94,0.477,0
119,86,93,941,0,11,460,12578,60.19,19129955,197.519,18.1,2.979,1095.042,227.349,3.94,0.477,0
119,87,19,960,1,12,372,12950,60.19,19129955,197.519,18.1,2.979,1095.042,227.349,3.94,0.477,0
119,88,45,1005,1,13,419,13369,60.19,19129955,197.519,18.1,2.979,1095.042,227.349,3.94,0.477,0
119,89,33,1038,0,13,549,13918,60.19,19129955,197.519,18.1,2.979,1095.042,227.349,3.94,0.477,0
119,90,108,1146,0,13,255,14173,60.19,19129955,197.519,18.1,2.979,1095.042,227.349,3.94,0.477,0
119,91,78,1224,1,14,510,14683,60.19,19129955,197.519,18.1,2.979,1095.042,227.349,3.94,0.477,0
119,92,41,1265,2,16,494,15177,60.19,19129955,197.519,18.1,2.979,1095.042,227.349,3.94,0.477,0
119,93,77,1342,0,16,547,15724,60.19,19129955,197.519,18.1,2.979,1095.042,227.349,3.94,0.477,0
119,94,60,1402,0,16,557,16281,60.19,19129955,197.519,18.1,2.979,1095.042,227.349,3.94,0.477,0
119,95,96,1498,0,16,0,16281,60.19,19129955,197.519,18.1,2.979,1095.042,227.349,3.94,0.477,0
119,96,115,1613,1,17,0,17406,60.19,19129955,197.519,18.1,2.979,1095.042,227.349,3.94,0.477,0
119,97,129,1742,2,19,287,17693,60.19,19129955,197.519,18.1,2.979,1095.042,227.349,3.94,0.477,0
119,98,76,1818,0,19,0,17693,60.19,19129955,197.519,18.1,2.979,1095.042,227.349,3.94,0.477,0
119,99,59,1877,5,24,0,18814,60.19,19129955,197.519,18.1,2.979,1095.042,227.349,3.94,0.477,0
119,100,52,1929,1,25,482,19296,60.19,19129955,197.519,18.1,2.979,1095.042,227.349,3.94,0.477,0
119,101,55,1984,4,29,802,20098,60.19,19129955,197.519,18.1,2.979,1095.042,227.349,3.94,0.477,0
119,102,85,2069,2,31,559,20657,60.19,19129955,197.519,18.1,2.979,1095.042,227.349,3.94,0.477,0
119,103,192,2261,2,33,317,20974,60.19,19129955,197.519,18.1,2.979,1095.042,227.349,3.94,0.477,0
119,104,103,2364,5,38,558,21532,60.19,19129955,197.519,18.1,2.979,1095.042,227.349,3.94,0.477,0
119,105,66,2430,1,39,421,21953,60.19,19129955,197.519,18.1,2.979,1095.042,227.349,3.94,0.477,0
119,106,67,2497,1,40,343,22296,60.19,19129955,197.519,18.1,2.979,1095.042,227.349,3.94,0.477,0
119,107,117,2614,3,43,934,23230,60.19,19129955,197.519,18.1,2.979,1095.042,227.349,3.94,0.477,0
119,108,98,2712,8,51,0,23230,60.19,19129955,197.519,18.1,2.979,1095.042,227.349,3.94,0.477,0
119,109,98,2810,4,55,0,23733,60.19,19129955,197.519,18.1,2.979,1095.042,227.349,3.94,0.477,0
119,110,97,2907,4,59,459,24192,60.19,19129955,197.519,18.1,2.979,1095.042,227.349,3.94,0.477,0
119,111,85,2992,3,62,283,24475,60.19,19129955,197.519,18.1,2.979,1095.042,227.349,3.94,0.477,0
119,112,53,3045,2,64,347,24822,60.19,19129955,197.519,18.1,2.979,1095.042,227.349,3.94,0.477,0
119,113,104,3149,7,71,459,25281,60.19,19129955,197.519,18.1,2.979,1095.042,227.349,3.94,0.477,0
119,114,153,3302,5,76,475,25756,60.19,19129955,197.519,18.1,2.979,1095.042,227.349,3.94,0.477,0
119,115,84,3386,3,79,457,26213,60.19,19129955,197.519,18.1,2.979,1095.042,227.349,3.94,0.477,0
119,116,67,3453,8,87,389,26602,60.19,19129955,197.519,18.1,2.979,1095.042,227.349,3.94,0.477,0
119,117,0,3453,0,87,545,27147,60.19,19129955,197.519,18.1,2.979,1095.042,227.349,3.94,0.477,0
119,118,187,3640,12,99,243,27390,60.19,19129955,197.519,18.1,2.979,1095.042,227.349,3.94,0.477,0
119,119,69,3709,4,103,124,27514,60.19,19129955,197.519,18.1,2.979,1095.042,227.349,3.94,0.477,0
119,120,0,3709,0,103,1174,28688,60.19,19129955,197.519,18.1,2.979,1095.042,227.349,3.94,0.477,0
119,121,149,3858,4,107,911,29599,60.19,19129955,197.519,18.1,2.979,1095.042,227.349,3.94,0.477,0
119,122,123,3981,2,109,668,30267,60.19,19129955,197.519,18.1,2.979,1095.042,227.349,3.94,0.477,0
119,123,97,4078,5,114,663,30930,60.19,19129955,197.519,18.1,2.979,1095.042,227.349,3.94,0.477,0
119,124,108,4186,6,120,372,31302,60.19,19129955,197.519,18.1,2.979,1095.042,227.349,3.94,0.477,0
119,125,45,4231,3,123,343,31645,60.19,19129955,197.519,18.1,2.979,1095.042,227.349,3.94,0.477,0
119,126,42,4273,0,123,499,32144,60.19,19129955,197.519,18.1,2.979,1095.042,227.349,3.94,0.477,0
119,127,74,4347,5,128,536,32680,60.19,19129955,197.519,18.1,2.979,1095.042,227.349,3.94,0.477,0
119,128,79,4426,8,136,786,33466,60.19,19129955,197.519,18.1,2.979,1095.042,227.349,3.94,0.477,0
119,129,65,4491,1,137,585,34051,60.19,19129955,197.519,18.1,2.979,1095.042,227.349,3.94,0.477,0
119,130,84,4575,0,137,392,34443,64.81,19129955,197.519,18.1,2.979,1095.042,227.349,3.94,0.477,0
119,131,49,4624,6,143,320,34763,64.81,19129955,197.519,18.1,2.979,1095.042,227.349,3.94,0.477,0
119,132,34,4658,3,146,114,34877,64.81,19129955,197.519,18.1,2.979,1095.042,227.349,3.94,0.477,0
119,133,15,4673,0,146,460,35337,64.81,19129955,197.519,18.1,2.979,1095.042,227.349,3.94,0.477,0
119,134,39,4712,6,152,414,35751,64.81,19129955,197.519,18.1,2.979,1095.042,227.349,3.94,0.477,0
119,135,40,4752,0,152,1995,37746,64.81,19129955,197.519,18.1,2.979,1095.042,227.349,3.94,0.477,0
119,136,160,4912,1,153,705,38451,64.81,19129955,197.519,18.1,2.979,1095.042,227.349,3.94,0.477,0
119,137,76,4988,3,156,347,38798,64.81,19129955,197.519,18.1,2.979,1095.042,227.349,3.94,0.477,0
119,138,38,5026,1,157,416,39214,64.81,19129955,197.519,18.1,2.979,1095.042,227.349,3.94,0.477,0
119,139,46,5072,4,161,550,39764,64.81,19129955,197.519,18.1,2.979,1095.042,227.349,3.94,0.477,0
119,140,0,5072,0,161,342,40106,64.81,19129955,197.519,18.1,2.979,1095.042,227.349,3.94,0.477,0
119,141,121,5193,2,163,534,40640,64.81,19129955,197.519,18.1,2.979,1095.042,227.349,3.94,0.477,0
119,142,47,5240,1,164,386,41026,64.81,19129955,197.519,18.1,2.979,1095.042,227.349,3.94,0.477,0
119,143,0,5240,0,164,448,41474,64.81,19129955,197.519,18.1,2.979,1095.042,227.349,3.94,0.477,0
119,144,42,5282,1,165,541,42015,64.81,19129955,197.519,18.1,2.979,1095.042,227.349,3.94,0.477,0
119,145,40,5322,1,166,592,42607,64.81,19129955,197.519,18.1,2.979,1095.042,227.349,3.94,0.477,0
119,146,0,5322,0,166,220,42827,64.81,19129955,197.519,18.1,2.979,1095.042,227.349,3.94,0.477,0
119,147,97,5419,3,169,75,42902,64.81,19129955,197.519,18.1,2.979,1095.042,227.349,3.94,0.477,0
119,148,4,5423,1,170,601,43503,64.81,19129955,197.519,18.1,2.979,1095.042,227.349,3.94,0.477,0
119,149,51,5474,3,173,295,43798,64.81,19129955,197.519,18.1,2.979,1095.042,227.349,3.94,0.477,0
119,150,22,5496,0,173,421,44219,64.81,19129955,197.519,18.1,2.979,1095.042,227.349,3.94,0.477,0
119,151,27,5523,1,174,77,44296,64.81,19129955,197.519,18.1,2.979,1095.042,227.349,3.94,0.477,0
119,152,5,5528,0,174,215,44511,64.81,19129955,197.519,18.1,2.979,1095.042,227.349,3.94,0.477,0
119,153,8,5536,0,174,994,45505,64.81,19129955,197.519,18.1,2.979,1095.042,227.349,3.94,0.477,0
119,154,30,5566,1,175,117,45622,59.26,19129955,197.519,18.1,2.979,1095.042,227.349,3.94,0.477,0
119,155,10,5576,0,175,167,45789,59.26,19129955,197.519,18.1,2.979,1095.042,227.349,3.94,0.477,0
119,156,3,5579,0,175,247,46036,59.26,19129955,197.519,18.1,2.979,1095.042,227.349,3.94,0.477,0
119,157,14,5593,0,175,375,46411,59.26,19129955,197.519,18.1,2.979,1095.042,227.349,3.94,0.477,0
119,158,15,5608,0,175,73,46484,59.26,19129955,197.519,18.1,2.979,1095.042,227.349,3.94,0.477,0
119,159,3,5611,0,175,152,46636,59.26,19129955,197.519,18.1,2.979,1095.042,227.349,3.94,0.477,0
119,160,3,5614,0,175,114,46750,55.56,19129955,197.519,18.1,2.979,1095.042,227.349,3.94,0.477,0
119,161,7,5621,1,176,107,46857,55.56,19129955,197.519,18.1,2.979,1095.042,227.349,3.94,0.477,0
119,162,9,5630,0,176,494,47351,55.56,19129955,197.519,18.1,2.979,1095.042,227.349,3.94,0.477,0
119,163,23,5653,0,176,0,47351,55.56,19129955,197.519,18.1,2.979,1095.042,227.349,3.94,0.477,0
119,164,2,5655,0,176,0,47820,55.56,19129955,197.519,18.1,2.979,1095.042,227.349,3.94,0.477,0
119,165,14,5669,1,177,293,48113,55.56,19129955,197.519,18.1,2.979,1095.042,227.349,3.94,0.477,0
119,166,9,5678,0,177,443,48556,55.56,19129955,197.519,18.1,2.979,1095.042,227.349,3.94,0.477,0
119,167,12,5690,0,177,0,48556,55.56,19129955,197.519,18.1,2.979,1095.042,227.349,3.94,0.477,0
119,168,7,5697,1,178,0,48816,55.56,19129955,197.519,18.1,2.979,1095.042,227.349,3.94,0.477,0
119,169,4,5701,0,178,147,48963,55.56,19129955,197.519,18.1,2.979,1095.042,227.349,3.94,0.477,0
119,170,0,5701,0,178,378,49341,55.56,19129955,197.519,18.1,2.979,1095.042,227.349,3.94,0.477,0
119,171,10,5711,1,179,0,49341,54.63,19129955,197.519,18.1,2.979,1095.042,227.349,3.94,0.477,0
119,172,5,5716,0,179,0,50051,54.63,19129955,197.519,18.1,2.979,1095.042,227.349,3.94,0.477,0
119,173,0,5716,0,179,532,50583,54.63,19129955,197.519,18.1,2.979,1095.042,227.349,3.94,0.477,0
119,174,15,5731,0,179,37,50620,54.63,19129955,197.519,18.1,2.979,1095.042,227.349,3.94,0.477,0
119,175,2,5733,0,179,369,50989,54.63,19129955,197.519,18.1,2.979,1095.042,227.349,3.94,0.477,0
119,176,4,5737,0,179,0,50989,54.63,19129955,197.519,18.1,2.979,1095.042,227.349,3.94,0.477,0
119,177,9,5746,0,179,0,50989,54.63,19129955,197.519,18.1,2.979,1095.042,227.349,3.94,0.477,0
119,178,1,5747,0,179,0,50989,54.63,19129955,197.519,18.1,2.979,1095.042,227.349,3.94,0.477,0
119,179,14,5761,0,179,0,50989,54.63,19129955,197.519,18.1,2.979,1095.042,227.349,3.94,0.477,0
119,180,2,5763,0,179,0,52730,54.63,19129955,197.519,18.1,2.979,1095.042,227.349,3.94,0.477,0
119,181,5,5768,0,179,0,52730,54.63,19129955,197.519,18.1,2.979,1095.042,227.349,3.94,0.477,0
119,182,2,5770,0,179,0,52852,54.63,19129955,197.519,18.1,2.979,1095.042,227.349,3.94,0.477,0
119,183,2,5772,0,179,205,53057,54.63,19129955,197.519,18.1,2.979,1095.042,227.349,3.94,0.477,0
119,184,1,5773,0,179,0,53057,54.63,19129955,197.519,18.1,2.979,1095.042,227.349,3.94,0.477,0
119,185,6,5779,0,179,0,54015,54.63,19129955,197.519,18.1,2.979,1095.042,227.349,3.94,0.477,0
119,186,4,5783,0,179,231,54246,54.63,19129955,197.519,18.1,2.979,1095.042,227.349,3.94,0.477,0
119,187,0,5783,0,179,105,54351,54.63,19129955,197.519,18.1,2.979,1095.042,227.349,3.94,0.477,0
119,188,3,5786,0,179,121,54472,54.63,19129955,197.519,18.1,2.979,1095.042,227.349,3.94,0.477,0
119,189,8,5794,1,180,94,54566,54.63,19129955,197.519,18.1,2.979,1095.042,227.349,3.94,0.477,0
119,190,2,5796,0,180,161,54727,54.63,19129955,197.519,18.1,2.979,1095.042,227.349,3.94,0.477,0
119,191,7,5803,0,180,761,55488,54.63,19129955,197.519,18.1,2.979,1095.042,227.349,3.94,0.477,0
119,192,6,5809,0,180,0,55488,54.63,19129955,197.519,18.1,2.979,1095.042,227.349,3.94,0.477,0
119,193,4,5813,0,180,0,56034,54.63,19129955,197.519,18.1,2.979,1095.042,227.349,3.94,0.477,0
119,194,8,5821,0,180,101,56135,54.63,19129955,197.519,18.1,2.979,1095.042,227.349,3.94,0.477,0
119,195,0,5821,0,180,161,56296,54.63,19129955,197.519,18.1,2.979,1095.042,227.349,3.94,0.477,0
119,196,3,5824,0,180,224,56520,54.63,19129955,197.519,18.1,2.979,1095.042,227.349,3.94,0.477,0
119,197,3,5827,1,181,189,56709,54.63,19129955,197.519,18.1,2.979,1095.042,227.349,3.94,0.477,0
119,198,2,5829,0,181,248,56957,54.63,19129955,197.519,18.1,2.979,1095.042,227.349,3.94,0.477,0
119,199,7,5836,0,181,308,57265,54.63,19129955,197.519,18.1,2.979,1095.042,227.349,3.94,0.477,0
119,200,6,5842,0,181,406,57671,54.63,19129955,197.519,18.1,2.979,1095.042,227.349,3.94,0.477,0
119,201,10,5852,0,181,234,57905,54.63,19129955,197.519,18.1,2.979,1095.042,227.349,3.94,0.477,0
119,202,5,5857,0,181,0,57905,54.63,19129955,197.519,18.1,2.979,1095.042,227.349,3.94,0.477,0
119,203,3,5860,0,181,0,57905,54.63,19129955,197.519,18.1,2.979,1095.042,227.349,3.94,0.477,0
119,204,1,5861,1,182,0,57905,54.63,19129955,197.519,18.1,2.979,1095.042,227.349,3.94,0.477,0
120,1,140,2766,6,43,3538,35802,73.15,32365998,96.254,29.9,6.293,26808.164,260.942,16.74,0.802,4
120,2,142,2908,2,45,1797,37599,73.15,32365998,96.254,29.9,6.293,26808.164,260.942,16.74,0.802,4
120,3,208,3116,5,50,1859,39458,73.15,32365998,96.254,29.9,6.293,26808.164,260.942,16.74,0.802,4
120,4,217,3333,3,53,1465,40923,73.15,32365998,96.254,29.9,6.293,26808.164,260.942,16.74,0.802,4
120,5,150,3483,4,57,2616,43539,73.15,32365998,96.254,29.9,6.293,26808.164,260.942,16.74,0.802,4
120,6,179,3662,4,61,3918,47457,73.15,32365998,96.254,29.9,6.293,26808.164,260.942,16.74,0.802,4
120,7,131,3793,1,62,5028,52485,73.15,32365998,96.254,29.9,6.293,26808.164,260.942,16.74,0.802,4
120,8,170,3963,1,63,5755,58240,73.15,32365998,96.254,29.9,6.293,26808.164,260.942,16.74,0.802,4
120,9,156,4119,2,65,5127,63367,73.15,32365998,96.254,29.9,6.293,26808.164,260.942,16.74,0.802,4
120,10,109,4228,2,67,4584,67951,73.15,32365998,96.254,29.9,6.293,26808.164,260.942,16.74,0.802,4
120,11,118,4346,3,70,3946,71897,73.15,32365998,96.254,29.9,6.293,26808.164,260.942,16.74,0.802,4
120,12,184,4530,3,73,5594,77491,73.15,32365998,96.254,29.9,6.293,26808.164,260.942,16.74,0.802,4
120,13,153,4683,3,76,4239,81730,73.15,32365998,96.254,29.9,6.293,26808.164,260.942,16.74,0.802,4
120,14,134,4817,1,77,3061,84791,73.15,32365998,96.254,29.9,6.293,26808.164,260.942,16.74,0.802,4
120,15,170,4987,5,82,2392,87183,73.15,32365998,96.254,29.9,6.293,26808.164,260.942,16.74,0.802,4
120,16,85,5072,1,83,0,87183,73.15,32365998,96.254,29.9,6.293,26808.164,260.942,16.74,0.802,4
120,17,110,5182,1,84,0,96695,73.15,32365998,96.254,29.9,6.293,26808.164,260.942,16.74,0.802,4
120,18,69,5251,2,86,4099,100794,73.15,32365998,96.254,29.9,6.293,26808.164,260.942,16.74,0.802,4
120,19,54,5305,2,88,3098,103892,73.15,32365998,96.254,29.9,6.293,26808.164,260.942,16.74,0.802,4
120,20,84,5389,1,89,4324,108216,73.15,32365998,96.254,29.9,6.293,26808.164,260.942,16.74,0.802,4
120,21,36,5425,0,89,0,108216,73.15,32365998,96.254,29.9,6.293,26808.164,260.942,16.74,0.802,4
120,22,57,5482,3,92,0,113755,73.15,32365998,96.254,29.9,6.293,26808.164,260.942,16.74,0.802,4
120,23,50,5532,1,93,3651,117406,73.15,32365998,96.254,29.9,6.293,26808.164,260.942,16.74,0.802,4
120,24,71,5603,2,95,4316,121722,73.15,32365998,96.254,29.9,6.293,26808.164,260.942,16.74,0.802,4
120,25,88,5691,1,96,5248,126970,73.15,32365998,96.254,29.9,6.293,26808.164,260.942,16.74,0.802,4
120,26,51,5742,2,98,4521,131491,73.15,32365998,96.254,29.9,6.293,26808.164,260.942,16.74,0.802,4
120,27,38,5780,0,98,7407,138898,73.15,32365998,96.254,29.9,6.293,26808.164,260.942,16.74,0.802,4
120,28,40,5820,1,99,7901,146799,73.15,32365998,96.254,29.9,6.293,26808.164,260.942,16.74,0.802,4
120,29,31,5851,1,100,7404,154203,73.15,32365998,96.254,29.9,6.293,26808.164,260.942,16.74,0.802,4
120,30,94,5945,0,100,0,154203,73.15,32365998,96.254,29.9,6.293,26808.164,260.942,16.74,0.802,4
120,31,57,6002,2,102,0,168784,73.15,32365998,96.254,29.9,6.293,26808.164,260.942,16.74,0.802,4
120,32,69,6071,1,103,15429,184213,73.15,32365998,96.254,29.9,6.293,26808.164,260.942,16.74,0.802,4
120,33,105,6176,0,103,11620,195833,73.15,32365998,96.254,29.9,6.293,26808.164,260.942,16.74,0.802,4
120,34,122,6298,2,105,9765,205598,69.44,32365998,96.254,29.9,6.293,26808.164,260.942,16.74,0.802,4
120,35,55,6353,0,105,7622,213220,69.44,32365998,96.254,29.9,6.293,26808.164,260.942,16.74,0.802,4
120,36,30,6383,1,106,8930,222150,69.44,32365998,96.254,29.9,6.293,26808.164,260.942,16.74,0.802,4
120,37,45,6428,1,107,8869,231019,69.44,32365998,96.254,29.9,6.293,26808.164,260.942,16.74,0.802,4
120,38,39,6467,0,107,8609,239628,69.44,32365998,96.254,29.9,6.293,26808.164,260.942,16.74,0.802,4
120,39,68,6535,0,107,0,239628,69.44,32365998,96.254,29.9,6.293,26808.164,260.942,16.74,0.802,4
120,40,54,6589,1,108,0,256937,69.44,32365998,96.254,29.9,6.293,26808.164,260.942,16.74,0.802,4
120,41,67,6656,0,108,9111,266048,69.44,32365998,96.254,29.9,6.293,26808.164,260.942,16.74,0.802,4
120,42,70,6726,1,109,0,266048,69.44,32365998,96.254,29.9,6.293,26808.164,260.942,16.74,0.802,4
120,43,16,6742,0,109,0,266048,69.44,32365998,96.254,29.9,6.293,26808.164,260.942,16.74,0.802,4
120,44,37,6779,2,111,0,297342,69.44,32365998,96.254,29.9,6.293,26808.164,260.942,16.74,0.802,4
120,45,40,6819,1,112,126964,424306,69.44,32365998,96.254,29.9,6.293,26808.164,260.942,16.74,0.802,4
120,46,36,6855,0,112,9830,434136,69.44,32365998,96.254,29.9,6.293,26808.164,260.942,16.74,0.802,4
120,47,17,6872,1,113,9127,443263,69.44,32365998,96.254,29.9,6.293,26808.164,260.942,16.74,0.802,4
120,48,22,6894,0,113,0,443263,69.44,32365998,96.254,29.9,6.293,26808.164,260.942,16.74,0.802,4
120,49,47,6941,0,113,0,462257,69.44,32365998,96.254,29.9,6.293,26808.164,260.942,16.74,0.802,4
120,50,37,6978,1,114,9061,471318,69.44,32365998,96.254,29.9,6.293,26808.164,260.942,16.74,0.802,4
120,51,31,7009,0,114,10093,481411,69.44,32365998,96.254,29.9,6.293,26808.164,260.942,16.74,0.802,4
120,52,50,7059,0,114,10318,491729,69.44,32365998,96.254,29.9,6.293,26808.164,260.942,16.74,0.802,4
120,53,78,7137,1,115,8740,500469,75,32365998,96.254,29.9,6.293,26808.164,260.942,16.74,0.802,4
120,54,48,7185,0,115,7213,507682,75,32365998,96.254,29.9,6.293,26808.164,260.942,16.74,0.802,4
120,55,60,7245,0,115,5688,513370,75,32365998,96.254,29.9,6.293,26808.164,260.942,16.74,0.802,4
120,56,172,7417,0,115,6574,519944,75,32365998,96.254,29.9,6.293,26808.164,260.942,16.74,0.802,4
120,57,187,7604,0,115,0,519944,75,32365998,96.254,29.9,6.293,26808.164,260.942,16.74,0.802,4
120,58,15,7619,0,115,0,530501,75,32365998,96.254,29.9,6.293,26808.164,260.942,16.74,0.802,4
120,59,10,7629,0,115,7393,537894,75,32365998,96.254,29.9,6.293,26808.164,260.942,16.74,0.802,4
120,60,103,7732,0,115,8474,546368,75,32365998,96.254,29.9,6.293,26808.164,260.942,16.74,0.802,4
120,61,30,7762,0,115,6815,553183,75,32365998,96.254,29.9,6.293,26808.164,260.942,16.74,0.802,4
120,62,57,7819,0,115,7555,560738,75,32365998,96.254,29.9,6.293,26808.164,260.942,16.74,0.802,4
120,63,38,7857,0,115,6549,567287,75,32365998,96.254,29.9,6.293,26808.164,260.942,16.74,0.802,4
120,64,20,7877,0,115,8218,575505,75,32365998,96.254,29.9,6.293,26808.164,260.942,16.74,0.802,4
120,65,93,7970,0,115,6981,582486,75,32365998,96.254,29.9,6.293,26808.164,260.942,16.74,0.802,4
120,66,0,7970,0,115,8127,590613,75,32365998,96.254,29.9,6.293,26808.164,260.942,16.74,0.802,4
120,67,296,8266,1,116,8841,599454,75,32365998,96.254,29.9,6.293,26808.164,260.942,16.74,0.802,4
120,68,37,8303,1,117,0,599454,75,32365998,96.254,29.9,6.293,26808.164,260.942,16.74,0.802,4
120,69,19,8322,0,117,0,614239,75,32365998,96.254,29.9,6.293,26808.164,260.942,16.74,0.802,4
120,70,7,8329,0,117,6081,620320,75,32365998,96.254,29.9,6.293,26808.164,260.942,16.74,0.802,4
120,71,7,8336,0,117,5455,625775,57.41,32365998,96.254,29.9,6.293,26808.164,260.942,16.74,0.802,4
120,72,2,8338,1,118,5833,631608,57.41,32365998,96.254,29.9,6.293,26808.164,260.942,16.74,0.802,4
120,73,31,8369,0,118,9072,640680,57.41,32365998,96.254,29.9,6.293,26808.164,260.942,16.74,0.802,4
120,74,33,8402,1,119,5375,646055,57.41,32365998,96.254,29.9,6.293,26808.164,260.942,16.74,0.802,4
120,75,43,8445,1,120,5289,651344,57.41,32365998,96.254,29.9,6.293,26808.164,260.942,16.74,0.802,4
120,76,8,8453,1,121,4866,656210,57.41,32365998,96.254,29.9,6.293,26808.164,260.942,16.74,0.802,4
120,77,41,8494,0,121,3422,659632,57.41,32365998,96.254,29.9,6.293,26808.164,260.942,16.74,0.802,4
120,78,11,8505,0,121,4702,664334,57.41,32365998,96.254,29.9,6.293,26808.164,260.942,16.74,0.802,4
120,79,10,8515,0,121,5255,669589,57.41,32365998,96.254,29.9,6.293,26808.164,260.942,16.74,0.802,4
120,80,14,8529,0,121,4962,674551,54.63,32365998,96.254,29.9,6.293,26808.164,260.942,16.74,0.802,4
120,81,6,8535,0,121,5275,679826,54.63,32365998,96.254,29.9,6.293,26808.164,260.942,16.74,0.802,4
120,82,21,8556,0,121,4142,683968,54.63,32365998,96.254,29.9,6.293,26808.164,260.942,16.74,0.802,4
120,83,16,8572,0,121,2937,686905,54.63,32365998,96.254,29.9,6.293,26808.164,260.942,16.74,0.802,4
120,84,15,8587,0,121,6698,693603,54.63,32365998,96.254,29.9,6.293,26808.164,260.942,16.74,0.802,4
120,85,3,8590,0,121,10733,704336,50.93,32365998,96.254,29.9,6.293,26808.164,260.942,16.74,0.802,4
120,86,6,8596,0,121,11842,716178,50.93,32365998,96.254,29.9,6.293,26808.164,260.942,16.74,0.802,4
120,87,4,8600,0,121,12938,729116,50.93,32365998,96.254,29.9,6.293,26808.164,260.942,16.74,0.802,4
120,88,6,8606,0,121,10342,739458,50.93,32365998,96.254,29.9,6.293,26808.164,260.942,16.74,0.802,4
120,89,10,8616,0,121,10492,749950,50.93,32365998,96.254,29.9,6.293,26808.164,260.942,16.74,0.802,4
120,90,18,8634,0,121,6221,756171,50.93,32365998,96.254,29.9,6.293,26808.164,260.942,16.74,0.802,4
120,91,3,8637,0,121,8828,764999,50.93,32365998,96.254,29.9,6.293,26808.164,260.942,16.74,0.802,4
120,92,2,8639,0,121,8912,773911,50.93,32365998,96.254,29.9,6.293,26808.164,260.942,16.74,0.802,4
120,93,1,8640,0,121,8727,782638,50.93,32365998,96.254,29.9,6.293,26808.164,260.942,16.74,0.802,4
120,94,3,8643,0,121,8221,790859,50.93,32365998,96.254,29.9,6.293,26808.164,260.942,16.74,0.802,4
120,95,5,8648,0,121,6937,797796,50.93,32365998,96.254,29.9,6.293,26808.164,260.942,16.74,0.802,4
120,96,10,8658,0,121,6722,804518,50.93,32365998,96.254,29.9,6.293,26808.164,260.942,16.74,0.802,4
120,97,0,8658,0,121,5539,810057,50.93,32365998,96.254,29.9,6.293,26808.164,260.942,16.74,0.802,4
120,98,10,8668,0,121,6061,816118,50.93,32365998,96.254,29.9,6.293,26808.164,260.942,16.74,0.802,4
120,99,6,8674,0,121,6528,822646,50.93,32365998,96.254,29.9,6.293,26808.164,260.942,16.74,0.802,4
120,100,3,8677,0,121,7342,829988,50.93,32365998,96.254,29.9,6.293,26808.164,260.942,16.74,0.802,4
120,101,6,8683,0,121,6267,836255,50.93,32365998,96.254,29.9,6.293,26808.164,260.942,16.74,0.802,4
120,102,13,8696,0,121,6221,842476,50.93,32365998,96.254,29.9,6.293,26808.164,260.942,16.74,0.802,4
120,103,8,8704,1,122,5034,847510,50.93,32365998,96.254,29.9,6.293,26808.164,260.942,16.74,0.802,4
120,104,14,8718,0,122,2913,850423,50.93,32365998,96.254,29.9,6.293,26808.164,260.942,16.74,0.802,4
120,105,7,8725,0,122,4696,855119,50.93,32365998,96.254,29.9,6.293,26808.164,260.942,16.74,0.802,4
120,106,4,8729,0,122,6777,861896,50.93,32365998,96.254,29.9,6.293,26808.164,260.942,16.74,0.802,4
120,107,5,8734,0,122,6498,868394,50.93,32365998,96.254,29.9,6.293,26808.164,260.942,16.74,0.802,4
120,108,3,8737,0,122,7828,876222,50.93,32365998,96.254,29.9,6.293,26808.164,260.942,16.74,0.802,4
120,109,18,8755,0,122,7948,884170,50.93,32365998,96.254,29.9,6.293,26808.164,260.942,16.74,0.802,4
120,110,9,8764,0,122,5574,889744,50.93,32365998,96.254,29.9,6.293,26808.164,260.942,16.74,0.802,4
120,111,15,8779,1,123,6014,895758,50.93,32365998,96.254,29.9,6.293,26808.164,260.942,16.74,0.802,4
120,112,21,8800,0,123,6681,902439,50.93,32365998,96.254,29.9,6.293,26808.164,260.942,16.74,0.802,4
120,113,15,8815,0,123,7188,909627,43.52,32365998,96.254,29.9,6.293,26808.164,260.942,16.74,0.802,4
120,114,16,8831,0,123,6713,916340,43.52,32365998,96.254,29.9,6.293,26808.164,260.942,16.74,0.802,4
120,115,9,8840,0,123,8848,925188,43.52,32365998,96.254,29.9,6.293,26808.164,260.942,16.74,0.802,4
120,116,21,8861,0,123,7209,932397,43.52,32365998,96.254,29.9,6.293,26808.164,260.942,16.74,0.802,4
120,117,23,8884,0,123,5248,937645,43.52,32365998,96.254,29.9,6.293,26808.164,260.942,16.74,0.802,4
120,118,13,8897,1,124,5599,943244,43.52,32365998,96.254,29.9,6.293,26808.164,260.942,16.74,0.802,4
120,119,7,8904,0,124,5897,949141,43.52,32365998,96.254,29.9,6.293,26808.164,260.942,16.74,0.802,4
120,120,39,8943,0,124,5992,955133,43.52,32365998,96.254,29.9,6.293,26808.164,260.942,16.74,0.802,4
120,121,13,8956,0,124,7946,963079,43.52,32365998,96.254,29.9,6.293,26808.164,260.942,16.74,0.802,4
120,122,8,8964,0,124,7565,970644,43.52,32365998,96.254,29.9,6.293,26808.164,260.942,16.74,0.802,4
120,123,12,8976,1,125,4030,974674,43.52,32365998,96.254,29.9,6.293,26808.164,260.942,16.74,0.802,4
120,124,9,8985,0,125,4504,979178,43.52,32365998,96.254,29.9,6.293,26808.164,260.942,16.74,0.802,4
120,125,14,8999,0,125,4119,983297,57.41,32365998,96.254,29.9,6.293,26808.164,260.942,16.74,0.802,4
120,126,2,9001,0,125,8036,991333,57.41,32365998,96.254,29.9,6.293,26808.164,260.942,16.74,0.802,4
120,127,1,9002,0,125,9757,1001090,57.41,32365998,96.254,29.9,6.293,26808.164,260.942,16.74,0.802,4
120,128,21,9023,0,125,11570,1012660,57.41,32365998,96.254,29.9,6.293,26808.164,260.942,16.74,0.802,4
120,129,15,9038,0,125,12059,1024719,57.41,32365998,96.254,29.9,6.293,26808.164,260.942,16.74,0.802,4
120,130,25,9063,0,125,11620,1036339,57.41,32365998,96.254,29.9,6.293,26808.164,260.942,16.74,0.802,4
120,131,7,9070,0,125,9637,1045976,57.41,32365998,96.254,29.9,6.293,26808.164,260.942,16.74,0.802,4
120,132,13,9083,0,125,7555,1053531,57.41,32365998,96.254,29.9,6.293,26808.164,260.942,16.74,0.802,4
120,133,11,9094,0,125,9773,1063304,57.41,32365998,96.254,29.9,6.293,26808.164,260.942,16.74,0.802,4
120,134,9,9103,0,125,10716,1074020,57.41,32365998,96.254,29.9,6.293,26808.164,260.942,16.74,0.802,4
120,135,11,9114,0,125,11020,1085040,57.41,32365998,96.254,29.9,6.293,26808.164,260.942,16.74,0.802,4
120,136,15,9129,0,125,10728,1095768,57.41,32365998,96.254,29.9,6.293,26808.164,260.942,16.74,0.802,4
120,137,20,9149,0,125,10449,1106217,57.41,32365998,96.254,29.9,6.293,26808.164,260.942,16.74,0.802,4
120,138,26,9175,0,125,8029,1114246,57.41,32365998,96.254,29.9,6.293,26808.164,260.942,16.74,0.802,4
120,139,25,9200,0,125,6420,1120666,57.41,32365998,96.254,29.9,6.293,26808.164,260.942,16.74,0.802,4
120,140,12,9212,0,125,8425,1129091,57.41,32365998,96.254,29.9,6.293,26808.164,260.942,16.74,0.802,4
120,141,7,9219,0,125,12588,1141679,57.41,32365998,96.254,29.9,6.293,26808.164,260.942,16.74,0.802,4
120,142,16,9235,0,125,10461,1152140,57.41,32365998,96.254,29.9,6.293,26808.164,260.942,16.74,0.802,4
120,143,5,9240,0,125,8250,1160390,57.41,32365998,96.254,29.9,6.293,26808.164,260.942,16.74,0.802,4
120,144,9,9249,0,125,7559,1167949,57.41,32365998,96.254,29.9,6.293,26808.164,260.942,16.74,0.802,4
120,145,8,9257,0,125,8467,1176416,57.41,32365998,96.254,29.9,6.293,26808.164,260.942,16.74,0.802,4
120,146,10,9267,0,125,6429,1182845,57.41,32365998,96.254,29.9,6.293,26808.164,260.942,16.74,0.802,4
120,147,7,9274,0,125,8655,1191500,57.41,32365998,96.254,29.9,6.293,26808.164,260.942,16.74,0.802,4
120,148,11,9285,0,125,11264,1202764,57.41,32365998,96.254,29.9,6.293,26808.164,260.942,16.74,0.802,4
120,149,6,9291,0,125,10026,1212790,57.41,32365998,96.254,29.9,6.293,26808.164,260.942,16.74,0.802,4
120,150,5,9296,0,125,10064,1222854,57.41,32365998,96.254,29.9,6.293,26808.164,260.942,16.74,0.802,4
120,151,10,9306,0,125,10073,1232927,57.41,32365998,96.254,29.9,6.293,26808.164,260.942,16.74,0.802,4
120,152,11,9317,0,125,10613,1243540,57.41,32365998,96.254,29.9,6.293,26808.164,260.942,16.74,0.802,4
120,153,17,9334,1,126,10315,1253855,57.41,32365998,96.254,29.9,6.293,26808.164,260.942,16.74,0.802,4
120,154,6,9340,1,127,8993,1262848,57.41,32365998,96.254,29.9,6.293,26808.164,260.942,16.74,0.802,4
120,155,14,9354,1,128,7381,1270229,57.41,32365998,96.254,29.9,6.293,26808.164,260.942,16.74,0.802,4
120,156,6,9360,0,128,10649,1280878,57.41,32365998,96.254,29.9,6.293,26808.164,260.942,16.74,0.802,4
120,157,14,9374,0,128,9724,1290602,57.41,32365998,96.254,29.9,6.293,26808.164,260.942,16.74,0.802,4
120,158,0,9374,0,128,9122,1299724,57.41,32365998,96.254,29.9,6.293,26808.164,260.942,16.74,0.802,4
120,159,17,9391,0,128,7730,1307454,57.41,32365998,96.254,29.9,6.293,26808.164,260.942,16.74,0.802,4
120,160,6,9397,0,128,6320,1313774,57.41,32365998,96.254,29.9,6.293,26808.164,260.942,16.74,0.802,4
120,161,62,9459,0,128,8671,1322445,57.41,32365998,96.254,29.9,6.293,26808.164,260.942,16.74,0.802,4
120,162,100,9559,0,128,10472,1332917,57.41,32365998,96.254,29.9,6.293,26808.164,260.942,16.74,0.802,4
120,163,24,9583,0,128,9555,1342472,57.41,32365998,96.254,29.9,6.293,26808.164,260.942,16.74,0.802,4
120,164,45,9628,0,128,11354,1353826,51.85,32365998,96.254,29.9,6.293,26808.164,260.942,16.74,0.802,4
120,165,182,9810,0,128,8805,1362631,51.85,32365998,96.254,29.9,6.293,26808.164,260.942,16.74,0.802,4
120,166,58,9868,0,128,9523,1372154,51.85,32365998,96.254,29.9,6.293,26808.164,260.942,16.74,0.802,4
120,167,47,9915,0,128,11615,1383769,51.85,32365998,96.254,29.9,6.293,26808.164,260.942,16.74,0.802,4
120,168,31,9946,0,128,11809,1395578,51.85,32365998,96.254,29.9,6.293,26808.164,260.942,16.74,0.802,4
120,169,23,9969,0,128,11681,1407259,51.85,32365998,96.254,29.9,6.293,26808.164,260.942,16.74,0.802,4
120,170,62,10031,0,128,9895,1417154,51.85,32365998,96.254,29.9,6.293,26808.164,260.942,16.74,0.802,4
120,171,21,10052,0,128,9979,1427133,51.85,32365998,96.254,29.9,6.293,26808.164,260.942,16.74,0.802,4
120,172,95,10147,1,129,10221,1437354,51.85,32365998,96.254,29.9,6.293,26808.164,260.942,16.74,0.802,4
120,173,20,10167,1,130,7332,1444686,51.85,32365998,96.254,29.9,6.293,26808.164,260.942,16.74,0.802,4
120,174,52,10219,0,130,7011,1451697,49.07,32365998,96.254,29.9,6.293,26808.164,260.942,16.74,0.802,4
120,175,57,10276,0,130,11860,1463557,49.07,32365998,96.254,29.9,6.293,26808.164,260.942,16.74,0.802,4
120,176,82,10358,0,130,0,1463557,49.07,32365998,96.254,29.9,6.293,26808.164,260.942,16.74,0.802,4
120,177,147,10505,3,133,0,1484812,49.07,32365998,96.254,29.9,6.293,26808.164,260.942,16.74,0.802,4
120,178,71,10576,0,133,8833,1493645,49.07,32365998,96.254,29.9,6.293,26808.164,260.942,16.74,0.802,4
120,179,0,10576,0,133,8465,1502110,49.07,32365998,96.254,29.9,6.293,26808.164,260.942,16.74,0.802,4
120,180,193,10769,0,133,8280,1510390,49.07,32365998,96.254,29.9,6.293,26808.164,260.942,16.74,0.802,4
120,181,150,10919,1,134,8830,1519220,49.07,32365998,96.254,29.9,6.293,26808.164,260.942,16.74,0.802,4
120,182,115,11034,0,134,13841,1533061,50.93,32365998,96.254,29.9,6.293,26808.164,260.942,16.74,0.802,4
120,183,101,11135,0,134,16689,1549750,50.93,32365998,96.254,29.9,6.293,26808.164,260.942,16.74,0.802,4
120,184,0,11135,0,134,17098,1566848,50.93,32365998,96.254,29.9,6.293,26808.164,260.942,16.74,0.802,4
120,185,349,11484,2,136,14360,1581208,50.93,32365998,96.254,29.9,6.293,26808.164,260.942,16.74,0.802,4
120,186,287,11771,0,136,16794,1598002,50.93,32365998,96.254,29.9,6.293,26808.164,260.942,16.74,0.802,4
120,187,317,12088,1,137,17039,1615041,50.93,32365998,96.254,29.9,6.293,26808.164,260.942,16.74,0.802,4
120,188,293,12381,0,137,12571,1627612,50.93,32365998,96.254,29.9,6.293,26808.164,260.942,16.74,0.802,4
120,189,432,12813,0,137,16039,1643651,50.93,32365998,96.254,29.9,6.293,26808.164,260.942,16.74,0.802,4
120,190,691,13504,4,141,20145,1663796,50.93,32365998,96.254,29.9,6.293,26808.164,260.942,16.74,0.802,4
120,191,489,13993,0,141,18013,1681809,50.93,32365998,96.254,29.9,6.293,26808.164,260.942,16.74,0.802,4
120,192,375,14368,5,146,22133,1703942,60.19,32365998,96.254,29.9,6.293,26808.164,260.942,16.74,0.802,4
120,193,354,14722,6,152,18895,1722837,60.19,32365998,96.254,29.9,6.293,26808.164,260.942,16.74,0.802,4
120,194,374,15096,3,155,16031,1738868,60.19,32365998,96.254,29.9,6.293,26808.164,260.942,16.74,0.802,4
120,195,561,15657,2,157,15123,1753991,60.19,32365998,96.254,29.9,6.293,26808.164,260.942,16.74,0.802,4
120,196,563,16220,2,159,14219,1768210,60.19,32365998,96.254,29.9,6.293,26808.164,260.942,16.74,0.802,4
120,197,660,16880,4,163,18619,1786829,65.74,32365998,96.254,29.9,6.293,26808.164,260.942,16.74,0.802,4
120,198,660,17540,4,167,23948,1810777,65.74,32365998,96.254,29.9,6.293,26808.164,260.942,16.74,0.802,4
120,199,589,18129,3,170,28923,1839700,65.74,32365998,96.254,29.9,6.293,26808.164,260.942,16.74,0.802,4
120,200,629,18758,6,176,23337,1863037,65.74,32365998,96.254,29.9,6.293,26808.164,260.942,16.74,0.802,4
120,201,869,19627,4,180,22810,1885847,65.74,32365998,96.254,29.9,6.293,26808.164,260.942,16.74,0.802,4
120,202,871,20498,7,187,0,1885847,65.74,32365998,96.254,29.9,6.293,26808.164,260.942,16.74,0.802,4
120,203,865,21363,3,190,0,1885847,65.74,32365998,96.254,29.9,6.293,26808.164,260.942,16.74,0.802,4
120,204,862,22225,3,193,0,1885847,65.74,32365998,96.254,29.9,6.293,26808.164,260.942,16.74,0.802,4
121,1,1,18,0,0,67,1199,0,540542,1454.433,30.6,4.12,15183.616,164.905,9.19,0.717,0
121,2,1,19,0,0,92,1291,0,540542,1454.433,30.6,4.12,15183.616,164.905,9.19,0.717,0
121,3,0,19,0,0,92,1383,0,540542,1454.433,30.6,4.12,15183.616,164.905,9.19,0.717,0
121,4,0,19,0,0,103,1486,0,540542,1454.433,30.6,4.12,15183.616,164.905,9.19,0.717,0
121,5,0,19,0,0,22,1508,0,540542,1454.433,30.6,4.12,15183.616,164.905,9.19,0.717,0
121,6,0,19,0,0,285,1793,0,540542,1454.433,30.6,4.12,15183.616,164.905,9.19,0.717,0
121,7,0,19,0,0,0,1793,0,540542,1454.433,30.6,4.12,15183.616,164.905,9.19,0.717,0
121,8,0,19,0,0,0,1793,0,540542,1454.433,30.6,4.12,15183.616,164.905,9.19,0.717,0
121,9,0,19,0,0,0,2434,0,540542,1454.433,30.6,4.12,15183.616,164.905,9.19,0.717,0
121,10,0,19,0,0,0,2434,0,540542,1454.433,30.6,4.12,15183.616,164.905,9.19,0.717,0
121,11,0,19,0,0,0,2434,0,540542,1454.433,30.6,4.12,15183.616,164.905,9.19,0.717,0
121,12,0,19,0,0,0,2632,0,540542,1454.433,30.6,4.12,15183.616,164.905,9.19,0.717,0
121,13,1,20,0,0,60,2692,0,540542,1454.433,30.6,4.12,15183.616,164.905,9.19,0.717,0
121,14,0,20,0,0,24,2716,0,540542,1454.433,30.6,4.12,15183.616,164.905,9.19,0.717,0
121,15,1,21,0,0,374,3090,0,540542,1454.433,30.6,4.12,15183.616,164.905,9.19,0.717,0
121,16,0,21,0,0,88,3178,0,540542,1454.433,30.6,4.12,15183.616,164.905,9.19,0.717,0
121,17,4,25,0,0,0,3178,0,540542,1454.433,30.6,4.12,15183.616,164.905,9.19,0.717,0
121,18,4,29,0,0,0,3178,0,540542,1454.433,30.6,4.12,15183.616,164.905,9.19,0.717,0
121,19,6,35,0,0,0,3178,0,540542,1454.433,30.6,4.12,15183.616,164.905,9.19,0.717,0
121,20,17,52,0,0,0,3178,0,540542,1454.433,30.6,4.12,15183.616,164.905,9.19,0.717,0
121,21,17,69,0,0,0,3178,0,540542,1454.433,30.6,4.12,15183.616,164.905,9.19,0.717,0
121,22,16,85,0,0,0,3178,0,540542,1454.433,30.6,4.12,15183.616,164.905,9.19,0.717,0
121,23,0,85,0,0,0,4650,0,540542,1454.433,30.6,4.12,15183.616,164.905,9.19,0.717,0
121,24,25,110,0,0,549,5199,0,540542,1454.433,30.6,4.12,15183.616,164.905,9.19,0.717,0
121,25,18,128,0,0,263,5462,0,540542,1454.433,30.6,4.12,15183.616,164.905,9.19,0.717,0
121,26,9,137,0,0,428,5890,0,540542,1454.433,30.6,4.12,15183.616,164.905,9.19,0.717,0
121,27,77,214,0,0,326,6216,0,540542,1454.433,30.6,4.12,15183.616,164.905,9.19,0.717,0
121,28,0,214,0,0,420,6636,0,540542,1454.433,30.6,4.12,15183.616,164.905,9.19,0.717,0
121,29,31,245,0,0,0,6636,0,540542,1454.433,30.6,4.12,15183.616,164.905,9.19,0.717,0
121,30,32,277,0,0,0,7311,0,540542,1454.433,30.6,4.12,15183.616,164.905,9.19,0.717,0
121,31,191,468,1,1,443,7754,0,540542,1454.433,30.6,4.12,15183.616,164.905,9.19,0.717,0
121,32,23,491,0,1,465,8219,0,540542,1454.433,30.6,4.12,15183.616,164.905,9.19,0.717,0
121,33,28,519,0,1,382,8601,0,540542,1454.433,30.6,4.12,15183.616,164.905,9.19,0.717,0
121,34,8,527,0,1,288,8889,0,540542,1454.433,30.6,4.12,15183.616,164.905,9.19,0.717,0
121,35,24,551,0,1,497,9386,0,540542,1454.433,30.6,4.12,15183.616,164.905,9.19,0.717,0
121,36,22,573,0,1,482,9868,0,540542,1454.433,30.6,4.12,15183.616,164.905,9.19,0.717,0
121,37,44,617,1,2,407,10275,0,540542,1454.433,30.6,4.12,15183.616,164.905,9.19,0.717,0
121,38,25,642,1,3,474,10749,0,540542,1454.433,30.6,4.12,15183.616,164.905,9.19,0.717,0
121,39,2,644,0,3,588,11337,0,540542,1454.433,30.6,4.12,15183.616,164.905,9.19,0.717,0
121,40,146,790,0,3,479,11816,0,540542,1454.433,30.6,4.12,15183.616,164.905,9.19,0.717,0
121,41,45,835,0,3,430,12246,0,540542,1454.433,30.6,4.12,15183.616,164.905,9.19,0.717,0
121,42,62,897,0,3,155,12401,0,540542,1454.433,30.6,4.12,15183.616,164.905,9.19,0.717,0
121,43,7,904,0,3,0,12401,0,540542,1454.433,30.6,4.12,15183.616,164.905,9.19,0.717,0
121,44,51,955,1,4,0,13291,0,540542,1454.433,30.6,4.12,15183.616,164.905,9.19,0.717,0
121,45,27,982,0,4,398,13689,0,540542,1454.433,30.6,4.12,15183.616,164.905,9.19,0.717,0
121,46,49,1031,0,4,787,14476,0,540542,1454.433,30.6,4.12,15183.616,164.905,9.19,0.717,0
121,47,47,1078,0,4,378,14854,0,540542,1454.433,30.6,4.12,15183.616,164.905,9.19,0.717,0
121,48,16,1094,0,4,426,15280,0,540542,1454.433,30.6,4.12,15183.616,164.905,9.19,0.717,0
121,49,12,1106,0,4,547,15827,0,540542,1454.433,30.6,4.12,15183.616,164.905,9.19,0.717,0
121,50,37,1143,0,4,524,16351,0,540542,1454.433,30.6,4.12,15183.616,164.905,9.19,0.717,0
121,51,43,1186,0,4,495,16846,0,540542,1454.433,30.6,4.12,15183.616,164.905,9.19,0.717,0
121,52,30,1216,0,4,328,17174,0,540542,1454.433,30.6,4.12,15183.616,164.905,9.19,0.717,0
121,53,58,1274,0,4,598,17772,0,540542,1454.433,30.6,4.12,15183.616,164.905,9.19,0.717,0
121,54,29,1303,0,4,711,18483,0,540542,1454.433,30.6,4.12,15183.616,164.905,9.19,0.717,0
121,55,68,1371,0,4,676,19159,0,540542,1454.433,30.6,4.12,15183.616,164.905,9.19,0.717,0
121,56,24,1395,0,4,861,20020,0,540542,1454.433,30.6,4.12,15183.616,164.905,9.19,0.717,0
121,57,43,1438,1,5,822,20842,0,540542,1454.433,30.6,4.12,15183.616,164.905,9.19,0.717,0
121,58,19,1457,0,5,797,21639,0,540542,1454.433,30.6,4.12,15183.616,164.905,9.19,0.717,0
121,59,56,1513,0,5,680,22319,0,540542,1454.433,30.6,4.12,15183.616,164.905,9.19,0.717,0
121,60,78,1591,0,5,808,23127,0,540542,1454.433,30.6,4.12,15183.616,164.905,9.19,0.717,0
121,61,81,1672,0,5,698,23825,0,540542,1454.433,30.6,4.12,15183.616,164.905,9.19,0.717,0
121,62,101,1773,0,5,959,24784,0,540542,1454.433,30.6,4.12,15183.616,164.905,9.19,0.717,0
121,63,56,1829,1,6,807,25591,0,540542,1454.433,30.6,4.12,15183.616,164.905,9.19,0.717,0
121,64,12,1841,1,7,652,26243,0,540542,1454.433,30.6,4.12,15183.616,164.905,9.19,0.717,0
121,65,9,1850,0,7,801,27044,0,540542,1454.433,30.6,4.12,15183.616,164.905,9.19,0.717,0
121,66,22,1872,0,7,933,27977,0,540542,1454.433,30.6,4.12,15183.616,164.905,9.19,0.717,0
121,67,11,1883,0,7,730,28707,0,540542,1454.433,30.6,4.12,15183.616,164.905,9.19,0.717,0
121,68,18,1901,0,7,875,29582,0,540542,1454.433,30.6,4.12,15183.616,164.905,9.19,0.717,0
121,69,2,1903,1,8,0,29582,0,540542,1454.433,30.6,4.12,15183.616,164.905,9.19,0.717,0
121,70,13,1916,0,8,0,31355,0,540542,1454.433,30.6,4.12,15183.616,164.905,9.19,0.717,0
121,71,26,1942,0,8,772,32127,0,540542,1454.433,30.6,4.12,15183.616,164.905,9.19,0.717,0
121,72,20,1962,0,8,657,32784,0,540542,1454.433,30.6,4.12,15183.616,164.905,9.19,0.717,0
121,73,14,1976,0,8,564,33348,0,540542,1454.433,30.6,4.12,15183.616,164.905,9.19,0.717,0
121,74,27,2003,0,8,764,34112,0,540542,1454.433,30.6,4.12,15183.616,164.905,9.19,0.717,0
121,75,10,2013,0,8,629,34741,0,540542,1454.433,30.6,4.12,15183.616,164.905,9.19,0.717,0
121,76,22,2035,0,8,0,34741,0,540542,1454.433,30.6,4.12,15183.616,164.905,9.19,0.717,0
121,77,30,2065,0,8,0,36857,0,540542,1454.433,30.6,4.12,15183.616,164.905,9.19,0.717,0
121,78,29,2094,0,8,634,37491,0,540542,1454.433,30.6,4.12,15183.616,164.905,9.19,0.717,0
121,79,26,2120,0,8,1132,38623,0,540542,1454.433,30.6,4.12,15183.616,164.905,9.19,0.717,0
121,80,17,2137,0,8,0,38623,0,540542,1454.433,30.6,4.12,15183.616,164.905,9.19,0.717,0
121,81,13,2150,0,8,0,40848,0,540542,1454.433,30.6,4.12,15183.616,164.905,9.19,0.717,0
121,82,37,2187,0,8,706,41554,0,540542,1454.433,30.6,4.12,15183.616,164.905,9.19,0.717,0
121,83,16,2203,0,8,1276,42830,0,540542,1454.433,30.6,4.12,15183.616,164.905,9.19,0.717,0
121,84,14,2217,0,8,1168,43998,0,540542,1454.433,30.6,4.12,15183.616,164.905,9.19,0.717,0
121,85,21,2238,0,8,1187,45185,0,540542,1454.433,30.6,4.12,15183.616,164.905,9.19,0.717,0
121,86,23,2261,0,8,997,46182,0,540542,1454.433,30.6,4.12,15183.616,164.905,9.19,0.717,0
121,87,16,2277,0,8,709,46891,0,540542,1454.433,30.6,4.12,15183.616,164.905,9.19,0.717,0
121,88,6,2283,0,8,850,47741,0,540542,1454.433,30.6,4.12,15183.616,164.905,9.19,0.717,0
121,89,22,2305,0,8,862,48603,0,540542,1454.433,30.6,4.12,15183.616,164.905,9.19,0.717,0
121,90,18,2323,0,8,735,49338,0,540542,1454.433,30.6,4.12,15183.616,164.905,9.19,0.717,0
121,91,13,2336,0,8,998,50336,0,540542,1454.433,30.6,4.12,15183.616,164.905,9.19,0.717,0
121,92,25,2361,1,9,1240,51576,0,540542,1454.433,30.6,4.12,15183.616,164.905,9.19,0.717,0
121,93,21,2382,0,9,1386,52962,0,540542,1454.433,30.6,4.12,15183.616,164.905,9.19,0.717,0
121,94,18,2400,1,10,905,53867,0,540542,1454.433,30.6,4.12,15183.616,164.905,9.19,0.717,0
121,95,10,2410,0,10,1378,55245,0,540542,1454.433,30.6,4.12,15183.616,164.905,9.19,0.717,0
121,96,25,2435,0,10,893,56138,0,540542,1454.433,30.6,4.12,15183.616,164.905,9.19,0.717,0
121,97,33,2468,1,11,778,56916,0,540542,1454.433,30.6,4.12,15183.616,164.905,9.19,0.717,0
121,98,23,2491,1,12,695,57611,0,540542,1454.433,30.6,4.12,15183.616,164.905,9.19,0.717,0
121,99,10,2501,0,12,972,58583,0,540542,1454.433,30.6,4.12,15183.616,164.905,9.19,0.717,0
121,100,16,2517,1,13,947,59530,0,540542,1454.433,30.6,4.12,15183.616,164.905,9.19,0.717,0
121,101,36,2553,0,13,451,59981,0,540542,1454.433,30.6,4.12,15183.616,164.905,9.19,0.717,0
121,102,64,2617,0,13,236,60217,0,540542,1454.433,30.6,4.12,15183.616,164.905,9.19,0.717,0
121,103,47,2664,0,13,1602,61819,0,540542,1454.433,30.6,4.12,15183.616,164.905,9.19,0.717,0
121,104,67,2731,0,13,948,62767,0,540542,1454.433,30.6,4.12,15183.616,164.905,9.19,0.717,0
121,105,31,2762,0,13,792,63559,0,540542,1454.433,30.6,4.12,15183.616,164.905,9.19,0.717,0
121,106,39,2801,1,14,680,64239,0,540542,1454.433,30.6,4.12,15183.616,164.905,9.19,0.717,0
121,107,30,2831,0,14,937,65176,0,540542,1454.433,30.6,4.12,15183.616,164.905,9.19,0.717,0
121,108,68,2899,1,15,623,65799,0,540542,1454.433,30.6,4.12,15183.616,164.905,9.19,0.717,0
121,109,14,2913,0,15,807,66606,0,540542,1454.433,30.6,4.12,15183.616,164.905,9.19,0.717,0
121,110,17,2930,0,15,658,67264,0,540542,1454.433,30.6,4.12,15183.616,164.905,9.19,0.717,0
121,111,36,2966,0,15,721,67985,0,540542,1454.433,30.6,4.12,15183.616,164.905,9.19,0.717,0
121,112,0,2966,0,15,711,68696,0,540542,1454.433,30.6,4.12,15183.616,164.905,9.19,0.717,0
121,113,78,3044,0,15,674,69370,0,540542,1454.433,30.6,4.12,15183.616,164.905,9.19,0.717,0
121,114,59,3103,0,15,680,70050,0,540542,1454.433,30.6,4.12,15183.616,164.905,9.19,0.717,0
121,115,0,3103,0,15,795,70845,0,540542,1454.433,30.6,4.12,15183.616,164.905,9.19,0.717,0
121,116,17,3120,0,15,1129,71974,0,540542,1454.433,30.6,4.12,15183.616,164.905,9.19,0.717,0
121,117,132,3252,0,15,987,72961,0,540542,1454.433,30.6,4.12,15183.616,164.905,9.19,0.717,0
121,118,50,3302,0,15,1146,74107,0,540542,1454.433,30.6,4.12,15183.616,164.905,9.19,0.717,0
121,119,67,3369,0,15,1443,75550,0,540542,1454.433,30.6,4.12,15183.616,164.905,9.19,0.717,0
121,120,137,3506,0,15,1387,76937,0,540542,1454.433,30.6,4.12,15183.616,164.905,9.19,0.717,0
121,121,61,3567,0,15,1103,78040,0,540542,1454.433,30.6,4.12,15183.616,164.905,9.19,0.717,0
121,122,152,3719,1,16,860,78900,0,540542,1454.433,30.6,4.12,15183.616,164.905,9.19,0.717,0
121,123,74,3793,0,16,917,79817,0,540542,1454.433,30.6,4.12,15183.616,164.905,9.19,0.717,0
121,124,156,3949,1,17,1182,80999,0,540542,1454.433,30.6,4.12,15183.616,164.905,9.19,0.717,0
121,125,215,4164,0,17,1209,82208,0,540542,1454.433,30.6,4.12,15183.616,164.905,9.19,0.717,0
121,126,129,4293,1,18,907,83115,0,540542,1454.433,30.6,4.12,15183.616,164.905,9.19,0.717,0
121,127,153,4446,1,19,1029,84144,0,540542,1454.433,30.6,4.12,15183.616,164.905,9.19,0.717,0
121,128,148,4594,0,19,1443,85587,0,540542,1454.433,30.6,4.12,15183.616,164.905,9.19,0.717,0
121,129,86,4680,0,19,1064,86651,0,540542,1454.433,30.6,4.12,15183.616,164.905,9.19,0.717,0
121,130,89,4769,0,19,981,87632,0,540542,1454.433,30.6,4.12,15183.616,164.905,9.19,0.717,0
121,131,129,4898,0,19,760,88392,0,540542,1454.433,30.6,4.12,15183.616,164.905,9.19,0.717,0
121,132,143,5041,0,19,1163,89555,0,540542,1454.433,30.6,4.12,15183.616,164.905,9.19,0.717,0
121,133,116,5157,0,19,1149,90704,0,540542,1454.433,30.6,4.12,15183.616,164.905,9.19,0.717,0
121,134,66,5223,1,20,1199,91903,0,540542,1454.433,30.6,4.12,15183.616,164.905,9.19,0.717,0
121,135,143,5366,1,21,1195,93098,0,540542,1454.433,30.6,4.12,15183.616,164.905,9.19,0.717,0
121,136,128,5494,0,21,949,94047,0,540542,1454.433,30.6,4.12,15183.616,164.905,9.19,0.717,0
121,137,78,5572,1,22,818,94865,0,540542,1454.433,30.6,4.12,15183.616,164.905,9.19,0.717,0
121,138,107,5679,0,22,1310,96175,0,540542,1454.433,30.6,4.12,15183.616,164.905,9.19,0.717,0
121,139,106,5785,0,22,1036,97211,0,540542,1454.433,30.6,4.12,15183.616,164.905,9.19,0.717,0
121,140,124,5909,1,23,964,98175,0,540542,1454.433,30.6,4.12,15183.616,164.905,9.19,0.717,0
121,141,170,6079,1,24,1125,99300,0,540542,1454.433,30.6,4.12,15183.616,164.905,9.19,0.717,0
121,142,146,6225,0,24,933,100233,0,540542,1454.433,30.6,4.12,15183.616,164.905,9.19,0.717,0
121,143,145,6370,0,24,1497,101730,0,540542,1454.433,30.6,4.12,15183.616,164.905,9.19,0.717,0
121,144,194,6564,1,25,952,102682,0,540542,1454.433,30.6,4.12,15183.616,164.905,9.19,0.717,0
121,145,96,6660,1,26,972,103654,0,540542,1454.433,30.6,4.12,15183.616,164.905,9.19,0.717,0
121,146,119,6779,0,26,977,104631,0,540542,1454.433,30.6,4.12,15183.616,164.905,9.19,0.717,0
121,147,133,6912,1,27,1224,105855,0,540542,1454.433,30.6,4.12,15183.616,164.905,9.19,0.717,0
121,148,135,7047,1,28,1054,106909,0,540542,1454.433,30.6,4.12,15183.616,164.905,9.19,0.717,0
121,149,178,7225,0,28,1190,108099,0,540542,1454.433,30.6,4.12,15183.616,164.905,9.19,0.717,0
121,150,104,7329,0,28,1021,109120,0,540542,1454.433,30.6,4.12,15183.616,164.905,9.19,0.717,0
121,151,140,7469,0,28,1129,110249,0,540542,1454.433,30.6,4.12,15183.616,164.905,9.19,0.717,0
121,152,109,7578,0,28,1489,111738,0,540542,1454.433,30.6,4.12,15183.616,164.905,9.19,0.717,0
121,153,89,7667,0,28,1189,112927,0,540542,1454.433,30.6,4.12,15183.616,164.905,9.19,0.717,0
121,154,141,7808,0,28,958,113885,0,540542,1454.433,30.6,4.12,15183.616,164.905,9.19,0.717,0
121,155,195,8003,1,29,1842,115727,0,540542,1454.433,30.6,4.12,15183.616,164.905,9.19,0.717,0
121,156,137,8140,0,29,1337,117064,0,540542,1454.433,30.6,4.12,15183.616,164.905,9.19,0.717,0
121,157,141,8281,0,29,1320,118384,0,540542,1454.433,30.6,4.12,15183.616,164.905,9.19,0.717,0
121,158,80,8361,0,29,1076,119460,0,540542,1454.433,30.6,4.12,15183.616,164.905,9.19,0.717,0
121,159,125,8486,0,29,1539,120999,0,540542,1454.433,30.6,4.12,15183.616,164.905,9.19,0.717,0
121,160,98,8584,0,29,1149,122148,0,540542,1454.433,30.6,4.12,15183.616,164.905,9.19,0.717,0
121,161,83,8667,0,29,1324,123472,0,540542,1454.433,30.6,4.12,15183.616,164.905,9.19,0.717,0
121,162,74,8741,0,29,1494,124966,0,540542,1454.433,30.6,4.12,15183.616,164.905,9.19,0.717,0
121,163,93,8834,2,31,1709,126675,0,540542,1454.433,30.6,4.12,15183.616,164.905,9.19,0.717,0
121,164,66,8900,0,31,1286,127961,0,540542,1454.433,30.6,4.12,15183.616,164.905,9.19,0.717,0
121,165,90,8990,0,31,1094,129055,0,540542,1454.433,30.6,4.12,15183.616,164.905,9.19,0.717,0
121,166,62,9052,0,31,1301,130356,0,540542,1454.433,30.6,4.12,15183.616,164.905,9.19,0.717,0
121,167,121,9173,1,32,1267,131623,0,540542,1454.433,30.6,4.12,15183.616,164.905,9.19,0.717,0
121,168,70,9243,1,33,1257,132880,0,540542,1454.433,30.6,4.12,15183.616,164.905,9.19,0.717,0
121,169,85,9328,0,33,1640,134520,0,540542,1454.433,30.6,4.12,15183.616,164.905,9.19,0.717,0
121,170,99,9427,0,33,1438,135958,0,540542,1454.433,30.6,4.12,15183.616,164.905,9.19,0.717,0
121,171,67,9494,0,33,1242,137200,0,540542,1454.433,30.6,4.12,15183.616,164.905,9.19,0.717,0
121,172,74,9568,0,33,1408,138608,0,540542,1454.433,30.6,4.12,15183.616,164.905,9.19,0.717,0
121,173,81,9649,0,33,1204,139812,0,540542,1454.433,30.6,4.12,15183.616,164.905,9.19,0.717,0
121,174,75,9724,0,33,1372,141184,0,540542,1454.433,30.6,4.12,15183.616,164.905,9.19,0.717,0
121,175,46,9770,1,34,1190,142374,0,540542,1454.433,30.6,4.12,15183.616,164.905,9.19,0.717,0
121,176,48,9818,0,34,1098,143472,0,540542,1454.433,30.6,4.12,15183.616,164.905,9.19,0.717,0
121,177,67,9885,0,34,1456,144928,0,540542,1454.433,30.6,4.12,15183.616,164.905,9.19,0.717,0
121,178,54,9939,0,34,1489,146417,0,540542,1454.433,30.6,4.12,15183.616,164.905,9.19,0.717,0
121,179,75,10014,0,34,1264,147681,0,540542,1454.433,30.6,4.12,15183.616,164.905,9.19,0.717,0
121,180,31,10045,0,34,1454,149135,0,540542,1454.433,30.6,4.12,15183.616,164.905,9.19,0.717,0
121,181,53,10098,0,34,1583,150718,0,540542,1454.433,30.6,4.12,15183.616,164.905,9.19,0.717,0
121,182,59,10157,0,34,1427,152145,0,540542,1454.433,30.6,4.12,15183.616,164.905,9.19,0.717,0
121,183,37,10194,0,34,1677,153822,0,540542,1454.433,30.6,4.12,15183.616,164.905,9.19,0.717,0
121,184,97,10291,0,34,1628,155450,0,540542,1454.433,30.6,4.12,15183.616,164.905,9.19,0.717,0
121,185,63,10354,0,34,1519,156969,0,540542,1454.433,30.6,4.12,15183.616,164.905,9.19,0.717,0
121,186,44,10398,0,34,1555,158524,0,540542,1454.433,30.6,4.12,15183.616,164.905,9.19,0.717,0
121,187,67,10465,0,34,1583,160107,0,540542,1454.433,30.6,4.12,15183.616,164.905,9.19,0.717,0
121,188,65,10530,0,34,1608,161715,0,540542,1454.433,30.6,4.12,15183.616,164.905,9.19,0.717,0
121,189,37,10567,0,34,1488,163203,0,540542,1454.433,30.6,4.12,15183.616,164.905,9.19,0.717,0
121,190,54,10621,0,34,1123,164326,0,540542,1454.433,30.6,4.12,15183.616,164.905,9.19,0.717,0
121,191,35,10656,0,34,1356,165682,0,540542,1454.433,30.6,4.12,15183.616,164.905,9.19,0.717,0
121,192,86,10742,0,34,1232,166914,0,540542,1454.433,30.6,4.12,15183.616,164.905,9.19,0.717,0
121,193,66,10808,0,34,1338,168252,0,540542,1454.433,30.6,4.12,15183.616,164.905,9.19,0.717,0
121,194,51,10859,0,34,1282,169534,0,540542,1454.433,30.6,4.12,15183.616,164.905,9.19,0.717,0
121,195,35,10894,1,35,1303,170837,0,540542,1454.433,30.6,4.12,15183.616,164.905,9.19,0.717,0
121,196,49,10943,0,35,1389,172226,0,540542,1454.433,30.6,4.12,15183.616,164.905,9.19,0.717,0
121,197,50,10993,0,35,1221,173447,0,540542,1454.433,30.6,4.12,15183.616,164.905,9.19,0.717,0
121,198,69,11062,0,35,1534,174981,0,540542,1454.433,30.6,4.12,15183.616,164.905,9.19,0.717,0
121,199,51,11113,0,35,1366,176347,0,540542,1454.433,30.6,4.12,15183.616,164.905,9.19,0.717,0
121,200,41,11154,0,35,1572,177919,0,540542,1454.433,30.6,4.12,15183.616,164.905,9.19,0.717,0
121,201,24,11178,1,36,1252,179171,0,540542,1454.433,30.6,4.12,15183.616,164.905,9.19,0.717,0
121,202,32,11210,1,37,0,179171,0,540542,1454.433,30.6,4.12,15183.616,164.905,9.19,0.717,0
121,203,22,11232,0,37,0,179171,0,540542,1454.433,30.6,4.12,15183.616,164.905,9.19,0.717,0
121,204,39,11271,0,37,0,179171,0,540542,1454.433,30.6,4.12,15183.616,164.905,9.19,0.717,0
122,1,0,18,1,1,0,0,72.22,20250834,15.196,16.4,2.519,2014.306,268.024,2.42,0.427,0
122,2,10,28,0,1,0,0,72.22,20250834,15.196,16.4,2.519,2014.306,268.024,2.42,0.427,0
122,3,8,36,2,3,0,0,72.22,20250834,15.196,16.4,2.519,2014.306,268.024,2.42,0.427,0
122,4,3,39,0,3,0,0,72.22,20250834,15.196,16.4,2.519,2014.306,268.024,2.42,0.427,0
122,5,2,41,0,3,0,0,72.22,20250834,15.196,16.4,2.519,2014.306,268.024,2.42,0.427,0
122,6,4,45,2,5,0,0,72.22,20250834,15.196,16.4,2.519,2014.306,268.024,2.42,0.427,0
122,7,2,47,0,5,0,0,72.22,20250834,15.196,16.4,2.519,2014.306,268.024,2.42,0.427,0
122,8,9,56,0,5,0,0,72.22,20250834,15.196,16.4,2.519,2014.306,268.024,2.42,0.427,0
122,9,3,59,2,7,0,0,72.22,20250834,15.196,16.4,2.519,2014.306,268.024,2.42,0.427,0
122,10,0,59,0,7,0,0,72.22,20250834,15.196,16.4,2.519,2014.306,268.024,2.42,0.427,0
122,11,28,87,0,7,0,0,72.22,20250834,15.196,16.4,2.519,2014.306,268.024,2.42,0.427,0
122,12,18,105,2,9,0,0,72.22,20250834,15.196,16.4,2.519,2014.306,268.024,2.42,0.427,0
122,13,11,116,0,9,0,0,72.22,20250834,15.196,16.4,2.519,2014.306,268.024,2.42,0.427,0
122,14,7,123,1,10,0,0,72.22,20250834,15.196,16.4,2.519,2014.306,268.024,2.42,0.427,0
122,15,21,144,3,13,0,0,72.22,20250834,15.196,16.4,2.519,2014.306,268.024,2.42,0.427,0
122,16,4,148,0,13,0,0,72.22,20250834,15.196,16.4,2.519,2014.306,268.024,2.42,0.427,0
122,17,23,171,0,13,0,0,72.22,20250834,15.196,16.4,2.519,2014.306,268.024,2.42,0.427,0
122,18,19,190,0,13,0,0,72.22,20250834,15.196,16.4,2.519,2014.306,268.024,2.42,0.427,0
122,19,26,216,0,13,0,0,72.22,20250834,15.196,16.4,2.519,2014.306,268.024,2.42,0.427,0
122,20,8,224,1,14,0,0,72.22,20250834,15.196,16.4,2.519,2014.306,268.024,2.42,0.427,0
122,21,22,246,0,14,0,0,72.22,20250834,15.196,16.4,2.519,2014.306,268.024,2.42,0.427,0
122,22,12,258,0,14,0,0,72.22,20250834,15.196,16.4,2.519,2014.306,268.024,2.42,0.427,0
122,23,35,293,3,17,0,0,72.22,20250834,15.196,16.4,2.519,2014.306,268.024,2.42,0.427,0
122,24,16,309,4,21,0,0,72.22,20250834,15.196,16.4,2.519,2014.306,268.024,2.42,0.427,0
122,25,16,325,0,21,0,0,72.22,20250834,15.196,16.4,2.519,2014.306,268.024,2.42,0.427,0
122,26,45,370,0,21,0,0,72.22,20250834,15.196,16.4,2.519,2014.306,268.024,2.42,0.427,0
122,27,19,389,2,23,0,0,72.22,20250834,15.196,16.4,2.519,2014.306,268.024,2.42,0.427,0
122,28,19,408,0,23,0,0,72.22,20250834,15.196,16.4,2.519,2014.306,268.024,2.42,0.427,0
122,29,16,424,1,24,0,0,72.22,20250834,15.196,16.4,2.519,2014.306,268.024,2.42,0.427,0
122,30,58,482,1,25,0,0,72.22,20250834,15.196,16.4,2.519,2014.306,268.024,2.42,0.427,0
122,31,8,490,1,26,0,0,69.44,20250834,15.196,16.4,2.519,2014.306,268.024,2.42,0.427,0
122,32,18,508,0,26,0,0,69.44,20250834,15.196,16.4,2.519,2014.306,268.024,2.42,0.427,0
122,33,36,544,0,26,0,0,69.44,20250834,15.196,16.4,2.519,2014.306,268.024,2.42,0.427,0
122,34,19,563,1,27,0,0,69.44,20250834,15.196,16.4,2.519,2014.306,268.024,2.42,0.427,0
122,35,17,580,2,29,0,0,69.44,20250834,15.196,16.4,2.519,2014.306,268.024,2.42,0.427,0
122,36,32,612,3,32,0,0,69.44,20250834,15.196,16.4,2.519,2014.306,268.024,2.42,0.427,0
122,37,19,631,0,32,0,0,69.44,20250834,15.196,16.4,2.519,2014.306,268.024,2.42,0.427,0
122,38,19,650,0,32,0,0,69.44,20250834,15.196,16.4,2.519,2014.306,268.024,2.42,0.427,0
122,39,18,668,3,35,0,0,69.44,20250834,15.196,16.4,2.519,2014.306,268.024,2.42,0.427,0
122,40,24,692,2,37,0,0,56.48,20250834,15.196,16.4,2.519,2014.306,268.024,2.42,0.427,0
122,41,12,704,1,38,0,0,56.48,20250834,15.196,16.4,2.519,2014.306,268.024,2.42,0.427,0
122,42,8,712,1,39,0,0,56.48,20250834,15.196,16.4,2.519,2014.306,268.024,2.42,0.427,0
122,43,18,730,1,40,0,0,56.48,20250834,15.196,16.4,2.519,2014.306,268.024,2.42,0.427,0
122,44,28,758,4,44,0,0,56.48,20250834,15.196,16.4,2.519,2014.306,268.024,2.42,0.427,0
122,45,21,779,2,46,0,0,56.48,20250834,15.196,16.4,2.519,2014.306,268.024,2.42,0.427,0
122,46,27,806,0,46,0,0,56.48,20250834,15.196,16.4,2.519,2014.306,268.024,2.42,0.427,0
122,47,29,835,2,48,0,0,56.48,20250834,15.196,16.4,2.519,2014.306,268.024,2.42,0.427,0
122,48,25,860,4,52,0,0,56.48,20250834,15.196,16.4,2.519,2014.306,268.024,2.42,0.427,0
122,49,14,874,0,52,0,0,56.48,20250834,15.196,16.4,2.519,2014.306,268.024,2.42,0.427,0
122,50,27,901,1,53,0,0,56.48,20250834,15.196,16.4,2.519,2014.306,268.024,2.42,0.427,0
122,51,30,931,2,55,0,0,56.48,20250834,15.196,16.4,2.519,2014.306,268.024,2.42,0.427,0
122,52,16,947,5,60,0,0,56.48,20250834,15.196,16.4,2.519,2014.306,268.024,2.42,0.427,0
122,53,22,969,2,62,0,0,56.48,20250834,15.196,16.4,2.519,2014.306,268.024,2.42,0.427,0
122,54,46,1015,1,63,0,0,56.48,20250834,15.196,16.4,2.519,2014.306,268.024,2.42,0.427,0
122,55,15,1030,2,65,0,0,56.48,20250834,15.196,16.4,2.519,2014.306,268.024,2.42,0.427,0
122,56,29,1059,2,67,0,0,56.48,20250834,15.196,16.4,2.519,2014.306,268.024,2.42,0.427,0
122,57,18,1077,3,70,0,0,56.48,20250834,15.196,16.4,2.519,2014.306,268.024,2.42,0.427,0
122,58,39,1116,0,70,0,0,56.48,20250834,15.196,16.4,2.519,2014.306,268.024,2.42,0.427,0
122,59,78,1194,2,72,0,0,56.48,20250834,15.196,16.4,2.519,2014.306,268.024,2.42,0.427,0
122,60,32,1226,1,73,0,0,56.48,20250834,15.196,16.4,2.519,2014.306,268.024,2.42,0.427,0
122,61,24,1250,3,76,0,0,56.48,20250834,15.196,16.4,2.519,2014.306,268.024,2.42,0.427,0
122,62,15,1265,1,77,0,0,56.48,20250834,15.196,16.4,2.519,2014.306,268.024,2.42,0.427,0
122,63,50,1315,1,78,0,0,52.78,20250834,15.196,16.4,2.519,2014.306,268.024,2.42,0.427,0
122,64,36,1351,0,78,0,0,52.78,20250834,15.196,16.4,2.519,2014.306,268.024,2.42,0.427,0
122,65,0,1351,0,78,0,0,52.78,20250834,15.196,16.4,2.519,2014.306,268.024,2.42,0.427,0
122,66,110,1461,7,85,0,0,52.78,20250834,15.196,16.4,2.519,2014.306,268.024,2.42,0.427,0
122,67,24,1485,2,87,0,0,52.78,20250834,15.196,16.4,2.519,2014.306,268.024,2.42,0.427,0
122,68,38,1523,3,90,0,0,52.78,20250834,15.196,16.4,2.519,2014.306,268.024,2.42,0.427,0
122,69,10,1533,2,92,0,0,52.78,20250834,15.196,16.4,2.519,2014.306,268.024,2.42,0.427,0
122,70,14,1547,0,92,0,0,52.78,20250834,15.196,16.4,2.519,2014.306,268.024,2.42,0.427,0
122,71,39,1586,2,94,0,0,52.78,20250834,15.196,16.4,2.519,2014.306,268.024,2.42,0.427,0
122,72,81,1667,2,96,0,0,52.78,20250834,15.196,16.4,2.519,2014.306,268.024,2.42,0.427,0
122,73,55,1722,1,97,0,0,52.78,20250834,15.196,16.4,2.519,2014.306,268.024,2.42,0.427,0
122,74,30,1752,4,101,0,0,52.78,20250834,15.196,16.4,2.519,2014.306,268.024,2.42,0.427,0
122,75,24,1776,3,104,0,0,52.78,20250834,15.196,16.4,2.519,2014.306,268.024,2.42,0.427,0
122,76,33,1809,0,104,0,0,52.78,20250834,15.196,16.4,2.519,2014.306,268.024,2.42,0.427,0
122,77,51,1860,0,104,0,0,52.78,20250834,15.196,16.4,2.519,2014.306,268.024,2.42,0.427,0
122,78,25,1885,2,106,0,0,52.78,20250834,15.196,16.4,2.519,2014.306,268.024,2.42,0.427,0
122,79,5,1890,1,107,0,0,52.78,20250834,15.196,16.4,2.519,2014.306,268.024,2.42,0.427,0
122,80,16,1906,0,107,0,0,52.78,20250834,15.196,16.4,2.519,2014.306,268.024,2.42,0.427,0
122,81,17,1923,1,108,0,0,52.78,20250834,15.196,16.4,2.519,2014.306,268.024,2.42,0.427,0
122,82,10,1933,1,109,0,0,52.78,20250834,15.196,16.4,2.519,2014.306,268.024,2.42,0.427,0
122,83,28,1961,2,111,0,0,52.78,20250834,15.196,16.4,2.519,2014.306,268.024,2.42,0.427,0
122,84,0,1961,0,111,0,0,52.78,20250834,15.196,16.4,2.519,2014.306,268.024,2.42,0.427,0
122,85,17,1978,0,111,0,0,52.78,20250834,15.196,16.4,2.519,2014.306,268.024,2.42,0.427,0
122,86,23,2001,1,112,0,0,52.78,20250834,15.196,16.4,2.519,2014.306,268.024,2.42,0.427,0
122,87,6,2007,1,113,0,0,52.78,20250834,15.196,16.4,2.519,2014.306,268.024,2.42,0.427,0
122,88,32,2039,0,113,0,0,52.78,20250834,15.196,16.4,2.519,2014.306,268.024,2.42,0.427,0
122,89,79,2118,0,113,0,0,52.78,20250834,15.196,16.4,2.519,2014.306,268.024,2.42,0.427,0
122,90,29,2147,1,114,0,0,52.78,20250834,15.196,16.4,2.519,2014.306,268.024,2.42,0.427,0
122,91,26,2173,1,115,0,0,52.78,20250834,15.196,16.4,2.519,2014.306,268.024,2.42,0.427,0
122,92,8,2181,1,116,0,0,52.78,20250834,15.196,16.4,2.519,2014.306,268.024,2.42,0.427,0
122,93,21,2202,0,116,0,0,52.78,20250834,15.196,16.4,2.519,2014.306,268.024,2.42,0.427,0
122,94,58,2260,1,117,0,0,52.78,20250834,15.196,16.4,2.519,2014.306,268.024,2.42,0.427,0
122,95,25,2285,0,117,0,0,52.78,20250834,15.196,16.4,2.519,2014.306,268.024,2.42,0.427,0
122,96,18,2303,1,118,0,0,52.78,20250834,15.196,16.4,2.519,2014.306,268.024,2.42,0.427,0
122,97,27,2330,1,119,0,0,52.78,20250834,15.196,16.4,2.519,2014.306,268.024,2.42,0.427,0
122,98,1,2331,0,119,0,0,52.78,20250834,15.196,16.4,2.519,2014.306,268.024,2.42,0.427,0
122,99,17,2348,0,119,0,0,52.78,20250834,15.196,16.4,2.519,2014.306,268.024,2.42,0.427,0
122,100,10,2358,1,120,0,0,52.78,20250834,15.196,16.4,2.519,2014.306,268.024,2.42,0.427,0
122,101,0,2358,0,120,0,0,52.78,20250834,15.196,16.4,2.519,2014.306,268.024,2.42,0.427,0
122,102,46,2404,1,121,0,0,52.78,20250834,15.196,16.4,2.519,2014.306,268.024,2.42,0.427,0
122,103,2,2406,0,121,0,0,52.78,20250834,15.196,16.4,2.519,2014.306,268.024,2.42,0.427,0
122,104,5,2411,0,121,0,0,52.78,20250834,15.196,16.4,2.519,2014.306,268.024,2.42,0.427,0
122,105,1,2412,0,121,0,0,52.78,20250834,15.196,16.4,2.519,2014.306,268.024,2.42,0.427,0
122,106,11,2423,0,121,0,0,52.78,20250834,15.196,16.4,2.519,2014.306,268.024,2.42,0.427,0
122,107,10,2433,0,121,0,0,52.78,20250834,15.196,16.4,2.519,2014.306,268.024,2.42,0.427,0
122,108,7,2440,0,121,0,0,52.78,20250834,15.196,16.4,2.519,2014.306,268.024,2.42,0.427,0
122,109,27,2467,0,121,0,0,52.78,20250834,15.196,16.4,2.519,2014.306,268.024,2.42,0.427,0
122,110,5,2472,0,121,0,0,52.78,20250834,15.196,16.4,2.519,2014.306,268.024,2.42,0.427,0
122,111,3,2475,0,121,0,0,52.78,20250834,15.196,16.4,2.519,2014.306,268.024,2.42,0.427,0
122,112,0,2475,0,121,0,0,52.78,20250834,15.196,16.4,2.519,2014.306,268.024,2.42,0.427,0
122,113,2,2477,1,122,0,0,52.78,20250834,15.196,16.4,2.519,2014.306,268.024,2.42,0.427,0
122,114,17,2494,1,123,0,0,52.78,20250834,15.196,16.4,2.519,2014.306,268.024,2.42,0.427,0
122,115,0,2494,0,123,0,0,52.78,20250834,15.196,16.4,2.519,2014.306,268.024,2.42,0.427,0
122,116,9,2503,0,123,0,0,52.78,20250834,15.196,16.4,2.519,2014.306,268.024,2.42,0.427,0
122,117,0,2503,0,123,0,0,52.78,20250834,15.196,16.4,2.519,2014.306,268.024,2.42,0.427,0
122,118,7,2510,0,123,0,0,52.78,20250834,15.196,16.4,2.519,2014.306,268.024,2.42,0.427,0
122,119,3,2513,1,124,0,0,52.78,20250834,15.196,16.4,2.519,2014.306,268.024,2.42,0.427,0
122,120,7,2520,0,124,0,0,52.78,20250834,15.196,16.4,2.519,2014.306,268.024,2.42,0.427,0
122,121,1,2521,0,124,0,0,52.78,20250834,15.196,16.4,2.519,2014.306,268.024,2.42,0.427,0
122,122,1,2522,0,124,0,0,47.22,20250834,15.196,16.4,2.519,2014.306,268.024,2.42,0.427,0
122,123,13,2535,0,124,0,0,47.22,20250834,15.196,16.4,2.519,2014.306,268.024,2.42,0.427,0
122,124,0,2535,0,124,0,0,47.22,20250834,15.196,16.4,2.519,2014.306,268.024,2.42,0.427,0
122,125,6,2541,0,124,0,0,47.22,20250834,15.196,16.4,2.519,2014.306,268.024,2.42,0.427,0
122,126,2,2543,0,124,0,0,47.22,20250834,15.196,16.4,2.519,2014.306,268.024,2.42,0.427,0
122,127,0,2543,0,124,0,0,47.22,20250834,15.196,16.4,2.519,2014.306,268.024,2.42,0.427,0
122,128,3,2546,0,124,0,0,47.22,20250834,15.196,16.4,2.519,2014.306,268.024,2.42,0.427,0
122,129,6,2552,0,124,0,0,47.22,20250834,15.196,16.4,2.519,2014.306,268.024,2.42,0.427,0
122,130,9,2561,1,125,0,0,47.22,20250834,15.196,16.4,2.519,2014.306,268.024,2.42,0.427,0
122,131,4,2565,0,125,0,0,47.22,20250834,15.196,16.4,2.519,2014.306,268.024,2.42,0.427,0
122,132,2,2567,0,125,0,0,47.22,20250834,15.196,16.4,2.519,2014.306,268.024,2.42,0.427,0
122,133,6,2573,0,125,0,0,47.22,20250834,15.196,16.4,2.519,2014.306,268.024,2.42,0.427,0
122,134,4,2577,0,125,0,0,47.22,20250834,15.196,16.4,2.519,2014.306,268.024,2.42,0.427,0
122,135,5,2582,0,125,0,0,47.22,20250834,15.196,16.4,2.519,2014.306,268.024,2.42,0.427,0
122,136,15,2597,0,125,0,0,47.22,20250834,15.196,16.4,2.519,2014.306,268.024,2.42,0.427,0
122,137,0,2597,0,125,0,0,47.22,20250834,15.196,16.4,2.519,2014.306,268.024,2.42,0.427,0
122,138,17,2614,0,125,0,0,47.22,20250834,15.196,16.4,2.519,2014.306,268.024,2.42,0.427,0
122,139,0,2614,0,125,0,0,47.22,20250834,15.196,16.4,2.519,2014.306,268.024,2.42,0.427,0
122,140,26,2640,0,125,0,0,47.22,20250834,15.196,16.4,2.519,2014.306,268.024,2.42,0.427,0
122,141,26,2666,0,125,0,0,47.22,20250834,15.196,16.4,2.519,2014.306,268.024,2.42,0.427,0
122,142,1,2667,0,125,0,0,47.22,20250834,15.196,16.4,2.519,2014.306,268.024,2.42,0.427,0
122,143,0,2667,0,125,0,0,47.22,20250834,15.196,16.4,2.519,2014.306,268.024,2.42,0.427,0
122,144,21,2688,0,125,0,0,47.22,20250834,15.196,16.4,2.519,2014.306,268.024,2.42,0.427,0
122,145,11,2699,0,125,0,0,47.22,20250834,15.196,16.4,2.519,2014.306,268.024,2.42,0.427,0
122,146,6,2705,0,125,0,0,47.22,20250834,15.196,16.4,2.519,2014.306,268.024,2.42,0.427,0
122,147,3,2708,0,125,0,0,47.22,20250834,15.196,16.4,2.519,2014.306,268.024,2.42,0.427,0
122,148,5,2713,0,125,0,0,47.22,20250834,15.196,16.4,2.519,2014.306,268.024,2.42,0.427,0
122,149,4,2717,1,126,0,0,47.22,20250834,15.196,16.4,2.519,2014.306,268.024,2.42,0.427,0
122,150,13,2730,0,126,0,0,47.22,20250834,15.196,16.4,2.519,2014.306,268.024,2.42,0.427,0
122,151,6,2736,0,126,0,0,47.22,20250834,15.196,16.4,2.519,2014.306,268.024,2.42,0.427,0
122,152,21,2757,0,126,0,0,47.22,20250834,15.196,16.4,2.519,2014.306,268.024,2.42,0.427,0
122,153,16,2773,0,126,0,0,47.22,20250834,15.196,16.4,2.519,2014.306,268.024,2.42,0.427,0
122,154,3,2776,0,126,0,0,47.22,20250834,15.196,16.4,2.519,2014.306,268.024,2.42,0.427,0
122,155,1,2777,0,126,0,0,47.22,20250834,15.196,16.4,2.519,2014.306,268.024,2.42,0.427,0
122,156,25,2802,0,126,0,0,47.22,20250834,15.196,16.4,2.519,2014.306,268.024,2.42,0.427,0
122,157,5,2807,0,126,0,0,47.22,20250834,15.196,16.4,2.519,2014.306,268.024,2.42,0.427,0
122,158,7,2814,0,126,0,0,39.81,20250834,15.196,16.4,2.519,2014.306,268.024,2.42,0.427,0
122,159,19,2833,0,126,0,0,39.81,20250834,15.196,16.4,2.519,2014.306,268.024,2.42,0.427,0
122,160,9,2842,1,127,0,0,39.81,20250834,15.196,16.4,2.519,2014.306,268.024,2.42,0.427,0
122,161,28,2870,0,127,0,0,39.81,20250834,15.196,16.4,2.519,2014.306,268.024,2.42,0.427,0
122,162,12,2882,0,127,0,0,39.81,20250834,15.196,16.4,2.519,2014.306,268.024,2.42,0.427,0
122,163,16,2898,1,128,0,0,39.81,20250834,15.196,16.4,2.519,2014.306,268.024,2.42,0.427,0
122,164,11,2909,0,128,0,0,39.81,20250834,15.196,16.4,2.519,2014.306,268.024,2.42,0.427,0
122,165,3,2912,0,128,0,0,39.81,20250834,15.196,16.4,2.519,2014.306,268.024,2.42,0.427,0
122,166,4,2916,0,128,0,0,39.81,20250834,15.196,16.4,2.519,2014.306,268.024,2.42,0.427,0
122,167,8,2924,0,128,0,0,39.81,20250834,15.196,16.4,2.519,2014.306,268.024,2.42,0.427,0
122,168,11,2935,0,128,0,0,39.81,20250834,15.196,16.4,2.519,2014.306,268.024,2.42,0.427,0
122,169,5,2940,0,128,0,0,39.81,20250834,15.196,16.4,2.519,2014.306,268.024,2.42,0.427,0
122,170,26,2966,0,128,0,0,39.81,20250834,15.196,16.4,2.519,2014.306,268.024,2.42,0.427,0
122,171,0,2966,0,128,0,0,39.81,20250834,15.196,16.4,2.519,2014.306,268.024,2.42,0.427,0
122,172,25,2991,0,128,0,0,39.81,20250834,15.196,16.4,2.519,2014.306,268.024,2.42,0.427,0
122,173,15,3006,0,128,0,0,39.81,20250834,15.196,16.4,2.519,2014.306,268.024,2.42,0.427,0
122,174,7,3013,0,128,0,0,39.81,20250834,15.196,16.4,2.519,2014.306,268.024,2.42,0.427,0
122,175,11,3024,0,128,0,0,39.81,20250834,15.196,16.4,2.519,2014.306,268.024,2.42,0.427,0
122,176,6,3030,1,129,0,0,39.81,20250834,15.196,16.4,2.519,2014.306,268.024,2.42,0.427,0
122,177,4,3034,1,130,0,0,39.81,20250834,15.196,16.4,2.519,2014.306,268.024,2.42,0.427,0
122,178,7,3041,0,130,0,0,39.81,20250834,15.196,16.4,2.519,2014.306,268.024,2.42,0.427,0
122,179,23,3064,0,130,0,0,39.81,20250834,15.196,16.4,2.519,2014.306,268.024,2.42,0.427,0
122,180,16,3080,0,130,0,0,39.81,20250834,15.196,16.4,2.519,2014.306,268.024,2.42,0.427,0
122,181,6,3086,0,130,0,0,39.81,20250834,15.196,16.4,2.519,2014.306,268.024,2.42,0.427,0
122,182,4,3090,0,130,0,0,39.81,20250834,15.196,16.4,2.519,2014.306,268.024,2.42,0.427,0
122,183,0,3090,0,130,0,0,39.81,20250834,15.196,16.4,2.519,2014.306,268.024,2.42,0.427,0
122,184,28,3118,1,131,0,0,39.81,20250834,15.196,16.4,2.519,2014.306,268.024,2.42,0.427,0
122,185,13,3131,0,131,0,0,39.81,20250834,15.196,16.4,2.519,2014.306,268.024,2.42,0.427,0
122,186,25,3156,0,131,0,0,39.81,20250834,15.196,16.4,2.519,2014.306,268.024,2.42,0.427,0
122,187,14,3170,0,131,0,0,39.81,20250834,15.196,16.4,2.519,2014.306,268.024,2.42,0.427,0
122,188,14,3184,0,131,0,0,39.81,20250834,15.196,16.4,2.519,2014.306,268.024,2.42,0.427,0
122,189,5,3189,0,131,0,0,39.81,20250834,15.196,16.4,2.519,2014.306,268.024,2.42,0.427,0
122,190,6,3195,0,131,0,0,39.81,20250834,15.196,16.4,2.519,2014.306,268.024,2.42,0.427,0
122,191,15,3210,0,131,0,0,34.26,20250834,15.196,16.4,2.519,2014.306,268.024,2.42,0.427,0
122,192,25,3235,0,131,0,0,34.26,20250834,15.196,16.4,2.519,2014.306,268.024,2.42,0.427,0
122,193,13,3248,0,131,0,0,34.26,20250834,15.196,16.4,2.519,2014.306,268.024,2.42,0.427,0
122,194,25,3273,1,132,0,0,34.26,20250834,15.196,16.4,2.519,2014.306,268.024,2.42,0.427,0
122,195,13,3286,0,132,0,0,34.26,20250834,15.196,16.4,2.519,2014.306,268.024,2.42,0.427,0
122,196,10,3296,0,132,0,0,34.26,20250834,15.196,16.4,2.519,2014.306,268.024,2.42,0.427,0
122,197,0,3296,0,132,0,0,34.26,20250834,15.196,16.4,2.519,2014.306,268.024,2.42,0.427,0
122,198,56,3352,0,132,0,0,34.26,20250834,15.196,16.4,2.519,2014.306,268.024,2.42,0.427,0
122,199,16,3368,0,132,0,0,34.26,20250834,15.196,16.4,2.519,2014.306,268.024,2.42,0.427,0
122,200,0,3368,0,132,0,0,34.26,20250834,15.196,16.4,2.519,2014.306,268.024,2.42,0.427,0
122,201,11,3379,0,132,0,0,34.26,20250834,15.196,16.4,2.519,2014.306,268.024,2.42,0.427,0
122,202,0,3379,0,132,0,0,34.26,20250834,15.196,16.4,2.519,2014.306,268.024,2.42,0.427,0
122,203,28,3407,0,132,0,0,34.26,20250834,15.196,16.4,2.519,2014.306,268.024,2.42,0.427,0
122,204,4,3411,0,132,0,0,34.26,20250834,15.196,16.4,2.519,2014.306,268.024,2.42,0.427,0
123,1,13,169,0,0,737,8548,0,441539,1454.037,42.4,19.426,36513.323,168.711,8.83,0.878,0
123,2,19,188,0,0,747,9295,0,441539,1454.037,42.4,19.426,36513.323,168.711,8.83,0.878,0
123,3,7,195,0,0,660,9955,0,441539,1454.037,42.4,19.426,36513.323,168.711,8.83,0.878,0
123,4,7,202,0,0,654,10609,0,441539,1454.037,42.4,19.426,36513.323,168.711,8.83,0.878,0
123,5,11,213,0,0,555,11164,0,441539,1454.037,42.4,19.426,36513.323,168.711,8.83,0.878,0
123,6,14,227,0,0,817,11981,0,441539,1454.037,42.4,19.426,36513.323,168.711,8.83,0.878,0
123,7,14,241,0,0,991,12972,0,441539,1454.037,42.4,19.426,36513.323,168.711,8.83,0.878,0
123,8,52,293,0,0,1001,13973,0,441539,1454.037,42.4,19.426,36513.323,168.711,8.83,0.878,0
123,9,6,299,0,0,995,14968,0,441539,1454.037,42.4,19.426,36513.323,168.711,8.83,0.878,0
123,10,38,337,1,1,1200,16168,0,441539,1454.037,42.4,19.426,36513.323,168.711,8.83,0.878,0
123,11,13,350,1,2,1024,17192,0,441539,1454.037,42.4,19.426,36513.323,168.711,8.83,0.878,0
123,12,20,370,0,2,948,18140,0,441539,1454.037,42.4,19.426,36513.323,168.711,8.83,0.878,0
123,13,8,378,1,3,1047,19187,0,441539,1454.037,42.4,19.426,36513.323,168.711,8.83,0.878,0
123,14,6,384,0,3,1062,20249,0,441539,1454.037,42.4,19.426,36513.323,168.711,8.83,0.878,0
123,15,9,393,0,3,1029,21278,0,441539,1454.037,42.4,19.426,36513.323,168.711,8.83,0.878,0
123,16,6,399,0,3,1076,22354,0,441539,1454.037,42.4,19.426,36513.323,168.711,8.83,0.878,0
123,17,13,412,0,3,979,23333,0,441539,1454.037,42.4,19.426,36513.323,168.711,8.83,0.878,0
123,18,10,422,0,3,783,24116,0,441539,1454.037,42.4,19.426,36513.323,168.711,8.83,0.878,0
123,19,4,426,0,3,572,24688,0,441539,1454.037,42.4,19.426,36513.323,168.711,8.83,0.878,0
123,20,1,427,0,3,705,25393,0,441539,1454.037,42.4,19.426,36513.323,168.711,8.83,0.878,0
123,21,4,431,0,3,810,26203,0,441539,1454.037,42.4,19.426,36513.323,168.711,8.83,0.878,0
123,22,12,443,0,3,640,26843,0,441539,1454.037,42.4,19.426,36513.323,168.711,8.83,0.878,0
123,23,1,444,0,3,609,27452,0,441539,1454.037,42.4,19.426,36513.323,168.711,8.83,0.878,0
123,24,0,444,0,3,555,28007,0,441539,1454.037,42.4,19.426,36513.323,168.711,8.83,0.878,0
123,25,2,446,0,3,614,28621,0,441539,1454.037,42.4,19.426,36513.323,168.711,8.83,0.878,0
123,26,1,447,0,3,698,29319,0,441539,1454.037,42.4,19.426,36513.323,168.711,8.83,0.878,0
123,27,2,449,1,4,1068,30387,0,441539,1454.037,42.4,19.426,36513.323,168.711,8.83,0.878,0
123,28,0,449,0,4,1207,31594,0,441539,1454.037,42.4,19.426,36513.323,168.711,8.83,0.878,0
123,29,8,457,0,4,1243,32837,0,441539,1454.037,42.4,19.426,36513.323,168.711,8.83,0.878,0
123,30,5,462,0,4,1181,34018,0,441539,1454.037,42.4,19.426,36513.323,168.711,8.83,0.878,0
123,31,2,464,0,4,1008,35026,0,441539,1454.037,42.4,19.426,36513.323,168.711,8.83,0.878,0
123,32,2,466,0,4,1070,36096,0,441539,1454.037,42.4,19.426,36513.323,168.711,8.83,0.878,0
123,33,1,467,0,4,731,36827,0,441539,1454.037,42.4,19.426,36513.323,168.711,8.83,0.878,0
123,34,9,476,0,4,1214,38041,0,441539,1454.037,42.4,19.426,36513.323,168.711,8.83,0.878,0
123,35,3,479,0,4,1394,39435,0,441539,1454.037,42.4,19.426,36513.323,168.711,8.83,0.878,0
123,36,1,480,1,5,1009,40444,0,441539,1454.037,42.4,19.426,36513.323,168.711,8.83,0.878,0
123,37,3,483,0,5,1135,41579,0,441539,1454.037,42.4,19.426,36513.323,168.711,8.83,0.878,0
123,38,2,485,0,5,1005,42584,0,441539,1454.037,42.4,19.426,36513.323,168.711,8.83,0.878,0
123,39,3,488,0,5,1107,43691,0,441539,1454.037,42.4,19.426,36513.323,168.711,8.83,0.878,0
123,40,1,489,0,5,775,44466,0,441539,1454.037,42.4,19.426,36513.323,168.711,8.83,0.878,0
123,41,6,495,0,5,1238,45704,0,441539,1454.037,42.4,19.426,36513.323,168.711,8.83,0.878,0
123,42,7,502,0,5,1132,46836,0,441539,1454.037,42.4,19.426,36513.323,168.711,8.83,0.878,0
123,43,3,505,0,5,1316,48152,0,441539,1454.037,42.4,19.426,36513.323,168.711,8.83,0.878,0
123,44,2,507,1,6,1495,49647,0,441539,1454.037,42.4,19.426,36513.323,168.711,8.83,0.878,0
123,45,14,521,0,6,1719,51366,0,441539,1454.037,42.4,19.426,36513.323,168.711,8.83,0.878,0
123,46,10,531,0,6,1425,52791,0,441539,1454.037,42.4,19.426,36513.323,168.711,8.83,0.878,0
123,47,14,545,0,6,1011,53802,0,441539,1454.037,42.4,19.426,36513.323,168.711,8.83,0.878,0
123,48,7,552,0,6,1514,55316,0,441539,1454.037,42.4,19.426,36513.323,168.711,8.83,0.878,0
123,49,5,557,0,6,1661,56977,0,441539,1454.037,42.4,19.426,36513.323,168.711,8.83,0.878,0
123,50,11,568,0,6,1367,58344,0,441539,1454.037,42.4,19.426,36513.323,168.711,8.83,0.878,0
123,51,15,583,0,6,1546,59890,0,441539,1454.037,42.4,19.426,36513.323,168.711,8.83,0.878,0
123,52,15,598,0,6,1717,61607,0,441539,1454.037,42.4,19.426,36513.323,168.711,8.83,0.878,0
123,53,1,599,0,6,1286,62893,0,441539,1454.037,42.4,19.426,36513.323,168.711,8.83,0.878,0
123,54,9,608,0,6,816,63709,0,441539,1454.037,42.4,19.426,36513.323,168.711,8.83,0.878,0
123,55,1,609,0,6,1467,65176,0,441539,1454.037,42.4,19.426,36513.323,168.711,8.83,0.878,0
123,56,1,610,0,6,1248,66424,0,441539,1454.037,42.4,19.426,36513.323,168.711,8.83,0.878,0
123,57,0,610,0,6,1224,67648,0,441539,1454.037,42.4,19.426,36513.323,168.711,8.83,0.878,0
123,58,1,611,0,6,1192,68840,0,441539,1454.037,42.4,19.426,36513.323,168.711,8.83,0.878,0
123,59,4,615,1,7,1367,70207,0,441539,1454.037,42.4,19.426,36513.323,168.711,8.83,0.878,0
123,60,0,615,0,7,985,71192,0,441539,1454.037,42.4,19.426,36513.323,168.711,8.83,0.878,0
123,61,2,617,2,9,593,71785,0,441539,1454.037,42.4,19.426,36513.323,168.711,8.83,0.878,0
123,62,0,617,0,9,1015,72800,0,441539,1454.037,42.4,19.426,36513.323,168.711,8.83,0.878,0
123,63,1,618,0,9,945,73745,0,441539,1454.037,42.4,19.426,36513.323,168.711,8.83,0.878,0
123,64,1,619,0,9,905,74650,0,441539,1454.037,42.4,19.426,36513.323,168.711,8.83,0.878,0
123,65,2,621,0,9,977,75627,0,441539,1454.037,42.4,19.426,36513.323,168.711,8.83,0.878,0
123,66,0,621,0,9,877,76504,0,441539,1454.037,42.4,19.426,36513.323,168.711,8.83,0.878,0
123,67,3,624,0,9,905,77409,0,441539,1454.037,42.4,19.426,36513.323,168.711,8.83,0.878,0
123,68,2,626,0,9,507,77916,0,441539,1454.037,42.4,19.426,36513.323,168.711,8.83,0.878,0
123,69,2,628,0,9,1152,79068,0,441539,1454.037,42.4,19.426,36513.323,168.711,8.83,0.878,0
123,70,1,629,0,9,851,79919,0,441539,1454.037,42.4,19.426,36513.323,168.711,8.83,0.878,0
123,71,2,631,0,9,902,80821,0,441539,1454.037,42.4,19.426,36513.323,168.711,8.83,0.878,0
123,72,3,634,0,9,1130,81951,0,441539,1454.037,42.4,19.426,36513.323,168.711,8.83,0.878,0
123,73,5,639,0,9,1042,82993,0,441539,1454.037,42.4,19.426,36513.323,168.711,8.83,0.878,0
123,74,5,644,0,9,1310,84303,0,441539,1454.037,42.4,19.426,36513.323,168.711,8.83,0.878,0
123,75,1,645,0,9,554,84857,0,441539,1454.037,42.4,19.426,36513.323,168.711,8.83,0.878,0
123,76,2,647,0,9,1236,86093,0,441539,1454.037,42.4,19.426,36513.323,168.711,8.83,0.878,0
123,77,2,649,0,9,911,87004,0,441539,1454.037,42.4,19.426,36513.323,168.711,8.83,0.878,0
123,78,6,655,0,9,860,87864,0,441539,1454.037,42.4,19.426,36513.323,168.711,8.83,0.878,0
123,79,6,661,0,9,852,88716,0,441539,1454.037,42.4,19.426,36513.323,168.711,8.83,0.878,0
123,80,1,662,0,9,786,89502,0,441539,1454.037,42.4,19.426,36513.323,168.711,8.83,0.878,0
123,81,0,662,0,9,768,90270,0,441539,1454.037,42.4,19.426,36513.323,168.711,8.83,0.878,0
123,82,1,663,0,9,464,90734,0,441539,1454.037,42.4,19.426,36513.323,168.711,8.83,0.878,0
123,83,1,664,0,9,927,91661,0,441539,1454.037,42.4,19.426,36513.323,168.711,8.83,0.878,0
123,84,0,664,0,9,923,92584,0,441539,1454.037,42.4,19.426,36513.323,168.711,8.83,0.878,0
123,85,0,664,0,9,1027,93611,0,441539,1454.037,42.4,19.426,36513.323,168.711,8.83,0.878,0
123,86,0,664,0,9,946,94557,0,441539,1454.037,42.4,19.426,36513.323,168.711,8.83,0.878,0
123,87,3,667,0,9,870,95427,0,441539,1454.037,42.4,19.426,36513.323,168.711,8.83,0.878,0
123,88,2,669,0,9,661,96088,0,441539,1454.037,42.4,19.426,36513.323,168.711,8.83,0.878,0
123,89,0,669,0,9,516,96604,0,441539,1454.037,42.4,19.426,36513.323,168.711,8.83,0.878,0
123,90,0,669,0,9,567,97171,0,441539,1454.037,42.4,19.426,36513.323,168.711,8.83,0.878,0
123,91,0,669,0,9,1135,98306,0,441539,1454.037,42.4,19.426,36513.323,168.711,8.83,0.878,0
123,92,0,669,0,9,892,99198,0,441539,1454.037,42.4,19.426,36513.323,168.711,8.83,0.878,0
123,93,1,670,0,9,981,100179,0,441539,1454.037,42.4,19.426,36513.323,168.711,8.83,0.878,0
123,94,0,670,0,9,987,101166,0,441539,1454.037,42.4,19.426,36513.323,168.711,8.83,0.878,0
123,95,1,671,0,9,771,101937,0,441539,1454.037,42.4,19.426,36513.323,168.711,8.83,0.878,0
123,96,0,671,0,9,457,102394,0,441539,1454.037,42.4,19.426,36513.323,168.711,8.83,0.878,0
123,97,0,671,0,9,930,103324,0,441539,1454.037,42.4,19.426,36513.323,168.711,8.83,0.878,0
123,98,0,671,0,9,775,104099,0,441539,1454.037,42.4,19.426,36513.323,168.711,8.83,0.878,0
123,99,1,672,0,9,809,104908,0,441539,1454.037,42.4,19.426,36513.323,168.711,8.83,0.878,0
123,100,0,672,0,9,775,105683,0,441539,1454.037,42.4,19.426,36513.323,168.711,8.83,0.878,0
123,101,1,673,0,9,742,106425,0,441539,1454.037,42.4,19.426,36513.323,168.711,8.83,0.878,0
123,102,0,673,0,9,741,107166,0,441539,1454.037,42.4,19.426,36513.323,168.711,8.83,0.878,0
123,103,0,673,0,9,456,107622,0,441539,1454.037,42.4,19.426,36513.323,168.711,8.83,0.878,0
123,104,0,673,0,9,931,108553,0,441539,1454.037,42.4,19.426,36513.323,168.711,8.83,0.878,0
123,105,0,673,0,9,985,109538,0,441539,1454.037,42.4,19.426,36513.323,168.711,8.83,0.878,0
123,106,0,673,0,9,1087,110625,0,441539,1454.037,42.4,19.426,36513.323,168.711,8.83,0.878,0
123,107,0,673,0,9,930,111555,0,441539,1454.037,42.4,19.426,36513.323,168.711,8.83,0.878,0
123,108,0,673,0,9,848,112403,0,441539,1454.037,42.4,19.426,36513.323,168.711,8.83,0.878,0
123,109,0,673,0,9,834,113237,0,441539,1454.037,42.4,19.426,36513.323,168.711,8.83,0.878,0
123,110,1,674,0,9,583,113820,0,441539,1454.037,42.4,19.426,36513.323,168.711,8.83,0.878,0
123,111,0,674,0,9,959,114779,0,441539,1454.037,42.4,19.426,36513.323,168.711,8.83,0.878,0
123,112,1,675,0,9,1016,115795,0,441539,1454.037,42.4,19.426,36513.323,168.711,8.83,0.878,0
123,113,0,675,0,9,1114,116909,0,441539,1454.037,42.4,19.426,36513.323,168.711,8.83,0.878,0
123,114,2,677,0,9,931,117840,0,441539,1454.037,42.4,19.426,36513.323,168.711,8.83,0.878,0
123,115,1,678,0,9,1085,118925,0,441539,1454.037,42.4,19.426,36513.323,168.711,8.83,0.878,0
123,116,2,680,0,9,1220,120145,0,441539,1454.037,42.4,19.426,36513.323,168.711,8.83,0.878,0
123,117,4,684,0,9,850,120995,0,441539,1454.037,42.4,19.426,36513.323,168.711,8.83,0.878,0
123,118,14,698,0,9,1353,122348,0,441539,1454.037,42.4,19.426,36513.323,168.711,8.83,0.878,0
123,119,1,699,0,9,1615,123963,0,441539,1454.037,42.4,19.426,36513.323,168.711,8.83,0.878,0
123,120,6,705,0,9,1722,125685,0,441539,1454.037,42.4,19.426,36513.323,168.711,8.83,0.878,0
123,121,13,718,0,9,1314,126999,0,441539,1454.037,42.4,19.426,36513.323,168.711,8.83,0.878,0
123,122,9,727,0,9,1748,128747,0,441539,1454.037,42.4,19.426,36513.323,168.711,8.83,0.878,0
123,123,9,736,0,9,1416,130163,0,441539,1454.037,42.4,19.426,36513.323,168.711,8.83,0.878,0
123,124,18,754,0,9,1437,131600,0,441539,1454.037,42.4,19.426,36513.323,168.711,8.83,0.878,0
123,125,15,769,0,9,1501,133101,0,441539,1454.037,42.4,19.426,36513.323,168.711,8.83,0.878,0
123,126,14,783,0,9,1839,134940,0,441539,1454.037,42.4,19.426,36513.323,168.711,8.83,0.878,0
123,127,16,799,0,9,1769,136709,0,441539,1454.037,42.4,19.426,36513.323,168.711,8.83,0.878,0
123,128,21,820,0,9,1717,138426,0,441539,1454.037,42.4,19.426,36513.323,168.711,8.83,0.878,0
123,129,19,839,0,9,1548,139974,0,441539,1454.037,42.4,19.426,36513.323,168.711,8.83,0.878,0
123,130,50,889,0,9,1789,141763,0,441539,1454.037,42.4,19.426,36513.323,168.711,8.83,0.878,0
123,131,40,929,0,9,1617,143380,0,441539,1454.037,42.4,19.426,36513.323,168.711,8.83,0.878,0
123,132,54,983,0,9,1881,145261,0,441539,1454.037,42.4,19.426,36513.323,168.711,8.83,0.878,0
123,133,23,1006,0,9,2144,147405,0,441539,1454.037,42.4,19.426,36513.323,168.711,8.83,0.878,0
123,134,29,1035,0,9,2483,149888,0,441539,1454.037,42.4,19.426,36513.323,168.711,8.83,0.878,0
123,135,49,1084,0,9,2191,152079,0,441539,1454.037,42.4,19.426,36513.323,168.711,8.83,0.878,0
123,136,55,1139,0,9,2434,154513,0,441539,1454.037,42.4,19.426,36513.323,168.711,8.83,0.878,0
123,137,31,1170,0,9,2140,156653,0,441539,1454.037,42.4,19.426,36513.323,168.711,8.83,0.878,0
123,138,72,1242,0,9,2270,158923,0,441539,1454.037,42.4,19.426,36513.323,168.711,8.83,0.878,0
123,139,63,1305,0,9,2123,161046,0,441539,1454.037,42.4,19.426,36513.323,168.711,8.83,0.878,0
123,140,68,1373,0,9,2260,163306,0,441539,1454.037,42.4,19.426,36513.323,168.711,8.83,0.878,0
123,141,49,1422,0,9,3029,166335,0,441539,1454.037,42.4,19.426,36513.323,168.711,8.83,0.878,0
123,142,47,1469,0,9,2445,168780,0,441539,1454.037,42.4,19.426,36513.323,168.711,8.83,0.878,0
123,143,40,1509,0,9,2310,171090,0,441539,1454.037,42.4,19.426,36513.323,168.711,8.83,0.878,0
123,144,36,1545,0,9,2173,173263,0,441539,1454.037,42.4,19.426,36513.323,168.711,8.83,0.878,0
123,145,31,1576,1,10,2194,175457,0,441539,1454.037,42.4,19.426,36513.323,168.711,8.83,0.878,0
123,146,35,1611,0,10,2047,177504,0,441539,1454.037,42.4,19.426,36513.323,168.711,8.83,0.878,0
123,147,57,1668,0,10,2185,179689,0,441539,1454.037,42.4,19.426,36513.323,168.711,8.83,0.878,0
123,148,38,1706,0,10,2542,182231,0,441539,1454.037,42.4,19.426,36513.323,168.711,8.83,0.878,0
123,149,46,1752,0,10,2109,184340,0,441539,1454.037,42.4,19.426,36513.323,168.711,8.83,0.878,0
123,150,37,1789,0,10,2290,186630,0,441539,1454.037,42.4,19.426,36513.323,168.711,8.83,0.878,0
123,151,32,1821,0,10,1909,188539,0,441539,1454.037,42.4,19.426,36513.323,168.711,8.83,0.878,0
123,152,28,1849,0,10,2040,190579,0,441539,1454.037,42.4,19.426,36513.323,168.711,8.83,0.878,0
123,153,15,1864,1,11,1915,192494,0,441539,1454.037,42.4,19.426,36513.323,168.711,8.83,0.878,0
123,154,21,1885,1,12,2067,194561,0,441539,1454.037,42.4,19.426,36513.323,168.711,8.83,0.878,0
123,155,26,1911,0,12,2438,196999,0,441539,1454.037,42.4,19.426,36513.323,168.711,8.83,0.878,0
123,156,21,1932,1,13,1869,198868,0,441539,1454.037,42.4,19.426,36513.323,168.711,8.83,0.878,0
123,157,34,1966,0,13,1703,200571,0,441539,1454.037,42.4,19.426,36513.323,168.711,8.83,0.878,0
123,158,19,1985,0,13,1551,202122,0,441539,1454.037,42.4,19.426,36513.323,168.711,8.83,0.878,0
123,159,30,2015,1,14,1640,203762,0,441539,1454.037,42.4,19.426,36513.323,168.711,8.83,0.878,0
123,160,25,2040,0,14,1363,205125,0,441539,1454.037,42.4,19.426,36513.323,168.711,8.83,0.878,0
123,161,37,2077,0,14,2043,207168,0,441539,1454.037,42.4,19.426,36513.323,168.711,8.83,0.878,0
123,162,23,2100,0,14,1957,209125,0,441539,1454.037,42.4,19.426,36513.323,168.711,8.83,0.878,0
123,163,63,2163,0,14,2094,211219,0,441539,1454.037,42.4,19.426,36513.323,168.711,8.83,0.878,0
123,164,42,2205,0,14,1647,212866,0,441539,1454.037,42.4,19.426,36513.323,168.711,8.83,0.878,0
123,165,43,2248,1,15,2404,215270,0,441539,1454.037,42.4,19.426,36513.323,168.711,8.83,0.878,0
123,166,27,2275,0,15,1736,217006,0,441539,1454.037,42.4,19.426,36513.323,168.711,8.83,0.878,0
123,167,78,2353,0,15,1665,218671,0,441539,1454.037,42.4,19.426,36513.323,168.711,8.83,0.878,0
123,168,53,2406,1,16,2470,221141,0,441539,1454.037,42.4,19.426,36513.323,168.711,8.83,0.878,0
123,169,49,2455,0,16,2535,223676,0,441539,1454.037,42.4,19.426,36513.323,168.711,8.83,0.878,0
123,170,106,2561,0,16,2632,226308,0,441539,1454.037,42.4,19.426,36513.323,168.711,8.83,0.878,0
123,171,35,2596,0,16,2922,229230,0,441539,1454.037,42.4,19.426,36513.323,168.711,8.83,0.878,0
123,172,38,2634,0,16,2196,231426,0,441539,1454.037,42.4,19.426,36513.323,168.711,8.83,0.878,0
123,173,65,2699,1,17,1783,233209,0,441539,1454.037,42.4,19.426,36513.323,168.711,8.83,0.878,0
123,174,32,2731,3,20,2409,235618,0,441539,1454.037,42.4,19.426,36513.323,168.711,8.83,0.878,0
123,175,46,2777,3,23,2443,238061,0,441539,1454.037,42.4,19.426,36513.323,168.711,8.83,0.878,0
123,176,38,2815,0,23,2301,240362,0,441539,1454.037,42.4,19.426,36513.323,168.711,8.83,0.878,0
123,177,42,2857,2,25,2544,242906,0,441539,1454.037,42.4,19.426,36513.323,168.711,8.83,0.878,0
123,178,41,2898,2,27,2096,245002,0,441539,1454.037,42.4,19.426,36513.323,168.711,8.83,0.878,0
123,179,31,2929,2,29,2326,247328,0,441539,1454.037,42.4,19.426,36513.323,168.711,8.83,0.878,0
123,180,0,2929,0,29,2302,249630,0,441539,1454.037,42.4,19.426,36513.323,168.711,8.83,0.878,0
123,181,0,2929,0,29,2116,251746,0,441539,1454.037,42.4,19.426,36513.323,168.711,8.83,0.878,0
123,182,77,3006,3,32,0,251746,0,441539,1454.037,42.4,19.426,36513.323,168.711,8.83,0.878,0
123,183,29,3035,2,34,0,251746,0,441539,1454.037,42.4,19.426,36513.323,168.711,8.83,0.878,0
123,184,23,3058,0,34,0,251746,0,441539,1454.037,42.4,19.426,36513.323,168.711,8.83,0.878,0
123,185,37,3095,1,35,0,251746,0,441539,1454.037,42.4,19.426,36513.323,168.711,8.83,0.878,0
123,186,44,3139,2,37,0,251746,0,441539,1454.037,42.4,19.426,36513.323,168.711,8.83,0.878,0
123,187,0,3139,0,37,0,251746,0,441539,1454.037,42.4,19.426,36513.323,168.711,8.83,0.878,0
123,188,0,3139,0,37,0,251746,0,441539,1454.037,42.4,19.426,36513.323,168.711,8.83,0.878,0
123,189,188,3327,2,39,0,251746,0,441539,1454.037,42.4,19.426,36513.323,168.711,8.83,0.878,0
123,190,47,3374,1,40,0,251746,0,441539,1454.037,42.4,19.426,36513.323,168.711,8.83,0.878,0
123,191,68,3442,1,41,0,251746,0,441539,1454.037,42.4,19.426,36513.323,168.711,8.83,0.878,0
123,192,64,3506,0,41,0,251746,0,441539,1454.037,42.4,19.426,36513.323,168.711,8.83,0.878,0
123,193,75,3581,0,41,0,251746,0,441539,1454.037,42.4,19.426,36513.323,168.711,8.83,0.878,0
123,194,100,3681,0,41,0,251746,0,441539,1454.037,42.4,19.426,36513.323,168.711,8.83,0.878,0
123,195,95,3776,0,41,0,251746,0,441539,1454.037,42.4,19.426,36513.323,168.711,8.83,0.878,0
123,196,68,3844,2,43,0,251746,0,441539,1454.037,42.4,19.426,36513.323,168.711,8.83,0.878,0
123,197,93,3937,1,44,0,251746,0,441539,1454.037,42.4,19.426,36513.323,168.711,8.83,0.878,0
123,198,111,4048,0,44,0,251746,0,441539,1454.037,42.4,19.426,36513.323,168.711,8.83,0.878,0
123,199,104,4152,1,45,0,251746,0,441539,1454.037,42.4,19.426,36513.323,168.711,8.83,0.878,0
123,200,130,4282,0,45,0,251746,0,441539,1454.037,42.4,19.426,36513.323,168.711,8.83,0.878,0
123,201,0,4282,0,45,0,251746,0,441539,1454.037,42.4,19.426,36513.323,168.711,8.83,0.878,0
123,202,0,4282,0,45,0,251746,0,441539,1454.037,42.4,19.426,36513.323,168.711,8.83,0.878,0
123,203,455,4737,0,45,0,251746,0,441539,1454.037,42.4,19.426,36513.323,168.711,8.83,0.878,0
123,204,134,4871,1,46,0,251746,0,441539,1454.037,42.4,19.426,36513.323,168.711,8.83,0.878,0
124,1,0,5,0,0,0,0,77.78,4649660,4.289,20.3,3.138,3597.633,232.347,2.42,0.52,0
124,2,0,5,0,0,0,0,77.78,4649660,4.289,20.3,3.138,3597.633,232.347,2.42,0.52,0
124,3,1,6,1,1,0,0,77.78,4649660,4.289,20.3,3.138,3597.633,232.347,2.42,0.52,0
124,4,0,6,0,1,0,0,77.78,4649660,4.289,20.3,3.138,3597.633,232.347,2.42,0.52,0
124,5,0,6,0,1,0,0,77.78,4649660,4.289,20.3,3.138,3597.633,232.347,2.42,0.52,0
124,6,0,6,0,1,0,0,77.78,4649660,4.289,20.3,3.138,3597.633,232.347,2.42,0.52,0
124,7,0,6,0,1,0,0,77.78,4649660,4.289,20.3,3.138,3597.633,232.347,2.42,0.52,0
124,8,0,6,0,1,0,0,77.78,4649660,4.289,20.3,3.138,3597.633,232.347,2.42,0.52,0
124,9,0,6,0,1,0,0,77.78,4649660,4.289,20.3,3.138,3597.633,232.347,2.42,0.52,0
124,10,1,7,0,1,0,0,77.78,4649660,4.289,20.3,3.138,3597.633,232.347,2.42,0.52,0
124,11,0,7,0,1,0,0,77.78,4649660,4.289,20.3,3.138,3597.633,232.347,2.42,0.52,0
124,12,0,7,0,1,0,0,77.78,4649660,4.289,20.3,3.138,3597.633,232.347,2.42,0.52,0
124,13,0,7,0,1,0,0,77.78,4649660,4.289,20.3,3.138,3597.633,232.347,2.42,0.52,0
124,14,0,7,0,1,0,0,77.78,4649660,4.289,20.3,3.138,3597.633,232.347,2.42,0.52,0
124,15,0,7,0,1,0,0,77.78,4649660,4.289,20.3,3.138,3597.633,232.347,2.42,0.52,0
124,16,0,7,0,1,0,0,77.78,4649660,4.289,20.3,3.138,3597.633,232.347,2.42,0.52,0
124,17,0,7,0,1,0,0,77.78,4649660,4.289,20.3,3.138,3597.633,232.347,2.42,0.52,0
124,18,0,7,0,1,0,0,77.78,4649660,4.289,20.3,3.138,3597.633,232.347,2.42,0.52,0
124,19,0,7,0,1,0,0,77.78,4649660,4.289,20.3,3.138,3597.633,232.347,2.42,0.52,0
124,20,0,7,0,1,0,0,77.78,4649660,4.289,20.3,3.138,3597.633,232.347,2.42,0.52,0
124,21,0,7,0,1,0,0,77.78,4649660,4.289,20.3,3.138,3597.633,232.347,2.42,0.52,0
124,22,0,7,0,1,0,0,77.78,4649660,4.289,20.3,3.138,3597.633,232.347,2.42,0.52,0
124,23,0,7,0,1,0,0,77.78,4649660,4.289,20.3,3.138,3597.633,232.347,2.42,0.52,0
124,24,0,7,0,1,0,0,77.78,4649660,4.289,20.3,3.138,3597.633,232.347,2.42,0.52,0
124,25,0,7,0,1,0,0,77.78,4649660,4.289,20.3,3.138,3597.633,232.347,2.42,0.52,0
124,26,0,7,0,1,0,0,77.78,4649660,4.289,20.3,3.138,3597.633,232.347,2.42,0.52,0
124,27,0,7,0,1,0,0,77.78,4649660,4.289,20.3,3.138,3597.633,232.347,2.42,0.52,0
124,28,0,7,0,1,0,0,77.78,4649660,4.289,20.3,3.138,3597.633,232.347,2.42,0.52,0
124,29,0,7,0,1,0,0,77.78,4649660,4.289,20.3,3.138,3597.633,232.347,2.42,0.52,0
124,30,0,7,0,1,0,0,77.78,4649660,4.289,20.3,3.138,3597.633,232.347,2.42,0.52,0
124,31,1,8,0,1,0,0,77.78,4649660,4.289,20.3,3.138,3597.633,232.347,2.42,0.52,0
124,32,0,8,0,1,0,0,77.78,4649660,4.289,20.3,3.138,3597.633,232.347,2.42,0.52,0
124,33,0,8,0,1,0,0,77.78,4649660,4.289,20.3,3.138,3597.633,232.347,2.42,0.52,0
124,34,0,8,0,1,0,0,77.78,4649660,4.289,20.3,3.138,3597.633,232.347,2.42,0.52,0
124,35,0,8,0,1,0,0,77.78,4649660,4.289,20.3,3.138,3597.633,232.347,2.42,0.52,0
124,36,0,8,0,1,0,0,77.78,4649660,4.289,20.3,3.138,3597.633,232.347,2.42,0.52,0
124,37,0,8,0,1,0,0,77.78,4649660,4.289,20.3,3.138,3597.633,232.347,2.42,0.52,0
124,38,0,8,0,1,0,0,77.78,4649660,4.289,20.3,3.138,3597.633,232.347,2.42,0.52,0
124,39,0,8,0,1,0,0,77.78,4649660,4.289,20.3,3.138,3597.633,232.347,2.42,0.52,0
124,40,0,8,0,1,0,0,77.78,4649660,4.289,20.3,3.138,3597.633,232.347,2.42,0.52,0
124,41,0,8,0,1,0,0,77.78,4649660,4.289,20.3,3.138,3597.633,232.347,2.42,0.52,0
124,42,0,8,0,1,0,0,77.78,4649660,4.289,20.3,3.138,3597.633,232.347,2.42,0.52,0
124,43,0,8,0,1,0,0,77.78,4649660,4.289,20.3,3.138,3597.633,232.347,2.42,0.52,0
124,44,1,9,1,2,0,0,77.78,4649660,4.289,20.3,3.138,3597.633,232.347,2.42,0.52,0
124,45,7,16,0,2,0,0,77.78,4649660,4.289,20.3,3.138,3597.633,232.347,2.42,0.52,0
124,46,13,29,1,3,0,0,77.78,4649660,4.289,20.3,3.138,3597.633,232.347,2.42,0.52,0
124,47,0,29,0,3,0,0,77.78,4649660,4.289,20.3,3.138,3597.633,232.347,2.42,0.52,0
124,48,33,62,1,4,0,0,77.78,4649660,4.289,20.3,3.138,3597.633,232.347,2.42,0.52,0
124,49,19,81,0,4,0,0,77.78,4649660,4.289,20.3,3.138,3597.633,232.347,2.42,0.52,0
124,50,0,81,0,4,0,0,77.78,4649660,4.289,20.3,3.138,3597.633,232.347,2.42,0.52,0
124,51,50,131,0,4,0,0,77.78,4649660,4.289,20.3,3.138,3597.633,232.347,2.42,0.52,0
124,52,42,173,1,5,0,0,77.78,4649660,4.289,20.3,3.138,3597.633,232.347,2.42,0.52,0
124,53,0,173,0,5,0,0,77.78,4649660,4.289,20.3,3.138,3597.633,232.347,2.42,0.52,0
124,54,54,227,1,6,0,0,77.78,4649660,4.289,20.3,3.138,3597.633,232.347,2.42,0.52,0
124,55,10,237,0,6,0,0,77.78,4649660,4.289,20.3,3.138,3597.633,232.347,2.42,0.52,0
124,56,0,237,0,6,0,0,77.78,4649660,4.289,20.3,3.138,3597.633,232.347,2.42,0.52,0
124,57,25,262,3,9,0,0,77.78,4649660,4.289,20.3,3.138,3597.633,232.347,2.42,0.52,0
124,58,30,292,7,16,0,0,77.78,4649660,4.289,20.3,3.138,3597.633,232.347,2.42,0.52,0
124,59,0,292,0,16,0,0,77.78,4649660,4.289,20.3,3.138,3597.633,232.347,2.42,0.52,0
124,60,131,423,4,20,0,0,77.78,4649660,4.289,20.3,3.138,3597.633,232.347,2.42,0.52,0
124,61,60,483,1,21,0,0,77.78,4649660,4.289,20.3,3.138,3597.633,232.347,2.42,0.52,0
124,62,47,530,2,23,0,0,77.78,4649660,4.289,20.3,3.138,3597.633,232.347,2.42,0.52,0
124,63,0,530,0,23,0,0,77.78,4649660,4.289,20.3,3.138,3597.633,232.347,2.42,0.52,0
124,64,138,668,8,31,0,0,77.78,4649660,4.289,20.3,3.138,3597.633,232.347,2.42,0.52,0
124,65,0,668,0,31,0,0,77.78,4649660,4.289,20.3,3.138,3597.633,232.347,2.42,0.52,0
124,66,116,784,8,39,0,0,77.78,4649660,4.289,20.3,3.138,3597.633,232.347,2.42,0.52,0
124,67,99,883,4,43,0,0,77.78,4649660,4.289,20.3,3.138,3597.633,232.347,2.42,0.52,0
124,68,64,947,0,43,0,0,77.78,4649660,4.289,20.3,3.138,3597.633,232.347,2.42,0.52,0
124,69,0,947,0,43,0,0,77.78,4649660,4.289,20.3,3.138,3597.633,232.347,2.42,0.52,0
124,70,0,947,0,43,0,0,77.78,4649660,4.289,20.3,3.138,3597.633,232.347,2.42,0.52,0
124,71,215,1162,18,61,0,0,77.78,4649660,4.289,20.3,3.138,3597.633,232.347,2.42,0.52,0
124,72,0,1162,0,61,0,0,77.78,4649660,4.289,20.3,3.138,3597.633,232.347,2.42,0.52,0
124,73,0,1162,0,61,0,0,77.78,4649660,4.289,20.3,3.138,3597.633,232.347,2.42,0.52,0
124,74,277,1439,13,74,0,0,77.78,4649660,4.289,20.3,3.138,3597.633,232.347,2.42,0.52,0
124,75,0,1439,0,74,0,0,77.78,4649660,4.289,20.3,3.138,3597.633,232.347,2.42,0.52,0
124,76,344,1783,13,87,0,0,77.78,4649660,4.289,20.3,3.138,3597.633,232.347,2.42,0.52,0
124,77,104,1887,4,91,0,0,77.78,4649660,4.289,20.3,3.138,3597.633,232.347,2.42,0.52,0
124,78,170,2057,2,93,0,0,77.78,4649660,4.289,20.3,3.138,3597.633,232.347,2.42,0.52,0
124,79,0,2057,0,93,0,0,77.78,4649660,4.289,20.3,3.138,3597.633,232.347,2.42,0.52,0
124,80,166,2223,2,95,0,0,77.78,4649660,4.289,20.3,3.138,3597.633,232.347,2.42,0.52,0
124,81,0,2223,0,95,0,0,77.78,4649660,4.289,20.3,3.138,3597.633,232.347,2.42,0.52,0
124,82,590,2813,13,108,0,0,77.78,4649660,4.289,20.3,3.138,3597.633,232.347,2.42,0.52,0
124,83,0,2813,0,108,0,0,77.78,4649660,4.289,20.3,3.138,3597.633,232.347,2.42,0.52,0
124,84,171,2984,3,111,0,0,77.78,4649660,4.289,20.3,3.138,3597.633,232.347,2.42,0.52,0
124,85,0,2984,0,111,0,0,77.78,4649660,4.289,20.3,3.138,3597.633,232.347,2.42,0.52,0
124,86,308,3292,3,114,0,0,77.78,4649660,4.289,20.3,3.138,3597.633,232.347,2.42,0.52,0
124,87,447,3739,5,119,0,0,77.78,4649660,4.289,20.3,3.138,3597.633,232.347,2.42,0.52,0
124,88,0,3739,0,119,0,0,77.78,4649660,4.289,20.3,3.138,3597.633,232.347,2.42,0.52,0
124,89,168,3907,1,120,0,0,77.78,4649660,4.289,20.3,3.138,3597.633,232.347,2.42,0.52,0
124,90,0,3907,0,120,0,0,77.78,4649660,4.289,20.3,3.138,3597.633,232.347,2.42,0.52,0
124,91,242,4149,6,126,0,0,77.78,4649660,4.289,20.3,3.138,3597.633,232.347,2.42,0.52,0
124,92,0,4149,0,126,0,0,74.07,4649660,4.289,20.3,3.138,3597.633,232.347,2.42,0.52,0
124,93,0,4149,0,126,0,0,74.07,4649660,4.289,20.3,3.138,3597.633,232.347,2.42,0.52,0
124,94,323,4472,3,129,0,0,74.07,4649660,4.289,20.3,3.138,3597.633,232.347,2.42,0.52,0
124,95,0,4472,0,129,0,0,74.07,4649660,4.289,20.3,3.138,3597.633,232.347,2.42,0.52,0
124,96,355,4827,0,129,0,0,74.07,4649660,4.289,20.3,3.138,3597.633,232.347,2.42,0.52,0
124,97,52,4879,1,130,0,0,74.07,4649660,4.289,20.3,3.138,3597.633,232.347,2.42,0.52,0
124,98,0,4879,0,130,832,0,53.7,4649660,4.289,20.3,3.138,3597.633,232.347,2.42,0.52,0
124,99,0,4879,0,130,137,0,53.7,4649660,4.289,20.3,3.138,3597.633,232.347,2.42,0.52,0
124,100,145,5024,5,135,136,0,53.7,4649660,4.289,20.3,3.138,3597.633,232.347,2.42,0.52,0
124,101,63,5087,4,139,0,0,29.63,4649660,4.289,20.3,3.138,3597.633,232.347,2.42,0.52,0
124,102,39,5126,5,144,0,0,29.63,4649660,4.289,20.3,3.138,3597.633,232.347,2.42,0.52,0
124,103,0,5126,0,144,262,0,29.63,4649660,4.289,20.3,3.138,3597.633,232.347,2.42,0.52,0
124,104,0,5126,0,144,192,0,29.63,4649660,4.289,20.3,3.138,3597.633,232.347,2.42,0.52,0
124,105,229,5355,3,147,0,0,29.63,4649660,4.289,20.3,3.138,3597.633,232.347,2.42,0.52,0
124,106,91,5446,2,149,0,0,29.63,4649660,4.289,20.3,3.138,3597.633,232.347,2.42,0.52,0
124,107,0,5446,0,149,0,0,29.63,4649660,4.289,20.3,3.138,3597.633,232.347,2.42,0.52,0
124,108,0,5446,0,149,0,0,29.63,4649660,4.289,20.3,3.138,3597.633,232.347,2.42,0.52,0
124,109,0,5446,0,149,0,0,29.63,4649660,4.289,20.3,3.138,3597.633,232.347,2.42,0.52,0
124,110,0,5446,0,149,291,0,29.63,4649660,4.289,20.3,3.138,3597.633,232.347,2.42,0.52,0
124,111,427,5873,6,155,532,0,29.63,4649660,4.289,20.3,3.138,3597.633,232.347,2.42,0.52,0
124,112,50,5923,0,155,0,0,29.63,4649660,4.289,20.3,3.138,3597.633,232.347,2.42,0.52,0
124,113,0,5923,0,155,343,0,29.63,4649660,4.289,20.3,3.138,3597.633,232.347,2.42,0.52,0
124,114,0,5923,0,155,258,0,29.63,4649660,4.289,20.3,3.138,3597.633,232.347,2.42,0.52,0
124,115,104,6027,0,155,0,0,29.63,4649660,4.289,20.3,3.138,3597.633,232.347,2.42,0.52,0
124,116,40,6067,1,156,324,0,29.63,4649660,4.289,20.3,3.138,3597.633,232.347,2.42,0.52,0
124,117,0,6067,0,156,244,0,29.63,4649660,4.289,20.3,3.138,3597.633,232.347,2.42,0.52,0
124,118,104,6171,0,156,0,0,29.63,4649660,4.289,20.3,3.138,3597.633,232.347,2.42,0.52,0
124,119,0,6171,0,156,769,0,29.63,4649660,4.289,20.3,3.138,3597.633,232.347,2.42,0.52,0
124,120,0,6171,0,156,0,0,29.63,4649660,4.289,20.3,3.138,3597.633,232.347,2.42,0.52,0
124,121,78,6249,0,156,538,0,29.63,4649660,4.289,20.3,3.138,3597.633,232.347,2.42,0.52,0
124,122,21,6270,0,156,0,0,29.63,4649660,4.289,20.3,3.138,3597.633,232.347,2.42,0.52,0
124,123,25,6295,1,157,0,0,29.63,4649660,4.289,20.3,3.138,3597.633,232.347,2.42,0.52,0
124,124,15,6310,0,157,29,0,29.63,4649660,4.289,20.3,3.138,3597.633,232.347,2.42,0.52,0
124,125,0,6310,0,157,315,0,29.63,4649660,4.289,20.3,3.138,3597.633,232.347,2.42,0.52,0
124,126,13,6323,0,157,0,0,29.63,4649660,4.289,20.3,3.138,3597.633,232.347,2.42,0.52,0
124,127,59,6382,0,157,343,0,29.63,4649660,4.289,20.3,3.138,3597.633,232.347,2.42,0.52,0
124,128,0,6382,0,157,435,0,29.63,4649660,4.289,20.3,3.138,3597.633,232.347,2.42,0.52,0
124,129,0,6382,0,157,216,0,29.63,4649660,4.289,20.3,3.138,3597.633,232.347,2.42,0.52,0
124,130,0,6382,0,157,101,0,29.63,4649660,4.289,20.3,3.138,3597.633,232.347,2.42,0.52,0
124,131,116,6498,0,157,82,0,29.63,4649660,4.289,20.3,3.138,3597.633,232.347,2.42,0.52,0
124,132,0,6498,0,157,168,0,29.63,4649660,4.289,20.3,3.138,3597.633,232.347,2.42,0.52,0
124,133,0,6498,0,157,284,0,29.63,4649660,4.289,20.3,3.138,3597.633,232.347,2.42,0.52,0
124,134,52,6550,0,157,487,0,29.63,4649660,4.289,20.3,3.138,3597.633,232.347,2.42,0.52,0
124,135,48,6598,0,157,205,0,29.63,4649660,4.289,20.3,3.138,3597.633,232.347,2.42,0.52,0
124,136,24,6622,0,157,353,0,29.63,4649660,4.289,20.3,3.138,3597.633,232.347,2.42,0.52,0
124,137,0,6622,0,157,87,0,29.63,4649660,4.289,20.3,3.138,3597.633,232.347,2.42,0.52,0
124,138,0,6622,0,157,65,0,29.63,4649660,4.289,20.3,3.138,3597.633,232.347,2.42,0.52,0
124,139,79,6701,0,157,362,0,29.63,4649660,4.289,20.3,3.138,3597.633,232.347,2.42,0.52,0
124,140,0,6701,0,157,344,0,29.63,4649660,4.289,20.3,3.138,3597.633,232.347,2.42,0.52,0
124,141,88,6789,0,157,361,0,29.63,4649660,4.289,20.3,3.138,3597.633,232.347,2.42,0.52,0
124,142,40,6829,1,158,0,0,29.63,4649660,4.289,20.3,3.138,3597.633,232.347,2.42,0.52,0
124,143,0,6829,0,158,393,0,29.63,4649660,4.289,20.3,3.138,3597.633,232.347,2.42,0.52,0
124,144,56,6885,0,158,0,0,29.63,4649660,4.289,20.3,3.138,3597.633,232.347,2.42,0.52,0
124,145,0,6885,0,158,0,0,29.63,4649660,4.289,20.3,3.138,3597.633,232.347,2.42,0.52,0
124,146,0,6885,0,158,0,0,29.63,4649660,4.289,20.3,3.138,3597.633,232.347,2.42,0.52,0
124,147,20,6905,0,158,0,0,29.63,4649660,4.289,20.3,3.138,3597.633,232.347,2.42,0.52,0
124,148,23,6928,0,158,0,0,29.63,4649660,4.289,20.3,3.138,3597.633,232.347,2.42,0.52,0
124,149,32,6960,0,158,0,0,29.63,4649660,4.289,20.3,3.138,3597.633,232.347,2.42,0.52,0
124,150,17,6977,0,158,0,0,29.63,4649660,4.289,20.3,3.138,3597.633,232.347,2.42,0.52,0
124,151,0,6977,0,158,0,0,29.63,4649660,4.289,20.3,3.138,3597.633,232.347,2.42,0.52,0
124,152,35,7012,0,158,97,0,29.63,4649660,4.289,20.3,3.138,3597.633,232.347,2.42,0.52,0
124,153,10,7022,1,159,249,0,29.63,4649660,4.289,20.3,3.138,3597.633,232.347,2.42,0.52,0
124,154,26,7048,0,159,155,0,22.22,4649660,4.289,20.3,3.138,3597.633,232.347,2.42,0.52,0
124,155,27,7075,0,159,0,0,22.22,4649660,4.289,20.3,3.138,3597.633,232.347,2.42,0.52,0
124,156,14,7089,1,160,0,0,22.22,4649660,4.289,20.3,3.138,3597.633,232.347,2.42,0.52,0
124,157,17,7106,0,160,0,0,22.22,4649660,4.289,20.3,3.138,3597.633,232.347,2.42,0.52,0
124,158,20,7126,0,160,0,0,22.22,4649660,4.289,20.3,3.138,3597.633,232.347,2.42,0.52,0
124,159,8,7134,0,160,0,0,22.22,4649660,4.289,20.3,3.138,3597.633,232.347,2.42,0.52,0
124,160,0,7134,0,160,0,0,22.22,4649660,4.289,20.3,3.138,3597.633,232.347,2.42,0.52,0
124,161,8,7142,0,160,0,0,22.22,4649660,4.289,20.3,3.138,3597.633,232.347,2.42,0.52,0
124,162,7,7149,0,160,0,0,22.22,4649660,4.289,20.3,3.138,3597.633,232.347,2.42,0.52,0
124,163,15,7164,0,160,302,0,13.89,4649660,4.289,20.3,3.138,3597.633,232.347,2.42,0.52,0
124,164,38,7202,1,161,0,0,13.89,4649660,4.289,20.3,3.138,3597.633,232.347,2.42,0.52,0
124,165,20,7222,0,161,127,0,13.89,4649660,4.289,20.3,3.138,3597.633,232.347,2.42,0.52,0
124,166,44,7266,0,161,113,0,13.89,4649660,4.289,20.3,3.138,3597.633,232.347,2.42,0.52,0
124,167,10,7276,0,161,214,0,13.89,4649660,4.289,20.3,3.138,3597.633,232.347,2.42,0.52,0
124,168,19,7295,0,161,282,0,13.89,4649660,4.289,20.3,3.138,3597.633,232.347,2.42,0.52,0
124,169,24,7319,0,161,0,0,13.89,4649660,4.289,20.3,3.138,3597.633,232.347,2.42,0.52,0
124,170,0,7319,0,161,0,0,13.89,4649660,4.289,20.3,3.138,3597.633,232.347,2.42,0.52,0
124,171,13,7332,0,161,277,0,13.89,4649660,4.289,20.3,3.138,3597.633,232.347,2.42,0.52,0
124,172,29,7361,0,161,67,0,13.89,4649660,4.289,20.3,3.138,3597.633,232.347,2.42,0.52,0
124,173,0,7361,0,161,219,0,13.89,4649660,4.289,20.3,3.138,3597.633,232.347,2.42,0.52,0
124,174,7,7368,0,161,207,0,13.89,4649660,4.289,20.3,3.138,3597.633,232.347,2.42,0.52,0
124,175,16,7384,0,161,232,0,13.89,4649660,4.289,20.3,3.138,3597.633,232.347,2.42,0.52,0
124,176,0,7384,0,161,250,0,13.89,4649660,4.289,20.3,3.138,3597.633,232.347,2.42,0.52,0
124,177,41,7425,0,161,184,0,13.89,4649660,4.289,20.3,3.138,3597.633,232.347,2.42,0.52,0
124,178,8,7433,0,161,0,0,13.89,4649660,4.289,20.3,3.138,3597.633,232.347,2.42,0.52,0
124,179,0,7433,0,161,0,0,13.89,4649660,4.289,20.3,3.138,3597.633,232.347,2.42,0.52,0
124,180,24,7457,0,161,62,0,13.89,4649660,4.289,20.3,3.138,3597.633,232.347,2.42,0.52,0
124,181,5,7462,0,161,0,0,13.89,4649660,4.289,20.3,3.138,3597.633,232.347,2.42,0.52,0
124,182,2,7464,0,161,169,0,13.89,4649660,4.289,20.3,3.138,3597.633,232.347,2.42,0.52,0
124,183,10,7474,0,161,206,0,13.89,4649660,4.289,20.3,3.138,3597.633,232.347,2.42,0.52,0
124,184,14,7488,0,161,276,0,13.89,4649660,4.289,20.3,3.138,3597.633,232.347,2.42,0.52,0
124,185,14,7502,0,161,0,0,13.89,4649660,4.289,20.3,3.138,3597.633,232.347,2.42,0.52,0
124,186,3,7505,0,161,0,0,13.89,4649660,4.289,20.3,3.138,3597.633,232.347,2.42,0.52,0
124,187,6,7511,0,161,43,0,13.89,4649660,4.289,20.3,3.138,3597.633,232.347,2.42,0.52,0
124,188,9,7520,0,161,256,0,13.89,4649660,4.289,20.3,3.138,3597.633,232.347,2.42,0.52,0
124,189,3,7523,1,162,0,0,13.89,4649660,4.289,20.3,3.138,3597.633,232.347,2.42,0.52,0
124,190,0,7523,0,162,0,0,13.89,4649660,4.289,20.3,3.138,3597.633,232.347,2.42,0.52,0
124,191,0,7523,0,162,0,0,13.89,4649660,4.289,20.3,3.138,3597.633,232.347,2.42,0.52,0
124,192,0,7523,0,162,0,0,13.89,4649660,4.289,20.3,3.138,3597.633,232.347,2.42,0.52,0
124,193,0,7523,0,162,65,0,13.89,4649660,4.289,20.3,3.138,3597.633,232.347,2.42,0.52,0
124,194,0,7523,0,162,83,0,13.89,4649660,4.289,20.3,3.138,3597.633,232.347,2.42,0.52,0
124,195,27,7550,1,163,0,0,13.89,4649660,4.289,20.3,3.138,3597.633,232.347,2.42,0.52,0
124,196,0,7550,0,163,0,0,13.89,4649660,4.289,20.3,3.138,3597.633,232.347,2.42,0.52,0
124,197,4,7554,0,163,0,0,13.89,4649660,4.289,20.3,3.138,3597.633,232.347,2.42,0.52,0
124,198,11,7565,0,163,0,0,13.89,4649660,4.289,20.3,3.138,3597.633,232.347,2.42,0.52,0
124,199,0,7565,0,163,0,0,13.89,4649660,4.289,20.3,3.138,3597.633,232.347,2.42,0.52,0
124,200,20,7585,0,163,0,0,13.89,4649660,4.289,20.3,3.138,3597.633,232.347,2.42,0.52,0
124,201,18,7603,0,163,0,0,13.89,4649660,4.289,20.3,3.138,3597.633,232.347,2.42,0.52,0
124,202,0,7603,0,163,0,0,13.89,4649660,4.289,20.3,3.138,3597.633,232.347,2.42,0.52,0
124,203,5,7608,0,163,0,0,13.89,4649660,4.289,20.3,3.138,3597.633,232.347,2.42,0.52,0
124,204,13,7621,0,163,0,0,13.89,4649660,4.289,20.3,3.138,3597.633,232.347,2.42,0.52,0
125,1,15,143,0,3,0,0,82.41,1271767,622.962,37.4,10.945,20292.745,224.644,22.02,0.79,0
125,2,11,154,2,5,0,0,82.41,1271767,622.962,37.4,10.945,20292.745,224.644,22.02,0.79,0
125,3,15,169,2,7,0,0,82.41,1271767,622.962,37.4,10.945,20292.745,224.644,22.02,0.79,0
125,4,17,186,0,7,0,0,82.41,1271767,622.962,37.4,10.945,20292.745,224.644,22.02,0.79,0
125,5,10,196,0,7,0,0,82.41,1271767,622.962,37.4,10.945,20292.745,224.644,22.02,0.79,0
125,6,31,227,0,7,0,0,82.41,1271767,622.962,37.4,10.945,20292.745,224.644,22.02,0.79,0
125,7,17,244,0,7,0,0,82.41,1271767,622.962,37.4,10.945,20292.745,224.644,22.02,0.79,0
125,8,24,268,0,7,0,0,82.41,1271767,622.962,37.4,10.945,20292.745,224.644,22.02,0.79,0
125,9,5,273,0,7,0,0,82.41,1271767,622.962,37.4,10.945,20292.745,224.644,22.02,0.79,0
125,10,41,314,0,7,0,0,82.41,1271767,622.962,37.4,10.945,20292.745,224.644,22.02,0.79,0
125,11,4,318,2,9,0,0,82.41,1271767,622.962,37.4,10.945,20292.745,224.644,22.02,0.79,0
125,12,1,319,0,9,0,0,82.41,1271767,622.962,37.4,10.945,20292.745,224.644,22.02,0.79,0
125,13,5,324,0,9,0,0,82.41,1271767,622.962,37.4,10.945,20292.745,224.644,22.02,0.79,0
125,14,0,324,0,9,0,0,82.41,1271767,622.962,37.4,10.945,20292.745,224.644,22.02,0.79,0
125,15,0,324,0,9,0,0,82.41,1271767,622.962,37.4,10.945,20292.745,224.644,22.02,0.79,0
125,16,0,324,0,9,0,0,82.41,1271767,622.962,37.4,10.945,20292.745,224.644,22.02,0.79,0
125,17,0,324,0,9,0,0,82.41,1271767,622.962,37.4,10.945,20292.745,224.644,22.02,0.79,0
125,18,0,324,0,9,0,0,82.41,1271767,622.962,37.4,10.945,20292.745,224.644,22.02,0.79,0
125,19,1,325,0,9,0,0,82.41,1271767,622.962,37.4,10.945,20292.745,224.644,22.02,0.79,0
125,20,3,328,0,9,0,0,82.41,1271767,622.962,37.4,10.945,20292.745,224.644,22.02,0.79,0
125,21,0,328,0,9,0,0,82.41,1271767,622.962,37.4,10.945,20292.745,224.644,22.02,0.79,0
125,22,0,328,0,9,0,0,82.41,1271767,622.962,37.4,10.945,20292.745,224.644,22.02,0.79,0
125,23,1,329,0,9,0,0,82.41,1271767,622.962,37.4,10.945,20292.745,224.644,22.02,0.79,0
125,24,2,331,0,9,0,0,82.41,1271767,622.962,37.4,10.945,20292.745,224.644,22.02,0.79,0
125,25,0,331,0,9,0,0,82.41,1271767,622.962,37.4,10.945,20292.745,224.644,22.02,0.79,0
125,26,0,331,0,9,0,0,82.41,1271767,622.962,37.4,10.945,20292.745,224.644,22.02,0.79,0
125,27,1,332,0,9,0,0,82.41,1271767,622.962,37.4,10.945,20292.745,224.644,22.02,0.79,0
125,28,0,332,1,10,0,0,82.41,1271767,622.962,37.4,10.945,20292.745,224.644,22.02,0.79,0
125,29,0,332,0,10,0,0,82.41,1271767,622.962,37.4,10.945,20292.745,224.644,22.02,0.79,0
125,30,0,332,0,10,0,0,82.41,1271767,622.962,37.4,10.945,20292.745,224.644,22.02,0.79,0
125,31,0,332,0,10,0,0,82.41,1271767,622.962,37.4,10.945,20292.745,224.644,22.02,0.79,0
125,32,0,332,0,10,0,0,82.41,1271767,622.962,37.4,10.945,20292.745,224.644,22.02,0.79,0
125,33,0,332,0,10,0,0,82.41,1271767,622.962,37.4,10.945,20292.745,224.644,22.02,0.79,0
125,34,0,332,0,10,0,0,82.41,1271767,622.962,37.4,10.945,20292.745,224.644,22.02,0.79,0
125,35,0,332,0,10,0,0,82.41,1271767,622.962,37.4,10.945,20292.745,224.644,22.02,0.79,0
125,36,0,332,0,10,0,0,82.41,1271767,622.962,37.4,10.945,20292.745,224.644,22.02,0.79,0
125,37,0,332,0,10,0,0,82.41,1271767,622.962,37.4,10.945,20292.745,224.644,22.02,0.79,0
125,38,0,332,0,10,0,0,82.41,1271767,622.962,37.4,10.945,20292.745,224.644,22.02,0.79,0
125,39,0,332,0,10,0,0,82.41,1271767,622.962,37.4,10.945,20292.745,224.644,22.02,0.79,0
125,40,0,332,0,10,0,0,82.41,1271767,622.962,37.4,10.945,20292.745,224.644,22.02,0.79,0
125,41,0,332,0,10,0,0,82.41,1271767,622.962,37.4,10.945,20292.745,224.644,22.02,0.79,0
125,42,0,332,0,10,0,0,82.41,1271767,622.962,37.4,10.945,20292.745,224.644,22.02,0.79,0
125,43,0,332,0,10,0,0,82.41,1271767,622.962,37.4,10.945,20292.745,224.644,22.02,0.79,0
125,44,0,332,0,10,0,0,82.41,1271767,622.962,37.4,10.945,20292.745,224.644,22.02,0.79,0
125,45,0,332,0,10,0,0,78.7,1271767,622.962,37.4,10.945,20292.745,224.644,22.02,0.79,0
125,46,0,332,0,10,0,0,78.7,1271767,622.962,37.4,10.945,20292.745,224.644,22.02,0.79,0
125,47,0,332,0,10,0,0,78.7,1271767,622.962,37.4,10.945,20292.745,224.644,22.02,0.79,0
125,48,0,332,0,10,0,0,78.7,1271767,622.962,37.4,10.945,20292.745,224.644,22.02,0.79,0
125,49,0,332,0,10,0,0,78.7,1271767,622.962,37.4,10.945,20292.745,224.644,22.02,0.79,0
125,50,0,332,0,10,0,0,78.7,1271767,622.962,37.4,10.945,20292.745,224.644,22.02,0.79,0
125,51,0,332,0,10,0,0,78.7,1271767,622.962,37.4,10.945,20292.745,224.644,22.02,0.79,0
125,52,0,332,0,10,0,0,78.7,1271767,622.962,37.4,10.945,20292.745,224.644,22.02,0.79,0
125,53,0,332,0,10,0,0,78.7,1271767,622.962,37.4,10.945,20292.745,224.644,22.02,0.79,0
125,54,0,332,0,10,0,0,78.7,1271767,622.962,37.4,10.945,20292.745,224.644,22.02,0.79,0
125,55,2,334,0,10,0,0,78.7,1271767,622.962,37.4,10.945,20292.745,224.644,22.02,0.79,0
125,56,0,334,0,10,0,0,78.7,1271767,622.962,37.4,10.945,20292.745,224.644,22.02,0.79,0
125,57,0,334,0,10,0,0,78.7,1271767,622.962,37.4,10.945,20292.745,224.644,22.02,0.79,0
125,58,0,334,0,10,0,0,78.7,1271767,622.962,37.4,10.945,20292.745,224.644,22.02,0.79,0
125,59,0,334,0,10,0,0,78.7,1271767,622.962,37.4,10.945,20292.745,224.644,22.02,0.79,0
125,60,1,335,0,10,0,0,65.74,1271767,622.962,37.4,10.945,20292.745,224.644,22.02,0.79,0
125,61,0,335,0,10,0,0,65.74,1271767,622.962,37.4,10.945,20292.745,224.644,22.02,0.79,0
125,62,0,335,0,10,0,0,65.74,1271767,622.962,37.4,10.945,20292.745,224.644,22.02,0.79,0
125,63,0,335,0,10,0,0,65.74,1271767,622.962,37.4,10.945,20292.745,224.644,22.02,0.79,0
125,64,0,335,0,10,0,0,65.74,1271767,622.962,37.4,10.945,20292.745,224.644,22.02,0.79,0
125,65,0,335,0,10,0,0,65.74,1271767,622.962,37.4,10.945,20292.745,224.644,22.02,0.79,0
125,66,0,335,0,10,0,0,65.74,1271767,622.962,37.4,10.945,20292.745,224.644,22.02,0.79,0
125,67,2,337,0,10,0,0,65.74,1271767,622.962,37.4,10.945,20292.745,224.644,22.02,0.79,0
125,68,0,337,0,10,0,0,65.74,1271767,622.962,37.4,10.945,20292.745,224.644,22.02,0.79,0
125,69,0,337,0,10,0,0,65.74,1271767,622.962,37.4,10.945,20292.745,224.644,22.02,0.79,0
125,70,0,337,0,10,0,0,65.74,1271767,622.962,37.4,10.945,20292.745,224.644,22.02,0.79,0
125,71,0,337,0,10,0,0,65.74,1271767,622.962,37.4,10.945,20292.745,224.644,22.02,0.79,0
125,72,0,337,0,10,0,0,65.74,1271767,622.962,37.4,10.945,20292.745,224.644,22.02,0.79,0
125,73,0,337,0,10,0,0,38.89,1271767,622.962,37.4,10.945,20292.745,224.644,22.02,0.79,0
125,74,0,337,0,10,0,0,38.89,1271767,622.962,37.4,10.945,20292.745,224.644,22.02,0.79,0
125,75,0,337,0,10,0,0,38.89,1271767,622.962,37.4,10.945,20292.745,224.644,22.02,0.79,0
125,76,0,337,0,10,0,0,33.33,1271767,622.962,37.4,10.945,20292.745,224.644,22.02,0.79,0
125,77,0,337,0,10,0,0,33.33,1271767,622.962,37.4,10.945,20292.745,224.644,22.02,0.79,0
125,78,0,337,0,10,0,0,33.33,1271767,622.962,37.4,10.945,20292.745,224.644,22.02,0.79,0
125,79,0,337,0,10,0,0,33.33,1271767,622.962,37.4,10.945,20292.745,224.644,22.02,0.79,0
125,80,0,337,0,10,0,0,33.33,1271767,622.962,37.4,10.945,20292.745,224.644,22.02,0.79,0
125,81,0,337,0,10,0,0,33.33,1271767,622.962,37.4,10.945,20292.745,224.644,22.02,0.79,0
125,82,0,337,0,10,0,0,33.33,1271767,622.962,37.4,10.945,20292.745,224.644,22.02,0.79,0
125,83,0,337,0,10,0,0,33.33,1271767,622.962,37.4,10.945,20292.745,224.644,22.02,0.79,0
125,84,3,340,0,10,0,0,33.33,1271767,622.962,37.4,10.945,20292.745,224.644,22.02,0.79,0
125,85,0,340,0,10,0,0,33.33,1271767,622.962,37.4,10.945,20292.745,224.644,22.02,0.79,0
125,86,1,341,0,10,0,0,33.33,1271767,622.962,37.4,10.945,20292.745,224.644,22.02,0.79,0
125,87,0,341,0,10,0,0,33.33,1271767,622.962,37.4,10.945,20292.745,224.644,22.02,0.79,0
125,88,0,341,0,10,0,0,33.33,1271767,622.962,37.4,10.945,20292.745,224.644,22.02,0.79,0
125,89,0,341,0,10,0,0,33.33,1271767,622.962,37.4,10.945,20292.745,224.644,22.02,0.79,0
125,90,0,341,0,10,0,0,33.33,1271767,622.962,37.4,10.945,20292.745,224.644,22.02,0.79,0
125,91,0,341,0,10,0,0,33.33,1271767,622.962,37.4,10.945,20292.745,224.644,22.02,0.79,0
125,92,0,341,0,10,0,0,22.22,1271767,622.962,37.4,10.945,20292.745,224.644,22.02,0.79,0
125,93,0,341,0,10,0,0,22.22,1271767,622.962,37.4,10.945,20292.745,224.644,22.02,0.79,0
125,94,0,341,0,10,0,0,22.22,1271767,622.962,37.4,10.945,20292.745,224.644,22.02,0.79,0
125,95,0,341,0,10,0,0,22.22,1271767,622.962,37.4,10.945,20292.745,224.644,22.02,0.79,0
125,96,0,341,0,10,0,0,22.22,1271767,622.962,37.4,10.945,20292.745,224.644,22.02,0.79,0
125,97,0,341,0,10,0,0,22.22,1271767,622.962,37.4,10.945,20292.745,224.644,22.02,0.79,0
125,98,1,342,0,10,0,0,22.22,1271767,622.962,37.4,10.945,20292.745,224.644,22.02,0.79,0
125,99,0,342,0,10,0,0,16.67,1271767,622.962,37.4,10.945,20292.745,224.644,22.02,0.79,0
125,100,0,342,0,10,0,0,16.67,1271767,622.962,37.4,10.945,20292.745,224.644,22.02,0.79,0
125,101,0,342,0,10,0,0,16.67,1271767,622.962,37.4,10.945,20292.745,224.644,22.02,0.79,0
125,102,0,342,0,10,0,0,16.67,1271767,622.962,37.4,10.945,20292.745,224.644,22.02,0.79,0
125,103,0,342,0,10,0,0,16.67,1271767,622.962,37.4,10.945,20292.745,224.644,22.02,0.79,0
125,104,0,342,0,10,0,0,16.67,1271767,622.962,37.4,10.945,20292.745,224.644,22.02,0.79,0
125,105,0,342,0,10,0,0,16.67,1271767,622.962,37.4,10.945,20292.745,224.644,22.02,0.79,0
125,106,0,342,0,10,0,0,16.67,1271767,622.962,37.4,10.945,20292.745,224.644,22.02,0.79,0
125,107,1,343,0,10,0,0,16.67,1271767,622.962,37.4,10.945,20292.745,224.644,22.02,0.79,0
125,108,0,343,0,10,0,0,16.67,1271767,622.962,37.4,10.945,20292.745,224.644,22.02,0.79,0
125,109,0,343,0,10,0,0,16.67,1271767,622.962,37.4,10.945,20292.745,224.644,22.02,0.79,0
125,110,0,343,0,10,0,0,16.67,1271767,622.962,37.4,10.945,20292.745,224.644,22.02,0.79,0
125,111,0,343,0,10,0,0,16.67,1271767,622.962,37.4,10.945,20292.745,224.644,22.02,0.79,0
125,112,0,343,0,10,0,0,16.67,1271767,622.962,37.4,10.945,20292.745,224.644,22.02,0.79,0
125,113,0,343,0,10,0,0,16.67,1271767,622.962,37.4,10.945,20292.745,224.644,22.02,0.79,0
125,114,0,343,0,10,0,0,16.67,1271767,622.962,37.4,10.945,20292.745,224.644,22.02,0.79,0
125,115,0,343,0,10,0,0,16.67,1271767,622.962,37.4,10.945,20292.745,224.644,22.02,0.79,0
125,116,1,344,0,10,0,0,16.67,1271767,622.962,37.4,10.945,20292.745,224.644,22.02,0.79,0
125,117,0,344,0,10,0,0,16.67,1271767,622.962,37.4,10.945,20292.745,224.644,22.02,0.79,0
125,118,0,344,0,10,0,0,16.67,1271767,622.962,37.4,10.945,20292.745,224.644,22.02,0.79,0
125,119,0,344,0,10,0,0,16.67,1271767,622.962,37.4,10.945,20292.745,224.644,22.02,0.79,0
125,120,0,344,0,10,0,0,16.67,1271767,622.962,37.4,10.945,20292.745,224.644,22.02,0.79,0
125,121,0,344,0,10,0,0,16.67,1271767,622.962,37.4,10.945,20292.745,224.644,22.02,0.79,0
125,122,0,344,0,10,0,0,16.67,1271767,622.962,37.4,10.945,20292.745,224.644,22.02,0.79,0
125,123,0,344,0,10,0,0,16.67,1271767,622.962,37.4,10.945,20292.745,224.644,22.02,0.79,0
125,124,0,344,0,10,0,0,16.67,1271767,622.962,37.4,10.945,20292.745,224.644,22.02,0.79,0
125,125,0,344,0,10,0,0,16.67,1271767,622.962,37.4,10.945,20292.745,224.644,22.02,0.79,0
125,126,0,344,0,10,0,0,16.67,1271767,622.962,37.4,10.945,20292.745,224.644,22.02,0.79,0
125,127,0,344,0,10,0,0,16.67,1271767,622.962,37.4,10.945,20292.745,224.644,22.02,0.79,0
125,128,0,344,0,10,0,0,16.67,1271767,622.962,37.4,10.945,20292.745,224.644,22.02,0.79,0
125,129,0,344,0,10,0,0,16.67,1271767,622.962,37.4,10.945,20292.745,224.644,22.02,0.79,0
125,130,0,344,0,10,0,0,16.67,1271767,622.962,37.4,10.945,20292.745,224.644,22.02,0.79,0
125,131,0,344,0,10,0,0,16.67,1271767,622.962,37.4,10.945,20292.745,224.644,22.02,0.79,0
125,132,0,344,0,10,0,0,16.67,1271767,622.962,37.4,10.945,20292.745,224.644,22.02,0.79,0
125,133,0,344,0,10,0,0,16.67,1271767,622.962,37.4,10.945,20292.745,224.644,22.02,0.79,0
125,134,0,344,0,10,0,0,16.67,1271767,622.962,37.4,10.945,20292.745,224.644,22.02,0.79,0
125,135,0,344,0,10,0,0,16.67,1271767,622.962,37.4,10.945,20292.745,224.644,22.02,0.79,0
125,136,0,344,0,10,0,0,16.67,1271767,622.962,37.4,10.945,20292.745,224.644,22.02,0.79,0
125,137,0,344,0,10,0,0,16.67,1271767,622.962,37.4,10.945,20292.745,224.644,22.02,0.79,0
125,138,0,344,0,10,0,0,16.67,1271767,622.962,37.4,10.945,20292.745,224.644,22.02,0.79,0
125,139,2,346,0,10,0,0,16.67,1271767,622.962,37.4,10.945,20292.745,224.644,22.02,0.79,0
125,140,0,346,0,10,0,0,16.67,1271767,622.962,37.4,10.945,20292.745,224.644,22.02,0.79,0
125,141,0,346,0,10,0,0,16.67,1271767,622.962,37.4,10.945,20292.745,224.644,22.02,0.79,0
125,142,0,346,0,10,0,0,16.67,1271767,622.962,37.4,10.945,20292.745,224.644,22.02,0.79,0
125,143,0,346,0,10,0,0,16.67,1271767,622.962,37.4,10.945,20292.745,224.644,22.02,0.79,0
125,144,0,346,0,10,0,0,16.67,1271767,622.962,37.4,10.945,20292.745,224.644,22.02,0.79,0
125,145,0,346,0,10,0,0,16.67,1271767,622.962,37.4,10.945,20292.745,224.644,22.02,0.79,0
125,146,0,346,0,10,0,0,16.67,1271767,622.962,37.4,10.945,20292.745,224.644,22.02,0.79,0
125,147,0,346,0,10,0,0,16.67,1271767,622.962,37.4,10.945,20292.745,224.644,22.02,0.79,0
125,148,0,346,0,10,0,0,22.22,1271767,622.962,37.4,10.945,20292.745,224.644,22.02,0.79,0
125,149,0,346,0,10,0,0,22.22,1271767,622.962,37.4,10.945,20292.745,224.644,22.02,0.79,0
125,150,0,346,0,10,0,0,22.22,1271767,622.962,37.4,10.945,20292.745,224.644,22.02,0.79,0
125,151,0,346,0,10,0,0,22.22,1271767,622.962,37.4,10.945,20292.745,224.644,22.02,0.79,0
125,152,0,346,0,10,0,0,22.22,1271767,622.962,37.4,10.945,20292.745,224.644,22.02,0.79,0
125,153,0,346,0,10,0,0,22.22,1271767,622.962,37.4,10.945,20292.745,224.644,22.02,0.79,0
125,154,10,356,0,10,0,0,22.22,1271767,622.962,37.4,10.945,20292.745,224.644,22.02,0.79,0
125,155,0,356,0,10,0,0,22.22,1271767,622.962,37.4,10.945,20292.745,224.644,22.02,0.79,0
125,156,0,356,0,10,0,0,22.22,1271767,622.962,37.4,10.945,20292.745,224.644,22.02,0.79,0
125,157,0,356,0,10,0,0,22.22,1271767,622.962,37.4,10.945,20292.745,224.644,22.02,0.79,0
125,158,0,356,0,10,0,0,22.22,1271767,622.962,37.4,10.945,20292.745,224.644,22.02,0.79,0
125,159,0,356,0,10,0,0,22.22,1271767,622.962,37.4,10.945,20292.745,224.644,22.02,0.79,0
125,160,0,356,0,10,0,0,22.22,1271767,622.962,37.4,10.945,20292.745,224.644,22.02,0.79,0
125,161,0,356,0,10,0,0,22.22,1271767,622.962,37.4,10.945,20292.745,224.644,22.02,0.79,0
125,162,0,356,0,10,0,0,22.22,1271767,622.962,37.4,10.945,20292.745,224.644,22.02,0.79,0
125,163,0,356,0,10,0,0,22.22,1271767,622.962,37.4,10.945,20292.745,224.644,22.02,0.79,0
125,164,0,356,0,10,0,0,22.22,1271767,622.962,37.4,10.945,20292.745,224.644,22.02,0.79,0
125,165,0,356,0,10,0,0,22.22,1271767,622.962,37.4,10.945,20292.745,224.644,22.02,0.79,0
125,166,0,356,0,10,0,0,22.22,1271767,622.962,37.4,10.945,20292.745,224.644,22.02,0.79,0
125,167,5,361,0,10,0,0,22.22,1271767,622.962,37.4,10.945,20292.745,224.644,22.02,0.79,0
125,168,0,361,0,10,0,0,22.22,1271767,622.962,37.4,10.945,20292.745,224.644,22.02,0.79,0
125,169,1,362,0,10,0,0,22.22,1271767,622.962,37.4,10.945,20292.745,224.644,22.02,0.79,0
125,170,3,365,0,10,0,0,22.22,1271767,622.962,37.4,10.945,20292.745,224.644,22.02,0.79,0
125,171,0,365,0,10,0,0,22.22,1271767,622.962,37.4,10.945,20292.745,224.644,22.02,0.79,0
125,172,1,366,0,10,0,0,22.22,1271767,622.962,37.4,10.945,20292.745,224.644,22.02,0.79,0
125,173,1,367,0,10,0,0,22.22,1271767,622.962,37.4,10.945,20292.745,224.644,22.02,0.79,0
125,174,0,367,0,10,0,0,22.22,1271767,622.962,37.4,10.945,20292.745,224.644,22.02,0.79,0
125,175,0,367,0,10,0,0,22.22,1271767,622.962,37.4,10.945,20292.745,224.644,22.02,0.79,0
125,176,0,367,0,10,0,0,22.22,1271767,622.962,37.4,10.945,20292.745,224.644,22.02,0.79,0
125,177,0,367,0,10,0,0,22.22,1271767,622.962,37.4,10.945,20292.745,224.644,22.02,0.79,0
125,178,0,367,0,10,0,0,22.22,1271767,622.962,37.4,10.945,20292.745,224.644,22.02,0.79,0
125,179,0,367,0,10,0,0,22.22,1271767,622.962,37.4,10.945,20292.745,224.644,22.02,0.79,0
125,180,0,367,0,10,0,0,22.22,1271767,622.962,37.4,10.945,20292.745,224.644,22.02,0.79,0
125,181,0,367,0,10,0,0,22.22,1271767,622.962,37.4,10.945,20292.745,224.644,22.02,0.79,0
125,182,0,367,0,10,0,0,22.22,1271767,622.962,37.4,10.945,20292.745,224.644,22.02,0.79,0
125,183,14,381,0,10,0,0,22.22,1271767,622.962,37.4,10.945,20292.745,224.644,22.02,0.79,0
125,184,0,381,0,10,0,0,16.67,1271767,622.962,37.4,10.945,20292.745,224.644,22.02,0.79,0
125,185,0,381,0,10,0,0,16.67,1271767,622.962,37.4,10.945,20292.745,224.644,22.02,0.79,0
125,186,0,381,0,10,0,0,16.67,1271767,622.962,37.4,10.945,20292.745,224.644,22.02,0.79,0
125,187,0,381,0,10,0,0,16.67,1271767,622.962,37.4,10.945,20292.745,224.644,22.02,0.79,0
125,188,0,381,0,10,0,0,16.67,1271767,622.962,37.4,10.945,20292.745,224.644,22.02,0.79,0
125,189,0,381,0,10,0,0,16.67,1271767,622.962,37.4,10.945,20292.745,224.644,22.02,0.79,0
125,190,14,395,0,10,0,0,16.67,1271767,622.962,37.4,10.945,20292.745,224.644,22.02,0.79,0
125,191,0,395,0,10,0,0,16.67,1271767,622.962,37.4,10.945,20292.745,224.644,22.02,0.79,0
125,192,0,395,0,10,0,0,16.67,1271767,622.962,37.4,10.945,20292.745,224.644,22.02,0.79,0
125,193,0,395,0,10,0,0,16.67,1271767,622.962,37.4,10.945,20292.745,224.644,22.02,0.79,0
125,194,0,395,0,10,0,0,16.67,1271767,622.962,37.4,10.945,20292.745,224.644,22.02,0.79,0
125,195,0,395,0,10,0,0,16.67,1271767,622.962,37.4,10.945,20292.745,224.644,22.02,0.79,0
125,196,9,404,0,10,0,0,16.67,1271767,622.962,37.4,10.945,20292.745,224.644,22.02,0.79,0
125,197,3,407,0,10,0,0,16.67,1271767,622.962,37.4,10.945,20292.745,224.644,22.02,0.79,0
125,198,0,407,0,10,0,0,16.67,1271767,622.962,37.4,10.945,20292.745,224.644,22.02,0.79,0
125,199,0,407,0,10,0,0,16.67,1271767,622.962,37.4,10.945,20292.745,224.644,22.02,0.79,0
125,200,0,407,0,10,0,0,16.67,1271767,622.962,37.4,10.945,20292.745,224.644,22.02,0.79,0
125,201,0,407,0,10,0,0,16.67,1271767,622.962,37.4,10.945,20292.745,224.644,22.02,0.79,0
125,202,0,407,0,10,0,0,16.67,1271767,622.962,37.4,10.945,20292.745,224.644,22.02,0.79,0
125,203,12,419,0,10,0,0,16.67,1271767,622.962,37.4,10.945,20292.745,224.644,22.02,0.79,0
125,204,0,419,0,10,0,0,16.67,1271767,622.962,37.4,10.945,20292.745,224.644,22.02,0.79,0
126,1,286,2732,1,29,1592,31237,82.41,128932753,66.444,29.3,6.857,17336.469,152.783,13.06,0.774,3
126,2,337,3069,8,37,1702,32939,82.41,128932753,66.444,29.3,6.857,17336.469,152.783,13.06,0.774,3
126,3,321,3390,13,50,1734,34673,82.41,128932753,66.444,29.3,6.857,17336.469,152.783,13.06,0.774,3
126,4,347,3737,10,60,1085,35758,82.41,128932753,66.444,29.3,6.857,17336.469,152.783,13.06,0.774,3
126,5,229,3966,19,79,814,36572,82.41,128932753,66.444,29.3,6.857,17336.469,152.783,13.06,0.774,3
126,6,237,4203,15,94,2025,38597,82.41,128932753,66.444,29.3,6.857,17336.469,152.783,13.06,0.774,3
126,7,573,4776,31,125,2004,40601,82.41,128932753,66.444,29.3,6.857,17336.469,152.783,13.06,0.774,3
126,8,473,5249,16,141,2187,42788,82.41,128932753,66.444,29.3,6.857,17336.469,152.783,13.06,0.774,3
126,9,534,5783,33,174,1656,44444,82.41,128932753,66.444,29.3,6.857,17336.469,152.783,13.06,0.774,3
126,10,429,6212,20,194,1937,46381,82.41,128932753,66.444,29.3,6.857,17336.469,152.783,13.06,0.774,3
126,11,514,6726,39,233,1391,47772,82.41,128932753,66.444,29.3,6.857,17336.469,152.783,13.06,0.774,3
126,12,426,7152,40,273,1198,48970,82.41,128932753,66.444,29.3,6.857,17336.469,152.783,13.06,0.774,3
126,13,437,7589,23,296,2828,51798,82.41,128932753,66.444,29.3,6.857,17336.469,152.783,13.06,0.774,3
126,14,888,8477,36,332,2907,54705,82.41,128932753,66.444,29.3,6.857,17336.469,152.783,13.06,0.774,3
126,15,866,9343,74,406,2807,57512,82.41,128932753,66.444,29.3,6.857,17336.469,152.783,13.06,0.774,3
126,16,912,10255,43,449,2718,60230,82.41,128932753,66.444,29.3,6.857,17336.469,152.783,13.06,0.774,3
126,17,939,11194,37,486,3055,63285,82.41,128932753,66.444,29.3,6.857,17336.469,152.783,13.06,0.774,3
126,18,1076,12270,60,546,1637,64922,82.41,128932753,66.444,29.3,6.857,17336.469,152.783,13.06,0.774,3
126,19,755,13025,104,650,1497,66419,82.41,128932753,66.444,29.3,6.857,17336.469,152.783,13.06,0.774,3
126,20,705,13730,36,686,3630,70049,82.41,128932753,66.444,29.3,6.857,17336.469,152.783,13.06,0.774,3
126,21,1432,15162,26,712,3346,73395,82.41,128932753,66.444,29.3,6.857,17336.469,152.783,13.06,0.774,3
126,22,1385,16547,145,857,3218,76613,82.41,128932753,66.444,29.3,6.857,17336.469,152.783,13.06,0.774,3
126,23,1303,17850,113,970,3519,80132,82.41,128932753,66.444,29.3,6.857,17336.469,152.783,13.06,0.774,3
126,24,1391,19241,99,1069,3970,84102,82.41,128932753,66.444,29.3,6.857,17336.469,152.783,13.06,0.774,3
126,25,1597,20838,152,1221,2219,86321,82.41,128932753,66.444,29.3,6.857,17336.469,152.783,13.06,0.774,3
126,26,1035,21873,84,1305,1933,88254,82.41,128932753,66.444,29.3,6.857,17336.469,152.783,13.06,0.774,3
126,27,992,22865,46,1351,4314,92568,82.41,128932753,66.444,29.3,6.857,17336.469,152.783,13.06,0.774,3
126,28,1805,24670,83,1434,4426,96994,82.41,128932753,66.444,29.3,6.857,17336.469,152.783,13.06,0.774,3
126,29,1797,26467,135,1569,4700,101694,82.41,128932753,66.444,29.3,6.857,17336.469,152.783,13.06,0.774,3
126,30,1755,28222,163,1732,5099,106793,82.41,128932753,66.444,29.3,6.857,17336.469,152.783,13.06,0.774,3
126,31,1765,29987,127,1859,3096,109889,82.41,128932753,66.444,29.3,6.857,17336.469,152.783,13.06,0.774,3
126,32,1379,31366,113,1972,2815,112704,82.41,128932753,66.444,29.3,6.857,17336.469,152.783,13.06,0.774,3
126,33,1352,32718,89,2061,2751,115455,82.41,128932753,66.444,29.3,6.857,17336.469,152.783,13.06,0.774,3
126,34,1241,33959,93,2154,5923,121378,82.41,128932753,66.444,29.3,6.857,17336.469,152.783,13.06,0.774,3
126,35,2507,36466,117,2271,5063,126441,82.41,128932753,66.444,29.3,6.857,17336.469,152.783,13.06,0.774,3
126,36,2082,38548,236,2507,5680,132121,82.41,128932753,66.444,29.3,6.857,17336.469,152.783,13.06,0.774,3
126,37,2265,40813,197,2704,5790,137911,82.41,128932753,66.444,29.3,6.857,17336.469,152.783,13.06,0.774,3
126,38,2374,43187,257,2961,6146,144057,82.41,128932753,66.444,29.3,6.857,17336.469,152.783,13.06,0.774,3
126,39,2393,45580,199,3160,3463,147520,82.41,128932753,66.444,29.3,6.857,17336.469,152.783,13.06,0.774,3
126,40,1513,47093,193,3353,2742,150262,82.41,128932753,66.444,29.3,6.857,17336.469,152.783,13.06,0.774,3
126,41,1402,48495,112,3465,6866,157128,82.41,128932753,66.444,29.3,6.857,17336.469,152.783,13.06,0.774,3
126,42,2942,51437,108,3573,7015,164143,82.41,128932753,66.444,29.3,6.857,17336.469,152.783,13.06,0.774,3
126,43,2903,54340,353,3926,6936,171079,82.41,128932753,66.444,29.3,6.857,17336.469,152.783,13.06,0.774,3
126,44,3095,57435,294,4220,7217,178296,82.41,128932753,66.444,29.3,6.857,17336.469,152.783,13.06,0.774,3
126,45,3050,60485,257,4477,7712,186008,82.41,128932753,66.444,29.3,6.857,17336.469,152.783,13.06,0.774,3
126,46,3449,63934,290,4767,4204,190212,82.41,128932753,66.444,29.3,6.857,17336.469,152.783,13.06,0.774,3
126,47,2151,66085,278,5045,2884,193096,82.41,128932753,66.444,29.3,6.857,17336.469,152.783,13.06,0.774,3
126,48,1623,67708,132,5177,8490,201586,82.41,128932753,66.444,29.3,6.857,17336.469,152.783,13.06,0.774,3
126,49,3998,71706,155,5332,7700,209286,82.41,128932753,66.444,29.3,6.857,17336.469,152.783,13.06,0.774,3
126,50,3547,75253,334,5666,8329,217615,82.41,128932753,66.444,29.3,6.857,17336.469,152.783,13.06,0.774,3
126,51,3894,79147,424,6090,8275,225890,82.41,128932753,66.444,29.3,6.857,17336.469,152.783,13.06,0.774,3
126,52,3978,83125,420,6510,8564,234454,82.41,128932753,66.444,29.3,6.857,17336.469,152.783,13.06,0.774,3
126,53,3963,87088,479,6989,4416,238870,82.41,128932753,66.444,29.3,6.857,17336.469,152.783,13.06,0.774,3
126,54,2256,89344,190,7179,3572,242442,82.41,128932753,66.444,29.3,6.857,17336.469,152.783,13.06,0.774,3
126,55,1861,91205,215,7394,9460,251902,82.41,128932753,66.444,29.3,6.857,17336.469,152.783,13.06,0.774,3
126,56,4593,95798,239,7633,9130,261032,82.41,128932753,66.444,29.3,6.857,17336.469,152.783,13.06,0.774,3
126,57,4314,100112,501,8134,9424,270456,82.41,128932753,66.444,29.3,6.857,17336.469,152.783,13.06,0.774,3
126,58,4457,104569,463,8597,8937,279393,82.41,128932753,66.444,29.3,6.857,17336.469,152.783,13.06,0.774,3
126,59,4203,108772,447,9044,9291,288684,82.41,128932753,66.444,29.3,6.857,17336.469,152.783,13.06,0.774,3
126,60,4344,113116,371,9415,5242,293926,82.41,128932753,66.444,29.3,6.857,17336.469,152.783,13.06,0.774,3
126,61,2713,115829,364,9779,3795,297721,82.41,128932753,66.444,29.3,6.857,17336.469,152.783,13.06,0.774,3
126,62,2061,117890,151,9930,10477,308198,72.69,128932753,66.444,29.3,6.857,17336.469,152.783,13.06,0.774,3
126,63,5249,123139,237,10167,9819,318017,72.69,128932753,66.444,29.3,6.857,17336.469,152.783,13.06,0.774,3
126,64,4716,127855,470,10637,10321,328338,72.69,128932753,66.444,29.3,6.857,17336.469,152.783,13.06,0.774,3
126,65,4916,132771,1091,11728,10173,338511,72.69,128932753,66.444,29.3,6.857,17336.469,152.783,13.06,0.774,3
126,66,4870,137641,817,12545,10629,349140,72.69,128932753,66.444,29.3,6.857,17336.469,152.783,13.06,0.774,3
126,67,5013,142654,625,13170,5571,354711,72.69,128932753,66.444,29.3,6.857,17336.469,152.783,13.06,0.774,3
126,68,2983,145637,341,13511,4121,358832,72.69,128932753,66.444,29.3,6.857,17336.469,152.783,13.06,0.774,3
126,69,2323,147960,188,13699,11757,370589,72.69,128932753,66.444,29.3,6.857,17336.469,152.783,13.06,0.774,3
126,70,6128,154088,354,14053,11751,382340,72.69,128932753,66.444,29.3,6.857,17336.469,152.783,13.06,0.774,3
126,71,5733,159821,596,14649,11732,394072,72.69,128932753,66.444,29.3,6.857,17336.469,152.783,13.06,0.774,3
126,72,5690,165511,708,15357,11391,405463,72.69,128932753,66.444,29.3,6.857,17336.469,152.783,13.06,0.774,3
126,73,5363,170874,587,15944,11842,417305,70.83,128932753,66.444,29.3,6.857,17336.469,152.783,13.06,0.774,3
126,74,5586,176460,504,16448,5599,422904,70.83,128932753,66.444,29.3,6.857,17336.469,152.783,13.06,0.774,3
126,75,3051,179511,424,16872,4517,427421,70.83,128932753,66.444,29.3,6.857,17336.469,152.783,13.06,0.774,3
126,76,2567,182078,269,17141,13229,440650,70.83,128932753,66.444,29.3,6.857,17336.469,152.783,13.06,0.774,3
126,77,6524,188602,439,17580,12733,453383,70.83,128932753,66.444,29.3,6.857,17336.469,152.783,13.06,0.774,3
126,78,6374,194976,730,18310,12167,465550,70.83,128932753,66.444,29.3,6.857,17336.469,152.783,13.06,0.774,3
126,79,6094,201070,770,19080,11872,477422,70.83,128932753,66.444,29.3,6.857,17336.469,152.783,13.06,0.774,3
126,80,6022,207092,667,19747,11919,489341,70.83,128932753,66.444,29.3,6.857,17336.469,152.783,13.06,0.774,3
126,81,6073,213165,647,20394,6246,495587,70.83,128932753,66.444,29.3,6.857,17336.469,152.783,13.06,0.774,3
126,82,3536,216701,387,20781,4016,499603,70.83,128932753,66.444,29.3,6.857,17336.469,152.783,13.06,0.774,3
126,83,2431,219132,1044,21825,12495,512098,70.83,128932753,66.444,29.3,6.857,17336.469,152.783,13.06,0.774,3
126,84,6832,225964,759,22584,12920,525018,70.83,128932753,66.444,29.3,6.857,17336.469,152.783,13.06,0.774,3
126,85,6574,232538,793,23377,12266,537284,70.83,128932753,66.444,29.3,6.857,17336.469,152.783,13.06,0.774,3
126,86,6264,238802,965,24342,12621,549905,70.83,128932753,66.444,29.3,6.857,17336.469,152.783,13.06,0.774,3
126,87,6231,245033,718,25060,13063,562968,70.83,128932753,66.444,29.3,6.857,17336.469,152.783,13.06,0.774,3
126,88,6469,251502,719,25779,6660,569628,70.83,128932753,66.444,29.3,6.857,17336.469,152.783,13.06,0.774,3
126,89,3629,255131,602,26381,4973,574601,70.83,128932753,66.444,29.3,6.857,17336.469,152.783,13.06,0.774,3
126,90,2917,258048,267,26648,14668,589269,70.83,128932753,66.444,29.3,6.857,17336.469,152.783,13.06,0.774,3
126,91,7462,265510,473,27121,14084,603353,70.83,128932753,66.444,29.3,6.857,17336.469,152.783,13.06,0.774,3
126,92,7143,272653,648,27769,14758,618111,70.83,128932753,66.444,29.3,6.857,17336.469,152.783,13.06,0.774,3
126,93,7543,280196,741,28510,13592,631703,70.83,128932753,66.444,29.3,6.857,17336.469,152.783,13.06,0.774,3
126,94,7000,287196,679,29189,13992,645695,70.83,128932753,66.444,29.3,6.857,17336.469,152.783,13.06,0.774,3
126,95,7016,294212,654,29843,6397,652092,70.83,128932753,66.444,29.3,6.857,17336.469,152.783,13.06,0.774,3
126,96,3623,297835,523,30366,5082,657174,70.83,128932753,66.444,29.3,6.857,17336.469,152.783,13.06,0.774,3
126,97,2953,300788,273,30639,15302,672476,70.83,128932753,66.444,29.3,6.857,17336.469,152.783,13.06,0.774,3
126,98,7786,308574,480,31119,15327,687803,70.83,128932753,66.444,29.3,6.857,17336.469,152.783,13.06,0.774,3
126,99,7827,316401,895,32014,14635,702438,70.83,128932753,66.444,29.3,6.857,17336.469,152.783,13.06,0.774,3
126,100,7401,323802,782,32796,14032,716470,70.83,128932753,66.444,29.3,6.857,17336.469,152.783,13.06,0.774,3
126,101,7094,330896,730,33526,14036,730506,70.83,128932753,66.444,29.3,6.857,17336.469,152.783,13.06,0.774,3
126,102,7150,338046,665,34191,6782,737288,70.83,128932753,66.444,29.3,6.857,17336.469,152.783,13.06,0.774,3
126,103,3819,341865,539,34730,5250,742538,70.83,128932753,66.444,29.3,6.857,17336.469,152.783,13.06,0.774,3
126,104,3176,345041,276,35006,16340,758878,70.83,128932753,66.444,29.3,6.857,17336.469,152.783,13.06,0.774,3
126,105,8792,353833,443,35449,15674,774552,70.83,128932753,66.444,29.3,6.857,17336.469,152.783,13.06,0.774,3
126,106,8412,362245,878,36327,16790,791342,70.83,128932753,66.444,29.3,6.857,17336.469,152.783,13.06,0.774,3
126,107,8738,370983,579,36906,16097,807439,70.83,128932753,66.444,29.3,6.857,17336.469,152.783,13.06,0.774,3
126,108,8179,379162,668,37574,16067,823506,70.83,128932753,66.444,29.3,6.857,17336.469,152.783,13.06,0.774,3
126,109,7891,387053,736,38310,7954,831460,70.83,128932753,66.444,29.3,6.857,17336.469,152.783,13.06,0.774,3
126,110,4344,391397,578,38888,5378,836838,70.83,128932753,66.444,29.3,6.857,17336.469,152.783,13.06,0.774,3
126,111,3389,394786,296,39184,17273,854111,70.83,128932753,66.444,29.3,6.857,17336.469,152.783,13.06,0.774,3
126,112,9044,403830,301,39485,16462,870573,70.83,128932753,66.444,29.3,6.857,17336.469,152.783,13.06,0.774,3
126,113,8610,412440,915,40400,16319,886892,70.83,128932753,66.444,29.3,6.857,17336.469,152.783,13.06,0.774,3
126,114,8276,420716,790,41190,15743,902635,70.83,128932753,66.444,29.3,6.857,17336.469,152.783,13.06,0.774,3
126,115,7988,428704,718,41908,15596,918231,70.83,128932753,66.444,29.3,6.857,17336.469,152.783,13.06,0.774,3
126,116,7949,436653,737,42645,7290,925521,70.83,128932753,66.444,29.3,6.857,17336.469,152.783,13.06,0.774,3
126,117,4113,440766,729,43374,5071,930592,70.83,128932753,66.444,29.3,6.857,17336.469,152.783,13.06,0.774,3
126,118,2965,443731,306,43680,15956,946548,70.83,128932753,66.444,29.3,6.857,17336.469,152.783,13.06,0.774,3
126,119,8413,452144,342,44022,16025,962573,70.83,128932753,66.444,29.3,6.857,17336.469,152.783,13.06,0.774,3
126,120,8110,460254,854,44876,15188,977761,70.83,128932753,66.444,29.3,6.857,17336.469,152.783,13.06,0.774,3
126,121,7617,467871,485,45361,15200,992961,70.83,128932753,66.444,29.3,6.857,17336.469,152.783,13.06,0.774,3
126,122,7524,475395,639,46000,14191,1007152,70.83,128932753,66.444,29.3,6.857,17336.469,152.783,13.06,0.774,3
126,123,6660,482055,688,46688,7215,1014367,70.83,128932753,66.444,29.3,6.857,17336.469,152.783,13.06,0.774,3
126,124,3721,485776,784,47472,4429,1018796,70.83,128932753,66.444,29.3,6.857,17336.469,152.783,13.06,0.774,3
126,125,2474,488250,274,47746,14722,1033518,70.83,128932753,66.444,29.3,6.857,17336.469,152.783,13.06,0.774,3
126,126,7430,495680,266,48012,15230,1048748,70.83,128932753,66.444,29.3,6.857,17336.469,152.783,13.06,0.774,3
126,127,7286,502966,857,48869,14852,1063600,70.83,128932753,66.444,29.3,6.857,17336.469,152.783,13.06,0.774,3
126,128,7071,510037,829,49698,14215,1077815,70.83,128932753,66.444,29.3,6.857,17336.469,152.783,13.06,0.774,3
126,129,6617,516654,819,50517,14295,1092110,70.83,128932753,66.444,29.3,6.857,17336.469,152.783,13.06,0.774,3
126,130,6539,523193,794,51311,6832,1098942,70.83,128932753,66.444,29.3,6.857,17336.469,152.783,13.06,0.774,3
126,131,3616,526809,695,52006,4272,1103214,70.83,128932753,66.444,29.3,6.857,17336.469,152.783,13.06,0.774,3
126,132,2377,529186,292,52298,15027,1118241,70.83,128932753,66.444,29.3,6.857,17336.469,152.783,13.06,0.774,3
126,133,7086,536272,705,53003,14891,1133132,70.83,128932753,66.444,29.3,6.857,17336.469,152.783,13.06,0.774,3
126,134,6783,543055,926,53929,14230,1147362,70.83,128932753,66.444,29.3,6.857,17336.469,152.783,13.06,0.774,3
126,135,6306,549361,737,54666,14089,1161451,70.83,128932753,66.444,29.3,6.857,17336.469,152.783,13.06,0.774,3
126,136,6249,555610,627,55293,13921,1175372,70.83,128932753,66.444,29.3,6.857,17336.469,152.783,13.06,0.774,3
126,137,6049,561659,615,55908,6456,1181828,70.83,128932753,66.444,29.3,6.857,17336.469,152.783,13.06,0.774,3
126,138,3144,564803,635,56543,4212,1186040,70.83,128932753,66.444,29.3,6.857,17336.469,152.783,13.06,0.774,3
126,139,2263,567066,214,56757,14487,1200527,70.83,128932753,66.444,29.3,6.857,17336.469,152.783,13.06,0.774,3
126,140,6709,573775,266,57023,14798,1215325,70.83,128932753,66.444,29.3,6.857,17336.469,152.783,13.06,0.774,3
126,141,6561,580336,751,57774,14131,1229456,70.83,128932753,66.444,29.3,6.857,17336.469,152.783,13.06,0.774,3
126,142,6148,586484,707,58481,12932,1242388,74.54,128932753,66.444,29.3,6.857,17336.469,152.783,13.06,0.774,3
126,143,5839,592323,625,59106,14071,1256459,74.54,128932753,66.444,29.3,6.857,17336.469,152.783,13.06,0.774,3
126,144,6118,598441,504,59610,6475,1262934,74.54,128932753,66.444,29.3,6.857,17336.469,152.783,13.06,0.774,3
126,145,3028,601469,644,60254,4160,1267094,74.54,128932753,66.444,29.3,6.857,17336.469,152.783,13.06,0.774,3
126,146,2270,603739,226,60480,14581,1281675,74.54,128932753,66.444,29.3,6.857,17336.469,152.783,13.06,0.774,3
126,147,6851,610590,320,60800,14469,1296144,74.54,128932753,66.444,29.3,6.857,17336.469,152.783,13.06,0.774,3
126,148,6403,616993,650,61450,16195,1312339,74.54,128932753,66.444,29.3,6.857,17336.469,152.783,13.06,0.774,3
126,149,6854,623847,626,62076,15565,1327904,74.54,128932753,66.444,29.3,6.857,17336.469,152.783,13.06,0.774,3
126,150,6248,630095,518,62594,15336,1343240,74.54,128932753,66.444,29.3,6.857,17336.469,152.783,13.06,0.774,3
126,151,6206,636301,552,63146,7277,1350517,74.54,128932753,66.444,29.3,6.857,17336.469,152.783,13.06,0.774,3
126,152,3017,639318,673,63819,4216,1354733,74.54,128932753,66.444,29.3,6.857,17336.469,152.783,13.06,0.774,3
126,153,2124,641442,339,64158,14986,1369719,74.54,128932753,66.444,29.3,6.857,17336.469,152.783,13.06,0.774,3
126,154,6729,648171,256,64414,15983,1385702,74.54,128932753,66.444,29.3,6.857,17336.469,152.783,13.06,0.774,3
126,155,6936,655107,827,65241,16054,1401756,74.54,128932753,66.444,29.3,6.857,17336.469,152.783,13.06,0.774,3
126,156,6758,661865,575,65816,15476,1417232,74.54,128932753,66.444,29.3,6.857,17336.469,152.783,13.06,0.774,3
126,157,6148,668013,513,66329,15220,1432452,74.54,128932753,66.444,29.3,6.857,17336.469,152.783,13.06,0.774,3
126,158,5893,673906,522,66851,6524,1438976,74.54,128932753,66.444,29.3,6.857,17336.469,152.783,13.06,0.774,3
126,159,2749,676655,703,67554,4002,1442978,74.54,128932753,66.444,29.3,6.857,17336.469,152.783,13.06,0.774,3
126,160,1980,678635,4,67558,14806,1457784,74.54,128932753,66.444,29.3,6.857,17336.469,152.783,13.06,0.774,3
126,161,6188,684823,223,67781,15674,1473458,74.54,128932753,66.444,29.3,6.857,17336.469,152.783,13.06,0.774,3
126,162,6403,691226,703,68484,15099,1488557,74.54,128932753,66.444,29.3,6.857,17336.469,152.783,13.06,0.774,3
126,163,5882,697108,611,69095,14697,1503254,74.54,128932753,66.444,29.3,6.857,17336.469,152.783,13.06,0.774,3
126,164,5482,702590,554,69649,14032,1517286,67.13,128932753,66.444,29.3,6.857,17336.469,152.783,13.06,0.774,3
126,165,5308,707898,534,70183,6197,1523483,67.13,128932753,66.444,29.3,6.857,17336.469,152.783,13.06,0.774,3
126,166,2669,710567,421,70604,3780,1527263,67.13,128932753,66.444,29.3,6.857,17336.469,152.783,13.06,0.774,3
126,167,1803,712370,217,70821,14655,1541918,67.13,128932753,66.444,29.3,6.857,17336.469,152.783,13.06,0.774,3
126,168,5985,718355,228,71049,10953,1552871,67.13,128932753,66.444,29.3,6.857,17336.469,152.783,13.06,0.774,3
126,169,4098,722453,629,71678,4334,1557205,67.13,128932753,66.444,29.3,6.857,17336.469,152.783,13.06,0.774,3
126,170,2082,724535,300,71978,14673,1571878,67.13,128932753,66.444,29.3,6.857,17336.469,152.783,13.06,0.774,3
126,171,6000,730535,201,72179,14424,1586302,69.91,128932753,66.444,29.3,6.857,17336.469,152.783,13.06,0.774,3
126,172,5551,736086,624,72803,6091,1592393,69.91,128932753,66.444,29.3,6.857,17336.469,152.783,13.06,0.774,3
126,173,2658,738744,455,73258,3627,1596020,69.91,128932753,66.444,29.3,6.857,17336.469,152.783,13.06,0.774,3
126,174,1701,740445,235,73493,14251,1610271,69.91,128932753,66.444,29.3,6.857,17336.469,152.783,13.06,0.774,3
126,175,6031,746476,204,73697,14994,1625265,73.61,128932753,66.444,29.3,6.857,17336.469,152.783,13.06,0.774,3
126,176,5939,752415,651,74348,14115,1639380,73.61,128932753,66.444,29.3,6.857,17336.469,152.783,13.06,0.774,3
126,177,5495,757910,601,74949,13483,1652863,73.61,128932753,66.444,29.3,6.857,17336.469,152.783,13.06,0.774,3
126,178,5156,763066,490,75439,13730,1666593,73.61,128932753,66.444,29.3,6.857,17336.469,152.783,13.06,0.774,3
126,179,5079,768145,405,75844,6068,1672661,73.61,128932753,66.444,29.3,6.857,17336.469,152.783,13.06,0.774,3
126,180,2535,770680,399,76243,3653,1676314,73.61,128932753,66.444,29.3,6.857,17336.469,152.783,13.06,0.774,3
126,181,1701,772381,187,76430,14662,1690976,73.61,128932753,66.444,29.3,6.857,17336.469,152.783,13.06,0.774,3
126,182,5952,778333,173,76603,14915,1705891,73.61,128932753,66.444,29.3,6.857,17336.469,152.783,13.06,0.774,3
126,183,5741,784074,560,77163,14015,1719906,73.61,128932753,66.444,29.3,6.857,17336.469,152.783,13.06,0.774,3
126,184,5212,789286,483,77646,13068,1732974,73.61,128932753,66.444,29.3,6.857,17336.469,152.783,13.06,0.774,3
126,185,4955,794241,432,78078,12747,1745721,73.61,128932753,66.444,29.3,6.857,17336.469,152.783,13.06,0.774,3
126,186,4699,798940,414,78492,5435,1751156,73.61,128932753,66.444,29.3,6.857,17336.469,152.783,13.06,0.774,3
126,187,2266,801206,388,78880,3412,1754568,73.61,128932753,66.444,29.3,6.857,17336.469,152.783,13.06,0.774,3
126,188,1580,802786,208,79088,12520,1767088,73.61,128932753,66.444,29.3,6.857,17336.469,152.783,13.06,0.774,3
126,189,5247,808033,180,79268,13804,1780892,73.61,128932753,66.444,29.3,6.857,17336.469,152.783,13.06,0.774,3
126,190,5405,813438,446,79714,13441,1794333,73.61,128932753,66.444,29.3,6.857,17336.469,152.783,13.06,0.774,3
126,191,5175,818613,369,80083,12688,1807021,73.61,128932753,66.444,29.3,6.857,17336.469,152.783,13.06,0.774,3
126,192,4936,823549,3013,83096,12532,1819553,73.61,128932753,66.444,29.3,6.857,17336.469,152.783,13.06,0.774,3
126,193,5009,828558,411,83507,5296,1824849,73.61,128932753,66.444,29.3,6.857,17336.469,152.783,13.06,0.774,3
126,194,2435,830993,135,83642,3447,1828296,73.61,128932753,66.444,29.3,6.857,17336.469,152.783,13.06,0.774,3
126,195,1750,832743,0,83642,13216,1841512,73.61,128932753,66.444,29.3,6.857,17336.469,152.783,13.06,0.774,3
126,196,5326,838069,303,83945,13438,1854950,73.61,128932753,66.444,29.3,6.857,17336.469,152.783,13.06,0.774,3
126,197,4548,842617,475,84420,10523,1865473,73.61,128932753,66.444,29.3,6.857,17336.469,152.783,13.06,0.774,3
126,198,2640,845257,478,84898,0,1865473,73.61,128932753,66.444,29.3,6.857,17336.469,152.783,13.06,0.774,3
126,199,1470,846727,387,85285,0,1865473,73.61,128932753,66.444,29.3,6.857,17336.469,152.783,13.06,0.774,3
126,200,380,847107,419,85704,0,1865473,73.61,128932753,66.444,29.3,6.857,17336.469,152.783,13.06,0.774,3
126,201,2800,849907,355,86059,0,1865473,73.61,128932753,66.444,29.3,6.857,17336.469,152.783,13.06,0.774,3
126,202,1320,851227,108,86167,0,1865473,73.61,128932753,66.444,29.3,6.857,17336.469,152.783,13.06,0.774,3
126,203,3699,854926,171,86338,0,1865473,73.61,128932753,66.444,29.3,6.857,17336.469,152.783,13.06,0.774,3
126,204,5788,860714,555,86893,0,1865473,73.61,128932753,66.444,29.3,6.857,17336.469,152.783,13.06,0.774,3
127,1,55,353,2,4,0,0,87.04,4033963,123.655,37.6,10.864,5189.972,408.502,5.72,0.7,0
127,2,70,423,1,5,0,0,87.04,4033963,123.655,37.6,10.864,5189.972,408.502,5.72,0.7,0
127,3,82,505,1,6,0,0,87.04,4033963,123.655,37.6,10.864,5189.972,408.502,5.72,0.7,0
127,4,86,591,2,8,0,0,87.04,4033963,123.655,37.6,10.864,5189.972,408.502,5.72,0.7,0
127,5,161,752,4,12,0,0,87.04,4033963,123.655,37.6,10.864,5189.972,408.502,5.72,0.7,0
127,6,112,864,3,15,0,0,87.04,4033963,123.655,37.6,10.864,5189.972,408.502,5.72,0.7,0
127,7,101,965,4,19,0,0,87.04,4033963,123.655,37.6,10.864,5189.972,408.502,5.72,0.7,0
127,8,91,1056,3,22,0,0,87.04,4033963,123.655,37.6,10.864,5189.972,408.502,5.72,0.7,0
127,9,118,1174,5,27,0,0,87.04,4033963,123.655,37.6,10.864,5189.972,408.502,5.72,0.7,0
127,10,115,1289,2,29,0,0,87.04,4033963,123.655,37.6,10.864,5189.972,408.502,5.72,0.7,0
127,11,149,1438,0,29,0,0,87.04,4033963,123.655,37.6,10.864,5189.972,408.502,5.72,0.7,0
127,12,122,1560,1,30,0,0,87.04,4033963,123.655,37.6,10.864,5189.972,408.502,5.72,0.7,0
127,13,102,1662,2,32,0,0,87.04,4033963,123.655,37.6,10.864,5189.972,408.502,5.72,0.7,0
127,14,50,1712,4,36,0,0,87.04,4033963,123.655,37.6,10.864,5189.972,408.502,5.72,0.7,0
127,15,222,1934,4,40,0,0,87.04,4033963,123.655,37.6,10.864,5189.972,408.502,5.72,0.7,0
127,16,115,2049,6,46,0,0,87.04,4033963,123.655,37.6,10.864,5189.972,408.502,5.72,0.7,0
127,17,105,2154,8,54,0,0,87.04,4033963,123.655,37.6,10.864,5189.972,408.502,5.72,0.7,0
127,18,110,2264,2,56,0,0,84.26,4033963,123.655,37.6,10.864,5189.972,408.502,5.72,0.7,0
127,19,87,2351,4,60,0,0,84.26,4033963,123.655,37.6,10.864,5189.972,408.502,5.72,0.7,0
127,20,121,2472,7,67,0,0,84.26,4033963,123.655,37.6,10.864,5189.972,408.502,5.72,0.7,0
127,21,76,2548,3,70,0,0,84.26,4033963,123.655,37.6,10.864,5189.972,408.502,5.72,0.7,0
127,22,66,2614,3,73,0,0,84.26,4033963,123.655,37.6,10.864,5189.972,408.502,5.72,0.7,0
127,23,164,2778,3,76,0,0,84.26,4033963,123.655,37.6,10.864,5189.972,408.502,5.72,0.7,0
127,24,148,2926,4,80,0,0,84.26,4033963,123.655,37.6,10.864,5189.972,408.502,5.72,0.7,0
127,25,184,3110,7,87,0,0,84.26,4033963,123.655,37.6,10.864,5189.972,408.502,5.72,0.7,0
127,26,194,3304,7,94,0,0,84.26,4033963,123.655,37.6,10.864,5189.972,408.502,5.72,0.7,0
127,27,104,3408,2,96,0,0,84.26,4033963,123.655,37.6,10.864,5189.972,408.502,5.72,0.7,0
127,28,73,3481,6,102,0,0,84.26,4033963,123.655,37.6,10.864,5189.972,408.502,5.72,0.7,0
127,29,157,3638,5,107,0,0,84.26,4033963,123.655,37.6,10.864,5189.972,408.502,5.72,0.7,0
127,30,133,3771,4,111,0,0,84.26,4033963,123.655,37.6,10.864,5189.972,408.502,5.72,0.7,0
127,31,126,3897,8,119,0,0,84.26,4033963,123.655,37.6,10.864,5189.972,408.502,5.72,0.7,0
127,32,83,3980,3,122,0,0,84.26,4033963,123.655,37.6,10.864,5189.972,408.502,5.72,0.7,0
127,33,72,4052,2,124,0,0,84.26,4033963,123.655,37.6,10.864,5189.972,408.502,5.72,0.7,0
127,34,69,4121,1,125,0,0,84.26,4033963,123.655,37.6,10.864,5189.972,408.502,5.72,0.7,0
127,35,127,4248,7,132,0,0,84.26,4033963,123.655,37.6,10.864,5189.972,408.502,5.72,0.7,0
127,36,115,4363,4,136,0,0,84.26,4033963,123.655,37.6,10.864,5189.972,408.502,5.72,0.7,0
127,37,113,4476,7,143,0,0,84.26,4033963,123.655,37.6,10.864,5189.972,408.502,5.72,0.7,0
127,38,129,4605,2,145,0,0,84.26,4033963,123.655,37.6,10.864,5189.972,408.502,5.72,0.7,0
127,39,123,4728,7,152,0,0,84.26,4033963,123.655,37.6,10.864,5189.972,408.502,5.72,0.7,0
127,40,139,4867,9,161,0,0,84.26,4033963,123.655,37.6,10.864,5189.972,408.502,5.72,0.7,0
127,41,60,4927,8,169,0,0,84.26,4033963,123.655,37.6,10.864,5189.972,408.502,5.72,0.7,0
127,42,68,4995,6,175,0,0,84.26,4033963,123.655,37.6,10.864,5189.972,408.502,5.72,0.7,0
127,43,159,5154,7,182,0,0,84.26,4033963,123.655,37.6,10.864,5189.972,408.502,5.72,0.7,0
127,44,252,5406,3,185,0,0,84.26,4033963,123.655,37.6,10.864,5189.972,408.502,5.72,0.7,0
127,45,147,5553,9,194,0,0,84.26,4033963,123.655,37.6,10.864,5189.972,408.502,5.72,0.7,0
127,46,192,5745,3,197,0,0,80.56,4033963,123.655,37.6,10.864,5189.972,408.502,5.72,0.7,0
127,47,189,5934,10,207,0,0,80.56,4033963,123.655,37.6,10.864,5189.972,408.502,5.72,0.7,0
127,48,126,6060,4,211,0,0,80.56,4033963,123.655,37.6,10.864,5189.972,408.502,5.72,0.7,0
127,49,78,6138,4,215,0,0,80.56,4033963,123.655,37.6,10.864,5189.972,408.502,5.72,0.7,0
127,50,202,6340,6,221,0,0,80.56,4033963,123.655,37.6,10.864,5189.972,408.502,5.72,0.7,0
127,51,213,6553,7,228,0,0,80.56,4033963,123.655,37.6,10.864,5189.972,408.502,5.72,0.7,0
127,52,151,6704,5,233,0,0,80.56,4033963,123.655,37.6,10.864,5189.972,408.502,5.72,0.7,0
127,53,143,6847,4,237,0,0,80.56,4033963,123.655,37.6,10.864,5189.972,408.502,5.72,0.7,0
127,54,147,6994,5,242,0,0,80.56,4033963,123.655,37.6,10.864,5189.972,408.502,5.72,0.7,0
127,55,99,7093,8,250,0,0,80.56,4033963,123.655,37.6,10.864,5189.972,408.502,5.72,0.7,0
127,56,54,7147,11,261,0,0,80.56,4033963,123.655,37.6,10.864,5189.972,408.502,5.72,0.7,0
127,57,158,7305,6,267,0,0,80.56,4033963,123.655,37.6,10.864,5189.972,408.502,5.72,0.7,0
127,58,232,7537,7,274,0,0,80.56,4033963,123.655,37.6,10.864,5189.972,408.502,5.72,0.7,0
127,59,188,7725,8,282,0,0,80.56,4033963,123.655,37.6,10.864,5189.972,408.502,5.72,0.7,0
127,60,171,7896,6,288,0,0,80.56,4033963,123.655,37.6,10.864,5189.972,408.502,5.72,0.7,0
127,61,202,8098,3,291,0,0,80.56,4033963,123.655,37.6,10.864,5189.972,408.502,5.72,0.7,0
127,62,153,8251,4,295,0,0,80.56,4033963,123.655,37.6,10.864,5189.972,408.502,5.72,0.7,0
127,63,109,8360,12,307,0,0,80.56,4033963,123.655,37.6,10.864,5189.972,408.502,5.72,0.7,0
127,64,188,8548,0,307,0,0,80.56,4033963,123.655,37.6,10.864,5189.972,408.502,5.72,0.7,0
127,65,247,8795,3,310,0,0,80.56,4033963,123.655,37.6,10.864,5189.972,408.502,5.72,0.7,0
127,66,223,9018,5,315,0,0,80.56,4033963,123.655,37.6,10.864,5189.972,408.502,5.72,0.7,0
127,67,229,9247,8,323,0,0,80.56,4033963,123.655,37.6,10.864,5189.972,408.502,5.72,0.7,0
127,68,264,9511,8,331,0,0,80.56,4033963,123.655,37.6,10.864,5189.972,408.502,5.72,0.7,0
127,69,189,9700,10,341,0,0,80.56,4033963,123.655,37.6,10.864,5189.972,408.502,5.72,0.7,0
127,70,107,9807,12,353,0,0,80.56,4033963,123.655,37.6,10.864,5189.972,408.502,5.72,0.7,0
127,71,218,10025,12,365,0,0,80.56,4033963,123.655,37.6,10.864,5189.972,408.502,5.72,0.7,0
127,72,296,10321,6,371,0,0,80.56,4033963,123.655,37.6,10.864,5189.972,408.502,5.72,0.7,0
127,73,406,10727,4,375,0,0,80.56,4033963,123.655,37.6,10.864,5189.972,408.502,5.72,0.7,0
127,74,366,11093,10,385,0,0,80.56,4033963,123.655,37.6,10.864,5189.972,408.502,5.72,0.7,0
127,75,366,11459,13,398,0,0,80.56,4033963,123.655,37.6,10.864,5189.972,408.502,5.72,0.7,0
127,76,281,11740,8,406,0,0,80.56,4033963,123.655,37.6,10.864,5189.972,408.502,5.72,0.7,0
127,77,139,11879,5,411,0,0,80.56,4033963,123.655,37.6,10.864,5189.972,408.502,5.72,0.7,0
127,78,375,12254,12,423,0,0,80.56,4033963,123.655,37.6,10.864,5189.972,408.502,5.72,0.7,0
127,79,478,12732,10,433,0,0,80.56,4033963,123.655,37.6,10.864,5189.972,408.502,5.72,0.7,0
127,80,374,13106,11,444,0,0,80.56,4033963,123.655,37.6,10.864,5189.972,408.502,5.72,0.7,0
127,81,450,13556,6,450,0,0,80.56,4033963,123.655,37.6,10.864,5189.972,408.502,5.72,0.7,0
127,82,397,13953,14,464,0,0,80.56,4033963,123.655,37.6,10.864,5189.972,408.502,5.72,0.7,0
127,83,247,14200,9,473,0,0,80.56,4033963,123.655,37.6,10.864,5189.972,408.502,5.72,0.7,0
127,84,163,14363,7,480,0,0,80.56,4033963,123.655,37.6,10.864,5189.972,408.502,5.72,0.7,0
127,85,351,14714,10,490,0,0,80.56,4033963,123.655,37.6,10.864,5189.972,408.502,5.72,0.7,0
127,86,364,15078,5,495,0,0,80.56,4033963,123.655,37.6,10.864,5189.972,408.502,5.72,0.7,0
127,87,375,15453,7,502,0,0,80.56,4033963,123.655,37.6,10.864,5189.972,408.502,5.72,0.7,0
127,88,323,15776,13,515,0,0,80.56,4033963,123.655,37.6,10.864,5189.972,408.502,5.72,0.7,0
127,89,304,16080,6,521,0,0,80.56,4033963,123.655,37.6,10.864,5189.972,408.502,5.72,0.7,0
127,90,170,16250,9,530,0,0,80.56,4033963,123.655,37.6,10.864,5189.972,408.502,5.72,0.7,0
127,91,107,16357,6,536,0,0,80.56,4033963,123.655,37.6,10.864,5189.972,408.502,5.72,0.7,0
127,92,256,16613,9,545,0,0,80.56,4033963,123.655,37.6,10.864,5189.972,408.502,5.72,0.7,0
127,93,285,16898,4,549,0,0,80.56,4033963,123.655,37.6,10.864,5189.972,408.502,5.72,0.7,0
127,94,252,17150,11,560,0,0,80.56,4033963,123.655,37.6,10.864,5189.972,408.502,5.72,0.7,0
127,95,295,17445,12,572,0,0,80.56,4033963,123.655,37.6,10.864,5189.972,408.502,5.72,0.7,0
127,96,227,17672,8,580,0,0,80.56,4033963,123.655,37.6,10.864,5189.972,408.502,5.72,0.7,0
127,97,142,17814,5,585,0,0,80.56,4033963,123.655,37.6,10.864,5189.972,408.502,5.72,0.7,0
127,98,92,17906,10,595,0,0,80.56,4033963,123.655,37.6,10.864,5189.972,408.502,5.72,0.7,0
127,99,235,18141,8,603,0,0,80.56,4033963,123.655,37.6,10.864,5189.972,408.502,5.72,0.7,0
127,100,330,18471,11,614,0,0,80.56,4033963,123.655,37.6,10.864,5189.972,408.502,5.72,0.7,0
127,101,195,18666,10,624,0,0,77.78,4033963,123.655,37.6,10.864,5189.972,408.502,5.72,0.7,0
127,102,258,18924,11,635,0,0,77.78,4033963,123.655,37.6,10.864,5189.972,408.502,5.72,0.7,0
127,103,284,19208,5,640,0,0,77.78,4033963,123.655,37.6,10.864,5189.972,408.502,5.72,0.7,0
127,104,174,19382,2,642,0,0,77.78,4033963,123.655,37.6,10.864,5189.972,408.502,5.72,0.7,0
127,105,57,19439,7,649,0,0,77.78,4033963,123.655,37.6,10.864,5189.972,408.502,5.72,0.7,0
127,106,269,19708,9,658,0,0,77.78,4033963,123.655,37.6,10.864,5189.972,408.502,5.72,0.7,0
127,107,332,20040,1,659,0,0,77.78,4033963,123.655,37.6,10.864,5189.972,408.502,5.72,0.7,0
127,108,224,20264,7,666,0,0,57.41,4033963,123.655,37.6,10.864,5189.972,408.502,5.72,0.7,0
127,109,230,20494,9,675,0,0,57.41,4033963,123.655,37.6,10.864,5189.972,408.502,5.72,0.7,0
127,110,300,20794,5,680,0,0,57.41,4033963,123.655,37.6,10.864,5189.972,408.502,5.72,0.7,0
127,111,186,20980,4,684,0,0,57.41,4033963,123.655,37.6,10.864,5189.972,408.502,5.72,0.7,0
127,112,135,21115,11,695,0,0,57.41,4033963,123.655,37.6,10.864,5189.972,408.502,5.72,0.7,0
127,113,327,21442,12,707,0,0,57.41,4033963,123.655,37.6,10.864,5189.972,408.502,5.72,0.7,0
127,114,356,21798,5,712,0,0,57.41,4033963,123.655,37.6,10.864,5189.972,408.502,5.72,0.7,0
127,115,307,22105,7,719,0,0,57.41,4033963,123.655,37.6,10.864,5189.972,408.502,5.72,0.7,0
127,116,378,22483,7,726,0,0,57.41,4033963,123.655,37.6,10.864,5189.972,408.502,5.72,0.7,0
127,117,345,22828,6,732,0,0,57.41,4033963,123.655,37.6,10.864,5189.972,408.502,5.72,0.7,0
127,118,206,23034,3,735,0,0,57.41,4033963,123.655,37.6,10.864,5189.972,408.502,5.72,0.7,0
127,119,120,23154,13,748,0,0,57.41,4033963,123.655,37.6,10.864,5189.972,408.502,5.72,0.7,0
127,120,367,23521,5,753,0,0,57.41,4033963,123.655,37.6,10.864,5189.972,408.502,5.72,0.7,0
127,121,426,23947,6,759,0,0,57.41,4033963,123.655,37.6,10.864,5189.972,408.502,5.72,0.7,0
127,122,0,23947,12,771,0,0,57.41,4033963,123.655,37.6,10.864,5189.972,408.502,5.72,0.7,0
127,123,786,24733,7,778,0,0,57.41,4033963,123.655,37.6,10.864,5189.972,408.502,5.72,0.7,0
127,124,380,25113,10,788,0,0,57.41,4033963,123.655,37.6,10.864,5189.972,408.502,5.72,0.7,0
127,125,249,25362,3,791,0,0,57.41,4033963,123.655,37.6,10.864,5189.972,408.502,5.72,0.7,0
127,126,120,25482,9,800,0,0,57.41,4033963,123.655,37.6,10.864,5189.972,408.502,5.72,0.7,0
127,127,332,25814,10,810,0,0,57.41,4033963,123.655,37.6,10.864,5189.972,408.502,5.72,0.7,0
127,128,408,26222,13,823,0,0,57.41,4033963,123.655,37.6,10.864,5189.972,408.502,5.72,0.7,0
127,129,406,26628,5,828,0,0,57.41,4033963,123.655,37.6,10.864,5189.972,408.502,5.72,0.7,0
127,130,362,26990,7,835,0,0,57.41,4033963,123.655,37.6,10.864,5189.972,408.502,5.72,0.7,0
127,131,453,27443,6,841,0,0,57.41,4033963,123.655,37.6,10.864,5189.972,408.502,5.72,0.7,0
127,132,217,27660,4,845,0,0,57.41,4033963,123.655,37.6,10.864,5189.972,408.502,5.72,0.7,0
127,133,181,27841,5,850,0,0,57.41,4033963,123.655,37.6,10.864,5189.972,408.502,5.72,0.7,0
127,134,382,28223,7,857,0,0,57.41,4033963,123.655,37.6,10.864,5189.972,408.502,5.72,0.7,0
127,135,474,28697,6,863,0,0,57.41,4033963,123.655,37.6,10.864,5189.972,408.502,5.72,0.7,0
127,136,390,29087,15,878,0,0,57.41,4033963,123.655,37.6,10.864,5189.972,408.502,5.72,0.7,0
127,137,396,29483,6,884,0,0,57.41,4033963,123.655,37.6,10.864,5189.972,408.502,5.72,0.7,0
127,138,422,29905,11,895,0,0,57.41,4033963,123.655,37.6,10.864,5189.972,408.502,5.72,0.7,0
127,139,278,30183,1,896,0,0,57.41,4033963,123.655,37.6,10.864,5189.972,408.502,5.72,0.7,0
127,140,194,30377,12,908,0,0,57.41,4033963,123.655,37.6,10.864,5189.972,408.502,5.72,0.7,0
127,141,412,30789,0,908,0,0,57.41,4033963,123.655,37.6,10.864,5189.972,408.502,5.72,0.7,0
127,142,626,31415,6,914,0,0,57.41,4033963,123.655,37.6,10.864,5189.972,408.502,5.72,0.7,0
127,143,522,31937,7,921,0,0,57.41,4033963,123.655,37.6,10.864,5189.972,408.502,5.72,0.7,0
127,144,547,32484,8,929,0,0,57.41,4033963,123.655,37.6,10.864,5189.972,408.502,5.72,0.7,0
127,145,588,33072,6,935,0,0,57.41,4033963,123.655,37.6,10.864,5189.972,408.502,5.72,0.7,0
127,146,406,33478,5,940,0,0,57.41,4033963,123.655,37.6,10.864,5189.972,408.502,5.72,0.7,0
127,147,350,33828,5,945,0,0,57.41,4033963,123.655,37.6,10.864,5189.972,408.502,5.72,0.7,0
127,148,530,34358,15,960,0,0,57.41,4033963,123.655,37.6,10.864,5189.972,408.502,5.72,0.7,0
127,149,624,34982,7,967,0,0,57.41,4033963,123.655,37.6,10.864,5189.972,408.502,5.72,0.7,0
127,150,564,35546,10,977,0,0,57.41,4033963,123.655,37.6,10.864,5189.972,408.502,5.72,0.7,0
127,151,358,35904,4,981,0,0,57.41,4033963,123.655,37.6,10.864,5189.972,408.502,5.72,0.7,0
127,152,500,36404,9,990,0,0,57.41,4033963,123.655,37.6,10.864,5189.972,408.502,5.72,0.7,0
127,153,296,36700,2,992,0,0,57.41,4033963,123.655,37.6,10.864,5189.972,408.502,5.72,0.7,0
127,154,220,36920,3,995,0,0,53.7,4033963,123.655,37.6,10.864,5189.972,408.502,5.72,0.7,0
127,155,288,37208,13,1008,0,0,53.7,4033963,123.655,37.6,10.864,5189.972,408.502,5.72,0.7,0
127,156,532,37740,16,1024,0,0,53.7,4033963,123.655,37.6,10.864,5189.972,408.502,5.72,0.7,0
127,157,632,38372,12,1036,0,0,53.7,4033963,123.655,37.6,10.864,5189.972,408.502,5.72,0.7,0
127,158,534,38906,11,1047,0,0,53.7,4033963,123.655,37.6,10.864,5189.972,408.502,5.72,0.7,0
127,159,567,39473,16,1063,0,0,53.7,4033963,123.655,37.6,10.864,5189.972,408.502,5.72,0.7,0
127,160,324,39797,0,1063,0,0,53.7,4033963,123.655,37.6,10.864,5189.972,408.502,5.72,0.7,0
127,161,258,40055,11,1074,0,0,53.7,4033963,123.655,37.6,10.864,5189.972,408.502,5.72,0.7,0
127,162,501,40556,13,1087,0,0,53.7,4033963,123.655,37.6,10.864,5189.972,408.502,5.72,0.7,0
127,163,588,41144,9,1096,0,0,53.7,4033963,123.655,37.6,10.864,5189.972,408.502,5.72,0.7,0
127,164,560,41704,10,1106,0,0,53.7,4033963,123.655,37.6,10.864,5189.972,408.502,5.72,0.7,0
127,165,479,42183,8,1114,0,0,53.7,4033963,123.655,37.6,10.864,5189.972,408.502,5.72,0.7,0
127,166,531,42714,4,1118,0,0,53.7,4033963,123.655,37.6,10.864,5189.972,408.502,5.72,0.7,0
127,167,264,42978,5,1123,0,0,53.7,4033963,123.655,37.6,10.864,5189.972,408.502,5.72,0.7,0
127,168,229,43207,7,1130,0,0,53.7,4033963,123.655,37.6,10.864,5189.972,408.502,5.72,0.7,0
127,169,527,43734,14,1144,0,0,50.93,4033963,123.655,37.6,10.864,5189.972,408.502,5.72,0.7,0
127,170,627,44361,15,1159,0,0,50.93,4033963,123.655,37.6,10.864,5189.972,408.502,5.72,0.7,0
127,171,622,44983,11,1170,0,0,50.93,4033963,123.655,37.6,10.864,5189.972,408.502,5.72,0.7,0
127,172,665,45648,16,1186,0,0,50.93,4033963,123.655,37.6,10.864,5189.972,408.502,5.72,0.7,0
127,173,688,46336,15,1201,0,0,50.93,4033963,123.655,37.6,10.864,5189.972,408.502,5.72,0.7,0
127,174,260,46596,2,1203,0,0,50.93,4033963,123.655,37.6,10.864,5189.972,408.502,5.72,0.7,0
127,175,200,46796,8,1211,0,0,50.93,4033963,123.655,37.6,10.864,5189.972,408.502,5.72,0.7,0
127,176,650,47446,19,1230,0,0,50.93,4033963,123.655,37.6,10.864,5189.972,408.502,5.72,0.7,0
127,177,786,48232,14,1244,0,0,45.37,4033963,123.655,37.6,10.864,5189.972,408.502,5.72,0.7,0
127,178,721,48953,8,1252,0,0,45.37,4033963,123.655,37.6,10.864,5189.972,408.502,5.72,0.7,0
127,179,713,49666,12,1264,0,0,45.37,4033963,123.655,37.6,10.864,5189.972,408.502,5.72,0.7,0
127,180,868,50534,15,1279,0,0,45.37,4033963,123.655,37.6,10.864,5189.972,408.502,5.72,0.7,0
127,181,341,50875,8,1287,0,0,44.44,4033963,123.655,37.6,10.864,5189.972,408.502,5.72,0.7,0
127,182,319,51194,14,1301,0,0,44.44,4033963,123.655,37.6,10.864,5189.972,408.502,5.72,0.7,0
127,183,835,52029,9,1310,0,0,44.44,4033963,123.655,37.6,10.864,5189.972,408.502,5.72,0.7,0
127,184,1013,53042,10,1320,0,0,44.44,4033963,123.655,37.6,10.864,5189.972,408.502,5.72,0.7,0
127,185,1022,54064,16,1336,0,0,44.44,4033963,123.655,37.6,10.864,5189.972,408.502,5.72,0.7,0
127,186,952,55016,8,1344,0,0,44.44,4033963,123.655,37.6,10.864,5189.972,408.502,5.72,0.7,0
127,187,872,55888,9,1353,0,0,44.44,4033963,123.655,37.6,10.864,5189.972,408.502,5.72,0.7,0
127,188,691,56579,13,1366,0,0,49.07,4033963,123.655,37.6,10.864,5189.972,408.502,5.72,0.7,0
127,189,322,56901,9,1375,0,0,49.07,4033963,123.655,37.6,10.864,5189.972,408.502,5.72,0.7,0
127,190,831,57732,14,1389,0,0,49.07,4033963,123.655,37.6,10.864,5189.972,408.502,5.72,0.7,0
127,191,1062,58794,17,1406,0,0,49.07,4033963,123.655,37.6,10.864,5189.972,408.502,5.72,0.7,0
127,192,1121,59915,18,1424,0,0,49.07,4033963,123.655,37.6,10.864,5189.972,408.502,5.72,0.7,0
127,193,918,60833,18,1442,0,0,49.07,4033963,123.655,37.6,10.864,5189.972,408.502,5.72,0.7,0
127,194,929,61762,16,1458,0,0,49.07,4033963,123.655,37.6,10.864,5189.972,408.502,5.72,0.7,0
127,195,389,62151,3,1461,0,0,49.07,4033963,123.655,37.6,10.864,5189.972,408.502,5.72,0.7,0
127,196,467,62618,17,1478,0,0,49.07,4033963,123.655,37.6,10.864,5189.972,408.502,5.72,0.7,0
127,197,657,63275,17,1495,0,0,49.07,4033963,123.655,37.6,10.864,5189.972,408.502,5.72,0.7,0
127,198,1149,64424,19,1514,0,0,49.07,4033963,123.655,37.6,10.864,5189.972,408.502,5.72,0.7,0
127,199,652,65076,16,1530,0,0,49.07,4033963,123.655,37.6,10.864,5189.972,408.502,5.72,0.7,0
127,200,784,65860,19,1549,0,0,49.07,4033963,123.655,37.6,10.864,5189.972,408.502,5.72,0.7,0
127,201,792,66652,20,1569,0,0,49.07,4033963,123.655,37.6,10.864,5189.972,408.502,5.72,0.7,0
127,202,398,67050,15,1584,0,0,49.07,4033963,123.655,37.6,10.864,5189.972,408.502,5.72,0.7,0
127,203,252,67302,17,1601,0,0,49.07,4033963,123.655,37.6,10.864,5189.972,408.502,5.72,0.7,0
127,204,656,67958,16,1617,0,0,49.07,4033963,123.655,37.6,10.864,5189.972,408.502,5.72,0.7,0
129,1,0,12,0,0,0,0,62.96,3278292,1.98,28.6,4.031,11840.846,460.043,4.82,0.741,0
129,2,2,14,0,0,0,0,62.96,3278292,1.98,28.6,4.031,11840.846,460.043,4.82,0.741,0
129,3,0,14,0,0,0,0,62.96,3278292,1.98,28.6,4.031,11840.846,460.043,4.82,0.741,0
129,4,0,14,0,0,0,0,62.96,3278292,1.98,28.6,4.031,11840.846,460.043,4.82,0.741,0
129,5,0,14,0,0,0,0,65.74,3278292,1.98,28.6,4.031,11840.846,460.043,4.82,0.741,0
129,6,0,14,0,0,0,0,65.74,3278292,1.98,28.6,4.031,11840.846,460.043,4.82,0.741,0
129,7,1,15,0,0,0,0,65.74,3278292,1.98,28.6,4.031,11840.846,460.043,4.82,0.741,0
129,8,0,15,0,0,0,0,65.74,3278292,1.98,28.6,4.031,11840.846,460.043,4.82,0.741,0
129,9,1,16,0,0,0,0,65.74,3278292,1.98,28.6,4.031,11840.846,460.043,4.82,0.741,0
129,10,0,16,0,0,0,0,65.74,3278292,1.98,28.6,4.031,11840.846,460.043,4.82,0.741,0
129,11,0,16,0,0,0,0,65.74,3278292,1.98,28.6,4.031,11840.846,460.043,4.82,0.741,0
129,12,0,16,0,0,0,0,65.74,3278292,1.98,28.6,4.031,11840.846,460.043,4.82,0.741,0
129,13,0,16,0,0,0,0,65.74,3278292,1.98,28.6,4.031,11840.846,460.043,4.82,0.741,0
129,14,0,16,0,0,0,0,65.74,3278292,1.98,28.6,4.031,11840.846,460.043,4.82,0.741,0
129,15,14,30,0,0,0,0,65.74,3278292,1.98,28.6,4.031,11840.846,460.043,4.82,0.741,0
129,16,0,30,0,0,0,0,65.74,3278292,1.98,28.6,4.031,11840.846,460.043,4.82,0.741,0
129,17,1,31,0,0,0,0,65.74,3278292,1.98,28.6,4.031,11840.846,460.043,4.82,0.741,0
129,18,0,31,0,0,0,0,65.74,3278292,1.98,28.6,4.031,11840.846,460.043,4.82,0.741,0
129,19,0,31,0,0,0,0,65.74,3278292,1.98,28.6,4.031,11840.846,460.043,4.82,0.741,0
129,20,1,32,0,0,0,0,65.74,3278292,1.98,28.6,4.031,11840.846,460.043,4.82,0.741,0
129,21,2,34,0,0,0,0,65.74,3278292,1.98,28.6,4.031,11840.846,460.043,4.82,0.741,0
129,22,1,35,0,0,0,0,65.74,3278292,1.98,28.6,4.031,11840.846,460.043,4.82,0.741,0
129,23,0,35,0,0,0,0,65.74,3278292,1.98,28.6,4.031,11840.846,460.043,4.82,0.741,0
129,24,1,36,0,0,0,0,65.74,3278292,1.98,28.6,4.031,11840.846,460.043,4.82,0.741,0
129,25,0,36,0,0,0,0,65.74,3278292,1.98,28.6,4.031,11840.846,460.043,4.82,0.741,0
129,26,2,38,0,0,0,0,65.74,3278292,1.98,28.6,4.031,11840.846,460.043,4.82,0.741,0
129,27,0,38,0,0,0,0,65.74,3278292,1.98,28.6,4.031,11840.846,460.043,4.82,0.741,0
129,28,0,38,0,0,0,0,74.07,3278292,1.98,28.6,4.031,11840.846,460.043,4.82,0.741,0
129,29,0,38,0,0,0,0,74.07,3278292,1.98,28.6,4.031,11840.846,460.043,4.82,0.741,0
129,30,0,38,0,0,0,0,74.07,3278292,1.98,28.6,4.031,11840.846,460.043,4.82,0.741,0
129,31,0,38,0,0,0,0,74.07,3278292,1.98,28.6,4.031,11840.846,460.043,4.82,0.741,0
129,32,1,39,0,0,0,0,74.07,3278292,1.98,28.6,4.031,11840.846,460.043,4.82,0.741,0
129,33,0,39,0,0,0,0,74.07,3278292,1.98,28.6,4.031,11840.846,460.043,4.82,0.741,0
129,34,1,40,0,0,0,0,74.07,3278292,1.98,28.6,4.031,11840.846,460.043,4.82,0.741,0
129,35,1,41,0,0,0,0,90.74,3278292,1.98,28.6,4.031,11840.846,460.043,4.82,0.741,0
129,36,0,41,0,0,0,0,90.74,3278292,1.98,28.6,4.031,11840.846,460.043,4.82,0.741,0
129,37,0,41,0,0,0,0,90.74,3278292,1.98,28.6,4.031,11840.846,460.043,4.82,0.741,0
129,38,1,42,0,0,0,0,74.07,3278292,1.98,28.6,4.031,11840.846,460.043,4.82,0.741,0
129,39,0,42,0,0,0,0,71.3,3278292,1.98,28.6,4.031,11840.846,460.043,4.82,0.741,0
129,40,0,42,0,0,0,0,71.3,3278292,1.98,28.6,4.031,11840.846,460.043,4.82,0.741,0
129,41,0,42,0,0,0,0,71.3,3278292,1.98,28.6,4.031,11840.846,460.043,4.82,0.741,0
129,42,0,42,0,0,0,0,71.3,3278292,1.98,28.6,4.031,11840.846,460.043,4.82,0.741,0
129,43,0,42,0,0,0,0,71.3,3278292,1.98,28.6,4.031,11840.846,460.043,4.82,0.741,0
129,44,19,61,0,0,0,0,71.3,3278292,1.98,28.6,4.031,11840.846,460.043,4.82,0.741,0
129,45,0,61,0,0,0,0,71.3,3278292,1.98,28.6,4.031,11840.846,460.043,4.82,0.741,0
129,46,74,135,0,0,0,0,71.3,3278292,1.98,28.6,4.031,11840.846,460.043,4.82,0.741,0
129,47,1,136,0,0,0,0,71.3,3278292,1.98,28.6,4.031,11840.846,460.043,4.82,0.741,0
129,48,4,140,0,0,0,0,71.3,3278292,1.98,28.6,4.031,11840.846,460.043,4.82,0.741,0
129,49,0,140,0,0,0,0,71.3,3278292,1.98,28.6,4.031,11840.846,460.043,4.82,0.741,0
129,50,0,140,0,0,0,0,71.3,3278292,1.98,28.6,4.031,11840.846,460.043,4.82,0.741,0
129,51,0,140,0,0,0,0,71.3,3278292,1.98,28.6,4.031,11840.846,460.043,4.82,0.741,0
129,52,1,141,0,0,0,0,71.3,3278292,1.98,28.6,4.031,11840.846,460.043,4.82,0.741,0
129,53,0,141,0,0,0,0,71.3,3278292,1.98,28.6,4.031,11840.846,460.043,4.82,0.741,0
129,54,0,141,0,0,0,0,71.3,3278292,1.98,28.6,4.031,11840.846,460.043,4.82,0.741,0
129,55,0,141,0,0,0,0,71.3,3278292,1.98,28.6,4.031,11840.846,460.043,4.82,0.741,0
129,56,0,141,0,0,0,0,71.3,3278292,1.98,28.6,4.031,11840.846,460.043,4.82,0.741,0
129,57,7,148,0,0,0,0,71.3,3278292,1.98,28.6,4.031,11840.846,460.043,4.82,0.741,0
129,58,13,161,0,0,0,0,71.3,3278292,1.98,28.6,4.031,11840.846,460.043,4.82,0.741,0
129,59,18,179,0,0,0,0,71.3,3278292,1.98,28.6,4.031,11840.846,460.043,4.82,0.741,0
129,60,0,179,0,0,0,0,71.3,3278292,1.98,28.6,4.031,11840.846,460.043,4.82,0.741,0
129,61,0,179,0,0,0,0,71.3,3278292,1.98,28.6,4.031,11840.846,460.043,4.82,0.741,0
129,62,6,185,0,0,0,0,71.3,3278292,1.98,28.6,4.031,11840.846,460.043,4.82,0.741,0
129,63,0,185,0,0,0,0,71.3,3278292,1.98,28.6,4.031,11840.846,460.043,4.82,0.741,0
129,64,0,185,0,0,0,0,71.3,3278292,1.98,28.6,4.031,11840.846,460.043,4.82,0.741,0
129,65,1,186,0,0,0,0,71.3,3278292,1.98,28.6,4.031,11840.846,460.043,4.82,0.741,0
129,66,5,191,0,0,0,0,71.3,3278292,1.98,28.6,4.031,11840.846,460.043,4.82,0.741,0
129,67,0,191,0,0,0,0,71.3,3278292,1.98,28.6,4.031,11840.846,460.043,4.82,0.741,0
129,68,2,193,0,0,0,0,71.3,3278292,1.98,28.6,4.031,11840.846,460.043,4.82,0.741,0
129,69,1,194,0,0,0,0,71.3,3278292,1.98,28.6,4.031,11840.846,460.043,4.82,0.741,0
129,70,0,194,0,0,0,0,71.3,3278292,1.98,28.6,4.031,11840.846,460.043,4.82,0.741,0
129,71,0,194,0,0,0,0,71.3,3278292,1.98,28.6,4.031,11840.846,460.043,4.82,0.741,0
129,72,0,194,0,0,0,0,71.3,3278292,1.98,28.6,4.031,11840.846,460.043,4.82,0.741,0
129,73,3,197,0,0,0,0,71.3,3278292,1.98,28.6,4.031,11840.846,460.043,4.82,0.741,0
129,74,0,197,0,0,0,0,71.3,3278292,1.98,28.6,4.031,11840.846,460.043,4.82,0.741,0
129,75,0,197,0,0,0,0,71.3,3278292,1.98,28.6,4.031,11840.846,460.043,4.82,0.741,0
129,76,0,197,0,0,0,0,71.3,3278292,1.98,28.6,4.031,11840.846,460.043,4.82,0.741,0
129,77,0,197,0,0,0,0,71.3,3278292,1.98,28.6,4.031,11840.846,460.043,4.82,0.741,0
129,78,0,197,0,0,0,0,71.3,3278292,1.98,28.6,4.031,11840.846,460.043,4.82,0.741,0
129,79,4,201,0,0,0,0,71.3,3278292,1.98,28.6,4.031,11840.846,460.043,4.82,0.741,0
129,80,3,204,0,0,0,0,71.3,3278292,1.98,28.6,4.031,11840.846,460.043,4.82,0.741,0
129,81,0,204,0,0,0,0,71.3,3278292,1.98,28.6,4.031,11840.846,460.043,4.82,0.741,0
129,82,2,206,0,0,0,0,71.3,3278292,1.98,28.6,4.031,11840.846,460.043,4.82,0.741,0
129,83,7,213,0,0,0,0,71.3,3278292,1.98,28.6,4.031,11840.846,460.043,4.82,0.741,0
129,84,2,215,0,0,0,0,71.3,3278292,1.98,28.6,4.031,11840.846,460.043,4.82,0.741,0
129,85,0,215,0,0,0,0,71.3,3278292,1.98,28.6,4.031,11840.846,460.043,4.82,0.741,0
129,86,1,216,0,0,0,0,71.3,3278292,1.98,28.6,4.031,11840.846,460.043,4.82,0.741,0
129,87,3,219,0,0,0,0,71.3,3278292,1.98,28.6,4.031,11840.846,460.043,4.82,0.741,0
129,88,0,219,0,0,0,0,71.3,3278292,1.98,28.6,4.031,11840.846,460.043,4.82,0.741,0
129,89,0,219,0,0,0,0,71.3,3278292,1.98,28.6,4.031,11840.846,460.043,4.82,0.741,0
129,90,1,220,0,0,0,0,71.3,3278292,1.98,28.6,4.031,11840.846,460.043,4.82,0.741,0
129,91,0,220,0,0,0,0,71.3,3278292,1.98,28.6,4.031,11840.846,460.043,4.82,0.741,0
129,92,0,220,0,0,0,0,71.3,3278292,1.98,28.6,4.031,11840.846,460.043,4.82,0.741,0
129,93,0,220,0,0,0,0,71.3,3278292,1.98,28.6,4.031,11840.846,460.043,4.82,0.741,0
129,94,0,220,0,0,0,0,60.19,3278292,1.98,28.6,4.031,11840.846,460.043,4.82,0.741,0
129,95,0,220,0,0,0,0,60.19,3278292,1.98,28.6,4.031,11840.846,460.043,4.82,0.741,0
129,96,0,220,0,0,0,0,60.19,3278292,1.98,28.6,4.031,11840.846,460.043,4.82,0.741,0
129,97,0,220,0,0,0,0,60.19,3278292,1.98,28.6,4.031,11840.846,460.043,4.82,0.741,0
129,98,0,220,0,0,0,0,60.19,3278292,1.98,28.6,4.031,11840.846,460.043,4.82,0.741,0
129,99,0,220,0,0,0,0,60.19,3278292,1.98,28.6,4.031,11840.846,460.043,4.82,0.741,0
129,100,7,227,0,0,0,0,60.19,3278292,1.98,28.6,4.031,11840.846,460.043,4.82,0.741,0
129,101,0,227,0,0,0,0,60.19,3278292,1.98,28.6,4.031,11840.846,460.043,4.82,0.741,0
129,102,0,227,0,0,0,0,60.19,3278292,1.98,28.6,4.031,11840.846,460.043,4.82,0.741,0
129,103,3,230,0,0,0,0,60.19,3278292,1.98,28.6,4.031,11840.846,460.043,4.82,0.741,0
129,104,0,230,0,0,0,0,60.19,3278292,1.98,28.6,4.031,11840.846,460.043,4.82,0.741,0
129,105,13,243,0,0,0,0,60.19,3278292,1.98,28.6,4.031,11840.846,460.043,4.82,0.741,0
129,106,18,261,0,0,0,0,60.19,3278292,1.98,28.6,4.031,11840.846,460.043,4.82,0.741,0
129,107,0,261,0,0,0,0,60.19,3278292,1.98,28.6,4.031,11840.846,460.043,4.82,0.741,0
129,108,1,262,0,0,0,0,60.19,3278292,1.98,28.6,4.031,11840.846,460.043,4.82,0.741,0
129,109,25,287,0,0,0,0,60.19,3278292,1.98,28.6,4.031,11840.846,460.043,4.82,0.741,0
129,110,0,287,0,0,0,0,60.19,3278292,1.98,28.6,4.031,11840.846,460.043,4.82,0.741,0
129,111,0,287,0,0,0,0,60.19,3278292,1.98,28.6,4.031,11840.846,460.043,4.82,0.741,0
129,112,0,287,0,0,0,0,60.19,3278292,1.98,28.6,4.031,11840.846,460.043,4.82,0.741,0
129,113,0,287,0,0,0,0,60.19,3278292,1.98,28.6,4.031,11840.846,460.043,4.82,0.741,0
129,114,0,287,0,0,0,0,60.19,3278292,1.98,28.6,4.031,11840.846,460.043,4.82,0.741,0
129,115,1,288,0,0,0,0,60.19,3278292,1.98,28.6,4.031,11840.846,460.043,4.82,0.741,0
129,116,0,288,0,0,0,0,60.19,3278292,1.98,28.6,4.031,11840.846,460.043,4.82,0.741,0
129,117,0,288,0,0,0,0,60.19,3278292,1.98,28.6,4.031,11840.846,460.043,4.82,0.741,0
129,118,0,288,0,0,0,0,60.19,3278292,1.98,28.6,4.031,11840.846,460.043,4.82,0.741,0
129,119,1,289,0,0,0,0,60.19,3278292,1.98,28.6,4.031,11840.846,460.043,4.82,0.741,0
129,120,2,291,0,0,0,0,60.19,3278292,1.98,28.6,4.031,11840.846,460.043,4.82,0.741,0
129,121,0,291,0,0,0,0,60.19,3278292,1.98,28.6,4.031,11840.846,460.043,4.82,0.741,0
129,122,0,291,0,0,0,0,60.19,3278292,1.98,28.6,4.031,11840.846,460.043,4.82,0.741,0
129,123,0,291,0,0,0,0,60.19,3278292,1.98,28.6,4.031,11840.846,460.043,4.82,0.741,0
129,124,2,293,0,0,0,0,60.19,3278292,1.98,28.6,4.031,11840.846,460.043,4.82,0.741,0
129,125,0,293,0,0,0,0,60.19,3278292,1.98,28.6,4.031,11840.846,460.043,4.82,0.741,0
129,126,0,293,0,0,0,0,60.19,3278292,1.98,28.6,4.031,11840.846,460.043,4.82,0.741,0
129,127,0,293,0,0,0,0,60.19,3278292,1.98,28.6,4.031,11840.846,460.043,4.82,0.741,0
129,128,0,293,0,0,0,0,60.19,3278292,1.98,28.6,4.031,11840.846,460.043,4.82,0.741,0
129,129,0,293,0,0,0,0,60.19,3278292,1.98,28.6,4.031,11840.846,460.043,4.82,0.741,0
129,130,0,293,0,0,0,0,60.19,3278292,1.98,28.6,4.031,11840.846,460.043,4.82,0.741,0
129,131,0,293,0,0,0,0,60.19,3278292,1.98,28.6,4.031,11840.846,460.043,4.82,0.741,0
129,132,0,293,0,0,0,0,60.19,3278292,1.98,28.6,4.031,11840.846,460.043,4.82,0.741,0
129,133,0,293,0,0,0,0,60.19,3278292,1.98,28.6,4.031,11840.846,460.043,4.82,0.741,0
129,134,0,293,0,0,0,0,60.19,3278292,1.98,28.6,4.031,11840.846,460.043,4.82,0.741,0
129,135,4,297,0,0,0,0,60.19,3278292,1.98,28.6,4.031,11840.846,460.043,4.82,0.741,0
129,136,0,297,0,0,0,0,60.19,3278292,1.98,28.6,4.031,11840.846,460.043,4.82,0.741,0
129,137,1,298,0,0,0,0,60.19,3278292,1.98,28.6,4.031,11840.846,460.043,4.82,0.741,0
129,138,0,298,0,0,0,0,60.19,3278292,1.98,28.6,4.031,11840.846,460.043,4.82,0.741,0
129,139,0,298,0,0,0,0,60.19,3278292,1.98,28.6,4.031,11840.846,460.043,4.82,0.741,0
129,140,0,298,0,0,0,0,60.19,3278292,1.98,28.6,4.031,11840.846,460.043,4.82,0.741,0
129,141,0,298,0,0,0,0,60.19,3278292,1.98,28.6,4.031,11840.846,460.043,4.82,0.741,0
129,142,0,298,0,0,0,0,60.19,3278292,1.98,28.6,4.031,11840.846,460.043,4.82,0.741,0
129,143,0,298,0,0,0,0,60.19,3278292,1.98,28.6,4.031,11840.846,460.043,4.82,0.741,0
129,144,0,298,0,0,0,0,60.19,3278292,1.98,28.6,4.031,11840.846,460.043,4.82,0.741,0
129,145,0,298,0,0,0,0,60.19,3278292,1.98,28.6,4.031,11840.846,460.043,4.82,0.741,0
129,146,0,298,0,0,0,0,60.19,3278292,1.98,28.6,4.031,11840.846,460.043,4.82,0.741,0
129,147,0,298,0,0,0,0,60.19,3278292,1.98,28.6,4.031,11840.846,460.043,4.82,0.741,0
129,148,2,300,0,0,0,0,60.19,3278292,1.98,28.6,4.031,11840.846,460.043,4.82,0.741,0
129,149,1,301,0,0,0,0,60.19,3278292,1.98,28.6,4.031,11840.846,460.043,4.82,0.741,0
129,150,0,301,0,0,0,0,60.19,3278292,1.98,28.6,4.031,11840.846,460.043,4.82,0.741,0
129,151,0,301,0,0,0,0,60.19,3278292,1.98,28.6,4.031,11840.846,460.043,4.82,0.741,0
129,152,0,301,0,0,0,0,60.19,3278292,1.98,28.6,4.031,11840.846,460.043,4.82,0.741,0
129,153,0,301,0,0,0,0,60.19,3278292,1.98,28.6,4.031,11840.846,460.043,4.82,0.741,0
129,154,3,304,0,0,0,0,54.63,3278292,1.98,28.6,4.031,11840.846,460.043,4.82,0.741,0
129,155,2,306,0,0,0,0,54.63,3278292,1.98,28.6,4.031,11840.846,460.043,4.82,0.741,0
129,156,0,306,0,0,0,0,54.63,3278292,1.98,28.6,4.031,11840.846,460.043,4.82,0.741,0
129,157,0,306,0,0,0,0,54.63,3278292,1.98,28.6,4.031,11840.846,460.043,4.82,0.741,0
129,158,0,306,0,0,0,0,54.63,3278292,1.98,28.6,4.031,11840.846,460.043,4.82,0.741,0
129,159,4,310,0,0,0,0,54.63,3278292,1.98,28.6,4.031,11840.846,460.043,4.82,0.741,0
129,160,0,310,0,0,0,0,54.63,3278292,1.98,28.6,4.031,11840.846,460.043,4.82,0.741,0
129,161,0,310,0,0,0,0,54.63,3278292,1.98,28.6,4.031,11840.846,460.043,4.82,0.741,0
129,162,0,310,0,0,0,0,54.63,3278292,1.98,28.6,4.031,11840.846,460.043,4.82,0.741,0
129,163,0,310,0,0,0,0,54.63,3278292,1.98,28.6,4.031,11840.846,460.043,4.82,0.741,0
129,164,1,311,0,0,0,0,54.63,3278292,1.98,28.6,4.031,11840.846,460.043,4.82,0.741,0
129,165,0,311,0,0,0,0,54.63,3278292,1.98,28.6,4.031,11840.846,460.043,4.82,0.741,0
129,166,0,311,0,0,0,0,54.63,3278292,1.98,28.6,4.031,11840.846,460.043,4.82,0.741,0
129,167,0,311,0,0,0,0,54.63,3278292,1.98,28.6,4.031,11840.846,460.043,4.82,0.741,0
129,168,0,311,0,0,0,0,54.63,3278292,1.98,28.6,4.031,11840.846,460.043,4.82,0.741,0
129,169,0,311,0,0,0,0,52.78,3278292,1.98,28.6,4.031,11840.846,460.043,4.82,0.741,0
129,170,0,311,0,0,0,0,52.78,3278292,1.98,28.6,4.031,11840.846,460.043,4.82,0.741,0
129,171,0,311,0,0,0,0,44.44,3278292,1.98,28.6,4.031,11840.846,460.043,4.82,0.741,0
129,172,0,311,0,0,0,0,44.44,3278292,1.98,28.6,4.031,11840.846,460.043,4.82,0.741,0
129,173,1,312,0,0,0,0,44.44,3278292,1.98,28.6,4.031,11840.846,460.043,4.82,0.741,0
129,174,0,312,0,0,0,0,44.44,3278292,1.98,28.6,4.031,11840.846,460.043,4.82,0.741,0
129,175,1,313,0,0,0,0,44.44,3278292,1.98,28.6,4.031,11840.846,460.043,4.82,0.741,0
129,176,0,313,0,0,0,0,44.44,3278292,1.98,28.6,4.031,11840.846,460.043,4.82,0.741,0
129,177,0,313,0,0,0,0,44.44,3278292,1.98,28.6,4.031,11840.846,460.043,4.82,0.741,0
129,178,0,313,0,0,0,0,44.44,3278292,1.98,28.6,4.031,11840.846,460.043,4.82,0.741,0
129,179,0,313,0,0,0,0,44.44,3278292,1.98,28.6,4.031,11840.846,460.043,4.82,0.741,0
129,180,0,313,0,0,0,0,44.44,3278292,1.98,28.6,4.031,11840.846,460.043,4.82,0.741,0
129,181,0,313,0,0,0,0,44.44,3278292,1.98,28.6,4.031,11840.846,460.043,4.82,0.741,0
129,182,0,313,0,0,0,0,44.44,3278292,1.98,28.6,4.031,11840.846,460.043,4.82,0.741,0
129,183,0,313,0,0,0,0,42.59,3278292,1.98,28.6,4.031,11840.846,460.043,4.82,0.741,0
129,184,0,313,0,0,0,0,42.59,3278292,1.98,28.6,4.031,11840.846,460.043,4.82,0.741,0
129,185,0,313,0,0,0,0,42.59,3278292,1.98,28.6,4.031,11840.846,460.043,4.82,0.741,0
129,186,0,313,0,0,0,0,42.59,3278292,1.98,28.6,4.031,11840.846,460.043,4.82,0.741,0
129,187,0,313,0,0,0,0,42.59,3278292,1.98,28.6,4.031,11840.846,460.043,4.82,0.741,0
129,188,1,314,0,0,0,0,42.59,3278292,1.98,28.6,4.031,11840.846,460.043,4.82,0.741,0
129,189,1,315,0,0,0,0,42.59,3278292,1.98,28.6,4.031,11840.846,460.043,4.82,0.741,0
129,190,0,315,0,0,0,0,42.59,3278292,1.98,28.6,4.031,11840.846,460.043,4.82,0.741,0
129,191,0,315,0,0,0,0,42.59,3278292,1.98,28.6,4.031,11840.846,460.043,4.82,0.741,0
129,192,0,315,0,0,0,0,42.59,3278292,1.98,28.6,4.031,11840.846,460.043,4.82,0.741,0
129,193,0,315,0,0,0,0,42.59,3278292,1.98,28.6,4.031,11840.846,460.043,4.82,0.741,0
129,194,1,316,0,0,0,0,42.59,3278292,1.98,28.6,4.031,11840.846,460.043,4.82,0.741,0
129,195,2,318,0,0,0,0,42.59,3278292,1.98,28.6,4.031,11840.846,460.043,4.82,0.741,0
129,196,2,320,0,0,0,0,42.59,3278292,1.98,28.6,4.031,11840.846,460.043,4.82,0.741,0
129,197,0,320,0,0,0,0,42.59,3278292,1.98,28.6,4.031,11840.846,460.043,4.82,0.741,0
129,198,0,320,0,0,0,0,42.59,3278292,1.98,28.6,4.031,11840.846,460.043,4.82,0.741,0
129,199,0,320,0,0,0,0,42.59,3278292,1.98,28.6,4.031,11840.846,460.043,4.82,0.741,0
129,200,0,320,0,0,0,0,42.59,3278292,1.98,28.6,4.031,11840.846,460.043,4.82,0.741,0
129,201,4,324,0,0,0,0,42.59,3278292,1.98,28.6,4.031,11840.846,460.043,4.82,0.741,0
129,202,0,324,0,0,0,0,42.59,3278292,1.98,28.6,4.031,11840.846,460.043,4.82,0.741,0
129,203,2,326,0,0,0,0,42.59,3278292,1.98,28.6,4.031,11840.846,460.043,4.82,0.741,0
129,204,1,327,0,0,0,0,42.59,3278292,1.98,28.6,4.031,11840.846,460.043,4.82,0.741,0
130,1,18,109,0,1,0,0,0,628062,46.28,39.1,14.762,16409.288,387.305,10.08,0.814,0
130,2,14,123,0,1,0,0,0,628062,46.28,39.1,14.762,16409.288,387.305,10.08,0.814,0
130,3,21,144,1,2,0,0,0,628062,46.28,39.1,14.762,16409.288,387.305,10.08,0.814,0
130,4,30,174,0,2,0,0,0,628062,46.28,39.1,14.762,16409.288,387.305,10.08,0.814,0
130,5,27,201,0,2,0,0,0,628062,46.28,39.1,14.762,16409.288,387.305,10.08,0.814,0
130,6,13,214,0,2,0,0,0,628062,46.28,39.1,14.762,16409.288,387.305,10.08,0.814,0
130,7,19,233,0,2,0,0,0,628062,46.28,39.1,14.762,16409.288,387.305,10.08,0.814,0
130,8,8,241,0,2,0,0,0,628062,46.28,39.1,14.762,16409.288,387.305,10.08,0.814,0
130,9,8,249,0,2,0,0,0,628062,46.28,39.1,14.762,16409.288,387.305,10.08,0.814,0
130,10,3,252,0,2,0,0,0,628062,46.28,39.1,14.762,16409.288,387.305,10.08,0.814,0
130,11,5,257,0,2,0,0,0,628062,46.28,39.1,14.762,16409.288,387.305,10.08,0.814,0
130,12,6,263,0,2,0,0,0,628062,46.28,39.1,14.762,16409.288,387.305,10.08,0.814,0
130,13,9,272,1,3,0,0,0,628062,46.28,39.1,14.762,16409.288,387.305,10.08,0.814,0
130,14,2,274,0,3,0,0,0,628062,46.28,39.1,14.762,16409.288,387.305,10.08,0.814,0
130,15,9,283,1,4,0,0,0,628062,46.28,39.1,14.762,16409.288,387.305,10.08,0.814,0
130,16,5,288,0,4,0,0,0,628062,46.28,39.1,14.762,16409.288,387.305,10.08,0.814,0
130,17,15,303,0,4,0,0,0,628062,46.28,39.1,14.762,16409.288,387.305,10.08,0.814,0
130,18,0,303,0,4,0,0,0,628062,46.28,39.1,14.762,16409.288,387.305,10.08,0.814,0
130,19,4,307,1,5,0,0,0,628062,46.28,39.1,14.762,16409.288,387.305,10.08,0.814,0
130,20,1,308,0,5,0,0,0,628062,46.28,39.1,14.762,16409.288,387.305,10.08,0.814,0
130,21,4,312,0,5,0,0,0,628062,46.28,39.1,14.762,16409.288,387.305,10.08,0.814,0
130,22,1,313,0,5,0,0,0,628062,46.28,39.1,14.762,16409.288,387.305,10.08,0.814,0
130,23,2,315,0,5,0,0,0,628062,46.28,39.1,14.762,16409.288,387.305,10.08,0.814,0
130,24,4,319,0,5,0,0,0,628062,46.28,39.1,14.762,16409.288,387.305,10.08,0.814,0
130,25,0,319,1,6,0,0,0,628062,46.28,39.1,14.762,16409.288,387.305,10.08,0.814,0
130,26,1,320,0,6,0,0,0,628062,46.28,39.1,14.762,16409.288,387.305,10.08,0.814,0
130,27,1,321,1,7,0,0,0,628062,46.28,39.1,14.762,16409.288,387.305,10.08,0.814,0
130,28,0,321,0,7,0,0,0,628062,46.28,39.1,14.762,16409.288,387.305,10.08,0.814,0
130,29,0,321,0,7,0,0,0,628062,46.28,39.1,14.762,16409.288,387.305,10.08,0.814,0
130,30,1,322,0,7,0,0,0,628062,46.28,39.1,14.762,16409.288,387.305,10.08,0.814,0
130,31,0,322,0,7,0,0,0,628062,46.28,39.1,14.762,16409.288,387.305,10.08,0.814,0
130,32,0,322,0,7,0,0,0,628062,46.28,39.1,14.762,16409.288,387.305,10.08,0.814,0
130,33,0,322,0,7,0,0,0,628062,46.28,39.1,14.762,16409.288,387.305,10.08,0.814,0
130,34,0,322,1,8,0,0,0,628062,46.28,39.1,14.762,16409.288,387.305,10.08,0.814,0
130,35,1,323,0,8,0,0,0,628062,46.28,39.1,14.762,16409.288,387.305,10.08,0.814,0
130,36,1,324,0,8,0,0,0,628062,46.28,39.1,14.762,16409.288,387.305,10.08,0.814,0
130,37,0,324,0,8,0,0,0,628062,46.28,39.1,14.762,16409.288,387.305,10.08,0.814,0
130,38,0,324,0,8,0,0,0,628062,46.28,39.1,14.762,16409.288,387.305,10.08,0.814,0
130,39,0,324,0,8,0,0,0,628062,46.28,39.1,14.762,16409.288,387.305,10.08,0.814,0
130,40,0,324,0,8,0,0,0,628062,46.28,39.1,14.762,16409.288,387.305,10.08,0.814,0
130,41,0,324,1,9,0,0,0,628062,46.28,39.1,14.762,16409.288,387.305,10.08,0.814,0
130,42,0,324,0,9,0,0,0,628062,46.28,39.1,14.762,16409.288,387.305,10.08,0.814,0
130,43,0,324,0,9,0,0,0,628062,46.28,39.1,14.762,16409.288,387.305,10.08,0.814,0
130,44,0,324,0,9,0,0,0,628062,46.28,39.1,14.762,16409.288,387.305,10.08,0.814,0
130,45,0,324,0,9,0,0,0,628062,46.28,39.1,14.762,16409.288,387.305,10.08,0.814,0
130,46,0,324,0,9,0,0,0,628062,46.28,39.1,14.762,16409.288,387.305,10.08,0.814,0
130,47,0,324,0,9,0,0,0,628062,46.28,39.1,14.762,16409.288,387.305,10.08,0.814,0
130,48,0,324,0,9,0,0,0,628062,46.28,39.1,14.762,16409.288,387.305,10.08,0.814,0
130,49,0,324,0,9,0,0,0,628062,46.28,39.1,14.762,16409.288,387.305,10.08,0.814,0
130,50,0,324,0,9,0,0,0,628062,46.28,39.1,14.762,16409.288,387.305,10.08,0.814,0
130,51,0,324,0,9,0,0,0,628062,46.28,39.1,14.762,16409.288,387.305,10.08,0.814,0
130,52,0,324,0,9,0,0,0,628062,46.28,39.1,14.762,16409.288,387.305,10.08,0.814,0
130,53,0,324,0,9,0,0,0,628062,46.28,39.1,14.762,16409.288,387.305,10.08,0.814,0
130,54,0,324,0,9,0,0,0,628062,46.28,39.1,14.762,16409.288,387.305,10.08,0.814,0
130,55,0,324,0,9,0,0,0,628062,46.28,39.1,14.762,16409.288,387.305,10.08,0.814,0
130,56,0,324,0,9,0,0,0,628062,46.28,39.1,14.762,16409.288,387.305,10.08,0.814,0
130,57,0,324,0,9,0,0,0,628062,46.28,39.1,14.762,16409.288,387.305,10.08,0.814,0
130,58,0,324,0,9,0,0,0,628062,46.28,39.1,14.762,16409.288,387.305,10.08,0.814,0
130,59,0,324,0,9,0,0,0,628062,46.28,39.1,14.762,16409.288,387.305,10.08,0.814,0
130,60,0,324,0,9,0,0,0,628062,46.28,39.1,14.762,16409.288,387.305,10.08,0.814,0
130,61,0,324,0,9,0,0,0,628062,46.28,39.1,14.762,16409.288,387.305,10.08,0.814,0
130,62,0,324,0,9,0,0,0,628062,46.28,39.1,14.762,16409.288,387.305,10.08,0.814,0
130,63,0,324,0,9,0,0,0,628062,46.28,39.1,14.762,16409.288,387.305,10.08,0.814,0
130,64,0,324,0,9,0,0,0,628062,46.28,39.1,14.762,16409.288,387.305,10.08,0.814,0
130,65,0,324,0,9,0,0,0,628062,46.28,39.1,14.762,16409.288,387.305,10.08,0.814,0
130,66,0,324,0,9,0,0,0,628062,46.28,39.1,14.762,16409.288,387.305,10.08,0.814,0
130,67,0,324,0,9,0,0,0,628062,46.28,39.1,14.762,16409.288,387.305,10.08,0.814,0
130,68,0,324,0,9,0,0,0,628062,46.28,39.1,14.762,16409.288,387.305,10.08,0.814,0
130,69,0,324,0,9,0,0,0,628062,46.28,39.1,14.762,16409.288,387.305,10.08,0.814,0
130,70,0,324,0,9,0,0,0,628062,46.28,39.1,14.762,16409.288,387.305,10.08,0.814,0
130,71,0,324,0,9,0,0,0,628062,46.28,39.1,14.762,16409.288,387.305,10.08,0.814,0
130,72,0,324,0,9,0,0,0,628062,46.28,39.1,14.762,16409.288,387.305,10.08,0.814,0
130,73,0,324,0,9,0,0,0,628062,46.28,39.1,14.762,16409.288,387.305,10.08,0.814,0
130,74,0,324,0,9,0,0,0,628062,46.28,39.1,14.762,16409.288,387.305,10.08,0.814,0
130,75,0,324,0,9,0,0,0,628062,46.28,39.1,14.762,16409.288,387.305,10.08,0.814,0
130,76,1,325,0,9,0,0,0,628062,46.28,39.1,14.762,16409.288,387.305,10.08,0.814,0
130,77,1,326,0,9,0,0,0,628062,46.28,39.1,14.762,16409.288,387.305,10.08,0.814,0
130,78,0,326,0,9,0,0,0,628062,46.28,39.1,14.762,16409.288,387.305,10.08,0.814,0
130,79,7,333,0,9,0,0,0,628062,46.28,39.1,14.762,16409.288,387.305,10.08,0.814,0
130,80,4,337,0,9,0,0,0,628062,46.28,39.1,14.762,16409.288,387.305,10.08,0.814,0
130,81,18,355,0,9,0,0,0,628062,46.28,39.1,14.762,16409.288,387.305,10.08,0.814,0
130,82,4,359,0,9,0,0,0,628062,46.28,39.1,14.762,16409.288,387.305,10.08,0.814,0
130,83,3,362,0,9,0,0,0,628062,46.28,39.1,14.762,16409.288,387.305,10.08,0.814,0
130,84,5,367,0,9,0,0,0,628062,46.28,39.1,14.762,16409.288,387.305,10.08,0.814,0
130,85,11,378,0,9,0,0,0,628062,46.28,39.1,14.762,16409.288,387.305,10.08,0.814,0
130,86,11,389,0,9,0,0,0,628062,46.28,39.1,14.762,16409.288,387.305,10.08,0.814,0
130,87,25,414,0,9,0,0,0,628062,46.28,39.1,14.762,16409.288,387.305,10.08,0.814,0
130,88,25,439,0,9,0,0,0,628062,46.28,39.1,14.762,16409.288,387.305,10.08,0.814,0
130,89,30,469,0,9,0,0,0,628062,46.28,39.1,14.762,16409.288,387.305,10.08,0.814,0
130,90,12,481,2,11,0,0,0,628062,46.28,39.1,14.762,16409.288,387.305,10.08,0.814,0
130,91,20,501,0,11,0,0,0,628062,46.28,39.1,14.762,16409.288,387.305,10.08,0.814,0
130,92,47,548,1,12,0,0,0,628062,46.28,39.1,14.762,16409.288,387.305,10.08,0.814,0
130,93,28,576,0,12,0,0,0,628062,46.28,39.1,14.762,16409.288,387.305,10.08,0.814,0
130,94,40,616,1,13,0,0,0,628062,46.28,39.1,14.762,16409.288,387.305,10.08,0.814,0
130,95,47,663,0,13,0,0,0,628062,46.28,39.1,14.762,16409.288,387.305,10.08,0.814,0
130,96,57,720,1,14,0,0,0,628062,46.28,39.1,14.762,16409.288,387.305,10.08,0.814,0
130,97,61,781,0,14,0,0,0,628062,46.28,39.1,14.762,16409.288,387.305,10.08,0.814,0
130,98,60,841,0,14,0,0,0,628062,46.28,39.1,14.762,16409.288,387.305,10.08,0.814,0
130,99,66,907,3,17,0,0,0,628062,46.28,39.1,14.762,16409.288,387.305,10.08,0.814,0
130,100,53,960,0,17,0,0,0,628062,46.28,39.1,14.762,16409.288,387.305,10.08,0.814,0
130,101,59,1019,2,19,0,0,0,628062,46.28,39.1,14.762,16409.288,387.305,10.08,0.814,0
130,102,58,1077,0,19,0,0,0,628062,46.28,39.1,14.762,16409.288,387.305,10.08,0.814,0
130,103,87,1164,4,23,0,0,0,628062,46.28,39.1,14.762,16409.288,387.305,10.08,0.814,0
130,104,57,1221,0,23,0,0,0,628062,46.28,39.1,14.762,16409.288,387.305,10.08,0.814,0
130,105,232,1453,1,24,0,0,0,628062,46.28,39.1,14.762,16409.288,387.305,10.08,0.814,0
130,106,69,1522,1,25,0,0,0,628062,46.28,39.1,14.762,16409.288,387.305,10.08,0.814,0
130,107,60,1582,0,25,0,0,0,628062,46.28,39.1,14.762,16409.288,387.305,10.08,0.814,0
130,108,36,1618,1,26,0,0,0,628062,46.28,39.1,14.762,16409.288,387.305,10.08,0.814,0
130,109,0,1618,0,26,0,0,0,628062,46.28,39.1,14.762,16409.288,387.305,10.08,0.814,0
130,110,46,1664,2,28,0,0,0,628062,46.28,39.1,14.762,16409.288,387.305,10.08,0.814,0
130,111,107,1771,2,30,0,0,0,628062,46.28,39.1,14.762,16409.288,387.305,10.08,0.814,0
130,112,90,1861,2,32,0,0,0,628062,46.28,39.1,14.762,16409.288,387.305,10.08,0.814,0
130,113,59,1920,3,35,0,0,0,628062,46.28,39.1,14.762,16409.288,387.305,10.08,0.814,0
130,114,17,1937,0,35,0,0,0,628062,46.28,39.1,14.762,16409.288,387.305,10.08,0.814,0
130,115,324,2261,4,39,0,0,0,628062,46.28,39.1,14.762,16409.288,387.305,10.08,0.814,0
130,116,308,2569,1,40,0,0,0,628062,46.28,39.1,14.762,16409.288,387.305,10.08,0.814,0
130,117,0,2569,0,40,0,0,0,628062,46.28,39.1,14.762,16409.288,387.305,10.08,0.814,0
130,118,0,2569,0,40,0,0,0,628062,46.28,39.1,14.762,16409.288,387.305,10.08,0.814,0
130,119,324,2893,3,43,0,0,0,628062,46.28,39.1,14.762,16409.288,387.305,10.08,0.814,0
130,120,56,2949,2,45,0,0,0,628062,46.28,39.1,14.762,16409.288,387.305,10.08,0.814,0
130,121,67,3016,2,47,0,0,0,628062,46.28,39.1,14.762,16409.288,387.305,10.08,0.814,0
130,122,57,3073,1,48,0,0,0,628062,46.28,39.1,14.762,16409.288,387.305,10.08,0.814,0
130,123,39,3112,1,49,0,0,0,628062,46.28,39.1,14.762,16409.288,387.305,10.08,0.814,0
130,124,86,3198,1,50,0,0,0,628062,46.28,39.1,14.762,16409.288,387.305,10.08,0.814,0
130,125,60,3258,1,51,0,0,0,628062,46.28,39.1,14.762,16409.288,387.305,10.08,0.814,0
130,126,43,3301,1,52,0,0,0,628062,46.28,39.1,14.762,16409.288,387.305,10.08,0.814,0
130,127,60,3361,1,53,0,0,0,628062,46.28,39.1,14.762,16409.288,387.305,10.08,0.814,0
130,128,50,3411,4,57,0,0,0,628062,46.28,39.1,14.762,16409.288,387.305,10.08,0.814,0
130,129,69,3480,3,60,0,0,0,628062,46.28,39.1,14.762,16409.288,387.305,10.08,0.814,0
130,130,69,3549,1,61,0,0,0,628062,46.28,39.1,14.762,16409.288,387.305,10.08,0.814,0
130,131,39,3588,1,62,0,0,0,628062,46.28,39.1,14.762,16409.288,387.305,10.08,0.814,0
130,132,30,3618,2,64,0,0,0,628062,46.28,39.1,14.762,16409.288,387.305,10.08,0.814,0
130,133,78,3696,4,68,0,0,0,628062,46.28,39.1,14.762,16409.288,387.305,10.08,0.814,0
130,134,52,3748,3,71,0,0,0,628062,46.28,39.1,14.762,16409.288,387.305,10.08,0.814,0
130,135,65,3813,2,73,0,0,0,628062,46.28,39.1,14.762,16409.288,387.305,10.08,0.814,0
130,136,44,3857,0,73,0,0,0,628062,46.28,39.1,14.762,16409.288,387.305,10.08,0.814,0
130,137,73,3930,0,73,0,0,0,628062,46.28,39.1,14.762,16409.288,387.305,10.08,0.814,0
130,138,30,3960,2,75,0,0,0,628062,46.28,39.1,14.762,16409.288,387.305,10.08,0.814,0
130,139,75,4035,2,77,0,0,0,628062,46.28,39.1,14.762,16409.288,387.305,10.08,0.814,0
130,140,50,4085,3,80,0,0,0,628062,46.28,39.1,14.762,16409.288,387.305,10.08,0.814,0
130,141,47,4132,0,80,0,0,0,628062,46.28,39.1,14.762,16409.288,387.305,10.08,0.814,0
130,142,42,4174,0,80,0,0,0,628062,46.28,39.1,14.762,16409.288,387.305,10.08,0.814,0
130,143,55,4229,1,81,0,0,0,628062,46.28,39.1,14.762,16409.288,387.305,10.08,0.814,0
130,144,48,4277,1,82,0,0,0,628062,46.28,39.1,14.762,16409.288,387.305,10.08,0.814,0
130,145,34,4311,2,84,0,0,0,628062,46.28,39.1,14.762,16409.288,387.305,10.08,0.814,0
130,146,32,4343,0,84,0,0,0,628062,46.28,39.1,14.762,16409.288,387.305,10.08,0.814,0
130,147,35,4378,0,84,0,0,0,628062,46.28,39.1,14.762,16409.288,387.305,10.08,0.814,0
130,148,66,4444,3,87,0,0,0,628062,46.28,39.1,14.762,16409.288,387.305,10.08,0.814,0
130,149,55,4499,1,88,0,0,0,628062,46.28,39.1,14.762,16409.288,387.305,10.08,0.814,0
130,150,59,4558,1,89,0,0,0,628062,46.28,39.1,14.762,16409.288,387.305,10.08,0.814,0
130,151,105,4663,3,92,0,0,0,628062,46.28,39.1,14.762,16409.288,387.305,10.08,0.814,0
130,152,64,4727,1,93,0,0,0,628062,46.28,39.1,14.762,16409.288,387.305,10.08,0.814,0
130,153,63,4790,5,98,0,0,0,628062,46.28,39.1,14.762,16409.288,387.305,10.08,0.814,0
130,154,45,4835,2,100,0,0,0,628062,46.28,39.1,14.762,16409.288,387.305,10.08,0.814,0
130,155,82,4917,2,102,0,0,0,628062,46.28,39.1,14.762,16409.288,387.305,10.08,0.814,0
130,156,102,5019,2,104,0,0,0,628062,46.28,39.1,14.762,16409.288,387.305,10.08,0.814,0
130,157,146,5165,0,104,0,0,0,628062,46.28,39.1,14.762,16409.288,387.305,10.08,0.814,0
130,158,110,5275,2,106,0,0,0,628062,46.28,39.1,14.762,16409.288,387.305,10.08,0.814,0
130,159,147,5422,1,107,0,0,0,628062,46.28,39.1,14.762,16409.288,387.305,10.08,0.814,0
130,160,131,5553,1,108,0,0,0,628062,46.28,39.1,14.762,16409.288,387.305,10.08,0.814,0
130,161,106,5659,1,109,0,0,0,628062,46.28,39.1,14.762,16409.288,387.305,10.08,0.814,0
130,162,216,5875,3,112,0,0,0,628062,46.28,39.1,14.762,16409.288,387.305,10.08,0.814,0
130,163,219,6094,2,114,0,0,0,628062,46.28,39.1,14.762,16409.288,387.305,10.08,0.814,0
130,164,128,6222,0,114,0,0,0,628062,46.28,39.1,14.762,16409.288,387.305,10.08,0.814,0
130,165,163,6385,1,115,0,0,0,628062,46.28,39.1,14.762,16409.288,387.305,10.08,0.814,0
130,166,145,6530,3,118,0,0,0,628062,46.28,39.1,14.762,16409.288,387.305,10.08,0.814,0
130,167,182,6712,2,120,0,0,0,628062,46.28,39.1,14.762,16409.288,387.305,10.08,0.814,0
130,168,188,6900,1,121,0,0,0,628062,46.28,39.1,14.762,16409.288,387.305,10.08,0.814,0
130,169,161,7061,2,123,0,0,0,628062,46.28,39.1,14.762,16409.288,387.305,10.08,0.814,0
130,170,230,7291,3,126,0,0,0,628062,46.28,39.1,14.762,16409.288,387.305,10.08,0.814,0
130,171,212,7503,3,129,0,0,0,628062,46.28,39.1,14.762,16409.288,387.305,10.08,0.814,0
130,172,208,7711,4,133,0,0,0,628062,46.28,39.1,14.762,16409.288,387.305,10.08,0.814,0
130,173,187,7898,1,134,0,0,0,628062,46.28,39.1,14.762,16409.288,387.305,10.08,0.814,0
130,174,714,8612,2,136,0,0,0,628062,46.28,39.1,14.762,16409.288,387.305,10.08,0.814,0
130,175,230,8842,2,138,0,0,0,628062,46.28,39.1,14.762,16409.288,387.305,10.08,0.814,0
130,176,296,9138,8,146,0,0,0,628062,46.28,39.1,14.762,16409.288,387.305,10.08,0.814,0
130,177,290,9428,5,151,0,0,0,628062,46.28,39.1,14.762,16409.288,387.305,10.08,0.814,0
130,178,289,9717,3,154,0,0,0,628062,46.28,39.1,14.762,16409.288,387.305,10.08,0.814,0
130,179,245,9962,1,155,0,0,0,628062,46.28,39.1,14.762,16409.288,387.305,10.08,0.814,0
130,180,235,10197,3,158,0,0,0,628062,46.28,39.1,14.762,16409.288,387.305,10.08,0.814,0
130,181,116,10313,0,158,0,0,0,628062,46.28,39.1,14.762,16409.288,387.305,10.08,0.814,0
130,182,128,10441,5,163,0,0,0,628062,46.28,39.1,14.762,16409.288,387.305,10.08,0.814,0
130,183,134,10575,1,164,0,0,0,628062,46.28,39.1,14.762,16409.288,387.305,10.08,0.814,0
130,184,197,10772,5,169,0,0,0,628062,46.28,39.1,14.762,16409.288,387.305,10.08,0.814,0
130,185,215,10987,1,170,0,0,0,628062,46.28,39.1,14.762,16409.288,387.305,10.08,0.814,0
130,186,703,11690,2,172,0,0,0,628062,46.28,39.1,14.762,16409.288,387.305,10.08,0.814,0
130,187,244,11934,2,174,0,0,0,628062,46.28,39.1,14.762,16409.288,387.305,10.08,0.814,0
130,188,193,12127,5,179,0,0,0,628062,46.28,39.1,14.762,16409.288,387.305,10.08,0.814,0
130,189,232,12359,3,182,0,0,0,628062,46.28,39.1,14.762,16409.288,387.305,10.08,0.814,0
130,190,225,12584,6,188,0,0,0,628062,46.28,39.1,14.762,16409.288,387.305,10.08,0.814,0
130,191,210,12794,2,190,0,0,0,628062,46.28,39.1,14.762,16409.288,387.305,10.08,0.814,0
130,192,210,13004,1,191,0,0,0,628062,46.28,39.1,14.762,16409.288,387.305,10.08,0.814,0
130,193,344,13348,3,194,0,0,0,628062,46.28,39.1,14.762,16409.288,387.305,10.08,0.814,0
130,194,293,13641,4,198,0,0,0,628062,46.28,39.1,14.762,16409.288,387.305,10.08,0.814,0
130,195,228,13869,4,202,0,0,0,628062,46.28,39.1,14.762,16409.288,387.305,10.08,0.814,0
130,196,181,14050,9,211,0,0,0,628062,46.28,39.1,14.762,16409.288,387.305,10.08,0.814,0
130,197,218,14268,2,213,0,0,0,628062,46.28,39.1,14.762,16409.288,387.305,10.08,0.814,0
130,198,193,14461,4,217,0,0,0,628062,46.28,39.1,14.762,16409.288,387.305,10.08,0.814,0
130,199,211,14672,4,221,0,0,0,628062,46.28,39.1,14.762,16409.288,387.305,10.08,0.814,0
130,200,609,15281,7,228,0,0,0,628062,46.28,39.1,14.762,16409.288,387.305,10.08,0.814,0
130,201,146,15427,3,231,0,0,0,628062,46.28,39.1,14.762,16409.288,387.305,10.08,0.814,0
130,202,188,15615,5,236,0,0,0,628062,46.28,39.1,14.762,16409.288,387.305,10.08,0.814,0
130,203,145,15760,4,240,0,0,0,628062,46.28,39.1,14.762,16409.288,387.305,10.08,0.814,0
130,204,132,15892,7,247,0,0,0,628062,46.28,39.1,14.762,16409.288,387.305,10.08,0.814,0
132,1,61,617,3,36,445,3345,93.52,36910558,80.08,29.6,6.769,7485.013,419.146,7.14,0.667,4
132,2,37,654,3,39,279,3624,93.52,36910558,80.08,29.6,6.769,7485.013,419.146,7.14,0.667,4
132,3,54,708,5,44,286,3910,93.52,36910558,80.08,29.6,6.769,7485.013,419.146,7.14,0.667,4
132,4,0,708,0,44,411,4321,93.52,36910558,80.08,29.6,6.769,7485.013,419.146,7.14,0.667,4
132,5,211,919,15,59,527,4848,93.52,36910558,80.08,29.6,6.769,7485.013,419.146,7.14,0.667,4
132,6,102,1021,11,70,256,5104,93.52,36910558,80.08,29.6,6.769,7485.013,419.146,7.14,0.667,4
132,7,99,1120,10,80,333,5437,93.52,36910558,80.08,29.6,6.769,7485.013,419.146,7.14,0.667,4
132,8,64,1184,10,90,315,5752,93.52,36910558,80.08,29.6,6.769,7485.013,419.146,7.14,0.667,4
132,9,91,1275,3,93,631,6383,93.52,36910558,80.08,29.6,6.769,7485.013,419.146,7.14,0.667,4
132,10,99,1374,4,97,856,7239,93.52,36910558,80.08,29.6,6.769,7485.013,419.146,7.14,0.667,4
132,11,74,1448,10,107,709,7948,93.52,36910558,80.08,29.6,6.769,7485.013,419.146,7.14,0.667,4
132,12,97,1545,4,111,656,8604,93.52,36910558,80.08,29.6,6.769,7485.013,419.146,7.14,0.667,4
132,13,116,1661,7,118,524,9128,93.52,36910558,80.08,29.6,6.769,7485.013,419.146,7.14,0.667,4
132,14,102,1763,8,126,794,9922,93.52,36910558,80.08,29.6,6.769,7485.013,419.146,7.14,0.667,4
132,15,125,1888,0,126,728,10650,93.52,36910558,80.08,29.6,6.769,7485.013,419.146,7.14,0.667,4
132,16,136,2024,1,127,1346,11996,93.52,36910558,80.08,29.6,6.769,7485.013,419.146,7.14,0.667,4
132,17,259,2283,3,130,956,12952,93.52,36910558,80.08,29.6,6.769,7485.013,419.146,7.14,0.667,4
132,18,281,2564,5,135,737,13689,93.52,36910558,80.08,29.6,6.769,7485.013,419.146,7.14,0.667,4
132,19,121,2685,2,137,1434,15123,93.52,36910558,80.08,29.6,6.769,7485.013,419.146,7.14,0.667,4
132,20,170,2855,4,141,1263,16386,93.52,36910558,80.08,29.6,6.769,7485.013,419.146,7.14,0.667,4
132,21,191,3046,2,143,1714,18100,93.52,36910558,80.08,29.6,6.769,7485.013,419.146,7.14,0.667,4
132,22,163,3209,2,145,1785,19885,93.52,36910558,80.08,29.6,6.769,7485.013,419.146,7.14,0.667,4
132,23,168,3377,4,149,2062,21947,93.52,36910558,80.08,29.6,6.769,7485.013,419.146,7.14,0.667,4
132,24,191,3568,6,155,1986,23933,93.52,36910558,80.08,29.6,6.769,7485.013,419.146,7.14,0.667,4
132,25,190,3758,3,158,1510,25443,93.52,36910558,80.08,29.6,6.769,7485.013,419.146,7.14,0.667,4
132,26,139,3897,1,159,1956,27399,93.52,36910558,80.08,29.6,6.769,7485.013,419.146,7.14,0.667,4
132,27,168,4065,2,161,1855,29254,93.52,36910558,80.08,29.6,6.769,7485.013,419.146,7.14,0.667,4
132,28,55,4120,1,162,1996,31250,93.52,36910558,80.08,29.6,6.769,7485.013,419.146,7.14,0.667,4
132,29,132,4252,3,165,1680,32930,93.52,36910558,80.08,29.6,6.769,7485.013,419.146,7.14,0.667,4
132,30,69,4321,3,168,1911,34841,93.52,36910558,80.08,29.6,6.769,7485.013,419.146,7.14,0.667,4
132,31,102,4423,2,170,2165,37006,93.52,36910558,80.08,29.6,6.769,7485.013,419.146,7.14,0.667,4
132,32,146,4569,1,171,2361,39367,93.52,36910558,80.08,29.6,6.769,7485.013,419.146,7.14,0.667,4
132,33,160,4729,2,173,2745,42112,93.52,36910558,80.08,29.6,6.769,7485.013,419.146,7.14,0.667,4
132,34,174,4903,1,174,3190,45302,93.52,36910558,80.08,29.6,6.769,7485.013,419.146,7.14,0.667,4
132,35,140,5043,5,179,4268,49570,93.52,36910558,80.08,29.6,6.769,7485.013,419.146,7.14,0.667,4
132,36,176,5219,2,181,3388,52958,93.52,36910558,80.08,29.6,6.769,7485.013,419.146,7.14,0.667,4
132,37,189,5408,2,183,3534,56492,93.52,36910558,80.08,29.6,6.769,7485.013,419.146,7.14,0.667,4
132,38,140,5548,0,183,3379,59871,93.52,36910558,80.08,29.6,6.769,7485.013,419.146,7.14,0.667,4
132,39,163,5711,3,186,3188,63059,93.52,36910558,80.08,29.6,6.769,7485.013,419.146,7.14,0.667,4
132,40,199,5910,0,186,2865,65924,93.52,36910558,80.08,29.6,6.769,7485.013,419.146,7.14,0.667,4
132,41,153,6063,2,188,3056,68980,93.52,36910558,80.08,29.6,6.769,7485.013,419.146,7.14,0.667,4
132,42,218,6281,0,188,2835,71815,93.52,36910558,80.08,29.6,6.769,7485.013,419.146,7.14,0.667,4
132,43,137,6418,0,188,4055,75870,93.52,36910558,80.08,29.6,6.769,7485.013,419.146,7.14,0.667,4
132,44,94,6512,0,188,2052,77922,93.52,36910558,80.08,29.6,6.769,7485.013,419.146,7.14,0.667,4
132,45,95,6607,2,190,3694,81616,93.52,36910558,80.08,29.6,6.769,7485.013,419.146,7.14,0.667,4
132,46,45,6652,0,190,3388,85004,93.52,36910558,80.08,29.6,6.769,7485.013,419.146,7.14,0.667,4
132,47,89,6741,2,192,4953,89957,93.52,36910558,80.08,29.6,6.769,7485.013,419.146,7.14,0.667,4
132,48,129,6870,0,192,5579,95536,93.52,36910558,80.08,29.6,6.769,7485.013,419.146,7.14,0.667,4
132,49,82,6952,0,192,4831,100367,93.52,36910558,80.08,29.6,6.769,7485.013,419.146,7.14,0.667,4
132,50,71,7023,1,193,5637,106004,93.52,36910558,80.08,29.6,6.769,7485.013,419.146,7.14,0.667,4
132,51,110,7133,1,194,6993,112997,93.52,36910558,80.08,29.6,6.769,7485.013,419.146,7.14,0.667,4
132,52,78,7211,2,196,10405,123402,93.52,36910558,80.08,29.6,6.769,7485.013,419.146,7.14,0.667,4
132,53,121,7332,1,197,10159,133561,93.52,36910558,80.08,29.6,6.769,7485.013,419.146,7.14,0.667,4
132,54,74,7406,1,198,9321,142882,93.52,36910558,80.08,29.6,6.769,7485.013,419.146,7.14,0.667,4
132,55,27,7433,1,199,9321,152203,93.52,36910558,80.08,29.6,6.769,7485.013,419.146,7.14,0.667,4
132,56,99,7532,1,200,9162,161365,93.52,36910558,80.08,29.6,6.769,7485.013,419.146,7.14,0.667,4
132,57,45,7577,2,202,9348,170713,93.52,36910558,80.08,29.6,6.769,7485.013,419.146,7.14,0.667,4
132,58,24,7601,0,202,9476,180189,93.52,36910558,80.08,29.6,6.769,7485.013,419.146,7.14,0.667,4
132,59,42,7643,0,202,9872,190061,93.52,36910558,80.08,29.6,6.769,7485.013,419.146,7.14,0.667,4
132,60,71,7714,0,202,9937,199998,93.52,36910558,80.08,29.6,6.769,7485.013,419.146,7.14,0.667,4
132,61,66,7780,2,204,9141,209139,93.52,36910558,80.08,29.6,6.769,7485.013,419.146,7.14,0.667,4
132,62,27,7807,1,205,12415,221554,93.52,36910558,80.08,29.6,6.769,7485.013,419.146,7.14,0.667,4
132,63,26,7833,0,205,13097,234651,93.52,36910558,80.08,29.6,6.769,7485.013,419.146,7.14,0.667,4
132,64,33,7866,1,206,13173,247824,93.52,36910558,80.08,29.6,6.769,7485.013,419.146,7.14,0.667,4
132,65,56,7922,0,206,13186,261010,93.52,36910558,80.08,29.6,6.769,7485.013,419.146,7.14,0.667,4
132,66,81,8003,2,208,14339,275349,93.52,36910558,80.08,29.6,6.769,7485.013,419.146,7.14,0.667,4
132,67,68,8071,0,208,14108,289457,93.52,36910558,80.08,29.6,6.769,7485.013,419.146,7.14,0.667,4
132,68,61,8132,0,208,16496,305953,93.52,36910558,80.08,29.6,6.769,7485.013,419.146,7.14,0.667,4
132,69,92,8224,0,208,16750,322703,93.52,36910558,80.08,29.6,6.769,7485.013,419.146,7.14,0.667,4
132,70,78,8302,0,208,16868,339571,93.52,36910558,80.08,29.6,6.769,7485.013,419.146,7.14,0.667,4
132,71,135,8437,2,210,16480,356051,93.52,36910558,80.08,29.6,6.769,7485.013,419.146,7.14,0.667,4
132,72,18,8455,0,210,16540,372591,76.85,36910558,80.08,29.6,6.769,7485.013,419.146,7.14,0.667,4
132,73,82,8537,1,211,16551,389142,76.85,36910558,80.08,29.6,6.769,7485.013,419.146,7.14,0.667,4
132,74,73,8610,1,212,16756,405898,76.85,36910558,80.08,29.6,6.769,7485.013,419.146,7.14,0.667,4
132,75,82,8692,0,212,16622,422520,76.85,36910558,80.08,29.6,6.769,7485.013,419.146,7.14,0.667,4
132,76,42,8734,0,212,16752,439272,76.85,36910558,80.08,29.6,6.769,7485.013,419.146,7.14,0.667,4
132,77,104,8838,0,212,16496,455768,76.85,36910558,80.08,29.6,6.769,7485.013,419.146,7.14,0.667,4
132,78,83,8921,0,212,15968,471736,76.85,36910558,80.08,29.6,6.769,7485.013,419.146,7.14,0.667,4
132,79,76,8997,1,213,17211,488947,76.85,36910558,80.08,29.6,6.769,7485.013,419.146,7.14,0.667,4
132,80,77,9074,0,213,16689,505636,76.85,36910558,80.08,29.6,6.769,7485.013,419.146,7.14,0.667,4
132,81,539,9613,0,213,16530,522166,76.85,36910558,80.08,29.6,6.769,7485.013,419.146,7.14,0.667,4
132,82,188,9801,0,213,16025,538191,74.07,36910558,80.08,29.6,6.769,7485.013,419.146,7.14,0.667,4
132,83,176,9977,1,214,18504,556695,74.07,36910558,80.08,29.6,6.769,7485.013,419.146,7.14,0.667,4
132,84,195,10172,0,214,18481,575176,74.07,36910558,80.08,29.6,6.769,7485.013,419.146,7.14,0.667,4
132,85,92,10264,0,214,16581,591757,64.81,36910558,80.08,29.6,6.769,7485.013,419.146,7.14,0.667,4
132,86,643,10907,2,216,0,591757,64.81,36910558,80.08,29.6,6.769,7485.013,419.146,7.14,0.667,4
132,87,431,11338,1,217,0,620435,64.81,36910558,80.08,29.6,6.769,7485.013,419.146,7.14,0.667,4
132,88,295,11633,1,218,13059,633494,64.81,36910558,80.08,29.6,6.769,7485.013,419.146,7.14,0.667,4
132,89,244,11877,2,220,12701,646195,64.81,36910558,80.08,29.6,6.769,7485.013,419.146,7.14,0.667,4
132,90,175,12052,1,221,16619,662814,64.81,36910558,80.08,29.6,6.769,7485.013,419.146,7.14,0.667,4
132,91,238,12290,4,225,18377,681191,64.81,36910558,80.08,29.6,6.769,7485.013,419.146,7.14,0.667,4
132,92,243,12533,3,228,16937,698128,64.81,36910558,80.08,29.6,6.769,7485.013,419.146,7.14,0.667,4
132,93,103,12636,0,228,17725,715853,64.81,36910558,80.08,29.6,6.769,7485.013,419.146,7.14,0.667,4
132,94,333,12969,1,229,16641,732494,64.81,36910558,80.08,29.6,6.769,7485.013,419.146,7.14,0.667,4
132,95,319,13288,1,230,15955,748449,64.81,36910558,80.08,29.6,6.769,7485.013,419.146,7.14,0.667,4
132,96,534,13822,2,232,17131,765580,64.81,36910558,80.08,29.6,6.769,7485.013,419.146,7.14,0.667,4
132,97,393,14215,3,235,18059,783639,64.81,36910558,80.08,29.6,6.769,7485.013,419.146,7.14,0.667,4
132,98,114,14329,0,235,17690,801329,64.81,36910558,80.08,29.6,6.769,7485.013,419.146,7.14,0.667,4
132,99,0,14329,0,235,17795,819124,64.81,36910558,80.08,29.6,6.769,7485.013,419.146,7.14,0.667,4
132,100,442,14771,7,242,16140,835264,64.81,36910558,80.08,29.6,6.769,7485.013,419.146,7.14,0.667,4
132,101,178,14949,0,242,13833,849097,64.81,36910558,80.08,29.6,6.769,7485.013,419.146,7.14,0.667,4
132,102,379,15328,1,243,15497,864594,64.81,36910558,80.08,29.6,6.769,7485.013,419.146,7.14,0.667,4
132,103,214,15542,2,245,14032,878626,64.81,36910558,80.08,29.6,6.769,7485.013,419.146,7.14,0.667,4
132,104,203,15745,5,250,18012,896638,64.81,36910558,80.08,29.6,6.769,7485.013,419.146,7.14,0.667,4
132,105,191,15936,5,255,18502,915140,64.81,36910558,80.08,29.6,6.769,7485.013,419.146,7.14,0.667,4
132,106,161,16097,2,257,18908,934048,64.81,36910558,80.08,29.6,6.769,7485.013,419.146,7.14,0.667,4
132,107,165,16262,2,259,19667,953715,64.81,36910558,80.08,29.6,6.769,7485.013,419.146,7.14,0.667,4
132,108,162,16424,1,260,19689,973404,64.81,36910558,80.08,29.6,6.769,7485.013,419.146,7.14,0.667,4
132,109,302,16726,4,264,17110,990514,64.81,36910558,80.08,29.6,6.769,7485.013,419.146,7.14,0.667,4
132,110,289,17015,5,269,18812,1009326,64.81,36910558,80.08,29.6,6.769,7485.013,419.146,7.14,0.667,4
132,111,221,17236,4,273,18447,1027773,64.81,36910558,80.08,29.6,6.769,7485.013,419.146,7.14,0.667,4
132,112,326,17562,3,276,19033,1046806,64.81,36910558,80.08,29.6,6.769,7485.013,419.146,7.14,0.667,4
132,113,180,17742,4,280,19027,1065833,64.81,36910558,80.08,29.6,6.769,7485.013,419.146,7.14,0.667,4
132,114,220,17962,5,285,19657,1085490,64.81,36910558,80.08,29.6,6.769,7485.013,419.146,7.14,0.667,4
132,115,302,18264,7,292,19781,1105271,64.81,36910558,80.08,29.6,6.769,7485.013,419.146,7.14,0.667,4
132,116,570,18834,7,299,20942,1126213,64.81,36910558,80.08,29.6,6.769,7485.013,419.146,7.14,0.667,4
132,117,811,19645,6,305,20960,1147173,64.81,36910558,80.08,29.6,6.769,7485.013,419.146,7.14,0.667,4
132,118,633,20278,8,313,20940,1168113,64.81,36910558,80.08,29.6,6.769,7485.013,419.146,7.14,0.667,4
132,119,609,20887,3,316,20688,1188801,64.81,36910558,80.08,29.6,6.769,7485.013,419.146,7.14,0.667,4
132,120,500,21387,11,327,21234,1210035,64.81,36910558,80.08,29.6,6.769,7485.013,419.146,7.14,0.667,4
132,121,826,22213,7,334,21160,1231195,64.81,36910558,80.08,29.6,6.769,7485.013,419.146,7.14,0.667,4
132,122,1046,23259,12,346,21170,1252365,64.81,36910558,80.08,29.6,6.769,7485.013,419.146,7.14,0.667,4
132,123,1063,24322,7,353,21574,1273939,64.81,36910558,80.08,29.6,6.769,7485.013,419.146,7.14,0.667,4
132,124,693,25015,14,367,21255,1295194,64.81,36910558,80.08,29.6,6.769,7485.013,419.146,7.14,0.667,4
132,125,522,25537,15,382,21667,1316861,64.81,36910558,80.08,29.6,6.769,7485.013,419.146,7.14,0.667,4
132,126,659,26196,19,401,22128,1338989,64.81,36910558,80.08,29.6,6.769,7485.013,419.146,7.14,0.667,4
132,127,1021,27217,16,417,22561,1361550,70.37,36910558,80.08,29.6,6.769,7485.013,419.146,7.14,0.667,4
132,128,1283,28500,18,435,22266,1383816,70.37,36910558,80.08,29.6,6.769,7485.013,419.146,7.14,0.667,4
132,129,1144,29644,14,449,21343,1405159,70.37,36910558,80.08,29.6,6.769,7485.013,419.146,7.14,0.667,4
132,130,1018,30662,12,461,22476,1427635,70.37,36910558,80.08,29.6,6.769,7485.013,419.146,7.14,0.667,4
132,131,1345,32007,19,480,22333,1449968,70.37,36910558,80.08,29.6,6.769,7485.013,419.146,7.14,0.667,4
132,132,1230,33237,18,498,22127,1472095,70.37,36910558,80.08,29.6,6.769,7485.013,419.146,7.14,0.667,4
132,133,826,34063,18,516,22001,1494096,70.37,36910558,80.08,29.6,6.769,7485.013,419.146,7.14,0.667,4
132,134,1132,35195,17,533,22306,1516402,70.37,36910558,80.08,29.6,6.769,7485.013,419.146,7.14,0.667,4
132,135,1499,36694,23,556,22118,1538520,70.37,36910558,80.08,29.6,6.769,7485.013,419.146,7.14,0.667,4
132,136,1241,37935,28,584,22007,1560527,70.37,36910558,80.08,29.6,6.769,7485.013,419.146,7.14,0.667,4
132,137,1306,39241,27,611,22707,1583234,70.37,36910558,80.08,29.6,6.769,7485.013,419.146,7.14,0.667,4
132,138,1776,41017,21,632,22379,1605613,70.37,36910558,80.08,29.6,6.769,7485.013,419.146,7.14,0.667,4
132,139,1472,42489,26,658,21197,1626810,70.37,36910558,80.08,29.6,6.769,7485.013,419.146,7.14,0.667,4
132,140,1069,43558,0,658,21918,1648728,70.37,36910558,80.08,29.6,6.769,7485.013,419.146,7.14,0.667,4
132,141,0,43558,23,681,21841,1670569,70.37,36910558,80.08,29.6,6.769,7485.013,419.146,7.14,0.667,4
132,142,2755,46313,62,743,21836,1692405,70.37,36910558,80.08,29.6,6.769,7485.013,419.146,7.14,0.667,4
132,143,1325,47638,32,775,22178,1714583,70.37,36910558,80.08,29.6,6.769,7485.013,419.146,7.14,0.667,4
132,144,1609,49247,42,817,22393,1736976,70.37,36910558,80.08,29.6,6.769,7485.013,419.146,7.14,0.667,4
132,145,1565,50812,41,858,21894,1758870,70.37,36910558,80.08,29.6,6.769,7485.013,419.146,7.14,0.667,4
132,146,0,50812,0,858,21110,1779980,70.37,36910558,80.08,29.6,6.769,7485.013,419.146,7.14,0.667,4
132,147,2440,53252,62,920,22190,1802170,70.37,36910558,80.08,29.6,6.769,7485.013,419.146,7.14,0.667,4
132,148,1276,54528,35,955,22081,1824251,70.37,36910558,80.08,29.6,6.769,7485.013,419.146,7.14,0.667,4
132,149,1336,55864,29,984,22009,1846260,70.37,36910558,80.08,29.6,6.769,7485.013,419.146,7.14,0.667,4
132,150,1221,57085,27,1011,22285,1868545,70.37,36910558,80.08,29.6,6.769,7485.013,419.146,7.14,0.667,4
132,151,1404,58489,41,1052,22419,1890964,70.37,36910558,80.08,29.6,6.769,7485.013,419.146,7.14,0.667,4
132,152,1567,60056,26,1078,22001,1912965,70.37,36910558,80.08,29.6,6.769,7485.013,419.146,7.14,0.667,4
132,153,1343,61399,33,1111,21369,1934334,70.37,36910558,80.08,29.6,6.769,7485.013,419.146,7.14,0.667,4
132,154,1191,62590,30,1141,22082,1956416,70.37,36910558,80.08,29.6,6.769,7485.013,419.146,7.14,0.667,4
132,155,1191,63781,43,1184,22424,1978840,70.37,36910558,80.08,29.6,6.769,7485.013,419.146,7.14,0.667,4
132,156,1672,65453,32,1216,22284,2001124,70.37,36910558,80.08,29.6,6.769,7485.013,419.146,7.14,0.667,4
132,157,402,65855,37,1253,22802,2023926,70.37,36910558,80.08,29.6,6.769,7485.013,419.146,7.14,0.667,4
132,158,0,65855,0,1253,22570,2046496,70.37,36910558,80.08,29.6,6.769,7485.013,419.146,7.14,0.667,4
132,159,4305,70160,76,1329,23557,2070053,70.37,36910558,80.08,29.6,6.769,7485.013,419.146,7.14,0.667,4
132,160,2234,72394,32,1361,22238,2092291,70.37,36910558,80.08,29.6,6.769,7485.013,419.146,7.14,0.667,4
132,161,1386,73780,33,1394,23099,2115390,68.52,36910558,80.08,29.6,6.769,7485.013,419.146,7.14,0.667,4
132,162,1941,75721,33,1427,22774,2138164,68.52,36910558,80.08,29.6,6.769,7485.013,419.146,7.14,0.667,4
132,163,2157,77878,26,1453,22634,2160798,68.52,36910558,80.08,29.6,6.769,7485.013,419.146,7.14,0.667,4
132,164,1889,79767,38,1491,23468,2184266,68.52,36910558,80.08,29.6,6.769,7485.013,419.146,7.14,0.667,4
132,165,2430,82197,33,1524,23130,2207396,68.52,36910558,80.08,29.6,6.769,7485.013,419.146,7.14,0.667,4
132,166,2238,84435,29,1553,22673,2230069,68.52,36910558,80.08,29.6,6.769,7485.013,419.146,7.14,0.667,4
132,167,2251,86686,25,1578,21694,2251763,65.74,36910558,80.08,29.6,6.769,7485.013,419.146,7.14,0.667,4
132,168,1517,88203,36,1614,22279,2274042,65.74,36910558,80.08,29.6,6.769,7485.013,419.146,7.14,0.667,4
132,169,2121,90324,34,1648,21769,2295811,65.74,36910558,80.08,29.6,6.769,7485.013,419.146,7.14,0.667,4
132,170,1692,92016,38,1686,0,2295811,65.74,36910558,80.08,29.6,6.769,7485.013,419.146,7.14,0.667,4
132,171,2488,94504,28,1714,0,2342307,65.74,36910558,80.08,29.6,6.769,7485.013,419.146,7.14,0.667,4
132,172,2760,97264,41,1755,23874,2366181,65.74,36910558,80.08,29.6,6.769,7485.013,419.146,7.14,0.667,4
132,173,2552,99816,40,1795,22934,2389115,65.74,36910558,80.08,29.6,6.769,7485.013,419.146,7.14,0.667,4
132,174,1927,101743,35,1830,21461,2410576,65.74,36910558,80.08,29.6,6.769,7485.013,419.146,7.14,0.667,4
132,175,1376,103119,25,1855,23293,2433869,65.74,36910558,80.08,29.6,6.769,7485.013,419.146,7.14,0.667,4
132,176,2227,105346,34,1889,23504,2457373,65.74,36910558,80.08,29.6,6.769,7485.013,419.146,7.14,0.667,4
132,177,2397,107743,29,1918,23778,2481151,65.74,36910558,80.08,29.6,6.769,7485.013,419.146,7.14,0.667,4
132,178,2356,110099,38,1956,24000,2505151,65.74,36910558,80.08,29.6,6.769,7485.013,419.146,7.14,0.667,4
132,179,2423,112522,42,1998,24246,2529397,65.74,36910558,80.08,29.6,6.769,7485.013,419.146,7.14,0.667,4
132,180,2719,115241,43,2041,23953,2553350,65.74,36910558,80.08,29.6,6.769,7485.013,419.146,7.14,0.667,4
132,181,2444,117685,28,2069,22307,2575657,65.74,36910558,80.08,29.6,6.769,7485.013,419.146,7.14,0.667,4
132,182,1422,119107,44,2113,22829,2598486,65.74,36910558,80.08,29.6,6.769,7485.013,419.146,7.14,0.667,4
132,183,2076,121183,39,2152,22828,2621314,65.74,36910558,80.08,29.6,6.769,7485.013,419.146,7.14,0.667,4
132,184,2470,123653,42,2194,22546,2643860,65.74,36910558,80.08,29.6,6.769,7485.013,419.146,7.14,0.667,4
132,185,2391,126044,35,2229,22598,2666458,65.74,36910558,80.08,29.6,6.769,7485.013,419.146,7.14,0.667,4
132,186,2521,128565,34,2263,22678,2689136,65.74,36910558,80.08,29.6,6.769,7485.013,419.146,7.14,0.667,4
132,187,2663,131228,30,2293,22067,2711203,65.74,36910558,80.08,29.6,6.769,7485.013,419.146,7.14,0.667,4
132,188,2044,133272,37,2330,20704,2731907,65.74,36910558,80.08,29.6,6.769,7485.013,419.146,7.14,0.667,4
132,189,1423,134695,39,2369,21975,2753882,65.74,36910558,80.08,29.6,6.769,7485.013,419.146,7.14,0.667,4
132,190,2553,137248,41,2410,24483,2778365,65.74,36910558,80.08,29.6,6.769,7485.013,419.146,7.14,0.667,4
132,191,2776,140024,29,2439,25126,2803491,65.74,36910558,80.08,29.6,6.769,7485.013,419.146,7.14,0.667,4
132,192,2929,142953,47,2486,25162,2828653,65.74,36910558,80.08,29.6,6.769,7485.013,419.146,7.14,0.667,4
132,193,3445,146398,44,2530,25131,2853784,65.74,36910558,80.08,29.6,6.769,7485.013,419.146,7.14,0.667,4
132,194,0,146398,0,2530,23718,2877502,65.74,36910558,80.08,29.6,6.769,7485.013,419.146,7.14,0.667,4
132,195,3443,149841,42,2572,20309,2897811,65.74,36910558,80.08,29.6,6.769,7485.013,419.146,7.14,0.667,4
132,196,3920,153761,64,2636,24200,2922011,65.74,36910558,80.08,29.6,6.769,7485.013,419.146,7.14,0.667,4
132,197,3185,156946,49,2685,24448,2946459,65.74,36910558,80.08,29.6,6.769,7485.013,419.146,7.14,0.667,4
132,198,3387,160333,41,2726,23428,2969887,65.74,36910558,80.08,29.6,6.769,7485.013,419.146,7.14,0.667,4
132,199,3317,163650,46,2772,23601,2993488,65.74,36910558,80.08,29.6,6.769,7485.013,419.146,7.14,0.667,4
132,200,3498,167148,46,2818,24000,3017488,65.74,36910558,80.08,29.6,6.769,7485.013,419.146,7.14,0.667,4
132,201,3763,170911,60,2878,22693,3040181,65.74,36910558,80.08,29.6,6.769,7485.013,419.146,7.14,0.667,4
132,202,2721,173632,50,2928,0,3040181,65.74,36910558,80.08,29.6,6.769,7485.013,419.146,7.14,0.667,4
132,203,2117,175749,48,2976,0,3040181,65.74,36910558,80.08,29.6,6.769,7485.013,419.146,7.14,0.667,4
132,204,3254,179003,51,3027,0,3040181,65.74,36910558,80.08,29.6,6.769,7485.013,419.146,7.14,0.667,4
133,1,0,8,0,0,19,288,56.48,31255435,37.728,17.7,3.158,1136.103,329.942,3.3,0.437,4
133,2,2,10,0,0,18,306,56.48,31255435,37.728,17.7,3.158,1136.103,329.942,3.3,0.437,4
133,3,0,10,0,0,15,321,56.48,31255435,37.728,17.7,3.158,1136.103,329.942,3.3,0.437,4
133,4,0,10,0,0,24,345,56.48,31255435,37.728,17.7,3.158,1136.103,329.942,3.3,0.437,4
133,5,0,10,0,0,22,367,56.48,31255435,37.728,17.7,3.158,1136.103,329.942,3.3,0.437,4
133,6,0,10,0,0,4,371,56.48,31255435,37.728,17.7,3.158,1136.103,329.942,3.3,0.437,4
133,7,0,10,0,0,57,428,56.48,31255435,37.728,17.7,3.158,1136.103,329.942,3.3,0.437,4
133,8,0,10,0,0,43,471,56.48,31255435,37.728,17.7,3.158,1136.103,329.942,3.3,0.437,4
133,9,7,17,0,0,16,487,56.48,31255435,37.728,17.7,3.158,1136.103,329.942,3.3,0.437,4
133,10,0,17,0,0,54,541,56.48,31255435,37.728,17.7,3.158,1136.103,329.942,3.3,0.437,4
133,11,3,20,0,0,10,551,56.48,31255435,37.728,17.7,3.158,1136.103,329.942,3.3,0.437,4
133,12,0,20,0,0,128,679,56.48,31255435,37.728,17.7,3.158,1136.103,329.942,3.3,0.437,4
133,13,1,21,0,0,4,683,56.48,31255435,37.728,17.7,3.158,1136.103,329.942,3.3,0.437,4
133,14,6,27,0,0,79,762,56.48,31255435,37.728,17.7,3.158,1136.103,329.942,3.3,0.437,4
133,15,1,28,0,0,31,793,56.48,31255435,37.728,17.7,3.158,1136.103,329.942,3.3,0.437,4
133,16,1,29,0,0,62,855,56.48,31255435,37.728,17.7,3.158,1136.103,329.942,3.3,0.437,4
133,17,2,31,0,0,43,898,56.48,31255435,37.728,17.7,3.158,1136.103,329.942,3.3,0.437,4
133,18,3,34,0,0,54,952,56.48,31255435,37.728,17.7,3.158,1136.103,329.942,3.3,0.437,4
133,19,1,35,0,0,85,1037,56.48,31255435,37.728,17.7,3.158,1136.103,329.942,3.3,0.437,4
133,20,4,39,0,0,73,1110,56.48,31255435,37.728,17.7,3.158,1136.103,329.942,3.3,0.437,4
133,21,0,39,0,0,53,1163,56.48,31255435,37.728,17.7,3.158,1136.103,329.942,3.3,0.437,4
133,22,0,39,0,0,84,1247,56.48,31255435,37.728,17.7,3.158,1136.103,329.942,3.3,0.437,4
133,23,2,41,0,0,78,1325,56.48,31255435,37.728,17.7,3.158,1136.103,329.942,3.3,0.437,4
133,24,5,46,0,0,114,1439,56.48,31255435,37.728,17.7,3.158,1136.103,329.942,3.3,0.437,4
133,25,19,65,0,0,136,1575,56.48,31255435,37.728,17.7,3.158,1136.103,329.942,3.3,0.437,4
133,26,5,70,0,0,69,1644,56.48,31255435,37.728,17.7,3.158,1136.103,329.942,3.3,0.437,4
133,27,6,76,0,0,44,1688,56.48,31255435,37.728,17.7,3.158,1136.103,329.942,3.3,0.437,4
133,28,0,76,0,0,84,1772,56.48,31255435,37.728,17.7,3.158,1136.103,329.942,3.3,0.437,4
133,29,0,76,0,0,124,1896,56.48,31255435,37.728,17.7,3.158,1136.103,329.942,3.3,0.437,4
133,30,0,76,0,0,180,2076,56.48,31255435,37.728,17.7,3.158,1136.103,329.942,3.3,0.437,4
133,31,0,76,0,0,170,2246,56.48,31255435,37.728,17.7,3.158,1136.103,329.942,3.3,0.437,4
133,32,3,79,0,0,91,2337,56.48,31255435,37.728,17.7,3.158,1136.103,329.942,3.3,0.437,4
133,33,0,79,0,0,129,2466,56.48,31255435,37.728,17.7,3.158,1136.103,329.942,3.3,0.437,4
133,34,1,80,0,0,132,2598,56.48,31255435,37.728,17.7,3.158,1136.103,329.942,3.3,0.437,4
133,35,0,80,0,0,269,2867,56.48,31255435,37.728,17.7,3.158,1136.103,329.942,3.3,0.437,4
133,36,1,81,0,0,174,3041,56.48,31255435,37.728,17.7,3.158,1136.103,329.942,3.3,0.437,4
133,37,0,81,0,0,147,3188,56.48,31255435,37.728,17.7,3.158,1136.103,329.942,3.3,0.437,4
133,38,0,81,0,0,168,3356,56.48,31255435,37.728,17.7,3.158,1136.103,329.942,3.3,0.437,4
133,39,1,82,0,0,393,3749,56.48,31255435,37.728,17.7,3.158,1136.103,329.942,3.3,0.437,4
133,40,5,87,0,0,174,3923,56.48,31255435,37.728,17.7,3.158,1136.103,329.942,3.3,0.437,4
133,41,4,91,0,0,250,4173,56.48,31255435,37.728,17.7,3.158,1136.103,329.942,3.3,0.437,4
133,42,12,103,0,0,192,4365,56.48,31255435,37.728,17.7,3.158,1136.103,329.942,3.3,0.437,4
133,43,1,104,0,0,375,4740,56.48,31255435,37.728,17.7,3.158,1136.103,329.942,3.3,0.437,4
133,44,3,107,0,0,379,5119,56.48,31255435,37.728,17.7,3.158,1136.103,329.942,3.3,0.437,4
133,45,8,115,0,0,242,5361,56.48,31255435,37.728,17.7,3.158,1136.103,329.942,3.3,0.437,4
133,46,4,119,0,0,374,5735,56.48,31255435,37.728,17.7,3.158,1136.103,329.942,3.3,0.437,4
133,47,10,129,0,0,276,6011,56.48,31255435,37.728,17.7,3.158,1136.103,329.942,3.3,0.437,4
133,48,8,137,0,0,261,6272,56.48,31255435,37.728,17.7,3.158,1136.103,329.942,3.3,0.437,4
133,49,8,145,0,0,265,6537,56.48,31255435,37.728,17.7,3.158,1136.103,329.942,3.3,0.437,4
133,50,1,146,0,0,232,6769,56.48,31255435,37.728,17.7,3.158,1136.103,329.942,3.3,0.437,4
133,51,10,156,0,0,294,7063,56.48,31255435,37.728,17.7,3.158,1136.103,329.942,3.3,0.437,4
133,52,6,162,0,0,417,7480,56.48,31255435,37.728,17.7,3.158,1136.103,329.942,3.3,0.437,4
133,53,2,164,0,0,467,7947,56.48,31255435,37.728,17.7,3.158,1136.103,329.942,3.3,0.437,4
133,54,4,168,0,0,516,8463,56.48,31255435,37.728,17.7,3.158,1136.103,329.942,3.3,0.437,4
133,55,26,194,0,0,333,8796,56.48,31255435,37.728,17.7,3.158,1136.103,329.942,3.3,0.437,4
133,56,15,209,1,1,240,9036,56.48,31255435,37.728,17.7,3.158,1136.103,329.942,3.3,0.437,4
133,57,4,213,0,1,294,9330,56.48,31255435,37.728,17.7,3.158,1136.103,329.942,3.3,0.437,4
133,58,14,227,0,1,488,9818,56.48,31255435,37.728,17.7,3.158,1136.103,329.942,3.3,0.437,4
133,59,6,233,1,2,416,10234,62.04,31255435,37.728,17.7,3.158,1136.103,329.942,3.3,0.437,4
133,60,1,234,0,2,27,10261,62.04,31255435,37.728,17.7,3.158,1136.103,329.942,3.3,0.437,4
133,61,10,244,0,2,617,10878,62.04,31255435,37.728,17.7,3.158,1136.103,329.942,3.3,0.437,4
133,62,10,254,0,2,92,10970,62.04,31255435,37.728,17.7,3.158,1136.103,329.942,3.3,0.437,4
133,63,0,254,0,2,269,11239,62.04,31255435,37.728,17.7,3.158,1136.103,329.942,3.3,0.437,4
133,64,53,307,0,2,333,11572,62.04,31255435,37.728,17.7,3.158,1136.103,329.942,3.3,0.437,4
133,65,9,316,0,2,554,12126,62.04,31255435,37.728,17.7,3.158,1136.103,329.942,3.3,0.437,4
133,66,36,352,0,2,217,12343,62.04,31255435,37.728,17.7,3.158,1136.103,329.942,3.3,0.437,4
133,67,2,354,0,2,1055,13398,62.04,31255435,37.728,17.7,3.158,1136.103,329.942,3.3,0.437,4
133,68,57,411,0,2,612,14010,62.04,31255435,37.728,17.7,3.158,1136.103,329.942,3.3,0.437,4
133,69,15,426,0,2,570,14580,62.04,31255435,37.728,17.7,3.158,1136.103,329.942,3.3,0.437,4
133,70,7,433,0,2,610,15190,62.04,31255435,37.728,17.7,3.158,1136.103,329.942,3.3,0.437,4
133,71,20,453,0,2,354,15544,62.04,31255435,37.728,17.7,3.158,1136.103,329.942,3.3,0.437,4
133,72,19,472,0,2,491,16035,62.04,31255435,37.728,17.7,3.158,1136.103,329.942,3.3,0.437,4
133,73,17,489,0,2,884,16919,62.04,31255435,37.728,17.7,3.158,1136.103,329.942,3.3,0.437,4
133,74,20,509,0,2,1142,18061,62.04,31255435,37.728,17.7,3.158,1136.103,329.942,3.3,0.437,4
133,75,44,553,0,2,559,18620,62.04,31255435,37.728,17.7,3.158,1136.103,329.942,3.3,0.437,4
133,76,30,583,1,3,961,19581,62.04,31255435,37.728,17.7,3.158,1136.103,329.942,3.3,0.437,4
133,77,26,609,0,3,682,20263,62.04,31255435,37.728,17.7,3.158,1136.103,329.942,3.3,0.437,4
133,78,29,638,1,4,751,21014,80.56,31255435,37.728,17.7,3.158,1136.103,329.942,3.3,0.437,4
133,79,13,651,0,4,766,21780,80.56,31255435,37.728,17.7,3.158,1136.103,329.942,3.3,0.437,4
133,80,11,662,0,4,483,22263,80.56,31255435,37.728,17.7,3.158,1136.103,329.942,3.3,0.437,4
133,81,6,668,0,4,841,23104,80.56,31255435,37.728,17.7,3.158,1136.103,329.942,3.3,0.437,4
133,82,20,688,0,4,656,23760,80.56,31255435,37.728,17.7,3.158,1136.103,329.942,3.3,0.437,4
133,83,45,733,1,5,588,24348,80.56,31255435,37.728,17.7,3.158,1136.103,329.942,3.3,0.437,4
133,84,4,737,0,5,694,25042,80.56,31255435,37.728,17.7,3.158,1136.103,329.942,3.3,0.437,4
133,85,20,757,0,5,404,25446,80.56,31255435,37.728,17.7,3.158,1136.103,329.942,3.3,0.437,4
133,86,5,762,0,5,758,26204,80.56,31255435,37.728,17.7,3.158,1136.103,329.942,3.3,0.437,4
133,87,26,788,0,5,919,27123,80.56,31255435,37.728,17.7,3.158,1136.103,329.942,3.3,0.437,4
133,88,28,816,0,5,833,27956,80.56,31255435,37.728,17.7,3.158,1136.103,329.942,3.3,0.437,4
133,89,23,839,0,5,691,28647,80.56,31255435,37.728,17.7,3.158,1136.103,329.942,3.3,0.437,4
133,90,20,859,0,5,757,29404,80.56,31255435,37.728,17.7,3.158,1136.103,329.942,3.3,0.437,4
133,91,24,883,1,6,173,29577,80.56,31255435,37.728,17.7,3.158,1136.103,329.942,3.3,0.437,4
133,92,6,889,0,6,757,30334,80.56,31255435,37.728,17.7,3.158,1136.103,329.942,3.3,0.437,4
133,93,14,903,0,6,605,30939,80.56,31255435,37.728,17.7,3.158,1136.103,329.942,3.3,0.437,4
133,94,15,918,0,6,845,31784,80.56,31255435,37.728,17.7,3.158,1136.103,329.942,3.3,0.437,4
133,95,21,939,0,6,714,32498,80.56,31255435,37.728,17.7,3.158,1136.103,329.942,3.3,0.437,4
133,96,30,969,1,7,627,33125,80.56,31255435,37.728,17.7,3.158,1136.103,329.942,3.3,0.437,4
133,97,18,987,1,8,911,34036,80.56,31255435,37.728,17.7,3.158,1136.103,329.942,3.3,0.437,4
133,98,25,1012,0,8,1104,35140,80.56,31255435,37.728,17.7,3.158,1136.103,329.942,3.3,0.437,4
133,99,28,1040,0,8,556,35696,80.56,31255435,37.728,17.7,3.158,1136.103,329.942,3.3,0.437,4
133,100,31,1071,0,8,1002,36698,80.56,31255435,37.728,17.7,3.158,1136.103,329.942,3.3,0.437,4
133,101,21,1092,1,9,1312,38010,80.56,31255435,37.728,17.7,3.158,1136.103,329.942,3.3,0.437,4
133,102,19,1111,0,9,1081,39091,80.56,31255435,37.728,17.7,3.158,1136.103,329.942,3.3,0.437,4
133,103,24,1135,0,9,1857,40948,80.56,31255435,37.728,17.7,3.158,1136.103,329.942,3.3,0.437,4
133,104,22,1157,0,9,-87,40861,75,31255435,37.728,17.7,3.158,1136.103,329.942,3.3,0.437,4
133,105,62,1219,0,9,884,41745,75,31255435,37.728,17.7,3.158,1136.103,329.942,3.3,0.437,4
133,106,49,1268,0,9,806,42551,75,31255435,37.728,17.7,3.158,1136.103,329.942,3.3,0.437,4
133,107,62,1330,0,9,1143,43694,75,31255435,37.728,17.7,3.158,1136.103,329.942,3.3,0.437,4
133,108,53,1383,0,9,528,44222,75,31255435,37.728,17.7,3.158,1136.103,329.942,3.3,0.437,4
133,109,19,1402,0,9,958,45180,75,31255435,37.728,17.7,3.158,1136.103,329.942,3.3,0.437,4
133,110,33,1435,1,10,1376,46556,75,31255435,37.728,17.7,3.158,1136.103,329.942,3.3,0.437,4
133,111,56,1491,0,10,1231,47787,75,31255435,37.728,17.7,3.158,1136.103,329.942,3.3,0.437,4
133,112,16,1507,1,11,866,48653,75,31255435,37.728,17.7,3.158,1136.103,329.942,3.3,0.437,4
133,113,29,1536,0,11,839,49492,75,31255435,37.728,17.7,3.158,1136.103,329.942,3.3,0.437,4
133,114,21,1557,0,11,629,50121,75,31255435,37.728,17.7,3.158,1136.103,329.942,3.3,0.437,4
133,115,25,1582,0,11,732,50853,75,31255435,37.728,17.7,3.158,1136.103,329.942,3.3,0.437,4
133,116,8,1590,0,11,591,51444,75,31255435,37.728,17.7,3.158,1136.103,329.942,3.3,0.437,4
133,117,26,1616,0,11,978,52422,75,31255435,37.728,17.7,3.158,1136.103,329.942,3.3,0.437,4
133,118,53,1669,0,11,1043,53465,75,31255435,37.728,17.7,3.158,1136.103,329.942,3.3,0.437,4
133,119,32,1701,0,11,616,54081,75,31255435,37.728,17.7,3.158,1136.103,329.942,3.3,0.437,4
133,120,19,1720,0,11,1130,55211,44.44,31255435,37.728,17.7,3.158,1136.103,329.942,3.3,0.437,4
133,121,28,1748,0,11,949,56160,44.44,31255435,37.728,17.7,3.158,1136.103,329.942,3.3,0.437,4
133,122,60,1808,0,11,1570,57730,44.44,31255435,37.728,17.7,3.158,1136.103,329.942,3.3,0.437,4
133,123,56,1864,0,11,1181,58911,44.44,31255435,37.728,17.7,3.158,1136.103,329.942,3.3,0.437,4
133,124,43,1907,0,11,731,59642,44.44,31255435,37.728,17.7,3.158,1136.103,329.942,3.3,0.437,4
133,125,39,1946,2,13,831,60473,44.44,31255435,37.728,17.7,3.158,1136.103,329.942,3.3,0.437,4
133,126,27,1973,1,14,1900,62373,44.44,31255435,37.728,17.7,3.158,1136.103,329.942,3.3,0.437,4
133,127,56,2029,1,15,1352,63725,44.44,31255435,37.728,17.7,3.158,1136.103,329.942,3.3,0.437,4
133,128,50,2079,0,15,1426,65151,44.44,31255435,37.728,17.7,3.158,1136.103,329.942,3.3,0.437,4
133,129,41,2120,0,15,1391,66542,75,31255435,37.728,17.7,3.158,1136.103,329.942,3.3,0.437,4
133,130,93,2213,0,15,861,67403,75,31255435,37.728,17.7,3.158,1136.103,329.942,3.3,0.437,4
133,131,28,2241,1,16,1283,68686,75,31255435,37.728,17.7,3.158,1136.103,329.942,3.3,0.437,4
133,132,28,2269,0,16,1773,70459,75,31255435,37.728,17.7,3.158,1136.103,329.942,3.3,0.437,4
133,133,142,2411,0,16,892,71351,75,31255435,37.728,17.7,3.158,1136.103,329.942,3.3,0.437,4
133,134,70,2481,1,17,1110,72461,75,31255435,37.728,17.7,3.158,1136.103,329.942,3.3,0.437,4
133,135,78,2559,2,19,1018,73479,75,31255435,37.728,17.7,3.158,1136.103,329.942,3.3,0.437,4
133,136,79,2638,0,19,1951,75430,75,31255435,37.728,17.7,3.158,1136.103,329.942,3.3,0.437,4
133,137,70,2708,0,19,1184,76614,75,31255435,37.728,17.7,3.158,1136.103,329.942,3.3,0.437,4
133,138,83,2791,0,19,970,77584,75,31255435,37.728,17.7,3.158,1136.103,329.942,3.3,0.437,4
133,139,64,2855,0,19,1293,78877,75,31255435,37.728,17.7,3.158,1136.103,329.942,3.3,0.437,4
133,140,59,2914,0,19,627,79504,62.5,31255435,37.728,17.7,3.158,1136.103,329.942,3.3,0.437,4
133,141,0,2914,0,19,1409,80913,62.5,31255435,37.728,17.7,3.158,1136.103,329.942,3.3,0.437,4
133,142,131,3045,0,19,1351,82264,62.5,31255435,37.728,17.7,3.158,1136.103,329.942,3.3,0.437,4
133,143,70,3115,1,20,1622,83886,62.5,31255435,37.728,17.7,3.158,1136.103,329.942,3.3,0.437,4
133,144,80,3195,0,20,1251,85137,62.5,31255435,37.728,17.7,3.158,1136.103,329.942,3.3,0.437,4
133,145,109,3304,0,20,1412,86549,62.5,31255435,37.728,17.7,3.158,1136.103,329.942,3.3,0.437,4
133,146,91,3395,0,20,1016,87565,62.5,31255435,37.728,17.7,3.158,1136.103,329.942,3.3,0.437,4
133,147,45,3440,1,21,1593,89158,62.5,31255435,37.728,17.7,3.158,1136.103,329.942,3.3,0.437,4
133,148,68,3508,0,21,1408,90566,62.5,31255435,37.728,17.7,3.158,1136.103,329.942,3.3,0.437,4
133,149,82,3590,0,21,564,91130,62.5,31255435,37.728,17.7,3.158,1136.103,329.942,3.3,0.437,4
133,150,61,3651,0,21,916,92046,62.5,31255435,37.728,17.7,3.158,1136.103,329.942,3.3,0.437,4
133,151,46,3697,0,21,952,92998,62.5,31255435,37.728,17.7,3.158,1136.103,329.942,3.3,0.437,4
133,152,63,3760,1,22,1698,94696,62.5,31255435,37.728,17.7,3.158,1136.103,329.942,3.3,0.437,4
133,153,61,3821,1,23,1691,96387,62.5,31255435,37.728,17.7,3.158,1136.103,329.942,3.3,0.437,4
133,154,95,3916,0,23,2068,98455,62.04,31255435,37.728,17.7,3.158,1136.103,329.942,3.3,0.437,4
133,155,123,4039,0,23,910,99365,62.04,31255435,37.728,17.7,3.158,1136.103,329.942,3.3,0.437,4
133,156,78,4117,2,25,1508,100873,62.04,31255435,37.728,17.7,3.158,1136.103,329.942,3.3,0.437,4
133,157,90,4207,1,26,1015,101888,62.04,31255435,37.728,17.7,3.158,1136.103,329.942,3.3,0.437,4
133,158,58,4265,0,26,568,102456,62.04,31255435,37.728,17.7,3.158,1136.103,329.942,3.3,0.437,4
133,159,76,4341,0,26,1920,104376,62.04,31255435,37.728,17.7,3.158,1136.103,329.942,3.3,0.437,4
133,160,103,4444,1,27,2006,106382,62.04,31255435,37.728,17.7,3.158,1136.103,329.942,3.3,0.437,4
133,161,113,4557,0,27,701,107083,62.04,31255435,37.728,17.7,3.158,1136.103,329.942,3.3,0.437,4
133,162,90,4647,1,28,675,107758,62.04,31255435,37.728,17.7,3.158,1136.103,329.942,3.3,0.437,4
133,163,117,4764,0,28,987,108745,62.04,31255435,37.728,17.7,3.158,1136.103,329.942,3.3,0.437,4
133,164,68,4832,3,31,1565,110310,62.04,31255435,37.728,17.7,3.158,1136.103,329.942,3.3,0.437,4
133,165,86,4918,0,31,1928,112238,62.04,31255435,37.728,17.7,3.158,1136.103,329.942,3.3,0.437,4
133,166,122,5040,4,35,2095,114333,62.04,31255435,37.728,17.7,3.158,1136.103,329.942,3.3,0.437,4
133,167,229,5269,0,35,1255,115588,62.04,31255435,37.728,17.7,3.158,1136.103,329.942,3.3,0.437,4
133,168,213,5482,0,35,1441,117029,62.04,31255435,37.728,17.7,3.158,1136.103,329.942,3.3,0.437,4
133,169,231,5713,2,37,1628,118657,62.04,31255435,37.728,17.7,3.158,1136.103,329.942,3.3,0.437,4
133,170,281,5994,2,39,1032,119689,62.04,31255435,37.728,17.7,3.158,1136.103,329.942,3.3,0.437,4
133,171,167,6161,0,39,1709,121398,62.04,31255435,37.728,17.7,3.158,1136.103,329.942,3.3,0.437,4
133,172,103,6264,1,40,1814,123212,62.04,31255435,37.728,17.7,3.158,1136.103,329.942,3.3,0.437,4
133,173,273,6537,1,41,1573,124785,62.04,31255435,37.728,17.7,3.158,1136.103,329.942,3.3,0.437,4
133,174,234,6771,2,43,848,125633,62.04,31255435,37.728,17.7,3.158,1136.103,329.942,3.3,0.437,4
133,175,141,6912,1,44,1745,127378,62.04,31255435,37.728,17.7,3.158,1136.103,329.942,3.3,0.437,4
133,176,202,7114,1,45,1427,128805,62.04,31255435,37.728,17.7,3.158,1136.103,329.942,3.3,0.437,4
133,177,148,7262,4,49,1255,130060,62.04,31255435,37.728,17.7,3.158,1136.103,329.942,3.3,0.437,4
133,178,137,7399,2,51,1519,131579,62.04,31255435,37.728,17.7,3.158,1136.103,329.942,3.3,0.437,4
133,179,190,7589,2,53,1400,132979,62.04,31255435,37.728,17.7,3.158,1136.103,329.942,3.3,0.437,4
133,180,168,7757,1,54,1032,134011,62.04,31255435,37.728,17.7,3.158,1136.103,329.942,3.3,0.437,4
133,181,226,7983,4,58,1395,135406,62.04,31255435,37.728,17.7,3.158,1136.103,329.942,3.3,0.437,4
133,182,305,8288,1,59,1277,136683,62.04,31255435,37.728,17.7,3.158,1136.103,329.942,3.3,0.437,4
133,183,268,8556,0,59,1703,138386,62.04,31255435,37.728,17.7,3.158,1136.103,329.942,3.3,0.437,4
133,184,172,8728,2,61,1924,140310,62.04,31255435,37.728,17.7,3.158,1136.103,329.942,3.3,0.437,4
133,185,160,8888,1,62,1718,142028,62.04,31255435,37.728,17.7,3.158,1136.103,329.942,3.3,0.437,4
133,186,91,8979,2,64,1253,143281,62.04,31255435,37.728,17.7,3.158,1136.103,329.942,3.3,0.437,4
133,187,70,9049,0,64,1337,144618,62.04,31255435,37.728,17.7,3.158,1136.103,329.942,3.3,0.437,4
133,188,147,9196,2,66,1488,146106,62.04,31255435,37.728,17.7,3.158,1136.103,329.942,3.3,0.437,4
133,189,100,9296,0,66,1352,147458,62.04,31255435,37.728,17.7,3.158,1136.103,329.942,3.3,0.437,4
133,190,102,9398,1,67,1080,148538,62.04,31255435,37.728,17.7,3.158,1136.103,329.942,3.3,0.437,4
133,191,96,9494,1,68,1469,150007,62.04,31255435,37.728,17.7,3.158,1136.103,329.942,3.3,0.437,4
133,192,145,9639,0,68,1806,151813,62.04,31255435,37.728,17.7,3.158,1136.103,329.942,3.3,0.437,4
133,193,103,9742,1,69,1163,152976,62.04,31255435,37.728,17.7,3.158,1136.103,329.942,3.3,0.437,4
133,194,102,9844,1,70,939,153915,62.04,31255435,37.728,17.7,3.158,1136.103,329.942,3.3,0.437,4
133,195,157,10001,1,71,1287,155202,62.04,31255435,37.728,17.7,3.158,1136.103,329.942,3.3,0.437,4
133,196,87,10088,1,72,4132,159334,62.04,31255435,37.728,17.7,3.158,1136.103,329.942,3.3,0.437,4
133,197,170,10258,1,73,1388,160722,62.04,31255435,37.728,17.7,3.158,1136.103,329.942,3.3,0.437,4
133,198,134,10392,0,73,1613,162335,62.04,31255435,37.728,17.7,3.158,1136.103,329.942,3.3,0.437,4
133,199,145,10537,0,73,2026,164361,62.04,31255435,37.728,17.7,3.158,1136.103,329.942,3.3,0.437,4
133,200,75,10612,0,73,1310,165671,62.04,31255435,37.728,17.7,3.158,1136.103,329.942,3.3,0.437,4
133,201,95,10707,1,74,1380,167051,62.04,31255435,37.728,17.7,3.158,1136.103,329.942,3.3,0.437,4
133,202,159,10866,1,75,0,167051,62.04,31255435,37.728,17.7,3.158,1136.103,329.942,3.3,0.437,4
133,203,214,11080,0,75,0,167051,62.04,31255435,37.728,17.7,3.158,1136.103,329.942,3.3,0.437,4
133,204,110,11190,3,78,0,167051,62.04,31255435,37.728,17.7,3.158,1136.103,329.942,3.3,0.437,4
134,1,1,15,1,1,0,0,65.74,54409794,81.721,29.1,5.732,5591.597,202.104,4.61,0.578,4
134,2,1,16,0,1,0,0,65.74,54409794,81.721,29.1,5.732,5591.597,202.104,4.61,0.578,4
134,3,4,20,0,1,0,1183,65.74,54409794,81.721,29.1,5.732,5591.597,202.104,4.61,0.578,4
134,4,0,20,0,1,63,1246,69.44,54409794,81.721,29.1,5.732,5591.597,202.104,4.61,0.578,4
134,5,1,21,0,1,0,1246,69.44,54409794,81.721,29.1,5.732,5591.597,202.104,4.61,0.578,4
134,6,0,21,0,1,0,1340,69.44,54409794,81.721,29.1,5.732,5591.597,202.104,4.61,0.578,4
134,7,1,22,0,1,0,1340,77.78,54409794,81.721,29.1,5.732,5591.597,202.104,4.61,0.578,4
134,8,0,22,0,1,0,1406,77.78,54409794,81.721,29.1,5.732,5591.597,202.104,4.61,0.578,4
134,9,0,22,2,3,137,1543,77.78,54409794,81.721,29.1,5.732,5591.597,202.104,4.61,0.578,4
134,10,5,27,0,3,76,1619,79.63,54409794,81.721,29.1,5.732,5591.597,202.104,4.61,0.578,4
134,11,1,28,0,3,230,1849,79.63,54409794,81.721,29.1,5.732,5591.597,202.104,4.61,0.578,4
134,12,3,31,0,3,285,2134,81.48,54409794,81.721,29.1,5.732,5591.597,202.104,4.61,0.578,4
134,13,10,41,1,4,309,2443,81.48,54409794,81.721,29.1,5.732,5591.597,202.104,4.61,0.578,4
134,14,21,62,0,4,360,2803,83.33,54409794,81.721,29.1,5.732,5591.597,202.104,4.61,0.578,4
134,15,12,74,0,4,433,3236,83.33,54409794,81.721,29.1,5.732,5591.597,202.104,4.61,0.578,4
134,16,0,74,0,4,0,3236,83.33,54409794,81.721,29.1,5.732,5591.597,202.104,4.61,0.578,4
134,17,11,85,0,4,0,3880,86.11,54409794,81.721,29.1,5.732,5591.597,202.104,4.61,0.578,4
134,18,9,94,1,5,267,4147,86.11,54409794,81.721,29.1,5.732,5591.597,202.104,4.61,0.578,4
134,19,13,107,0,5,370,4517,86.11,54409794,81.721,29.1,5.732,5591.597,202.104,4.61,0.578,4
134,20,4,111,0,5,402,4919,86.11,54409794,81.721,29.1,5.732,5591.597,202.104,4.61,0.578,4
134,21,8,119,0,5,276,5195,86.11,54409794,81.721,29.1,5.732,5591.597,202.104,4.61,0.578,4
134,22,2,121,0,5,251,5446,86.11,54409794,81.721,29.1,5.732,5591.597,202.104,4.61,0.578,4
134,23,6,127,0,5,328,5774,86.11,54409794,81.721,29.1,5.732,5591.597,202.104,4.61,0.578,4
134,24,5,132,0,5,341,6115,86.11,54409794,81.721,29.1,5.732,5591.597,202.104,4.61,0.578,4
134,25,12,144,0,5,416,6531,86.11,54409794,81.721,29.1,5.732,5591.597,202.104,4.61,0.578,4
134,26,2,146,0,5,0,6531,86.11,54409794,81.721,29.1,5.732,5591.597,202.104,4.61,0.578,4
134,27,0,146,0,5,0,7215,86.11,54409794,81.721,29.1,5.732,5591.597,202.104,4.61,0.578,4
134,28,0,146,0,5,393,7608,86.11,54409794,81.721,29.1,5.732,5591.597,202.104,4.61,0.578,4
134,29,4,150,0,5,282,7890,86.11,54409794,81.721,29.1,5.732,5591.597,202.104,4.61,0.578,4
134,30,0,150,1,6,195,8085,86.11,54409794,81.721,29.1,5.732,5591.597,202.104,4.61,0.578,4
134,31,1,151,0,6,155,8240,86.11,54409794,81.721,29.1,5.732,5591.597,202.104,4.61,0.578,4
134,32,0,151,0,6,340,8580,86.11,54409794,81.721,29.1,5.732,5591.597,202.104,4.61,0.578,4
134,33,0,151,0,6,214,8794,84.26,54409794,81.721,29.1,5.732,5591.597,202.104,4.61,0.578,4
134,34,4,155,0,6,244,9038,84.26,54409794,81.721,29.1,5.732,5591.597,202.104,4.61,0.578,4
134,35,6,161,0,6,257,9295,84.26,54409794,81.721,29.1,5.732,5591.597,202.104,4.61,0.578,4
134,36,0,161,0,6,747,10042,84.26,54409794,81.721,29.1,5.732,5591.597,202.104,4.61,0.578,4
134,37,1,162,0,6,224,10266,84.26,54409794,81.721,29.1,5.732,5591.597,202.104,4.61,0.578,4
134,38,14,176,0,6,566,10832,84.26,54409794,81.721,29.1,5.732,5591.597,202.104,4.61,0.578,4
134,39,1,177,0,6,390,11222,84.26,54409794,81.721,29.1,5.732,5591.597,202.104,4.61,0.578,4
134,40,1,178,0,6,260,11482,84.26,54409794,81.721,29.1,5.732,5591.597,202.104,4.61,0.578,4
134,41,2,180,0,6,340,11822,84.26,54409794,81.721,29.1,5.732,5591.597,202.104,4.61,0.578,4
134,42,0,180,0,6,240,12062,84.26,54409794,81.721,29.1,5.732,5591.597,202.104,4.61,0.578,4
134,43,0,180,0,6,420,12482,84.26,54409794,81.721,29.1,5.732,5591.597,202.104,4.61,0.578,4
134,44,1,181,0,6,513,12995,80.56,54409794,81.721,29.1,5.732,5591.597,202.104,4.61,0.578,4
134,45,0,181,0,6,639,13634,80.56,54409794,81.721,29.1,5.732,5591.597,202.104,4.61,0.578,4
134,46,1,182,0,6,365,13999,80.56,54409794,81.721,29.1,5.732,5591.597,202.104,4.61,0.578,4
134,47,0,182,0,6,562,14561,80.56,54409794,81.721,29.1,5.732,5591.597,202.104,4.61,0.578,4
134,48,5,187,0,6,576,15137,80.56,54409794,81.721,29.1,5.732,5591.597,202.104,4.61,0.578,4
134,49,4,191,0,6,701,15838,80.56,54409794,81.721,29.1,5.732,5591.597,202.104,4.61,0.578,4
134,50,2,193,0,6,712,16550,80.56,54409794,81.721,29.1,5.732,5591.597,202.104,4.61,0.578,4
134,51,6,199,0,6,1124,17674,80.56,54409794,81.721,29.1,5.732,5591.597,202.104,4.61,0.578,4
134,52,0,199,0,6,201,17875,80.56,54409794,81.721,29.1,5.732,5591.597,202.104,4.61,0.578,4
134,53,2,201,0,6,769,18644,80.56,54409794,81.721,29.1,5.732,5591.597,202.104,4.61,0.578,4
134,54,0,201,0,6,905,19549,80.56,54409794,81.721,29.1,5.732,5591.597,202.104,4.61,0.578,4
134,55,0,201,0,6,763,20312,80.56,54409794,81.721,29.1,5.732,5591.597,202.104,4.61,0.578,4
134,56,2,203,0,6,1130,21442,80.56,54409794,81.721,29.1,5.732,5591.597,202.104,4.61,0.578,4
134,57,3,206,0,6,1022,22464,80.56,54409794,81.721,29.1,5.732,5591.597,202.104,4.61,0.578,4
134,58,0,206,0,6,1026,23490,80.56,54409794,81.721,29.1,5.732,5591.597,202.104,4.61,0.578,4
134,59,0,206,0,6,923,24413,80.56,54409794,81.721,29.1,5.732,5591.597,202.104,4.61,0.578,4
134,60,18,224,0,6,1227,25640,80.56,54409794,81.721,29.1,5.732,5591.597,202.104,4.61,0.578,4
134,61,0,224,0,6,1437,27077,80.56,54409794,81.721,29.1,5.732,5591.597,202.104,4.61,0.578,4
134,62,4,228,0,6,1174,28251,80.56,54409794,81.721,29.1,5.732,5591.597,202.104,4.61,0.578,4
134,63,0,228,0,6,1672,29923,80.56,54409794,81.721,29.1,5.732,5591.597,202.104,4.61,0.578,4
134,64,5,233,0,6,1778,31701,80.56,54409794,81.721,29.1,5.732,5591.597,202.104,4.61,0.578,4
134,65,1,234,0,6,1886,33587,80.56,54409794,81.721,29.1,5.732,5591.597,202.104,4.61,0.578,4
134,66,2,236,0,6,1845,35432,80.56,54409794,81.721,29.1,5.732,5591.597,202.104,4.61,0.578,4
134,67,0,236,0,6,1887,37319,80.56,54409794,81.721,29.1,5.732,5591.597,202.104,4.61,0.578,4
134,68,4,240,0,6,1892,39211,80.56,54409794,81.721,29.1,5.732,5591.597,202.104,4.61,0.578,4
134,69,3,243,0,6,1389,40600,80.56,54409794,81.721,29.1,5.732,5591.597,202.104,4.61,0.578,4
134,70,1,244,0,6,1816,42416,80.56,54409794,81.721,29.1,5.732,5591.597,202.104,4.61,0.578,4
134,71,2,246,0,6,1520,43936,80.56,54409794,81.721,29.1,5.732,5591.597,202.104,4.61,0.578,4
134,72,3,249,0,6,1990,45926,80.56,54409794,81.721,29.1,5.732,5591.597,202.104,4.61,0.578,4
134,73,12,261,0,6,1784,47710,80.56,54409794,81.721,29.1,5.732,5591.597,202.104,4.61,0.578,4
134,74,0,261,0,6,2019,49729,80.56,54409794,81.721,29.1,5.732,5591.597,202.104,4.61,0.578,4
134,75,0,261,0,6,1722,51451,80.56,54409794,81.721,29.1,5.732,5591.597,202.104,4.61,0.578,4
134,76,1,262,0,6,1900,53351,80.56,54409794,81.721,29.1,5.732,5591.597,202.104,4.61,0.578,4
134,77,0,262,0,6,2061,55412,80.56,54409794,81.721,29.1,5.732,5591.597,202.104,4.61,0.578,4
134,78,0,262,0,6,1314,56726,80.56,54409794,81.721,29.1,5.732,5591.597,202.104,4.61,0.578,4
134,79,1,263,0,6,1904,58630,80.56,54409794,81.721,29.1,5.732,5591.597,202.104,4.61,0.578,4
134,80,23,286,0,6,1498,60128,80.56,54409794,81.721,29.1,5.732,5591.597,202.104,4.61,0.578,4
134,81,0,286,0,6,1942,62070,80.56,54409794,81.721,29.1,5.732,5591.597,202.104,4.61,0.578,4
134,82,1,287,0,6,1348,63418,80.56,54409794,81.721,29.1,5.732,5591.597,202.104,4.61,0.578,4
134,83,3,290,0,6,1114,64532,80.56,54409794,81.721,29.1,5.732,5591.597,202.104,4.61,0.578,4
134,84,1,291,0,6,1821,66353,80.56,54409794,81.721,29.1,5.732,5591.597,202.104,4.61,0.578,4
134,85,1,292,0,6,2051,68404,80.56,54409794,81.721,29.1,5.732,5591.597,202.104,4.61,0.578,4
134,86,1,293,0,6,1862,70266,80.56,54409794,81.721,29.1,5.732,5591.597,202.104,4.61,0.578,4
134,87,0,293,0,6,1426,71692,80.56,54409794,81.721,29.1,5.732,5591.597,202.104,4.61,0.578,4
134,88,0,293,0,6,1526,73218,80.56,54409794,81.721,29.1,5.732,5591.597,202.104,4.61,0.578,4
134,89,3,296,0,6,1760,74978,80.56,54409794,81.721,29.1,5.732,5591.597,202.104,4.61,0.578,4
134,90,3,299,0,6,1337,76315,80.56,54409794,81.721,29.1,5.732,5591.597,202.104,4.61,0.578,4
134,91,0,299,0,6,1451,77766,80.56,54409794,81.721,29.1,5.732,5591.597,202.104,4.61,0.578,4
134,92,0,299,0,6,1306,79072,80.56,54409794,81.721,29.1,5.732,5591.597,202.104,4.61,0.578,4
134,93,5,304,0,6,1535,80607,80.56,54409794,81.721,29.1,5.732,5591.597,202.104,4.61,0.578,4
134,94,0,304,0,6,1370,81977,80.56,54409794,81.721,29.1,5.732,5591.597,202.104,4.61,0.578,4
134,95,2,306,0,6,1562,83539,80.56,54409794,81.721,29.1,5.732,5591.597,202.104,4.61,0.578,4
134,96,7,313,0,6,934,84473,80.56,54409794,81.721,29.1,5.732,5591.597,202.104,4.61,0.578,4
134,97,0,313,0,6,0,84473,80.56,54409794,81.721,29.1,5.732,5591.597,202.104,4.61,0.578,4
134,98,3,316,0,6,0,86821,80.56,54409794,81.721,29.1,5.732,5591.597,202.104,4.61,0.578,4
134,99,0,316,0,6,1413,88234,80.56,54409794,81.721,29.1,5.732,5591.597,202.104,4.61,0.578,4
134,100,2,318,0,6,1679,89913,80.56,54409794,81.721,29.1,5.732,5591.597,202.104,4.61,0.578,4
134,101,3,321,0,6,1566,91479,80.56,54409794,81.721,29.1,5.732,5591.597,202.104,4.61,0.578,4
134,102,5,326,0,6,1697,93176,80.56,54409794,81.721,29.1,5.732,5591.597,202.104,4.61,0.578,4
134,103,4,330,0,6,992,94168,80.56,54409794,81.721,29.1,5.732,5591.597,202.104,4.61,0.578,4
134,104,1,331,0,6,704,94872,80.56,54409794,81.721,29.1,5.732,5591.597,202.104,4.61,0.578,4
134,105,5,336,0,6,1452,96324,80.56,54409794,81.721,29.1,5.732,5591.597,202.104,4.61,0.578,4
134,106,1,337,0,6,1327,97651,80.56,54409794,81.721,29.1,5.732,5591.597,202.104,4.61,0.578,4
134,107,0,337,0,6,1651,99302,80.56,54409794,81.721,29.1,5.732,5591.597,202.104,4.61,0.578,4
134,108,2,339,0,6,1649,100951,80.56,54409794,81.721,29.1,5.732,5591.597,202.104,4.61,0.578,4
134,109,0,339,0,6,1548,102499,80.56,54409794,81.721,29.1,5.732,5591.597,202.104,4.61,0.578,4
134,110,2,341,0,6,1389,103888,80.56,54409794,81.721,29.1,5.732,5591.597,202.104,4.61,0.578,4
134,111,0,341,0,6,986,104874,80.56,54409794,81.721,29.1,5.732,5591.597,202.104,4.61,0.578,4
134,112,0,341,0,6,761,105635,76.85,54409794,81.721,29.1,5.732,5591.597,202.104,4.61,0.578,4
134,113,0,341,0,6,1038,106673,76.85,54409794,81.721,29.1,5.732,5591.597,202.104,4.61,0.578,4
134,114,2,343,0,6,1255,107928,76.85,54409794,81.721,29.1,5.732,5591.597,202.104,4.61,0.578,4
134,115,0,343,0,6,1406,109334,76.85,54409794,81.721,29.1,5.732,5591.597,202.104,4.61,0.578,4
134,116,3,346,0,6,1192,110526,76.85,54409794,81.721,29.1,5.732,5591.597,202.104,4.61,0.578,4
134,117,3,349,0,6,899,111425,76.85,54409794,81.721,29.1,5.732,5591.597,202.104,4.61,0.578,4
134,118,1,350,0,6,956,112381,76.85,54409794,81.721,29.1,5.732,5591.597,202.104,4.61,0.578,4
134,119,0,350,0,6,1117,113498,76.85,54409794,81.721,29.1,5.732,5591.597,202.104,4.61,0.578,4
134,120,1,351,0,6,2203,115701,76.85,54409794,81.721,29.1,5.732,5591.597,202.104,4.61,0.578,4
134,121,2,353,0,6,819,116520,76.85,54409794,81.721,29.1,5.732,5591.597,202.104,4.61,0.578,4
134,122,0,353,0,6,699,117219,76.85,54409794,81.721,29.1,5.732,5591.597,202.104,4.61,0.578,4
134,123,0,353,0,6,908,118127,74.07,54409794,81.721,29.1,5.732,5591.597,202.104,4.61,0.578,4
134,124,0,353,0,6,1015,119142,74.07,54409794,81.721,29.1,5.732,5591.597,202.104,4.61,0.578,4
134,125,0,353,0,6,1150,120292,74.07,54409794,81.721,29.1,5.732,5591.597,202.104,4.61,0.578,4
134,126,2,355,0,6,540,120832,74.07,54409794,81.721,29.1,5.732,5591.597,202.104,4.61,0.578,4
134,127,1,356,0,6,1458,122290,74.07,54409794,81.721,29.1,5.732,5591.597,202.104,4.61,0.578,4
134,128,1,357,0,6,1151,123441,74.07,54409794,81.721,29.1,5.732,5591.597,202.104,4.61,0.578,4
134,129,2,359,0,6,1324,124765,74.07,54409794,81.721,29.1,5.732,5591.597,202.104,4.61,0.578,4
134,130,0,359,0,6,1062,125827,74.07,54409794,81.721,29.1,5.732,5591.597,202.104,4.61,0.578,4
134,131,0,359,0,6,1001,126828,74.07,54409794,81.721,29.1,5.732,5591.597,202.104,4.61,0.578,4
134,132,1,360,0,6,898,127726,74.07,54409794,81.721,29.1,5.732,5591.597,202.104,4.61,0.578,4
134,133,0,360,0,6,1075,128801,74.07,54409794,81.721,29.1,5.732,5591.597,202.104,4.61,0.578,4
134,134,0,360,0,6,1738,130539,74.07,54409794,81.721,29.1,5.732,5591.597,202.104,4.61,0.578,4
134,135,1,361,0,6,1760,132299,74.07,54409794,81.721,29.1,5.732,5591.597,202.104,4.61,0.578,4
134,136,8,369,0,6,1736,134035,74.07,54409794,81.721,29.1,5.732,5591.597,202.104,4.61,0.578,4
134,137,5,374,0,6,1367,135402,74.07,54409794,81.721,29.1,5.732,5591.597,202.104,4.61,0.578,4
134,138,0,374,0,6,751,136153,74.07,54409794,81.721,29.1,5.732,5591.597,202.104,4.61,0.578,4
134,139,1,375,0,6,1596,137749,74.07,54409794,81.721,29.1,5.732,5591.597,202.104,4.61,0.578,4
134,140,1,376,0,6,1765,139514,77.78,54409794,81.721,29.1,5.732,5591.597,202.104,4.61,0.578,4
134,141,3,379,0,6,1530,141044,77.78,54409794,81.721,29.1,5.732,5591.597,202.104,4.61,0.578,4
134,142,17,396,0,6,1472,142516,77.78,54409794,81.721,29.1,5.732,5591.597,202.104,4.61,0.578,4
134,143,13,409,0,6,1538,144054,77.78,54409794,81.721,29.1,5.732,5591.597,202.104,4.61,0.578,4
134,144,26,435,0,6,1113,145167,77.78,54409794,81.721,29.1,5.732,5591.597,202.104,4.61,0.578,4
134,145,9,444,0,6,870,146037,77.78,54409794,81.721,29.1,5.732,5591.597,202.104,4.61,0.578,4
134,146,19,463,0,6,1783,147820,77.78,54409794,81.721,29.1,5.732,5591.597,202.104,4.61,0.578,4
134,147,11,474,0,6,2041,149861,77.78,54409794,81.721,29.1,5.732,5591.597,202.104,4.61,0.578,4
134,148,30,504,0,6,2078,151939,81.48,54409794,81.721,29.1,5.732,5591.597,202.104,4.61,0.578,4
134,149,82,586,0,6,1882,153821,81.48,54409794,81.721,29.1,5.732,5591.597,202.104,4.61,0.578,4
134,150,42,628,0,6,2221,156042,81.48,54409794,81.721,29.1,5.732,5591.597,202.104,4.61,0.578,4
134,151,28,656,0,6,1801,157843,81.48,54409794,81.721,29.1,5.732,5591.597,202.104,4.61,0.578,4
134,152,93,749,0,6,2413,160256,81.48,54409794,81.721,29.1,5.732,5591.597,202.104,4.61,0.578,4
134,153,38,787,0,6,1912,162168,81.48,54409794,81.721,29.1,5.732,5591.597,202.104,4.61,0.578,4
134,154,100,887,0,6,2098,164266,81.48,54409794,81.721,29.1,5.732,5591.597,202.104,4.61,0.578,4
134,155,51,938,0,6,2167,166433,81.48,54409794,81.721,29.1,5.732,5591.597,202.104,4.61,0.578,4
134,156,120,1058,0,6,2468,168901,81.48,54409794,81.721,29.1,5.732,5591.597,202.104,4.61,0.578,4
134,157,75,1133,1,7,2830,171731,81.48,54409794,81.721,29.1,5.732,5591.597,202.104,4.61,0.578,4
134,158,83,1216,0,7,2979,174710,81.48,54409794,81.721,29.1,5.732,5591.597,202.104,4.61,0.578,4
134,159,103,1319,1,8,2232,176942,81.48,54409794,81.721,29.1,5.732,5591.597,202.104,4.61,0.578,4
134,160,145,1464,0,8,2529,179471,81.48,54409794,81.721,29.1,5.732,5591.597,202.104,4.61,0.578,4
134,161,146,1610,0,8,2852,182323,81.48,54409794,81.721,29.1,5.732,5591.597,202.104,4.61,0.578,4
134,162,197,1807,4,12,3151,185474,81.48,54409794,81.721,29.1,5.732,5591.597,202.104,4.61,0.578,4
134,163,202,2009,2,14,2898,188372,78.7,54409794,81.721,29.1,5.732,5591.597,202.104,4.61,0.578,4
134,164,256,2265,0,14,3324,191696,78.7,54409794,81.721,29.1,5.732,5591.597,202.104,4.61,0.578,4
134,165,180,2445,1,15,3036,194732,78.7,54409794,81.721,29.1,5.732,5591.597,202.104,4.61,0.578,4
134,166,351,2796,1,16,3062,197794,78.7,54409794,81.721,29.1,5.732,5591.597,202.104,4.61,0.578,4
134,167,219,3015,8,24,3572,201366,78.7,54409794,81.721,29.1,5.732,5591.597,202.104,4.61,0.578,4
134,168,284,3299,8,32,3794,205160,78.7,54409794,81.721,29.1,5.732,5591.597,202.104,4.61,0.578,4
134,169,337,3636,7,39,3677,208837,78.7,54409794,81.721,29.1,5.732,5591.597,202.104,4.61,0.578,4
134,170,258,3894,7,46,3989,212826,78.7,54409794,81.721,29.1,5.732,5591.597,202.104,4.61,0.578,4
134,171,405,4299,15,61,3384,216210,78.7,54409794,81.721,29.1,5.732,5591.597,202.104,4.61,0.578,4
134,172,322,4621,14,75,3977,220187,78.7,54409794,81.721,29.1,5.732,5591.597,202.104,4.61,0.578,4
134,173,642,5263,6,81,4196,224383,78.7,54409794,81.721,29.1,5.732,5591.597,202.104,4.61,0.578,4
134,174,542,5805,13,94,4454,228837,78.7,54409794,81.721,29.1,5.732,5591.597,202.104,4.61,0.578,4
134,175,666,6471,6,100,4589,233426,78.7,54409794,81.721,29.1,5.732,5591.597,202.104,4.61,0.578,4
134,176,488,6959,16,116,4812,238238,78.7,54409794,81.721,29.1,5.732,5591.597,202.104,4.61,0.578,4
134,177,868,7827,17,133,4219,242457,78.7,54409794,81.721,29.1,5.732,5591.597,202.104,4.61,0.578,4
134,178,688,8515,22,155,2697,245154,78.7,54409794,81.721,29.1,5.732,5591.597,202.104,4.61,0.578,4
134,179,597,9112,19,174,4576,249730,81.02,54409794,81.721,29.1,5.732,5591.597,202.104,4.61,0.578,4
134,180,879,9991,24,198,3974,253704,81.02,54409794,81.721,29.1,5.732,5591.597,202.104,4.61,0.578,4
134,181,743,10734,28,226,4897,258601,81.02,54409794,81.721,29.1,5.732,5591.597,202.104,4.61,0.578,4
134,182,897,11631,30,256,5262,263863,81.02,54409794,81.721,29.1,5.732,5591.597,202.104,4.61,0.578,4
134,183,794,12425,28,284,3431,267294,81.02,54409794,81.721,29.1,5.732,5591.597,202.104,4.61,0.578,4
134,184,948,13373,26,310,4587,271881,81.02,54409794,81.721,29.1,5.732,5591.597,202.104,4.61,0.578,4
134,185,1010,14383,11,321,6195,278076,81.02,54409794,81.721,29.1,5.732,5591.597,202.104,4.61,0.578,4
134,186,1142,15525,32,353,7495,285571,81.02,54409794,81.721,29.1,5.732,5591.597,202.104,4.61,0.578,4
134,187,978,16503,18,371,5913,291484,81.02,54409794,81.721,29.1,5.732,5591.597,202.104,4.61,0.578,4
134,188,1291,17794,41,412,6572,298056,81.02,54409794,81.721,29.1,5.732,5591.597,202.104,4.61,0.578,4
134,189,987,18781,32,444,0,298056,81.02,54409794,81.721,29.1,5.732,5591.597,202.104,4.61,0.578,4
134,190,1252,20033,27,471,0,317765,81.02,54409794,81.721,29.1,5.732,5591.597,202.104,4.61,0.578,4
134,191,1400,21433,39,510,0,317765,81.02,54409794,81.721,29.1,5.732,5591.597,202.104,4.61,0.578,4
134,192,1012,22445,25,535,0,317765,81.02,54409794,81.721,29.1,5.732,5591.597,202.104,4.61,0.578,4
134,193,1461,23906,31,566,0,317765,81.02,54409794,81.721,29.1,5.732,5591.597,202.104,4.61,0.578,4
134,194,2158,26064,32,598,0,317765,81.02,54409794,81.721,29.1,5.732,5591.597,202.104,4.61,0.578,4
134,195,1910,27974,48,646,0,317765,81.02,54409794,81.721,29.1,5.732,5591.597,202.104,4.61,0.578,4
134,196,1340,29314,18,664,0,317765,81.02,54409794,81.721,29.1,5.732,5591.597,202.104,4.61,0.578,4
134,197,1123,30437,29,693,0,317765,81.02,54409794,81.721,29.1,5.732,5591.597,202.104,4.61,0.578,4
134,198,888,31325,39,732,0,317765,81.02,54409794,81.721,29.1,5.732,5591.597,202.104,4.61,0.578,4
134,199,1026,32351,33,765,0,317765,81.02,54409794,81.721,29.1,5.732,5591.597,202.104,4.61,0.578,4
134,200,1137,33488,34,799,0,317765,81.02,54409794,81.721,29.1,5.732,5591.597,202.104,4.61,0.578,4
134,201,1387,34875,39,838,0,317765,81.02,54409794,81.721,29.1,5.732,5591.597,202.104,4.61,0.578,4
134,202,1150,36025,42,880,0,317765,81.02,54409794,81.721,29.1,5.732,5591.597,202.104,4.61,0.578,4
134,203,1180,37205,34,914,0,317765,81.02,54409794,81.721,29.1,5.732,5591.597,202.104,4.61,0.578,4
134,204,1297,38502,31,945,0,317765,81.02,54409794,81.721,29.1,5.732,5591.597,202.104,4.61,0.578,4
135,1,0,11,0,0,0,306,66.67,2540916,3.078,22,3.552,9541.808,243.811,3.94,0.647,0
135,2,2,13,0,0,0,306,66.67,2540916,3.078,22,3.552,9541.808,243.811,3.94,0.647,0
135,3,0,13,0,0,0,306,66.67,2540916,3.078,22,3.552,9541.808,243.811,3.94,0.647,0
135,4,1,14,0,0,0,306,66.67,2540916,3.078,22,3.552,9541.808,243.811,3.94,0.647,0
135,5,0,14,0,0,0,362,66.67,2540916,3.078,22,3.552,9541.808,243.811,3.94,0.647,0
135,6,2,16,0,0,0,362,66.67,2540916,3.078,22,3.552,9541.808,243.811,3.94,0.647,0
135,7,0,16,0,0,0,362,66.67,2540916,3.078,22,3.552,9541.808,243.811,3.94,0.647,0
135,8,0,16,0,0,0,362,66.67,2540916,3.078,22,3.552,9541.808,243.811,3.94,0.647,0
135,9,0,16,0,0,0,362,66.67,2540916,3.078,22,3.552,9541.808,243.811,3.94,0.647,0
135,10,0,16,0,0,0,362,66.67,2540916,3.078,22,3.552,9541.808,243.811,3.94,0.647,0
135,11,0,16,0,0,0,362,66.67,2540916,3.078,22,3.552,9541.808,243.811,3.94,0.647,0
135,12,0,16,0,0,0,362,66.67,2540916,3.078,22,3.552,9541.808,243.811,3.94,0.647,0
135,13,0,16,0,0,0,362,66.67,2540916,3.078,22,3.552,9541.808,243.811,3.94,0.647,0
135,14,0,16,0,0,0,362,66.67,2540916,3.078,22,3.552,9541.808,243.811,3.94,0.647,0
135,15,0,16,0,0,0,454,66.67,2540916,3.078,22,3.552,9541.808,243.811,3.94,0.647,0
135,16,0,16,0,0,0,454,66.67,2540916,3.078,22,3.552,9541.808,243.811,3.94,0.647,0
135,17,0,16,0,0,0,454,73.15,2540916,3.078,22,3.552,9541.808,243.811,3.94,0.647,0
135,18,0,16,0,0,0,499,73.15,2540916,3.078,22,3.552,9541.808,243.811,3.94,0.647,0
135,19,0,16,0,0,25,524,73.15,2540916,3.078,22,3.552,9541.808,243.811,3.94,0.647,0
135,20,0,16,0,0,0,524,73.15,2540916,3.078,22,3.552,9541.808,243.811,3.94,0.647,0
135,21,0,16,0,0,0,546,73.15,2540916,3.078,22,3.552,9541.808,243.811,3.94,0.647,0
135,22,0,16,0,0,0,546,73.15,2540916,3.078,22,3.552,9541.808,243.811,3.94,0.647,0
135,23,0,16,0,0,0,590,73.15,2540916,3.078,22,3.552,9541.808,243.811,3.94,0.647,0
135,24,0,16,0,0,31,621,73.15,2540916,3.078,22,3.552,9541.808,243.811,3.94,0.647,0
135,25,0,16,0,0,54,675,73.15,2540916,3.078,22,3.552,9541.808,243.811,3.94,0.647,0
135,26,0,16,0,0,29,704,73.15,2540916,3.078,22,3.552,9541.808,243.811,3.94,0.647,0
135,27,0,16,0,0,0,704,73.15,2540916,3.078,22,3.552,9541.808,243.811,3.94,0.647,0
135,28,0,16,0,0,0,765,73.15,2540916,3.078,22,3.552,9541.808,243.811,3.94,0.647,0
135,29,0,16,0,0,0,765,73.15,2540916,3.078,22,3.552,9541.808,243.811,3.94,0.647,0
135,30,0,16,0,0,0,872,73.15,2540916,3.078,22,3.552,9541.808,243.811,3.94,0.647,0
135,31,0,16,0,0,56,928,73.15,2540916,3.078,22,3.552,9541.808,243.811,3.94,0.647,0
135,32,0,16,0,0,132,1060,73.15,2540916,3.078,22,3.552,9541.808,243.811,3.94,0.647,0
135,33,0,16,0,0,62,1122,73.15,2540916,3.078,22,3.552,9541.808,243.811,3.94,0.647,0
135,34,0,16,0,0,0,,73.15,2540916,3.078,22,3.552,9541.808,243.811,3.94,0.647,0
135,35,0,16,0,0,0,1163,68.52,2540916,3.078,22,3.552,9541.808,243.811,3.94,0.647,0
135,36,0,16,0,0,18,1181,68.52,2540916,3.078,22,3.552,9541.808,243.811,3.94,0.647,0
135,37,0,16,0,0,102,1283,66.67,2540916,3.078,22,3.552,9541.808,243.811,3.94,0.647,0
135,38,0,16,0,0,0,1283,66.67,2540916,3.078,22,3.552,9541.808,243.811,3.94,0.647,0
135,39,0,16,0,0,0,1511,66.67,2540916,3.078,22,3.552,9541.808,243.811,3.94,0.647,0
135,40,0,16,0,0,32,1543,66.67,2540916,3.078,22,3.552,9541.808,243.811,3.94,0.647,0
135,41,0,16,0,0,0,1543,66.67,2540916,3.078,22,3.552,9541.808,243.811,3.94,0.647,0
135,42,0,16,0,0,0,1604,66.67,2540916,3.078,22,3.552,9541.808,243.811,3.94,0.647,0
135,43,0,16,0,0,164,1768,66.67,2540916,3.078,22,3.552,9541.808,243.811,3.94,0.647,0
135,44,0,16,0,0,243,2011,66.67,2540916,3.078,22,3.552,9541.808,243.811,3.94,0.647,0
135,45,0,16,0,0,0,2011,66.67,2540916,3.078,22,3.552,9541.808,243.811,3.94,0.647,0
135,46,0,16,0,0,0,2011,66.67,2540916,3.078,22,3.552,9541.808,243.811,3.94,0.647,0
135,47,0,16,0,0,0,2381,66.67,2540916,3.078,22,3.552,9541.808,243.811,3.94,0.647,0
135,48,0,16,0,0,0,2381,66.67,2540916,3.078,22,3.552,9541.808,243.811,3.94,0.647,0
135,49,0,16,0,0,0,2434,66.67,2540916,3.078,22,3.552,9541.808,243.811,3.94,0.647,0
135,50,0,16,0,0,152,2586,66.67,2540916,3.078,22,3.552,9541.808,243.811,3.94,0.647,0
135,51,0,16,0,0,95,2681,66.67,2540916,3.078,22,3.552,9541.808,243.811,3.94,0.647,0
135,52,2,18,0,0,0,2681,66.67,2540916,3.078,22,3.552,9541.808,243.811,3.94,0.647,0
135,53,1,19,0,0,0,2847,66.67,2540916,3.078,22,3.552,9541.808,243.811,3.94,0.647,0
135,54,1,20,0,0,180,3027,66.67,2540916,3.078,22,3.552,9541.808,243.811,3.94,0.647,0
135,55,1,21,0,0,90,3117,66.67,2540916,3.078,22,3.552,9541.808,243.811,3.94,0.647,0
135,56,0,21,0,0,69,3186,66.67,2540916,3.078,22,3.552,9541.808,243.811,3.94,0.647,0
135,57,0,21,0,0,15,3201,66.67,2540916,3.078,22,3.552,9541.808,243.811,3.94,0.647,0
135,58,1,22,0,0,169,3370,66.67,2540916,3.078,22,3.552,9541.808,243.811,3.94,0.647,0
135,59,0,22,0,0,42,3412,66.67,2540916,3.078,22,3.552,9541.808,243.811,3.94,0.647,0
135,60,1,23,0,0,133,3545,66.67,2540916,3.078,22,3.552,9541.808,243.811,3.94,0.647,0
135,61,0,23,0,0,135,3680,66.67,2540916,3.078,22,3.552,9541.808,243.811,3.94,0.647,0
135,62,1,24,0,0,290,3970,54.63,2540916,3.078,22,3.552,9541.808,243.811,3.94,0.647,0
135,63,1,25,0,0,35,4005,62.96,2540916,3.078,22,3.552,9541.808,243.811,3.94,0.647,0
135,64,0,25,0,0,0,4005,62.96,2540916,3.078,22,3.552,9541.808,243.811,3.94,0.647,0
135,65,0,25,0,0,0,4217,62.96,2540916,3.078,22,3.552,9541.808,243.811,3.94,0.647,0
135,66,0,25,0,0,178,4395,62.96,2540916,3.078,22,3.552,9541.808,243.811,3.94,0.647,0
135,67,0,25,0,0,193,4588,62.96,2540916,3.078,22,3.552,9541.808,243.811,3.94,0.647,0
135,68,4,29,0,0,0,4588,62.96,2540916,3.078,22,3.552,9541.808,243.811,3.94,0.647,0
135,69,0,29,0,0,0,4943,62.96,2540916,3.078,22,3.552,9541.808,243.811,3.94,0.647,0
135,70,2,31,0,0,27,4970,62.96,2540916,3.078,22,3.552,9541.808,243.811,3.94,0.647,0
135,71,0,31,0,0,114,5084,62.96,2540916,3.078,22,3.552,9541.808,243.811,3.94,0.647,0
135,72,0,31,0,0,217,5301,62.96,2540916,3.078,22,3.552,9541.808,243.811,3.94,0.647,0
135,73,0,31,0,0,213,5514,62.96,2540916,3.078,22,3.552,9541.808,243.811,3.94,0.647,0
135,74,0,31,0,0,168,5682,62.96,2540916,3.078,22,3.552,9541.808,243.811,3.94,0.647,0
135,75,1,32,0,0,167,5849,62.96,2540916,3.078,22,3.552,9541.808,243.811,3.94,0.647,0
135,76,0,32,0,0,0,5849,62.96,2540916,3.078,22,3.552,9541.808,243.811,3.94,0.647,0
135,77,0,32,0,0,0,5919,62.96,2540916,3.078,22,3.552,9541.808,243.811,3.94,0.647,0
135,78,2,34,0,0,187,6106,62.96,2540916,3.078,22,3.552,9541.808,243.811,3.94,0.647,0
135,79,2,36,0,0,249,6355,62.96,2540916,3.078,22,3.552,9541.808,243.811,3.94,0.647,0
135,80,3,39,0,0,159,6514,62.96,2540916,3.078,22,3.552,9541.808,243.811,3.94,0.647,0
135,81,6,45,0,0,323,6837,62.96,2540916,3.078,22,3.552,9541.808,243.811,3.94,0.647,0
135,82,1,46,0,0,172,7009,62.96,2540916,3.078,22,3.552,9541.808,243.811,3.94,0.647,0
135,83,9,55,0,0,322,7331,62.96,2540916,3.078,22,3.552,9541.808,243.811,3.94,0.647,0
135,84,8,63,0,0,0,7331,54.63,2540916,3.078,22,3.552,9541.808,243.811,3.94,0.647,0
135,85,9,72,0,0,0,7740,54.63,2540916,3.078,22,3.552,9541.808,243.811,3.94,0.647,0
135,86,4,76,0,0,274,8014,54.63,2540916,3.078,22,3.552,9541.808,243.811,3.94,0.647,0
135,87,5,81,0,0,91,8105,54.63,2540916,3.078,22,3.552,9541.808,243.811,3.94,0.647,0
135,88,40,121,0,0,158,8263,54.63,2540916,3.078,22,3.552,9541.808,243.811,3.94,0.647,0
135,89,0,121,0,0,443,8706,54.63,2540916,3.078,22,3.552,9541.808,243.811,3.94,0.647,0
135,90,62,183,0,0,0,8706,51.85,2540916,3.078,22,3.552,9541.808,243.811,3.94,0.647,0
135,91,13,196,0,0,0,9118,51.85,2540916,3.078,22,3.552,9541.808,243.811,3.94,0.647,0
135,92,7,203,0,0,445,9563,51.85,2540916,3.078,22,3.552,9541.808,243.811,3.94,0.647,0
135,93,82,285,0,0,98,9661,51.85,2540916,3.078,22,3.552,9541.808,243.811,3.94,0.647,0
135,94,8,293,0,0,622,10283,51.85,2540916,3.078,22,3.552,9541.808,243.811,3.94,0.647,0
135,95,57,350,0,0,399,10682,51.85,2540916,3.078,22,3.552,9541.808,243.811,3.94,0.647,0
135,96,25,375,0,0,0,10682,51.85,2540916,3.078,22,3.552,9541.808,243.811,3.94,0.647,0
135,97,37,412,0,0,0,11299,51.85,2540916,3.078,22,3.552,9541.808,243.811,3.94,0.647,0
135,98,73,485,0,0,0,11299,51.85,2540916,3.078,22,3.552,9541.808,243.811,3.94,0.647,0
135,99,54,539,0,0,0,12167,51.85,2540916,3.078,22,3.552,9541.808,243.811,3.94,0.647,0
135,100,54,593,0,0,457,12624,51.85,2540916,3.078,22,3.552,9541.808,243.811,3.94,0.647,0
135,101,22,615,0,0,165,12789,51.85,2540916,3.078,22,3.552,9541.808,243.811,3.94,0.647,0
135,102,53,668,1,1,0,12789,51.85,2540916,3.078,22,3.552,9541.808,243.811,3.94,0.647,0
135,103,0,668,0,1,0,13999,51.85,2540916,3.078,22,3.552,9541.808,243.811,3.94,0.647,0
135,104,117,785,0,1,699,14698,51.85,2540916,3.078,22,3.552,9541.808,243.811,3.94,0.647,0
135,105,76,861,0,1,741,15439,51.85,2540916,3.078,22,3.552,9541.808,243.811,3.94,0.647,0
135,106,3,864,1,2,866,16305,60.65,2540916,3.078,22,3.552,9541.808,243.811,3.94,0.647,0
135,107,96,960,0,2,76,16381,60.65,2540916,3.078,22,3.552,9541.808,243.811,3.94,0.647,0
135,108,72,1032,0,2,457,16838,60.65,2540916,3.078,22,3.552,9541.808,243.811,3.94,0.647,0
135,109,46,1078,0,2,203,17041,60.65,2540916,3.078,22,3.552,9541.808,243.811,3.94,0.647,0
135,110,125,1203,0,2,653,17694,60.65,2540916,3.078,22,3.552,9541.808,243.811,3.94,0.647,0
135,111,44,1247,1,3,300,17994,60.65,2540916,3.078,22,3.552,9541.808,243.811,3.94,0.647,0
135,112,97,1344,1,4,460,18454,60.65,2540916,3.078,22,3.552,9541.808,243.811,3.94,0.647,0
135,113,22,1366,3,7,806,19260,60.65,2540916,3.078,22,3.552,9541.808,243.811,3.94,0.647,0
135,114,36,1402,0,7,522,19782,60.65,2540916,3.078,22,3.552,9541.808,243.811,3.94,0.647,0
135,115,120,1522,0,7,319,20101,60.65,2540916,3.078,22,3.552,9541.808,243.811,3.94,0.647,0
135,116,96,1618,0,7,786,20887,60.65,2540916,3.078,22,3.552,9541.808,243.811,3.94,0.647,0
135,117,69,1687,0,7,919,21806,48.15,2540916,3.078,22,3.552,9541.808,243.811,3.94,0.647,0
135,118,88,1775,1,8,1334,23140,48.15,2540916,3.078,22,3.552,9541.808,243.811,3.94,0.647,0
135,119,68,1843,0,8,1185,24325,48.15,2540916,3.078,22,3.552,9541.808,243.811,3.94,0.647,0
135,120,74,1917,0,8,527,24852,48.15,2540916,3.078,22,3.552,9541.808,243.811,3.94,0.647,0
135,121,69,1986,1,9,773,25625,48.15,2540916,3.078,22,3.552,9541.808,243.811,3.94,0.647,0
135,122,66,2052,1,10,636,26261,48.15,2540916,3.078,22,3.552,9541.808,243.811,3.94,0.647,0
135,123,77,2129,0,10,83,26344,48.15,2540916,3.078,22,3.552,9541.808,243.811,3.94,0.647,0
135,124,95,2224,1,11,1374,27718,48.15,2540916,3.078,22,3.552,9541.808,243.811,3.94,0.647,0
135,125,70,2294,0,11,796,28514,46.76,2540916,3.078,22,3.552,9541.808,243.811,3.94,0.647,0
135,126,112,2406,1,12,719,29233,48.61,2540916,3.078,22,3.552,9541.808,243.811,3.94,0.647,0
135,127,64,2470,0,12,0,29233,48.61,2540916,3.078,22,3.552,9541.808,243.811,3.94,0.647,0
135,128,70,2540,0,12,0,31172,48.61,2540916,3.078,22,3.552,9541.808,243.811,3.94,0.647,0
135,129,112,2652,3,15,1197,32369,48.61,2540916,3.078,22,3.552,9541.808,243.811,3.94,0.647,0
135,130,150,2802,1,16,0,32369,48.61,2540916,3.078,22,3.552,9541.808,243.811,3.94,0.647,0
135,131,0,2802,0,16,0,33985,48.61,2540916,3.078,22,3.552,9541.808,243.811,3.94,0.647,0
135,132,147,2949,3,19,1190,35175,48.61,2540916,3.078,22,3.552,9541.808,243.811,3.94,0.647,0
135,133,152,3101,0,19,1112,36287,48.61,2540916,3.078,22,3.552,9541.808,243.811,3.94,0.647,0
135,134,128,3229,0,19,456,36743,60.19,2540916,3.078,22,3.552,9541.808,243.811,3.94,0.647,0
135,135,177,3406,3,22,1054,37797,60.19,2540916,3.078,22,3.552,9541.808,243.811,3.94,0.647,0
135,136,138,3544,5,27,946,38743,60.19,2540916,3.078,22,3.552,9541.808,243.811,3.94,0.647,0
135,137,182,3726,4,31,1654,40397,60.19,2540916,3.078,22,3.552,9541.808,243.811,3.94,0.647,0
135,138,181,3907,4,35,749,41146,60.19,2540916,3.078,22,3.552,9541.808,243.811,3.94,0.647,0
135,139,247,4154,0,35,721,41867,60.19,2540916,3.078,22,3.552,9541.808,243.811,3.94,0.647,0
135,140,190,4344,1,36,1078,42945,60.19,2540916,3.078,22,3.552,9541.808,243.811,3.94,0.647,0
135,141,120,4464,1,37,1045,43990,60.19,2540916,3.078,22,3.552,9541.808,243.811,3.94,0.647,0
135,142,201,4665,2,39,1754,45744,60.19,2540916,3.078,22,3.552,9541.808,243.811,3.94,0.647,0
135,143,247,4912,2,41,1378,47122,60.19,2540916,3.078,22,3.552,9541.808,243.811,3.94,0.647,0
135,144,315,5227,1,42,1686,48808,60.19,2540916,3.078,22,3.552,9541.808,243.811,3.94,0.647,0
135,145,311,5538,4,46,1583,50391,60.19,2540916,3.078,22,3.552,9541.808,243.811,3.94,0.647,0
135,146,316,5854,6,52,1214,51605,60.19,2540916,3.078,22,3.552,9541.808,243.811,3.94,0.647,0
135,147,176,6030,4,56,1782,53387,57.41,2540916,3.078,22,3.552,9541.808,243.811,3.94,0.647,0
135,148,130,6160,1,57,1554,54941,57.41,2540916,3.078,22,3.552,9541.808,243.811,3.94,0.647,0
135,149,271,6431,2,59,1667,56608,57.41,2540916,3.078,22,3.552,9541.808,243.811,3.94,0.647,0
135,150,281,6712,1,60,542,57150,57.41,2540916,3.078,22,3.552,9541.808,243.811,3.94,0.647,0
135,151,194,6906,5,65,1460,58610,57.41,2540916,3.078,22,3.552,9541.808,243.811,3.94,0.647,0
135,152,210,7116,4,69,1343,59953,57.41,2540916,3.078,22,3.552,9541.808,243.811,3.94,0.647,0
135,153,249,7365,3,72,1457,61410,57.41,2540916,3.078,22,3.552,9541.808,243.811,3.94,0.647,0
135,154,185,7550,3,75,1036,62446,57.41,2540916,3.078,22,3.552,9541.808,243.811,3.94,0.647,0
135,155,142,7692,6,81,1823,64269,57.41,2540916,3.078,22,3.552,9541.808,243.811,3.94,0.647,0
135,156,152,7844,1,82,1630,65899,57.41,2540916,3.078,22,3.552,9541.808,243.811,3.94,0.647,0
135,157,238,8082,4,86,1388,67287,63.89,2540916,3.078,22,3.552,9541.808,243.811,3.94,0.647,0
135,158,241,8323,0,86,1650,68937,63.89,2540916,3.078,22,3.552,9541.808,243.811,3.94,0.647,0
135,159,191,8514,1,87,1409,70346,63.89,2540916,3.078,22,3.552,9541.808,243.811,3.94,0.647,0
135,160,171,8685,2,89,1160,71506,56.48,2540916,3.078,22,3.552,9541.808,243.811,3.94,0.647,0
135,161,125,8810,2,91,680,72186,56.48,2540916,3.078,22,3.552,9541.808,243.811,3.94,0.647,0
135,162,118,8928,0,91,1907,74093,56.48,2540916,3.078,22,3.552,9541.808,243.811,3.94,0.647,0
135,163,180,9108,2,93,1418,75511,56.48,2540916,3.078,22,3.552,9541.808,243.811,3.94,0.647,0
135,164,148,9256,3,96,1910,77421,56.48,2540916,3.078,22,3.552,9541.808,243.811,3.94,0.647,0
135,165,181,9437,2,98,1701,79122,56.48,2540916,3.078,22,3.552,9541.808,243.811,3.94,0.647,0
135,166,167,9604,0,98,1230,80352,56.48,2540916,3.078,22,3.552,9541.808,243.811,3.94,0.647,0
135,167,115,9719,3,101,955,81307,56.48,2540916,3.078,22,3.552,9541.808,243.811,3.94,0.647,0
135,168,99,9818,2,103,1010,82317,56.48,2540916,3.078,22,3.552,9541.808,243.811,3.94,0.647,0
135,169,83,9901,3,106,1107,83424,56.48,2540916,3.078,22,3.552,9541.808,243.811,3.94,0.647,0
135,170,63,9964,2,108,1264,84688,56.48,2540916,3.078,22,3.552,9541.808,243.811,3.94,0.647,0
135,171,114,10078,0,108,1404,86092,56.48,2540916,3.078,22,3.552,9541.808,243.811,3.94,0.647,0
135,172,129,10207,0,108,1547,87639,56.48,2540916,3.078,22,3.552,9541.808,243.811,3.94,0.647,0
135,173,85,10292,3,111,1047,88686,56.48,2540916,3.078,22,3.552,9541.808,243.811,3.94,0.647,0
135,174,85,10377,1,112,1145,89831,56.48,2540916,3.078,22,3.552,9541.808,243.811,3.94,0.647,0
135,175,149,10526,1,113,1146,90977,56.48,2540916,3.078,22,3.552,9541.808,243.811,3.94,0.647,0
135,176,81,10607,3,116,925,91902,56.48,2540916,3.078,22,3.552,9541.808,243.811,3.94,0.647,0
135,177,56,10663,1,117,1041,92943,56.48,2540916,3.078,22,3.552,9541.808,243.811,3.94,0.647,0
135,178,77,10740,2,119,1021,93964,56.48,2540916,3.078,22,3.552,9541.808,243.811,3.94,0.647,0
135,179,95,10835,0,119,1010,94974,56.48,2540916,3.078,22,3.552,9541.808,243.811,3.94,0.647,0
135,180,83,10918,0,119,920,95894,56.48,2540916,3.078,22,3.552,9541.808,243.811,3.94,0.647,0
135,181,115,11033,0,119,147,96041,56.48,2540916,3.078,22,3.552,9541.808,243.811,3.94,0.647,0
135,182,88,11121,0,119,967,97008,56.48,2540916,3.078,22,3.552,9541.808,243.811,3.94,0.647,0
135,183,19,11140,2,121,944,97952,56.48,2540916,3.078,22,3.552,9541.808,243.811,3.94,0.647,0
135,184,125,11265,0,121,1430,99382,56.48,2540916,3.078,22,3.552,9541.808,243.811,3.94,0.647,0
135,185,108,11373,2,123,1339,100721,56.48,2540916,3.078,22,3.552,9541.808,243.811,3.94,0.647,0
135,186,107,11480,0,123,1310,102031,56.48,2540916,3.078,22,3.552,9541.808,243.811,3.94,0.647,0
135,187,92,11572,0,123,1223,103254,56.48,2540916,3.078,22,3.552,9541.808,243.811,3.94,0.647,0
135,188,54,11626,0,123,600,103854,56.48,2540916,3.078,22,3.552,9541.808,243.811,3.94,0.647,0
135,189,28,11654,2,125,455,104309,34.26,2540916,3.078,22,3.552,9541.808,243.811,3.94,0.647,0
135,190,19,11673,0,125,1077,105386,34.26,2540916,3.078,22,3.552,9541.808,243.811,3.94,0.647,0
135,191,41,11714,1,126,1312,106698,34.26,2540916,3.078,22,3.552,9541.808,243.811,3.94,0.647,0
135,192,67,11781,1,127,889,107587,34.26,2540916,3.078,22,3.552,9541.808,243.811,3.94,0.647,0
135,193,48,11829,0,127,897,108484,34.26,2540916,3.078,22,3.552,9541.808,243.811,3.94,0.647,0
135,194,62,11891,1,128,1345,109829,34.26,2540916,3.078,22,3.552,9541.808,243.811,3.94,0.647,0
135,195,45,11936,0,128,894,110723,34.26,2540916,3.078,22,3.552,9541.808,243.811,3.94,0.647,0
135,196,53,11989,1,129,592,111315,34.26,2540916,3.078,22,3.552,9541.808,243.811,3.94,0.647,0
135,197,11,12000,0,129,1133,112448,34.26,2540916,3.078,22,3.552,9541.808,243.811,3.94,0.647,0
135,198,69,12069,1,130,641,113089,34.26,2540916,3.078,22,3.552,9541.808,243.811,3.94,0.647,0
135,199,34,12103,0,130,1037,114126,34.26,2540916,3.078,22,3.552,9541.808,243.811,3.94,0.647,0
135,200,112,12215,1,131,1255,115381,34.26,2540916,3.078,22,3.552,9541.808,243.811,3.94,0.647,0
135,201,48,12263,0,131,724,116105,34.26,2540916,3.078,22,3.552,9541.808,243.811,3.94,0.647,0
135,202,30,12293,0,131,947,117052,34.26,2540916,3.078,22,3.552,9541.808,243.811,3.94,0.647,0
135,203,33,12326,0,131,0,117052,34.26,2540916,3.078,22,3.552,9541.808,243.811,3.94,0.647,0
135,204,41,12367,1,132,0,117052,34.26,2540916,3.078,22,3.552,9541.808,243.811,3.94,0.647,0
136,1,0,5,0,0,85,1145,96.3,29136808,204.43,25,5.809,2442.804,260.797,7.26,0.574,4
136,2,0,5,0,0,40,1185,96.3,29136808,204.43,25,5.809,2442.804,260.797,7.26,0.574,4
136,3,0,5,0,0,123,1308,96.3,29136808,204.43,25,5.809,2442.804,260.797,7.26,0.574,4
136,4,1,6,0,0,213,1521,96.3,29136808,204.43,25,5.809,2442.804,260.797,7.26,0.574,4
136,5,0,6,0,0,121,1642,96.3,29136808,204.43,25,5.809,2442.804,260.797,7.26,0.574,4
136,6,3,9,0,0,248,1890,96.3,29136808,204.43,25,5.809,2442.804,260.797,7.26,0.574,4
136,7,0,9,0,0,232,2122,96.3,29136808,204.43,25,5.809,2442.804,260.797,7.26,0.574,4
136,8,0,9,0,0,244,2366,96.3,29136808,204.43,25,5.809,2442.804,260.797,7.26,0.574,4
136,9,0,9,0,0,529,2895,96.3,29136808,204.43,25,5.809,2442.804,260.797,7.26,0.574,4
136,10,0,9,0,0,630,3525,96.3,29136808,204.43,25,5.809,2442.804,260.797,7.26,0.574,4
136,11,0,9,0,0,901,4426,96.3,29136808,204.43,25,5.809,2442.804,260.797,7.26,0.574,4
136,12,0,9,0,0,758,5184,96.3,29136808,204.43,25,5.809,2442.804,260.797,7.26,0.574,4
136,13,3,12,0,0,507,5691,96.3,29136808,204.43,25,5.809,2442.804,260.797,7.26,0.574,4
136,14,2,14,0,0,608,6299,96.3,29136808,204.43,25,5.809,2442.804,260.797,7.26,0.574,4
136,15,2,16,0,0,572,6871,96.3,29136808,204.43,25,5.809,2442.804,260.797,7.26,0.574,4
136,16,0,16,0,0,369,7240,96.3,29136808,204.43,25,5.809,2442.804,260.797,7.26,0.574,4
136,17,0,16,0,0,218,7458,96.3,29136808,204.43,25,5.809,2442.804,260.797,7.26,0.574,4
136,18,14,30,0,0,555,8013,96.3,29136808,204.43,25,5.809,2442.804,260.797,7.26,0.574,4
136,19,1,31,0,0,68,8081,96.3,29136808,204.43,25,5.809,2442.804,260.797,7.26,0.574,4
136,20,0,31,0,0,333,8414,96.3,29136808,204.43,25,5.809,2442.804,260.797,7.26,0.574,4
136,21,0,31,0,0,349,8763,96.3,29136808,204.43,25,5.809,2442.804,260.797,7.26,0.574,4
136,22,11,42,0,0,251,9014,96.3,29136808,204.43,25,5.809,2442.804,260.797,7.26,0.574,4
136,23,3,45,0,0,186,9200,96.3,29136808,204.43,25,5.809,2442.804,260.797,7.26,0.574,4
136,24,3,48,0,0,202,9402,96.3,29136808,204.43,25,5.809,2442.804,260.797,7.26,0.574,4
136,25,1,49,0,0,264,9666,96.3,29136808,204.43,25,5.809,2442.804,260.797,7.26,0.574,4
136,26,0,49,0,0,265,9931,96.3,29136808,204.43,25,5.809,2442.804,260.797,7.26,0.574,4
136,27,3,52,0,0,540,10471,96.3,29136808,204.43,25,5.809,2442.804,260.797,7.26,0.574,4
136,28,0,52,0,0,336,10807,96.3,29136808,204.43,25,5.809,2442.804,260.797,7.26,0.574,4
136,29,2,54,0,0,717,11524,96.3,29136808,204.43,25,5.809,2442.804,260.797,7.26,0.574,4
136,30,3,57,0,0,487,12011,96.3,29136808,204.43,25,5.809,2442.804,260.797,7.26,0.574,4
136,31,0,57,0,0,566,12577,96.3,29136808,204.43,25,5.809,2442.804,260.797,7.26,0.574,4
136,32,2,59,0,0,521,13098,96.3,29136808,204.43,25,5.809,2442.804,260.797,7.26,0.574,4
136,33,0,59,0,0,326,13424,96.3,29136808,204.43,25,5.809,2442.804,260.797,7.26,0.574,4
136,34,16,75,0,0,216,13640,96.3,29136808,204.43,25,5.809,2442.804,260.797,7.26,0.574,4
136,35,7,82,0,0,210,13850,96.3,29136808,204.43,25,5.809,2442.804,260.797,7.26,0.574,4
136,36,0,82,0,0,246,14096,96.3,29136808,204.43,25,5.809,2442.804,260.797,7.26,0.574,4
136,37,17,99,0,0,415,14511,92.59,29136808,204.43,25,5.809,2442.804,260.797,7.26,0.574,4
136,38,2,101,0,0,981,15492,92.59,29136808,204.43,25,5.809,2442.804,260.797,7.26,0.574,4
136,39,0,101,0,0,817,16309,92.59,29136808,204.43,25,5.809,2442.804,260.797,7.26,0.574,4
136,40,8,109,0,0,589,16898,92.59,29136808,204.43,25,5.809,2442.804,260.797,7.26,0.574,4
136,41,11,120,0,0,911,17809,92.59,29136808,204.43,25,5.809,2442.804,260.797,7.26,0.574,4
136,42,14,134,0,0,1155,18964,92.59,29136808,204.43,25,5.809,2442.804,260.797,7.26,0.574,4
136,43,83,217,0,0,2376,21340,92.59,29136808,204.43,25,5.809,2442.804,260.797,7.26,0.574,4
136,44,2,219,0,0,1324,22664,92.59,29136808,204.43,25,5.809,2442.804,260.797,7.26,0.574,4
136,45,39,258,0,0,1250,23914,92.59,29136808,204.43,25,5.809,2442.804,260.797,7.26,0.574,4
136,46,18,276,0,0,2777,26691,92.59,29136808,204.43,25,5.809,2442.804,260.797,7.26,0.574,4
136,47,15,291,1,1,1470,28161,92.59,29136808,204.43,25,5.809,2442.804,260.797,7.26,0.574,4
136,48,13,304,1,2,2563,30724,92.59,29136808,204.43,25,5.809,2442.804,260.797,7.26,0.574,4
136,49,71,375,0,2,2282,33006,92.59,29136808,204.43,25,5.809,2442.804,260.797,7.26,0.574,4
136,50,27,402,0,2,2488,35494,92.59,29136808,204.43,25,5.809,2442.804,260.797,7.26,0.574,4
136,51,42,444,0,2,3243,38737,92.59,29136808,204.43,25,5.809,2442.804,260.797,7.26,0.574,4
136,52,43,487,1,3,3780,42517,92.59,29136808,204.43,25,5.809,2442.804,260.797,7.26,0.574,4
136,53,61,548,0,3,3442,45959,92.59,29136808,204.43,25,5.809,2442.804,260.797,7.26,0.574,4
136,54,36,584,0,3,2856,48815,92.59,29136808,204.43,25,5.809,2442.804,260.797,7.26,0.574,4
136,55,19,603,0,3,2827,51642,92.59,29136808,204.43,25,5.809,2442.804,260.797,7.26,0.574,4
136,56,79,682,1,4,3055,54697,92.59,29136808,204.43,25,5.809,2442.804,260.797,7.26,0.574,4
136,57,90,772,0,4,3580,58277,92.59,29136808,204.43,25,5.809,2442.804,260.797,7.26,0.574,4
136,58,114,886,0,4,2639,60916,92.59,29136808,204.43,25,5.809,2442.804,260.797,7.26,0.574,4
136,59,156,1042,1,5,3238,64154,92.59,29136808,204.43,25,5.809,2442.804,260.797,7.26,0.574,4
136,60,170,1212,1,6,2575,66729,92.59,29136808,204.43,25,5.809,2442.804,260.797,7.26,0.574,4
136,61,189,1401,0,6,2858,69587,92.59,29136808,204.43,25,5.809,2442.804,260.797,7.26,0.574,4
136,62,171,1572,2,8,2316,71903,92.59,29136808,204.43,25,5.809,2442.804,260.797,7.26,0.574,4
136,63,226,1798,0,8,3440,75343,92.59,29136808,204.43,25,5.809,2442.804,260.797,7.26,0.574,4
136,64,301,2099,0,8,4924,80267,92.59,29136808,204.43,25,5.809,2442.804,260.797,7.26,0.574,4
136,65,201,2300,1,9,3867,84134,92.59,29136808,204.43,25,5.809,2442.804,260.797,7.26,0.574,4
136,66,334,2634,1,10,4232,88366,92.59,29136808,204.43,25,5.809,2442.804,260.797,7.26,0.574,4
136,67,278,2912,1,11,4111,92477,92.59,29136808,204.43,25,5.809,2442.804,260.797,7.26,0.574,4
136,68,0,2912,0,11,3728,96205,92.59,29136808,204.43,25,5.809,2442.804,260.797,7.26,0.574,4
136,69,536,3448,2,13,4766,100971,92.59,29136808,204.43,25,5.809,2442.804,260.797,7.26,0.574,4
136,70,314,3762,1,14,5359,106330,92.59,29136808,204.43,25,5.809,2442.804,260.797,7.26,0.574,4
136,71,323,4085,1,15,4414,110744,92.59,29136808,204.43,25,5.809,2442.804,260.797,7.26,0.574,4
136,72,279,4364,0,15,5193,115937,92.59,29136808,204.43,25,5.809,2442.804,260.797,7.26,0.574,4
136,73,250,4614,0,15,5925,121862,92.59,29136808,204.43,25,5.809,2442.804,260.797,7.26,0.574,4
136,74,448,5062,1,16,5426,127288,92.59,29136808,204.43,25,5.809,2442.804,260.797,7.26,0.574,4
136,75,273,5335,2,18,6089,133377,92.59,29136808,204.43,25,5.809,2442.804,260.797,7.26,0.574,4
136,76,425,5760,1,19,5306,138683,92.59,29136808,204.43,25,5.809,2442.804,260.797,7.26,0.574,4
136,77,451,6211,0,19,5055,143738,92.59,29136808,204.43,25,5.809,2442.804,260.797,7.26,0.574,4
136,78,380,6591,0,19,6034,149772,92.59,29136808,204.43,25,5.809,2442.804,260.797,7.26,0.574,4
136,79,586,7177,1,20,5746,155518,92.59,29136808,204.43,25,5.809,2442.804,260.797,7.26,0.574,4
136,80,671,7848,2,22,6231,161749,92.59,29136808,204.43,25,5.809,2442.804,260.797,7.26,0.574,4
136,81,426,8274,0,22,7416,169165,92.59,29136808,204.43,25,5.809,2442.804,260.797,7.26,0.574,4
136,82,331,8605,0,22,6008,175173,92.59,29136808,204.43,25,5.809,2442.804,260.797,7.26,0.574,4
136,83,421,9026,1,23,6198,181371,92.59,29136808,204.43,25,5.809,2442.804,260.797,7.26,0.574,4
136,84,0,9026,0,23,4995,186366,92.59,29136808,204.43,25,5.809,2442.804,260.797,7.26,0.574,4
136,85,0,9026,0,23,6828,193194,92.59,29136808,204.43,25,5.809,2442.804,260.797,7.26,0.574,4
136,86,1702,10728,0,23,6543,199737,92.59,29136808,204.43,25,5.809,2442.804,260.797,7.26,0.574,4
136,87,434,11162,3,26,6534,206271,92.59,29136808,204.43,25,5.809,2442.804,260.797,7.26,0.574,4
136,88,593,11755,1,27,4606,210877,92.59,29136808,204.43,25,5.809,2442.804,260.797,7.26,0.574,4
136,89,0,11755,0,27,4962,215839,92.59,29136808,204.43,25,5.809,2442.804,260.797,7.26,0.574,4
136,90,1017,12772,1,28,7791,223630,92.59,29136808,204.43,25,5.809,2442.804,260.797,7.26,0.574,4
136,91,476,13248,1,29,4711,228341,92.59,29136808,204.43,25,5.809,2442.804,260.797,7.26,0.574,4
136,92,316,13564,0,29,4886,233227,92.59,29136808,204.43,25,5.809,2442.804,260.797,7.26,0.574,4
136,93,482,14046,1,30,4537,237764,92.59,29136808,204.43,25,5.809,2442.804,260.797,7.26,0.574,4
136,94,473,14519,1,31,4483,242247,92.59,29136808,204.43,25,5.809,2442.804,260.797,7.26,0.574,4
136,95,740,15259,1,32,4050,246297,92.59,29136808,204.43,25,5.809,2442.804,260.797,7.26,0.574,4
136,96,232,15491,2,34,4710,251007,92.59,29136808,204.43,25,5.809,2442.804,260.797,7.26,0.574,4
136,97,293,15784,0,34,4721,255728,92.59,29136808,204.43,25,5.809,2442.804,260.797,7.26,0.574,4
136,98,180,15964,1,35,6133,261861,92.59,29136808,204.43,25,5.809,2442.804,260.797,7.26,0.574,4
136,99,0,15964,0,35,4696,266557,92.59,29136808,204.43,25,5.809,2442.804,260.797,7.26,0.574,4
136,100,459,16423,0,35,4588,271145,92.59,29136808,204.43,25,5.809,2442.804,260.797,7.26,0.574,4
136,101,108,16531,0,35,4806,275951,92.59,29136808,204.43,25,5.809,2442.804,260.797,7.26,0.574,4
136,102,118,16649,0,35,3648,279599,92.59,29136808,204.43,25,5.809,2442.804,260.797,7.26,0.574,4
136,103,70,16719,3,38,3916,283515,92.59,29136808,204.43,25,5.809,2442.804,260.797,7.26,0.574,4
136,104,82,16801,0,38,5802,289317,92.59,29136808,204.43,25,5.809,2442.804,260.797,7.26,0.574,4
136,105,144,16945,0,38,4422,293739,92.59,29136808,204.43,25,5.809,2442.804,260.797,7.26,0.574,4
136,106,116,17061,0,38,5090,298829,92.59,29136808,204.43,25,5.809,2442.804,260.797,7.26,0.574,4
136,107,116,17177,1,39,4981,303810,92.59,29136808,204.43,25,5.809,2442.804,260.797,7.26,0.574,4
136,108,167,17344,0,39,4688,308498,92.59,29136808,204.43,25,5.809,2442.804,260.797,7.26,0.574,4
136,109,101,17445,1,40,3331,311829,92.59,29136808,204.43,25,5.809,2442.804,260.797,7.26,0.574,4
136,110,57,17502,0,40,3741,315570,92.59,29136808,204.43,25,5.809,2442.804,260.797,7.26,0.574,4
136,111,156,17658,0,40,4302,319872,92.59,29136808,204.43,25,5.809,2442.804,260.797,7.26,0.574,4
136,112,186,17844,0,40,3544,323416,77.78,29136808,204.43,25,5.809,2442.804,260.797,7.26,0.574,4
136,113,100,17944,0,40,4198,327614,74.07,29136808,204.43,25,5.809,2442.804,260.797,7.26,0.574,4
136,114,150,18094,2,42,3481,331095,74.07,29136808,204.43,25,5.809,2442.804,260.797,7.26,0.574,4
136,115,147,18241,1,43,3987,335082,78.7,29136808,204.43,25,5.809,2442.804,260.797,7.26,0.574,4
136,116,133,18374,1,44,4075,339157,78.7,29136808,204.43,25,5.809,2442.804,260.797,7.26,0.574,4
136,117,109,18483,1,45,3300,342457,78.7,29136808,204.43,25,5.809,2442.804,260.797,7.26,0.574,4
136,118,130,18613,0,45,4818,347275,78.7,29136808,204.43,25,5.809,2442.804,260.797,7.26,0.574,4
136,119,139,18752,3,48,5032,352307,78.7,29136808,204.43,25,5.809,2442.804,260.797,7.26,0.574,4
136,120,311,19063,1,49,6037,358344,78.7,29136808,204.43,25,5.809,2442.804,260.797,7.26,0.574,4
136,121,210,19273,0,49,6304,364648,78.7,29136808,204.43,25,5.809,2442.804,260.797,7.26,0.574,4
136,122,274,19547,3,52,10768,375416,78.7,29136808,204.43,25,5.809,2442.804,260.797,7.26,0.574,4
136,123,224,19771,4,56,6993,382409,78.7,29136808,204.43,25,5.809,2442.804,260.797,7.26,0.574,4
136,124,315,20086,0,56,8861,391270,78.7,29136808,204.43,25,5.809,2442.804,260.797,7.26,0.574,4
136,125,246,20332,1,57,7637,398907,78.7,29136808,204.43,25,5.809,2442.804,260.797,7.26,0.574,4
136,126,418,20750,0,57,7687,406594,78.7,29136808,204.43,25,5.809,2442.804,260.797,7.26,0.574,4
136,127,259,21009,1,58,6359,412953,78.7,29136808,204.43,25,5.809,2442.804,260.797,7.26,0.574,4
136,128,381,21390,2,60,6622,419575,78.7,29136808,204.43,25,5.809,2442.804,260.797,7.26,0.574,4
136,129,360,21750,5,65,7926,427501,84.26,29136808,204.43,25,5.809,2442.804,260.797,7.26,0.574,4
136,130,464,22214,5,70,7788,435289,84.26,29136808,204.43,25,5.809,2442.804,260.797,7.26,0.574,4
136,131,378,22592,3,73,8515,443804,84.26,29136808,204.43,25,5.809,2442.804,260.797,7.26,0.574,4
136,132,380,22972,2,75,8432,452236,84.26,29136808,204.43,25,5.809,2442.804,260.797,7.26,0.574,4
136,133,338,23310,4,79,10462,462698,90.74,29136808,204.43,25,5.809,2442.804,260.797,7.26,0.574,4
136,134,638,23948,4,83,10481,473179,90.74,29136808,204.43,25,5.809,2442.804,260.797,7.26,0.574,4
136,135,484,24432,8,91,9859,483038,90.74,29136808,204.43,25,5.809,2442.804,260.797,7.26,0.574,4
136,136,525,24957,4,95,11575,494613,90.74,29136808,204.43,25,5.809,2442.804,260.797,7.26,0.574,4
136,137,594,25551,4,99,11047,505660,90.74,29136808,204.43,25,5.809,2442.804,260.797,7.26,0.574,4
136,138,468,26019,3,102,12247,517907,90.74,29136808,204.43,25,5.809,2442.804,260.797,7.26,0.574,4
136,139,641,26660,2,104,11520,529427,90.74,29136808,204.43,25,5.809,2442.804,260.797,7.26,0.574,4
136,140,581,27241,3,107,13439,542866,90.74,29136808,204.43,25,5.809,2442.804,260.797,7.26,0.574,4
136,141,1016,28257,7,114,11522,554388,85.19,29136808,204.43,25,5.809,2442.804,260.797,7.26,0.574,4
136,142,681,28938,6,120,11832,566220,85.19,29136808,204.43,25,5.809,2442.804,260.797,7.26,0.574,4
136,143,707,29645,6,126,13679,579899,82.41,29136808,204.43,25,5.809,2442.804,260.797,7.26,0.574,4
136,144,838,30483,11,137,12519,592418,82.41,29136808,204.43,25,5.809,2442.804,260.797,7.26,0.574,4
136,145,634,31117,9,146,8026,600444,82.41,29136808,204.43,25,5.809,2442.804,260.797,7.26,0.574,4
136,146,818,31935,3,149,10234,610678,82.41,29136808,204.43,25,5.809,2442.804,260.797,7.26,0.574,4
136,147,743,32678,8,157,11321,621999,82.41,29136808,204.43,25,5.809,2442.804,260.797,7.26,0.574,4
136,148,855,33533,7,164,13253,635252,82.41,29136808,204.43,25,5.809,2442.804,260.797,7.26,0.574,4
136,149,885,34418,11,175,12629,647881,82.41,29136808,204.43,25,5.809,2442.804,260.797,7.26,0.574,4
136,150,1111,35529,8,183,10229,658110,82.41,29136808,204.43,25,5.809,2442.804,260.797,7.26,0.574,4
136,151,927,36456,12,195,11516,669626,82.41,29136808,204.43,25,5.809,2442.804,260.797,7.26,0.574,4
136,152,884,37340,12,207,12717,682343,82.41,29136808,204.43,25,5.809,2442.804,260.797,7.26,0.574,4
136,153,1221,38561,14,221,11129,693472,82.41,29136808,204.43,25,5.809,2442.804,260.797,7.26,0.574,4
136,154,899,39460,7,228,12088,705560,82.41,29136808,204.43,25,5.809,2442.804,260.797,7.26,0.574,4
136,155,1069,40529,11,239,12879,718439,76.85,29136808,204.43,25,5.809,2442.804,260.797,7.26,0.574,4
136,156,1120,41649,12,251,13413,731852,76.85,29136808,204.43,25,5.809,2442.804,260.797,7.26,0.574,4
136,157,1228,42877,6,257,13638,745490,76.85,29136808,204.43,25,5.809,2442.804,260.797,7.26,0.574,4
136,158,1359,44236,14,271,12473,757963,76.85,29136808,204.43,25,5.809,2442.804,260.797,7.26,0.574,4
136,159,1041,45277,9,280,10382,768345,74.07,29136808,204.43,25,5.809,2442.804,260.797,7.26,0.574,4
136,160,980,46257,9,289,9218,777563,74.07,29136808,204.43,25,5.809,2442.804,260.797,7.26,0.574,4
136,161,979,47236,11,300,10611,788174,74.07,29136808,204.43,25,5.809,2442.804,260.797,7.26,0.574,4
136,162,902,48138,6,306,11167,799341,74.07,29136808,204.43,25,5.809,2442.804,260.797,7.26,0.574,4
136,163,1081,49219,6,312,11144,810485,74.07,29136808,204.43,25,5.809,2442.804,260.797,7.26,0.574,4
136,164,1246,50465,5,317,10701,821186,74.07,29136808,204.43,25,5.809,2442.804,260.797,7.26,0.574,4
136,165,1454,51919,5,322,10176,831362,74.07,29136808,204.43,25,5.809,2442.804,260.797,7.26,0.574,4
136,166,1201,53120,14,336,9165,840527,74.07,29136808,204.43,25,5.809,2442.804,260.797,7.26,0.574,4
136,167,1039,54159,9,345,10878,851405,76.85,29136808,204.43,25,5.809,2442.804,260.797,7.26,0.574,4
136,168,1170,55329,15,360,10375,861780,76.85,29136808,204.43,25,5.809,2442.804,260.797,7.26,0.574,4
136,169,1459,56788,11,371,10494,872274,76.85,29136808,204.43,25,5.809,2442.804,260.797,7.26,0.574,4
136,170,1539,58327,8,379,10641,882915,76.85,29136808,204.43,25,5.809,2442.804,260.797,7.26,0.574,4
136,171,1246,59573,4,383,11458,894373,76.85,29136808,204.43,25,5.809,2442.804,260.797,7.26,0.574,4
136,172,2020,61593,7,390,10333,904706,76.85,29136808,204.43,25,5.809,2442.804,260.797,7.26,0.574,4
136,173,1204,62797,11,401,9584,914290,76.85,29136808,204.43,25,5.809,2442.804,260.797,7.26,0.574,4
136,174,1325,64122,10,411,9533,923823,76.85,29136808,204.43,25,5.809,2442.804,260.797,7.26,0.574,4
136,175,1154,65276,16,427,11154,934977,76.85,29136808,204.43,25,5.809,2442.804,260.797,7.26,0.574,4
136,176,1356,66632,2,429,9497,944474,76.85,29136808,204.43,25,5.809,2442.804,260.797,7.26,0.574,4
136,177,1172,67804,7,436,11449,955923,76.85,29136808,204.43,25,5.809,2442.804,260.797,7.26,0.574,4
136,178,1497,69301,17,453,12262,968185,76.85,29136808,204.43,25,5.809,2442.804,260.797,7.26,0.574,4
136,179,1313,70614,6,459,10019,978204,76.85,29136808,204.43,25,5.809,2442.804,260.797,7.26,0.574,4
136,180,1207,71821,8,467,10123,988327,76.85,29136808,204.43,25,5.809,2442.804,260.797,7.26,0.574,4
136,181,1573,73394,10,477,10080,998407,76.85,29136808,204.43,25,5.809,2442.804,260.797,7.26,0.574,4
136,182,1351,74745,4,481,10891,1009298,76.85,29136808,204.43,25,5.809,2442.804,260.797,7.26,0.574,4
136,183,1513,76258,10,491,12205,1021503,76.85,29136808,204.43,25,5.809,2442.804,260.797,7.26,0.574,4
136,184,1559,77817,7,498,12444,1033947,76.85,29136808,204.43,25,5.809,2442.804,260.797,7.26,0.574,4
136,185,1911,79728,11,509,14739,1048686,76.85,29136808,204.43,25,5.809,2442.804,260.797,7.26,0.574,4
136,186,2722,82450,11,520,12978,1061664,76.85,29136808,204.43,25,5.809,2442.804,260.797,7.26,0.574,4
136,187,2120,84570,8,528,12784,1074448,76.85,29136808,204.43,25,5.809,2442.804,260.797,7.26,0.574,4
136,188,2253,86823,7,535,13781,1088229,76.85,29136808,204.43,25,5.809,2442.804,260.797,7.26,0.574,4
136,189,2440,89263,19,554,11047,1099276,76.85,29136808,204.43,25,5.809,2442.804,260.797,7.26,0.574,4
136,190,1551,90814,9,563,14209,1113485,76.85,29136808,204.43,25,5.809,2442.804,260.797,7.26,0.574,4
136,191,3439,94253,15,578,18473,1131958,76.85,29136808,204.43,25,5.809,2442.804,260.797,7.26,0.574,4
136,192,4364,98617,12,590,13279,1145237,76.85,29136808,204.43,25,5.809,2442.804,260.797,7.26,0.574,4
136,193,2059,100676,10,600,19320,1164557,76.85,29136808,204.43,25,5.809,2442.804,260.797,7.26,0.574,4
136,194,5008,105684,14,614,12427,1176984,76.85,29136808,204.43,25,5.809,2442.804,260.797,7.26,0.574,4
136,195,2071,107755,22,636,14530,1191514,76.85,29136808,204.43,25,5.809,2442.804,260.797,7.26,0.574,4
136,196,4047,111802,9,645,15577,1207091,76.85,29136808,204.43,25,5.809,2442.804,260.797,7.26,0.574,4
136,197,3556,115358,18,663,13947,1221038,76.85,29136808,204.43,25,5.809,2442.804,260.797,7.26,0.574,4
136,198,2638,117996,12,675,16598,1237636,76.85,29136808,204.43,25,5.809,2442.804,260.797,7.26,0.574,4
136,199,3749,121745,19,694,16531,1254167,76.85,29136808,204.43,25,5.809,2442.804,260.797,7.26,0.574,4
136,200,4392,126137,21,715,15438,1269605,76.85,29136808,204.43,25,5.809,2442.804,260.797,7.26,0.574,4
136,201,3167,129304,12,727,13749,1283354,76.85,29136808,204.43,25,5.809,2442.804,260.797,7.26,0.574,4
136,202,2942,132246,12,739,17564,1300918,76.85,29136808,204.43,25,5.809,2442.804,260.797,7.26,0.574,4
136,203,3790,136036,18,757,0,1300918,76.85,29136808,204.43,25,5.809,2442.804,260.797,7.26,0.574,4
136,204,3093,139129,8,765,0,1300918,76.85,29136808,204.43,25,5.809,2442.804,260.797,7.26,0.574,4
137,1,845,12595,175,1039,0,0,79.63,17134873,508.544,43.2,18.779,48472.545,109.361,5.29,0.931,0
137,2,1019,13614,134,1173,0,0,79.63,17134873,508.544,43.2,18.779,48472.545,109.361,5.29,0.931,0
137,3,1083,14697,166,1339,0,0,79.63,17134873,508.544,43.2,18.779,48472.545,109.361,5.29,0.931,0
137,4,1026,15723,148,1487,0,0,79.63,17134873,508.544,43.2,18.779,48472.545,109.361,5.29,0.931,0
137,5,904,16627,164,1651,0,92261,79.63,17134873,508.544,43.2,18.779,48472.545,109.361,5.29,0.931,0
137,6,1224,17851,115,1766,0,92261,79.63,17134873,508.544,43.2,18.779,48472.545,109.361,5.29,0.931,0
137,7,952,18803,101,1867,0,92261,79.63,17134873,508.544,43.2,18.779,48472.545,109.361,5.29,0.931,0
137,8,777,19580,234,2101,0,92261,79.63,17134873,508.544,43.2,18.779,48472.545,109.361,5.29,0.931,0
137,9,969,20549,147,2248,0,92261,79.63,17134873,508.544,43.2,18.779,48472.545,109.361,5.29,0.931,0
137,10,1213,21762,148,2396,0,92261,79.63,17134873,508.544,43.2,18.779,48472.545,109.361,5.29,0.931,0
137,11,1335,23097,115,2511,0,92261,79.63,17134873,508.544,43.2,18.779,48472.545,109.361,5.29,0.931,0
137,12,1316,24413,132,2643,0,131221,79.63,17134873,508.544,43.2,18.779,48472.545,109.361,5.29,0.931,0
137,13,1174,25587,94,2737,0,131221,79.63,17134873,508.544,43.2,18.779,48472.545,109.361,5.29,0.931,0
137,14,964,26551,86,2823,0,131221,79.63,17134873,508.544,43.2,18.779,48472.545,109.361,5.29,0.931,0
137,15,868,27419,122,2945,0,131221,79.63,17134873,508.544,43.2,18.779,48472.545,109.361,5.29,0.931,0
137,16,734,28153,189,3134,0,131221,79.63,17134873,508.544,43.2,18.779,48472.545,109.361,5.29,0.931,0
137,17,1061,29214,181,3315,0,131221,79.63,17134873,508.544,43.2,18.779,48472.545,109.361,5.29,0.931,0
137,18,1235,30449,144,3459,0,131221,79.63,17134873,508.544,43.2,18.779,48472.545,109.361,5.29,0.931,0
137,19,1140,31589,142,3601,0,171323,79.63,17134873,508.544,43.2,18.779,48472.545,109.361,5.29,0.931,0
137,20,1066,32655,83,3684,0,171323,79.63,17134873,508.544,43.2,18.779,48472.545,109.361,5.29,0.931,0
137,21,750,33405,67,3751,0,171323,79.63,17134873,508.544,43.2,18.779,48472.545,109.361,5.29,0.931,0
137,22,729,34134,165,3916,0,171323,79.63,17134873,508.544,43.2,18.779,48472.545,109.361,5.29,0.931,0
137,23,708,34842,138,4054,0,171323,79.63,17134873,508.544,43.2,18.779,48472.545,109.361,5.29,0.931,0
137,24,887,35729,123,4177,0,171323,79.63,17134873,508.544,43.2,18.779,48472.545,109.361,5.29,0.931,0
137,25,806,36535,112,4289,0,171323,79.63,17134873,508.544,43.2,18.779,48472.545,109.361,5.29,0.931,0
137,26,655,37190,120,4409,0,209718,79.63,17134873,508.544,43.2,18.779,48472.545,109.361,5.29,0.931,0
137,27,655,37845,66,4475,0,209718,79.63,17134873,508.544,43.2,18.779,48472.545,109.361,5.29,0.931,0
137,28,400,38245,43,4518,0,209718,79.63,17134873,508.544,43.2,18.779,48472.545,109.361,5.29,0.931,0
137,29,171,38416,48,4566,0,209718,79.63,17134873,508.544,43.2,18.779,48472.545,109.361,5.29,0.931,0
137,30,386,38802,145,4711,0,209718,79.63,17134873,508.544,43.2,18.779,48472.545,109.361,5.29,0.931,0
137,31,514,39316,84,4795,0,209718,79.63,17134873,508.544,43.2,18.779,48472.545,109.361,5.29,0.931,0
137,32,475,39791,98,4893,0,209718,79.63,17134873,508.544,43.2,18.779,48472.545,109.361,5.29,0.931,0
137,33,445,40236,94,4987,0,238672,79.63,17134873,508.544,43.2,18.779,48472.545,109.361,5.29,0.931,0
137,34,335,40571,69,5056,0,238672,79.63,17134873,508.544,43.2,18.779,48472.545,109.361,5.29,0.931,0
137,35,199,40770,26,5082,0,238672,79.63,17134873,508.544,43.2,18.779,48472.545,109.361,5.29,0.931,0
137,36,317,41087,86,5168,0,238672,79.63,17134873,508.544,43.2,18.779,48472.545,109.361,5.29,0.931,0
137,37,232,41319,36,5204,0,238672,79.63,17134873,508.544,43.2,18.779,48472.545,109.361,5.29,0.931,0
137,38,455,41774,84,5288,0,238672,79.63,17134873,508.544,43.2,18.779,48472.545,109.361,5.29,0.931,0
137,39,319,42093,71,5359,0,238672,79.63,17134873,508.544,43.2,18.779,48472.545,109.361,5.29,0.931,0
137,40,289,42382,63,5422,0,267678,79.63,17134873,508.544,43.2,18.779,48472.545,109.361,5.29,0.931,0
137,41,245,42627,18,5440,0,267678,68.52,17134873,508.544,43.2,18.779,48472.545,109.361,5.29,0.931,0
137,42,161,42788,16,5456,0,267678,68.52,17134873,508.544,43.2,18.779,48472.545,109.361,5.29,0.931,0
137,43,196,42984,54,5510,0,267678,68.52,17134873,508.544,43.2,18.779,48472.545,109.361,5.29,0.931,0
137,44,227,43211,52,5562,0,267678,68.52,17134873,508.544,43.2,18.779,48472.545,109.361,5.29,0.931,0
137,45,270,43481,28,5590,0,267678,68.52,17134873,508.544,43.2,18.779,48472.545,109.361,5.29,0.931,0
137,46,200,43681,53,5643,0,267678,68.52,17134873,508.544,43.2,18.779,48472.545,109.361,5.29,0.931,0
137,47,189,43870,27,5670,0,300365,68.52,17134873,508.544,43.2,18.779,48472.545,109.361,5.29,0.931,0
137,48,125,43995,10,5680,0,300365,68.52,17134873,508.544,43.2,18.779,48472.545,109.361,5.29,0.931,0
137,49,146,44141,14,5694,0,300365,68.52,17134873,508.544,43.2,18.779,48472.545,109.361,5.29,0.931,0
137,50,108,44249,21,5715,0,300365,68.52,17134873,508.544,43.2,18.779,48472.545,109.361,5.29,0.931,0
137,51,198,44447,33,5748,0,300365,68.52,17134873,508.544,43.2,18.779,48472.545,109.361,5.29,0.931,0
137,52,253,44700,27,5775,0,300365,68.52,17134873,508.544,43.2,18.779,48472.545,109.361,5.29,0.931,0
137,53,188,44888,13,5788,0,300365,68.52,17134873,508.544,43.2,18.779,48472.545,109.361,5.29,0.931,0
137,54,176,45064,23,5811,0,329704,68.52,17134873,508.544,43.2,18.779,48472.545,109.361,5.29,0.931,0
137,55,172,45236,11,5822,0,329704,68.52,17134873,508.544,43.2,18.779,48472.545,109.361,5.29,0.931,0
137,56,209,45445,8,5830,0,329704,68.52,17134873,508.544,43.2,18.779,48472.545,109.361,5.29,0.931,0
137,57,133,45578,26,5856,0,329704,68.52,17134873,508.544,43.2,18.779,48472.545,109.361,5.29,0.931,0
137,58,190,45768,15,5871,0,329704,68.52,17134873,508.544,43.2,18.779,48472.545,109.361,5.29,0.931,0
137,59,182,45950,32,5903,0,329704,68.52,17134873,508.544,43.2,18.779,48472.545,109.361,5.29,0.931,0
137,60,176,46126,28,5931,0,329704,68.52,17134873,508.544,43.2,18.779,48472.545,109.361,5.29,0.931,0
137,61,131,46257,20,5951,0,363575,68.52,17134873,508.544,43.2,18.779,48472.545,109.361,5.29,0.931,0
137,62,185,46442,5,5956,0,363575,62.96,17134873,508.544,43.2,18.779,48472.545,109.361,5.29,0.931,0
137,63,103,46545,6,5962,0,363575,62.96,17134873,508.544,43.2,18.779,48472.545,109.361,5.29,0.931,0
137,64,102,46647,5,5967,0,363575,62.96,17134873,508.544,43.2,18.779,48472.545,109.361,5.29,0.931,0
137,65,86,46733,10,5977,0,363575,62.96,17134873,508.544,43.2,18.779,48472.545,109.361,5.29,0.931,0
137,66,209,46942,13,5990,0,363575,62.96,17134873,508.544,43.2,18.779,48472.545,109.361,5.29,0.931,0
137,67,210,47152,15,6005,0,363575,62.96,17134873,508.544,43.2,18.779,48472.545,109.361,5.29,0.931,0
137,68,183,47335,6,6011,0,422531,62.96,17134873,508.544,43.2,18.779,48472.545,109.361,5.29,0.931,0
137,69,239,47574,2,6013,0,422531,62.96,17134873,508.544,43.2,18.779,48472.545,109.361,5.29,0.931,0
137,70,165,47739,3,6016,0,422531,62.96,17134873,508.544,43.2,18.779,48472.545,109.361,5.29,0.931,0
137,71,164,47903,15,6031,0,422531,62.96,17134873,508.544,43.2,18.779,48472.545,109.361,5.29,0.931,0
137,72,184,48087,11,6042,0,422531,62.96,17134873,508.544,43.2,18.779,48472.545,109.361,5.29,0.931,0
137,73,164,48251,2,6044,0,422531,62.96,17134873,508.544,43.2,18.779,48472.545,109.361,5.29,0.931,0
137,74,210,48461,9,6053,0,422531,62.96,17134873,508.544,43.2,18.779,48472.545,109.361,5.29,0.931,0
137,75,179,48640,4,6057,0,486309,62.96,17134873,508.544,43.2,18.779,48472.545,109.361,5.29,0.931,0
137,76,143,48783,2,6059,0,486309,59.26,17134873,508.544,43.2,18.779,48472.545,109.361,5.29,0.931,0
137,77,165,48948,6,6065,0,486309,59.26,17134873,508.544,43.2,18.779,48472.545,109.361,5.29,0.931,0
137,78,139,49087,5,6070,0,486309,59.26,17134873,508.544,43.2,18.779,48472.545,109.361,5.29,0.931,0
137,79,117,49204,4,6074,0,486309,59.26,17134873,508.544,43.2,18.779,48472.545,109.361,5.29,0.931,0
137,80,115,49319,4,6078,0,486309,59.26,17134873,508.544,43.2,18.779,48472.545,109.361,5.29,0.931,0
137,81,107,49426,3,6081,0,486309,59.26,17134873,508.544,43.2,18.779,48472.545,109.361,5.29,0.931,0
137,82,76,49502,8,6089,0,551850,59.26,17134873,508.544,43.2,18.779,48472.545,109.361,5.29,0.931,0
137,83,91,49593,1,6090,0,551850,59.26,17134873,508.544,43.2,18.779,48472.545,109.361,5.29,0.931,0
137,84,65,49658,0,6090,0,551850,59.26,17134873,508.544,43.2,18.779,48472.545,109.361,5.29,0.931,0
137,85,64,49722,5,6095,0,551850,59.26,17134873,508.544,43.2,18.779,48472.545,109.361,5.29,0.931,0
137,86,82,49804,2,6097,0,551850,59.26,17134873,508.544,43.2,18.779,48472.545,109.361,5.29,0.931,0
137,87,110,49914,3,6100,0,551850,59.26,17134873,508.544,43.2,18.779,48472.545,109.361,5.29,0.931,0
137,88,91,50005,3,6103,0,551850,59.26,17134873,508.544,43.2,18.779,48472.545,109.361,5.29,0.931,0
137,89,69,50074,2,6105,0,615990,59.26,17134873,508.544,43.2,18.779,48472.545,109.361,5.29,0.931,0
137,90,73,50147,0,6105,0,615990,59.26,17134873,508.544,43.2,18.779,48472.545,109.361,5.29,0.931,0
137,91,76,50223,2,6107,0,615990,59.26,17134873,508.544,43.2,18.779,48472.545,109.361,5.29,0.931,0
137,92,50,50273,6,6113,0,615990,39.81,17134873,508.544,43.2,18.779,48472.545,109.361,5.29,0.931,0
137,93,62,50335,2,6115,0,615990,39.81,17134873,508.544,43.2,18.779,48472.545,109.361,5.29,0.931,0
137,94,77,50412,3,6118,0,615990,39.81,17134873,508.544,43.2,18.779,48472.545,109.361,5.29,0.931,0
137,95,75,50487,2,6120,0,615990,39.81,17134873,508.544,43.2,18.779,48472.545,109.361,5.29,0.931,0
137,96,61,50548,6,6126,0,685648,39.81,17134873,508.544,43.2,18.779,48472.545,109.361,5.29,0.931,0
137,97,73,50621,1,6127,0,685648,39.81,17134873,508.544,43.2,18.779,48472.545,109.361,5.29,0.931,0
137,98,36,50657,1,6128,0,685648,39.81,17134873,508.544,43.2,18.779,48472.545,109.361,5.29,0.931,0
137,99,37,50694,4,6132,0,685648,39.81,17134873,508.544,43.2,18.779,48472.545,109.361,5.29,0.931,0
137,100,52,50746,3,6135,0,685648,39.81,17134873,508.544,43.2,18.779,48472.545,109.361,5.29,0.931,0
137,101,52,50798,0,6135,0,685648,39.81,17134873,508.544,43.2,18.779,48472.545,109.361,5.29,0.931,0
137,102,42,50840,0,6135,0,685648,39.81,17134873,508.544,43.2,18.779,48472.545,109.361,5.29,0.931,0
137,103,81,50921,0,6135,0,764957,39.81,17134873,508.544,43.2,18.779,48472.545,109.361,5.29,0.931,0
137,104,101,51022,0,6135,0,764957,39.81,17134873,508.544,43.2,18.779,48472.545,109.361,5.29,0.931,0
137,105,71,51093,0,6135,0,764957,39.81,17134873,508.544,43.2,18.779,48472.545,109.361,5.29,0.931,0
137,106,53,51146,0,6135,0,764957,39.81,17134873,508.544,43.2,18.779,48472.545,109.361,5.29,0.931,0
137,107,106,51252,1,6136,0,764957,39.81,17134873,508.544,43.2,18.779,48472.545,109.361,5.29,0.931,0
137,108,99,51351,0,6136,0,764957,39.81,17134873,508.544,43.2,18.779,48472.545,109.361,5.29,0.931,0
137,109,103,51454,0,6136,0,764957,39.81,17134873,508.544,43.2,18.779,48472.545,109.361,5.29,0.931,0
137,110,127,51581,0,6136,0,854740,39.81,17134873,508.544,43.2,18.779,48472.545,109.361,5.29,0.931,0
137,111,144,51725,0,6136,0,854740,39.81,17134873,508.544,43.2,18.779,48472.545,109.361,5.29,0.931,0
137,112,185,51910,0,6136,0,854740,39.81,17134873,508.544,43.2,18.779,48472.545,109.361,5.29,0.931,0
137,113,163,52073,0,6136,0,854740,39.81,17134873,508.544,43.2,18.779,48472.545,109.361,5.29,0.931,0
137,114,168,52241,3,6139,0,854740,39.81,17134873,508.544,43.2,18.779,48472.545,109.361,5.29,0.931,0
137,115,163,52404,0,6139,0,854740,39.81,17134873,508.544,43.2,18.779,48472.545,109.361,5.29,0.931,0
137,116,191,52595,0,6139,0,854740,39.81,17134873,508.544,43.2,18.779,48472.545,109.361,5.29,0.931,0
137,117,137,52732,1,6140,0,968484,39.81,17134873,508.544,43.2,18.779,48472.545,109.361,5.29,0.931,0
137,118,214,52946,0,6140,0,968484,39.81,17134873,508.544,43.2,18.779,48472.545,109.361,5.29,0.931,0
137,119,205,53151,0,6140,0,968484,39.81,17134873,508.544,43.2,18.779,48472.545,109.361,5.29,0.931,0
137,120,223,53374,0,6140,0,968484,39.81,17134873,508.544,43.2,18.779,48472.545,109.361,5.29,0.931,0
137,121,247,53621,0,6140,0,968484,39.81,17134873,508.544,43.2,18.779,48472.545,109.361,5.29,0.931,0
137,122,342,53963,0,6140,0,968484,39.81,17134873,508.544,43.2,18.779,48472.545,109.361,5.29,0.931,0
137,123,338,54301,0,6140,0,968484,39.81,17134873,508.544,43.2,18.779,48472.545,109.361,5.29,0.931,0
137,124,431,54732,0,6140,0,1090505,39.81,17134873,508.544,43.2,18.779,48472.545,109.361,5.29,0.931,0
137,125,311,55043,0,6140,0,1090505,39.81,17134873,508.544,43.2,18.779,48472.545,109.361,5.29,0.931,0
137,126,372,55415,0,6140,0,1090505,39.81,17134873,508.544,43.2,18.779,48472.545,109.361,5.29,0.931,0
137,127,540,55955,1,6141,0,1090505,39.81,17134873,508.544,43.2,18.779,48472.545,109.361,5.29,0.931,0
137,128,426,56381,4,6145,0,1090505,39.81,17134873,508.544,43.2,18.779,48472.545,109.361,5.29,0.931,0
137,129,601,56982,0,6145,0,1090505,39.81,17134873,508.544,43.2,18.779,48472.545,109.361,5.29,0.931,0
137,130,519,57501,0,6145,0,1090505,39.81,17134873,508.544,43.2,18.779,48472.545,109.361,5.29,0.931,0
137,131,486,57987,3,6148,0,1208563,39.81,17134873,508.544,43.2,18.779,48472.545,109.361,5.29,0.931,0
137,132,577,58564,0,6148,0,1208563,39.81,17134873,508.544,43.2,18.779,48472.545,109.361,5.29,0.931,0
137,133,575,59139,0,6148,0,1208563,39.81,17134873,508.544,43.2,18.779,48472.545,109.361,5.29,0.931,0
137,134,779,59918,2,6150,0,1208563,39.81,17134873,508.544,43.2,18.779,48472.545,109.361,5.29,0.931,0
137,135,654,60572,2,6152,0,1208563,39.81,17134873,508.544,43.2,18.779,48472.545,109.361,5.29,0.931,0
137,136,577,61149,4,6156,0,1208563,39.81,17134873,508.544,43.2,18.779,48472.545,109.361,5.29,0.931,0
137,137,636,61785,2,6158,0,1208563,39.81,17134873,508.544,43.2,18.779,48472.545,109.361,5.29,0.931,0
137,138,652,62437,2,6160,0,1329929,39.81,17134873,508.544,43.2,18.779,48472.545,109.361,5.29,0.931,0
137,139,506,62943,3,6163,0,1329929,36.11,17134873,508.544,43.2,18.779,48472.545,109.361,5.29,0.931,0
137,140,481,63424,0,6163,0,1329929,47.22,17134873,508.544,43.2,18.779,48472.545,109.361,5.29,0.931,0
137,141,487,63911,3,6166,0,1329929,47.22,17134873,508.544,43.2,18.779,48472.545,109.361,5.29,0.931,0
137,142,552,64463,6,6172,0,1329929,47.22,17134873,508.544,43.2,18.779,48472.545,109.361,5.29,0.931,0
137,143,529,64992,10,6182,0,1329929,47.22,17134873,508.544,43.2,18.779,48472.545,109.361,5.29,0.931,0
137,144,534,65526,4,6186,0,1329929,47.22,17134873,508.544,43.2,18.779,48472.545,109.361,5.29,0.931,0
137,145,508,66034,5,6191,0,1491335,47.22,17134873,508.544,43.2,18.779,48472.545,109.361,5.29,0.931,0
137,146,456,66490,0,6191,0,1491335,47.22,17134873,508.544,43.2,18.779,48472.545,109.361,5.29,0.931,0
137,147,572,67062,2,6193,0,1491335,47.22,17134873,508.544,43.2,18.779,48472.545,109.361,5.29,0.931,0
137,148,414,67476,5,6198,0,1491335,47.22,17134873,508.544,43.2,18.779,48472.545,109.361,5.29,0.931,0
137,149,570,68046,8,6206,0,1491335,47.22,17134873,508.544,43.2,18.779,48472.545,109.361,5.29,0.931,0
137,150,510,68556,3,6209,0,1491335,47.22,17134873,508.544,43.2,18.779,48472.545,109.361,5.29,0.931,0
137,151,507,69063,2,6211,0,1491335,47.22,17134873,508.544,43.2,18.779,48472.545,109.361,5.29,0.931,0
137,152,500,69563,4,6215,0,1676502,47.22,17134873,508.544,43.2,18.779,48472.545,109.361,5.29,0.931,0
137,153,508,70071,0,6215,0,1676502,47.22,17134873,508.544,43.2,18.779,48472.545,109.361,5.29,0.931,0
137,154,525,70596,0,6215,0,1676502,47.22,17134873,508.544,43.2,18.779,48472.545,109.361,5.29,0.931,0
137,155,461,71057,6,6221,0,1676502,47.22,17134873,508.544,43.2,18.779,48472.545,109.361,5.29,0.931,0
137,156,914,71971,5,6226,0,1676502,47.22,17134873,508.544,43.2,18.779,48472.545,109.361,5.29,0.931,0
137,157,421,72392,0,6226,0,1676502,47.22,17134873,508.544,43.2,18.779,48472.545,109.361,5.29,0.931,0
137,158,744,73136,2,6228,0,1676502,47.22,17134873,508.544,43.2,18.779,48472.545,109.361,5.29,0.931,0
137,159,654,73790,4,6232,0,1861263,47.22,17134873,508.544,43.2,18.779,48472.545,109.361,5.29,0.931,0
137,160,925,74715,2,6234,0,1861263,47.22,17134873,508.544,43.2,18.779,48472.545,109.361,5.29,0.931,0
137,161,797,75512,0,6234,0,1861263,47.22,17134873,508.544,43.2,18.779,48472.545,109.361,5.29,0.931,0
137,162,963,76475,1,6235,0,1861263,47.22,17134873,508.544,43.2,18.779,48472.545,109.361,5.29,0.931,0
137,163,1140,77615,2,6237,0,1861263,47.22,17134873,508.544,43.2,18.779,48472.545,109.361,5.29,0.931,0
137,164,823,78438,3,6240,0,1861263,47.22,17134873,508.544,43.2,18.779,48472.545,109.361,5.29,0.931,0
137,165,1268,79706,3,6243,0,1861263,47.22,17134873,508.544,43.2,18.779,48472.545,109.361,5.29,0.931,0
137,166,1231,80937,1,6244,0,2059186,47.22,17134873,508.544,43.2,18.779,48472.545,109.361,5.29,0.931,0
137,167,1086,82023,1,6245,0,2059186,47.22,17134873,508.544,43.2,18.779,48472.545,109.361,5.29,0.931,0
137,168,1298,83321,2,6247,0,2059186,47.22,17134873,508.544,43.2,18.779,48472.545,109.361,5.29,0.931,0
137,169,1376,84697,2,6249,0,2059186,47.22,17134873,508.544,43.2,18.779,48472.545,109.361,5.29,0.931,0
137,170,1540,86237,2,6251,0,2059186,47.22,17134873,508.544,43.2,18.779,48472.545,109.361,5.29,0.931,0
137,171,1750,87987,6,6257,0,2059186,47.22,17134873,508.544,43.2,18.779,48472.545,109.361,5.29,0.931,0
137,172,1972,89959,7,6264,0,2059186,47.22,17134873,508.544,43.2,18.779,48472.545,109.361,5.29,0.931,0
137,173,1882,91841,2,6266,0,2260833,44.44,17134873,508.544,43.2,18.779,48472.545,109.361,5.29,0.931,0
137,174,1843,93684,4,6270,0,2260833,44.44,17134873,508.544,43.2,18.779,48472.545,109.361,5.29,0.931,0
137,175,2215,95899,2,6272,0,2260833,44.44,17134873,508.544,43.2,18.779,48472.545,109.361,5.29,0.931,0
137,176,2243,98142,10,6282,0,2260833,44.44,17134873,508.544,43.2,18.779,48472.545,109.361,5.29,0.931,0
137,177,2351,100493,5,6287,0,2260833,44.44,17134873,508.544,43.2,18.779,48472.545,109.361,5.29,0.931,0
137,178,2541,103034,16,6303,0,2260833,44.44,17134873,508.544,43.2,18.779,48472.545,109.361,5.29,0.931,0
137,179,2776,105810,16,6319,0,2260833,44.44,17134873,508.544,43.2,18.779,48472.545,109.361,5.29,0.931,0
137,180,2711,108521,38,6357,0,2470471,44.44,17134873,508.544,43.2,18.779,48472.545,109.361,5.29,0.931,0
137,181,2989,111510,8,6365,0,2470471,44.44,17134873,508.544,43.2,18.779,48472.545,109.361,5.29,0.931,0
137,182,2909,114419,6,6371,0,2470471,58.33,17134873,508.544,43.2,18.779,48472.545,109.361,5.29,0.931,0
137,183,3001,117420,13,6384,0,2470471,58.33,17134873,508.544,43.2,18.779,48472.545,109.361,5.29,0.931,0
137,184,3293,120713,13,6397,0,2470471,58.33,17134873,508.544,43.2,18.779,48472.545,109.361,5.29,0.931,0
137,185,3253,123966,13,6410,0,2470471,58.33,17134873,508.544,43.2,18.779,48472.545,109.361,5.29,0.931,0
137,186,3820,127786,9,6419,0,2470471,58.33,17134873,508.544,43.2,18.779,48472.545,109.361,5.29,0.931,0
137,187,3963,131749,21,6440,0,2663325,58.33,17134873,508.544,43.2,18.779,48472.545,109.361,5.29,0.931,0
137,188,4000,135749,5,6445,0,2663325,58.33,17134873,508.544,43.2,18.779,48472.545,109.361,5.29,0.931,0
137,189,4572,140321,7,6452,0,2663325,58.33,17134873,508.544,43.2,18.779,48472.545,109.361,5.29,0.931,0
137,190,4517,144838,21,6473,0,2663325,58.33,17134873,508.544,43.2,18.779,48472.545,109.361,5.29,0.931,0
137,191,4979,149817,36,6509,0,2663325,58.33,17134873,508.544,43.2,18.779,48472.545,109.361,5.29,0.931,0
137,192,5813,155630,13,6522,0,2663325,58.33,17134873,508.544,43.2,18.779,48472.545,109.361,5.29,0.931,0
137,193,5959,161589,13,6535,0,2663325,58.33,17134873,508.544,43.2,18.779,48472.545,109.361,5.29,0.931,0
137,194,6493,168082,23,6558,0,2872935,58.33,17134873,508.544,43.2,18.779,48472.545,109.361,5.29,0.931,0
137,195,6368,174450,17,6575,0,2872935,58.33,17134873,508.544,43.2,18.779,48472.545,109.361,5.29,0.931,0
137,196,6844,181294,12,6587,0,2872935,58.33,17134873,508.544,43.2,18.779,48472.545,109.361,5.29,0.931,0
137,197,7368,188662,35,6622,0,2872935,58.33,17134873,508.544,43.2,18.779,48472.545,109.361,5.29,0.931,0
137,198,7271,195933,32,6654,0,2872935,58.33,17134873,508.544,43.2,18.779,48472.545,109.361,5.29,0.931,0
137,199,7779,203712,29,6683,0,2872935,58.33,17134873,508.544,43.2,18.779,48472.545,109.361,5.29,0.931,0
137,200,7978,211690,16,6699,0,2872935,58.33,17134873,508.544,43.2,18.779,48472.545,109.361,5.29,0.931,0
137,201,8105,219795,29,6728,0,2872935,58.33,17134873,508.544,43.2,18.779,48472.545,109.361,5.29,0.931,0
137,202,8439,228234,23,6751,0,2872935,58.33,17134873,508.544,43.2,18.779,48472.545,109.361,5.29,0.931,0
137,203,7720,235954,8,6759,0,2872935,58.33,17134873,508.544,43.2,18.779,48472.545,109.361,5.29,0.931,0
137,204,8149,244103,45,6804,0,2872935,58.33,17134873,508.544,43.2,18.779,48472.545,109.361,5.29,0.931,0
139,1,0,647,0,1,3662,28748,96.3,4822233,18.206,37.9,15.322,36085.843,128.797,8.08,0.917,0
139,2,76,723,0,1,4057,32805,96.3,4822233,18.206,37.9,15.322,36085.843,128.797,8.08,0.917,0
139,3,49,772,0,1,4361,37166,96.3,4822233,18.206,37.9,15.322,36085.843,128.797,8.08,0.917,0
139,4,52,824,0,1,2603,39769,96.3,4822233,18.206,37.9,15.322,36085.843,128.797,8.08,0.917,0
139,5,48,872,0,1,2541,42310,96.3,4822233,18.206,37.9,15.322,36085.843,128.797,8.08,0.917,0
139,6,39,911,0,1,3378,45688,96.3,4822233,18.206,37.9,15.322,36085.843,128.797,8.08,0.917,0
139,7,32,943,0,1,4834,50522,96.3,4822233,18.206,37.9,15.322,36085.843,128.797,8.08,0.917,0
139,8,26,969,0,1,3705,54227,96.3,4822233,18.206,37.9,15.322,36085.843,128.797,8.08,0.917,0
139,9,23,992,0,1,3788,58015,96.3,4822233,18.206,37.9,15.322,36085.843,128.797,8.08,0.917,0
139,10,23,1015,1,2,1716,59731,96.3,4822233,18.206,37.9,15.322,36085.843,128.797,8.08,0.917,0
139,11,20,1035,2,4,1794,61525,96.3,4822233,18.206,37.9,15.322,36085.843,128.797,8.08,0.917,0
139,12,14,1049,0,4,1350,62875,96.3,4822233,18.206,37.9,15.322,36085.843,128.797,8.08,0.917,0
139,13,15,1064,1,5,1482,64357,96.3,4822233,18.206,37.9,15.322,36085.843,128.797,8.08,0.917,0
139,14,8,1072,4,9,3123,67480,96.3,4822233,18.206,37.9,15.322,36085.843,128.797,8.08,0.917,0
139,15,6,1078,0,9,4021,71501,96.3,4822233,18.206,37.9,15.322,36085.843,128.797,8.08,0.917,0
139,16,6,1084,0,9,4396,75897,96.3,4822233,18.206,37.9,15.322,36085.843,128.797,8.08,0.917,0
139,17,2,1086,2,11,4850,80747,96.3,4822233,18.206,37.9,15.322,36085.843,128.797,8.08,0.917,0
139,18,8,1094,0,11,3206,83953,96.3,4822233,18.206,37.9,15.322,36085.843,128.797,8.08,0.917,0
139,19,4,1098,1,12,2306,86259,96.3,4822233,18.206,37.9,15.322,36085.843,128.797,8.08,0.917,0
139,20,7,1105,0,12,5732,91991,96.3,4822233,18.206,37.9,15.322,36085.843,128.797,8.08,0.917,0
139,21,2,1107,1,13,7124,99115,96.3,4822233,18.206,37.9,15.322,36085.843,128.797,8.08,0.917,0
139,22,5,1112,1,14,6243,105358,96.3,4822233,18.206,37.9,15.322,36085.843,128.797,8.08,0.917,0
139,23,0,1112,2,16,6640,111998,96.3,4822233,18.206,37.9,15.322,36085.843,128.797,8.08,0.917,0
139,24,2,1114,1,17,6543,118541,96.3,4822233,18.206,37.9,15.322,36085.843,128.797,8.08,0.917,0
139,25,3,1117,1,18,2741,121282,96.3,4822233,18.206,37.9,15.322,36085.843,128.797,8.08,0.917,0
139,26,4,1121,0,18,2098,123380,96.3,4822233,18.206,37.9,15.322,36085.843,128.797,8.08,0.917,0
139,27,1,1122,1,19,2034,125414,96.3,4822233,18.206,37.9,15.322,36085.843,128.797,8.08,0.917,0
139,28,2,1124,0,19,5102,130516,87.04,4822233,18.206,37.9,15.322,36085.843,128.797,8.08,0.917,0
139,29,2,1126,0,19,5351,135867,83.33,4822233,18.206,37.9,15.322,36085.843,128.797,8.08,0.917,0
139,30,3,1129,0,19,5474,141341,83.33,4822233,18.206,37.9,15.322,36085.843,128.797,8.08,0.917,0
139,31,3,1132,0,19,5653,146994,83.33,4822233,18.206,37.9,15.322,36085.843,128.797,8.08,0.917,0
139,32,2,1134,1,20,2803,149797,83.33,4822233,18.206,37.9,15.322,36085.843,128.797,8.08,0.917,0
139,33,2,1136,0,20,1660,151457,83.33,4822233,18.206,37.9,15.322,36085.843,128.797,8.08,0.917,0
139,34,1,1137,0,20,5237,156694,83.33,4822233,18.206,37.9,15.322,36085.843,128.797,8.08,0.917,0
139,35,0,1137,0,20,6864,163558,83.33,4822233,18.206,37.9,15.322,36085.843,128.797,8.08,0.917,0
139,36,1,1138,1,21,7282,170840,83.33,4822233,18.206,37.9,15.322,36085.843,128.797,8.08,0.917,0
139,37,1,1139,0,21,7814,178654,83.33,4822233,18.206,37.9,15.322,36085.843,128.797,8.08,0.917,0
139,38,2,1141,0,21,8435,187089,83.33,4822233,18.206,37.9,15.322,36085.843,128.797,8.08,0.917,0
139,39,1,1142,0,21,3435,190524,83.33,4822233,18.206,37.9,15.322,36085.843,128.797,8.08,0.917,0
139,40,2,1144,0,21,1745,192269,83.33,4822233,18.206,37.9,15.322,36085.843,128.797,8.08,0.917,0
139,41,3,1147,0,21,5427,197696,83.33,4822233,18.206,37.9,15.322,36085.843,128.797,8.08,0.917,0
139,42,0,1147,0,21,7495,205191,83.33,4822233,18.206,37.9,15.322,36085.843,128.797,8.08,0.917,0
139,43,0,1147,0,21,6857,212048,83.33,4822233,18.206,37.9,15.322,36085.843,128.797,8.08,0.917,0
139,44,0,1147,0,21,6582,218630,36.11,4822233,18.206,37.9,15.322,36085.843,128.797,8.08,0.917,0
139,45,1,1148,0,21,5780,224410,36.11,4822233,18.206,37.9,15.322,36085.843,128.797,8.08,0.917,0
139,46,0,1148,0,21,2379,226789,36.11,4822233,18.206,37.9,15.322,36085.843,128.797,8.08,0.917,0
139,47,1,1149,0,21,1552,228341,36.11,4822233,18.206,37.9,15.322,36085.843,128.797,8.08,0.917,0
139,48,0,1149,0,21,5397,233738,36.11,4822233,18.206,37.9,15.322,36085.843,128.797,8.08,0.917,0
139,49,4,1153,0,21,5701,239439,36.11,4822233,18.206,37.9,15.322,36085.843,128.797,8.08,0.917,0
139,50,0,1153,0,21,5640,245079,36.11,4822233,18.206,37.9,15.322,36085.843,128.797,8.08,0.917,0
139,51,0,1153,0,21,5657,250736,36.11,4822233,18.206,37.9,15.322,36085.843,128.797,8.08,0.917,0
139,52,1,1154,0,21,4727,255463,36.11,4822233,18.206,37.9,15.322,36085.843,128.797,8.08,0.917,0
139,53,0,1154,0,21,1472,256935,36.11,4822233,18.206,37.9,15.322,36085.843,128.797,8.08,0.917,0
139,54,0,1154,0,21,1119,258054,36.11,4822233,18.206,37.9,15.322,36085.843,128.797,8.08,0.917,0
139,55,0,1154,0,21,4428,262482,36.11,4822233,18.206,37.9,15.322,36085.843,128.797,8.08,0.917,0
139,56,0,1154,0,21,4017,266499,36.11,4822233,18.206,37.9,15.322,36085.843,128.797,8.08,0.917,0
139,57,0,1154,0,21,3482,269981,36.11,4822233,18.206,37.9,15.322,36085.843,128.797,8.08,0.917,0
139,58,0,1154,1,22,3052,273033,36.11,4822233,18.206,37.9,15.322,36085.843,128.797,8.08,0.917,0
139,59,0,1154,0,22,2413,275446,33.33,4822233,18.206,37.9,15.322,36085.843,128.797,8.08,0.917,0
139,60,0,1154,0,22,769,276215,33.33,4822233,18.206,37.9,15.322,36085.843,128.797,8.08,0.917,0
139,61,0,1154,0,22,177,276392,33.33,4822233,18.206,37.9,15.322,36085.843,128.797,8.08,0.917,0
139,62,0,1154,0,22,671,277063,33.33,4822233,18.206,37.9,15.322,36085.843,128.797,8.08,0.917,0
139,63,0,1154,0,22,1149,278212,33.33,4822233,18.206,37.9,15.322,36085.843,128.797,8.08,0.917,0
139,64,0,1154,0,22,2720,280932,33.33,4822233,18.206,37.9,15.322,36085.843,128.797,8.08,0.917,0
139,65,0,1154,0,22,2717,283649,33.33,4822233,18.206,37.9,15.322,36085.843,128.797,8.08,0.917,0
139,66,0,1154,0,22,2993,286642,33.33,4822233,18.206,37.9,15.322,36085.843,128.797,8.08,0.917,0
139,67,0,1154,0,22,2076,288718,33.33,4822233,18.206,37.9,15.322,36085.843,128.797,8.08,0.917,0
139,68,0,1154,0,22,794,289512,33.33,4822233,18.206,37.9,15.322,36085.843,128.797,8.08,0.917,0
139,69,0,1154,0,22,990,290502,22.22,4822233,18.206,37.9,15.322,36085.843,128.797,8.08,0.917,0
139,70,0,1154,0,22,2641,293143,22.22,4822233,18.206,37.9,15.322,36085.843,128.797,8.08,0.917,0
139,71,0,1154,0,22,3427,296570,22.22,4822233,18.206,37.9,15.322,36085.843,128.797,8.08,0.917,0
139,72,0,1154,0,22,2915,299485,22.22,4822233,18.206,37.9,15.322,36085.843,128.797,8.08,0.917,0
139,73,0,1154,0,22,2934,302419,22.22,4822233,18.206,37.9,15.322,36085.843,128.797,8.08,0.917,0
139,74,0,1154,0,22,2484,304903,22.22,4822233,18.206,37.9,15.322,36085.843,128.797,8.08,0.917,0
139,75,0,1154,0,22,760,305663,22.22,4822233,18.206,37.9,15.322,36085.843,128.797,8.08,0.917,0
139,76,0,1154,0,22,1460,307123,22.22,4822233,18.206,37.9,15.322,36085.843,128.797,8.08,0.917,0
139,77,2,1156,0,22,3567,310690,22.22,4822233,18.206,37.9,15.322,36085.843,128.797,8.08,0.917,0
139,78,0,1156,0,22,4832,315522,22.22,4822233,18.206,37.9,15.322,36085.843,128.797,8.08,0.917,0
139,79,1,1157,0,22,6310,321832,22.22,4822233,18.206,37.9,15.322,36085.843,128.797,8.08,0.917,0
139,80,0,1157,0,22,7704,329536,22.22,4822233,18.206,37.9,15.322,36085.843,128.797,8.08,0.917,0
139,81,2,1159,0,22,6058,335594,22.22,4822233,18.206,37.9,15.322,36085.843,128.797,8.08,0.917,0
139,82,2,1161,0,22,3451,339045,22.22,4822233,18.206,37.9,15.322,36085.843,128.797,8.08,0.917,0
139,83,2,1163,0,22,4151,343196,22.22,4822233,18.206,37.9,15.322,36085.843,128.797,8.08,0.917,0
139,84,2,1165,0,22,8968,352164,22.22,4822233,18.206,37.9,15.322,36085.843,128.797,8.08,0.917,0
139,85,1,1166,0,22,10359,362523,22.22,4822233,18.206,37.9,15.322,36085.843,128.797,8.08,0.917,0
139,86,3,1169,0,22,10006,372529,22.22,4822233,18.206,37.9,15.322,36085.843,128.797,8.08,0.917,0
139,87,1,1170,0,22,9091,381620,22.22,4822233,18.206,37.9,15.322,36085.843,128.797,8.08,0.917,0
139,88,2,1172,0,22,5465,387085,22.22,4822233,18.206,37.9,15.322,36085.843,128.797,8.08,0.917,0
139,89,4,1176,0,22,2809,389894,22.22,4822233,18.206,37.9,15.322,36085.843,128.797,8.08,0.917,0
139,90,2,1178,0,22,1815,391709,22.22,4822233,18.206,37.9,15.322,36085.843,128.797,8.08,0.917,0
139,91,0,1178,0,22,4733,396442,22.22,4822233,18.206,37.9,15.322,36085.843,128.797,8.08,0.917,0
139,92,0,1178,0,22,3404,399846,22.22,4822233,18.206,37.9,15.322,36085.843,128.797,8.08,0.917,0
139,93,2,1180,0,22,3728,403574,22.22,4822233,18.206,37.9,15.322,36085.843,128.797,8.08,0.917,0
139,94,0,1180,0,22,2091,405665,22.22,4822233,18.206,37.9,15.322,36085.843,128.797,8.08,0.917,0
139,95,0,1180,0,22,587,406252,22.22,4822233,18.206,37.9,15.322,36085.843,128.797,8.08,0.917,0
139,96,3,1183,0,22,2611,408863,22.22,4822233,18.206,37.9,15.322,36085.843,128.797,8.08,0.917,0
139,97,0,1183,0,22,1850,410713,22.22,4822233,18.206,37.9,15.322,36085.843,128.797,8.08,0.917,0
139,98,3,1186,0,22,2188,412901,22.22,4822233,18.206,37.9,15.322,36085.843,128.797,8.08,0.917,0
139,99,1,1187,0,22,3003,415904,22.22,4822233,18.206,37.9,15.322,36085.843,128.797,8.08,0.917,0
139,100,3,1190,0,22,2665,418569,22.22,4822233,18.206,37.9,15.322,36085.843,128.797,8.08,0.917,0
139,101,2,1192,0,22,2102,420671,22.22,4822233,18.206,37.9,15.322,36085.843,128.797,8.08,0.917,0
139,102,1,1193,0,22,1721,422392,22.22,4822233,18.206,37.9,15.322,36085.843,128.797,8.08,0.917,0
139,103,1,1194,0,22,1091,423483,22.22,4822233,18.206,37.9,15.322,36085.843,128.797,8.08,0.917,0
139,104,0,1194,0,22,1534,425017,22.22,4822233,18.206,37.9,15.322,36085.843,128.797,8.08,0.917,0
139,105,1,1195,0,22,2791,427808,22.22,4822233,18.206,37.9,15.322,36085.843,128.797,8.08,0.917,0
139,106,2,1197,0,22,2827,430635,22.22,4822233,18.206,37.9,15.322,36085.843,128.797,8.08,0.917,0
139,107,1,1198,0,22,2351,432986,22.22,4822233,18.206,37.9,15.322,36085.843,128.797,8.08,0.917,0
139,108,1,1199,0,22,2575,435561,22.22,4822233,18.206,37.9,15.322,36085.843,128.797,8.08,0.917,0
139,109,1,1200,0,22,1436,436997,22.22,4822233,18.206,37.9,15.322,36085.843,128.797,8.08,0.917,0
139,110,3,1203,0,22,704,437701,22.22,4822233,18.206,37.9,15.322,36085.843,128.797,8.08,0.917,0
139,111,1,1204,0,22,955,438656,22.22,4822233,18.206,37.9,15.322,36085.843,128.797,8.08,0.917,0
139,112,1,1205,0,22,2196,440852,22.22,4822233,18.206,37.9,15.322,36085.843,128.797,8.08,0.917,0
139,113,0,1205,0,22,2366,443218,22.22,4822233,18.206,37.9,15.322,36085.843,128.797,8.08,0.917,0
139,114,0,1205,0,22,2746,445964,22.22,4822233,18.206,37.9,15.322,36085.843,128.797,8.08,0.917,0
139,115,1,1206,0,22,2394,448358,22.22,4822233,18.206,37.9,15.322,36085.843,128.797,8.08,0.917,0
139,116,0,1206,0,22,1682,450040,22.22,4822233,18.206,37.9,15.322,36085.843,128.797,8.08,0.917,0
139,117,0,1206,0,22,645,450685,22.22,4822233,18.206,37.9,15.322,36085.843,128.797,8.08,0.917,0
139,118,0,1206,0,22,1606,452291,22.22,4822233,18.206,37.9,15.322,36085.843,128.797,8.08,0.917,0
139,119,1,1207,0,22,2401,454692,22.22,4822233,18.206,37.9,15.322,36085.843,128.797,8.08,0.917,0
139,120,2,1209,0,22,2414,457106,22.22,4822233,18.206,37.9,15.322,36085.843,128.797,8.08,0.917,0
139,121,1,1210,0,22,2396,459502,22.22,4822233,18.206,37.9,15.322,36085.843,128.797,8.08,0.917,0
139,122,0,1210,0,22,3077,462579,22.22,4822233,18.206,37.9,15.322,36085.843,128.797,8.08,0.917,0
139,123,2,1212,0,22,2409,464988,22.22,4822233,18.206,37.9,15.322,36085.843,128.797,8.08,0.917,0
139,124,3,1215,0,22,1689,466677,22.22,4822233,18.206,37.9,15.322,36085.843,128.797,8.08,0.917,0
139,125,2,1217,0,22,1702,468379,22.22,4822233,18.206,37.9,15.322,36085.843,128.797,8.08,0.917,0
139,126,0,1217,0,22,4114,472493,22.22,4822233,18.206,37.9,15.322,36085.843,128.797,8.08,0.917,0
139,127,2,1219,0,22,4889,477382,22.22,4822233,18.206,37.9,15.322,36085.843,128.797,8.08,0.917,0
139,128,0,1219,0,22,4070,481452,22.22,4822233,18.206,37.9,15.322,36085.843,128.797,8.08,0.917,0
139,129,0,1219,0,22,3365,484817,22.22,4822233,18.206,37.9,15.322,36085.843,128.797,8.08,0.917,0
139,130,0,1219,0,22,4090,488907,22.22,4822233,18.206,37.9,15.322,36085.843,128.797,8.08,0.917,0
139,131,0,1219,0,22,2338,491245,22.22,4822233,18.206,37.9,15.322,36085.843,128.797,8.08,0.917,0
139,132,0,1219,0,22,1687,492932,22.22,4822233,18.206,37.9,15.322,36085.843,128.797,8.08,0.917,0
139,133,1,1220,0,22,4164,497096,22.22,4822233,18.206,37.9,15.322,36085.843,128.797,8.08,0.917,0
139,134,0,1220,0,22,5978,503074,68.98,4822233,18.206,37.9,15.322,36085.843,128.797,8.08,0.917,0
139,135,18,1238,0,22,15653,518727,68.98,4822233,18.206,37.9,15.322,36085.843,128.797,8.08,0.917,0
139,136,13,1251,0,22,23378,542105,68.98,4822233,18.206,37.9,15.322,36085.843,128.797,8.08,0.917,0
139,137,7,1258,0,22,23991,566096,68.98,4822233,18.206,37.9,15.322,36085.843,128.797,8.08,0.917,0
139,138,13,1271,0,22,25005,591101,68.98,4822233,18.206,37.9,15.322,36085.843,128.797,8.08,0.917,0
139,139,9,1280,0,22,18436,609537,68.98,4822233,18.206,37.9,15.322,36085.843,128.797,8.08,0.917,0
139,140,13,1293,0,22,22699,632236,68.98,4822233,18.206,37.9,15.322,36085.843,128.797,8.08,0.917,0
139,141,6,1299,0,22,17598,649834,68.98,4822233,18.206,37.9,15.322,36085.843,128.797,8.08,0.917,0
139,142,5,1304,0,22,14662,664496,68.98,4822233,18.206,37.9,15.322,36085.843,128.797,8.08,0.917,0
139,143,11,1315,0,22,12009,676505,68.98,4822233,18.206,37.9,15.322,36085.843,128.797,8.08,0.917,0
139,144,6,1321,0,22,7271,683776,68.98,4822233,18.206,37.9,15.322,36085.843,128.797,8.08,0.917,0
139,145,3,1324,0,22,4477,688253,72.69,4822233,18.206,37.9,15.322,36085.843,128.797,8.08,0.917,0
139,146,8,1332,0,22,4194,692447,72.69,4822233,18.206,37.9,15.322,36085.843,128.797,8.08,0.917,0
139,147,7,1339,0,22,8498,700945,72.69,4822233,18.206,37.9,15.322,36085.843,128.797,8.08,0.917,0
139,148,5,1344,0,22,8786,709731,72.69,4822233,18.206,37.9,15.322,36085.843,128.797,8.08,0.917,0
139,149,7,1351,0,22,10410,720141,72.69,4822233,18.206,37.9,15.322,36085.843,128.797,8.08,0.917,0
139,150,12,1363,0,22,10178,730319,72.69,4822233,18.206,37.9,15.322,36085.843,128.797,8.08,0.917,0
139,151,13,1376,0,22,10500,740819,72.69,4822233,18.206,37.9,15.322,36085.843,128.797,8.08,0.917,0
139,152,2,1378,0,22,6566,747385,72.69,4822233,18.206,37.9,15.322,36085.843,128.797,8.08,0.917,0
139,153,9,1387,0,22,8939,756324,40.28,4822233,18.206,37.9,15.322,36085.843,128.797,8.08,0.917,0
139,154,14,1401,0,22,11149,767473,34.72,4822233,18.206,37.9,15.322,36085.843,128.797,8.08,0.917,0
139,155,5,1406,0,22,10523,777996,34.72,4822233,18.206,37.9,15.322,36085.843,128.797,8.08,0.917,0
139,156,2,1408,0,22,9589,787585,34.72,4822233,18.206,37.9,15.322,36085.843,128.797,8.08,0.917,0
139,157,5,1413,0,22,8860,796445,34.72,4822233,18.206,37.9,15.322,36085.843,128.797,8.08,0.917,0
139,158,0,1413,0,22,7775,804220,34.72,4822233,18.206,37.9,15.322,36085.843,128.797,8.08,0.917,0
139,159,8,1421,2,24,3999,808219,34.72,4822233,18.206,37.9,15.322,36085.843,128.797,8.08,0.917,0
139,160,4,1425,0,24,4695,812914,34.72,4822233,18.206,37.9,15.322,36085.843,128.797,8.08,0.917,0
139,161,6,1431,0,24,8016,820930,34.72,4822233,18.206,37.9,15.322,36085.843,128.797,8.08,0.917,0
139,162,6,1437,0,24,7707,828637,34.72,4822233,18.206,37.9,15.322,36085.843,128.797,8.08,0.917,0
139,163,4,1441,0,24,8551,837188,34.72,4822233,18.206,37.9,15.322,36085.843,128.797,8.08,0.917,0
139,164,1,1442,0,24,8915,846103,34.72,4822233,18.206,37.9,15.322,36085.843,128.797,8.08,0.917,0
139,165,2,1444,0,24,7485,853588,34.72,4822233,18.206,37.9,15.322,36085.843,128.797,8.08,0.917,0
139,166,2,1446,0,24,3862,857450,34.72,4822233,18.206,37.9,15.322,36085.843,128.797,8.08,0.917,0
139,167,1,1447,0,24,3931,861381,34.72,4822233,18.206,37.9,15.322,36085.843,128.797,8.08,0.917,0
139,168,3,1450,0,24,8598,869979,34.72,4822233,18.206,37.9,15.322,36085.843,128.797,8.08,0.917,0
139,169,1,1451,1,25,8345,878324,34.72,4822233,18.206,37.9,15.322,36085.843,128.797,8.08,0.917,0
139,170,7,1458,0,25,0,878324,34.72,4822233,18.206,37.9,15.322,36085.843,128.797,8.08,0.917,0
139,171,0,1458,0,25,8170,893811,34.72,4822233,18.206,37.9,15.322,36085.843,128.797,8.08,0.917,0
139,172,2,1460,0,25,5537,899348,34.72,4822233,18.206,37.9,15.322,36085.843,128.797,8.08,0.917,0
139,173,4,1464,0,25,3367,902715,34.72,4822233,18.206,37.9,15.322,36085.843,128.797,8.08,0.917,0
139,174,0,1464,0,25,3507,906222,34.72,4822233,18.206,37.9,15.322,36085.843,128.797,8.08,0.917,0
139,175,0,1464,0,25,6842,913064,34.72,4822233,18.206,37.9,15.322,36085.843,128.797,8.08,0.917,0
139,176,4,1468,0,25,6080,919144,31.94,4822233,18.206,37.9,15.322,36085.843,128.797,8.08,0.917,0
139,177,3,1471,0,25,6435,925579,31.94,4822233,18.206,37.9,15.322,36085.843,128.797,8.08,0.917,0
139,178,2,1473,0,25,5875,931454,31.94,4822233,18.206,37.9,15.322,36085.843,128.797,8.08,0.917,0
139,179,2,1475,0,25,5077,936531,31.94,4822233,18.206,37.9,15.322,36085.843,128.797,8.08,0.917,0
139,180,2,1477,0,25,3612,940143,31.94,4822233,18.206,37.9,15.322,36085.843,128.797,8.08,0.917,0
139,181,0,1477,0,25,3244,943387,31.94,4822233,18.206,37.9,15.322,36085.843,128.797,8.08,0.917,0
139,182,2,1479,0,25,4995,948382,31.94,4822233,18.206,37.9,15.322,36085.843,128.797,8.08,0.917,0
139,183,1,1480,0,25,5607,953989,31.94,4822233,18.206,37.9,15.322,36085.843,128.797,8.08,0.917,0
139,184,0,1480,0,25,4749,958738,31.94,4822233,18.206,37.9,15.322,36085.843,128.797,8.08,0.917,0
139,185,12,1492,0,25,6359,965097,31.94,4822233,18.206,37.9,15.322,36085.843,128.797,8.08,0.917,0
139,186,1,1493,0,25,4010,969107,31.94,4822233,18.206,37.9,15.322,36085.843,128.797,8.08,0.917,0
139,187,5,1498,0,25,2579,971686,31.94,4822233,18.206,37.9,15.322,36085.843,128.797,8.08,0.917,0
139,188,1,1499,0,25,3038,974724,31.94,4822233,18.206,37.9,15.322,36085.843,128.797,8.08,0.917,0
139,189,3,1502,0,25,5669,980393,31.94,4822233,18.206,37.9,15.322,36085.843,128.797,8.08,0.917,0
139,190,3,1505,0,25,6152,986545,22.22,4822233,18.206,37.9,15.322,36085.843,128.797,8.08,0.917,0
139,191,3,1508,0,25,5597,992142,22.22,4822233,18.206,37.9,15.322,36085.843,128.797,8.08,0.917,0
139,192,2,1510,0,25,4814,996956,22.22,4822233,18.206,37.9,15.322,36085.843,128.797,8.08,0.917,0
139,193,4,1514,0,25,3809,1000765,22.22,4822233,18.206,37.9,15.322,36085.843,128.797,8.08,0.917,0
139,194,1,1515,0,25,2026,1002791,22.22,4822233,18.206,37.9,15.322,36085.843,128.797,8.08,0.917,0
139,195,0,1515,0,25,3017,1005808,22.22,4822233,18.206,37.9,15.322,36085.843,128.797,8.08,0.917,0
139,196,1,1516,0,25,5849,1011657,22.22,4822233,18.206,37.9,15.322,36085.843,128.797,8.08,0.917,0
139,197,2,1518,0,25,5196,1016853,22.22,4822233,18.206,37.9,15.322,36085.843,128.797,8.08,0.917,0
139,198,2,1520,0,25,5078,1021931,22.22,4822233,18.206,37.9,15.322,36085.843,128.797,8.08,0.917,0
139,199,4,1524,0,25,4794,1026725,22.22,4822233,18.206,37.9,15.322,36085.843,128.797,8.08,0.917,0
139,200,3,1527,0,25,3390,1030115,22.22,4822233,18.206,37.9,15.322,36085.843,128.797,8.08,0.917,0
139,201,3,1530,0,25,1773,1031888,22.22,4822233,18.206,37.9,15.322,36085.843,128.797,8.08,0.917,0
139,202,0,1530,0,25,2715,1034603,22.22,4822233,18.206,37.9,15.322,36085.843,128.797,8.08,0.917,0
139,203,1,1531,0,25,0,1034603,22.22,4822233,18.206,37.9,15.322,36085.843,128.797,8.08,0.917,0
139,204,25,1556,0,25,0,1034603,22.22,4822233,18.206,37.9,15.322,36085.843,128.797,8.08,0.917,0
140,1,0,4,0,1,0,0,8.33,6624554,51.667,27.3,5.445,5321.444,137.016,11.47,0.658,0
140,2,1,5,0,1,0,0,8.33,6624554,51.667,27.3,5.445,5321.444,137.016,11.47,0.658,0
140,3,0,5,0,1,0,0,8.33,6624554,51.667,27.3,5.445,5321.444,137.016,11.47,0.658,0
140,4,0,5,0,1,0,0,8.33,6624554,51.667,27.3,5.445,5321.444,137.016,11.47,0.658,0
140,5,0,5,0,1,0,0,8.33,6624554,51.667,27.3,5.445,5321.444,137.016,11.47,0.658,0
140,6,0,5,0,1,0,0,8.33,6624554,51.667,27.3,5.445,5321.444,137.016,11.47,0.658,0
140,7,1,6,0,1,0,0,8.33,6624554,51.667,27.3,5.445,5321.444,137.016,11.47,0.658,0
140,8,0,6,0,1,0,0,8.33,6624554,51.667,27.3,5.445,5321.444,137.016,11.47,0.658,0
140,9,0,6,0,1,0,0,8.33,6624554,51.667,27.3,5.445,5321.444,137.016,11.47,0.658,0
140,10,0,6,0,1,0,0,8.33,6624554,51.667,27.3,5.445,5321.444,137.016,11.47,0.658,0
140,11,1,7,0,1,0,0,8.33,6624554,51.667,27.3,5.445,5321.444,137.016,11.47,0.658,0
140,12,0,7,0,1,0,0,8.33,6624554,51.667,27.3,5.445,5321.444,137.016,11.47,0.658,0
140,13,2,9,0,1,0,0,8.33,6624554,51.667,27.3,5.445,5321.444,137.016,11.47,0.658,0
140,14,0,9,0,1,0,0,8.33,6624554,51.667,27.3,5.445,5321.444,137.016,11.47,0.658,0
140,15,0,9,0,1,0,0,16.67,6624554,51.667,27.3,5.445,5321.444,137.016,11.47,0.658,0
140,16,0,9,0,1,0,0,16.67,6624554,51.667,27.3,5.445,5321.444,137.016,11.47,0.658,0
140,17,0,9,0,1,0,0,16.67,6624554,51.667,27.3,5.445,5321.444,137.016,11.47,0.658,0
140,18,0,9,0,1,0,0,16.67,6624554,51.667,27.3,5.445,5321.444,137.016,11.47,0.658,0
140,19,0,9,0,1,0,0,16.67,6624554,51.667,27.3,5.445,5321.444,137.016,11.47,0.658,0
140,20,0,9,0,1,0,0,16.67,6624554,51.667,27.3,5.445,5321.444,137.016,11.47,0.658,0
140,21,0,9,1,2,0,0,16.67,6624554,51.667,27.3,5.445,5321.444,137.016,11.47,0.658,0
140,22,1,10,0,2,0,0,16.67,6624554,51.667,27.3,5.445,5321.444,137.016,11.47,0.658,0
140,23,0,10,0,2,0,0,16.67,6624554,51.667,27.3,5.445,5321.444,137.016,11.47,0.658,0
140,24,0,10,0,2,0,0,16.67,6624554,51.667,27.3,5.445,5321.444,137.016,11.47,0.658,0
140,25,1,11,1,3,0,0,16.67,6624554,51.667,27.3,5.445,5321.444,137.016,11.47,0.658,0
140,26,1,12,0,3,0,0,16.67,6624554,51.667,27.3,5.445,5321.444,137.016,11.47,0.658,0
140,27,1,13,0,3,0,0,16.67,6624554,51.667,27.3,5.445,5321.444,137.016,11.47,0.658,0
140,28,0,13,0,3,0,0,16.67,6624554,51.667,27.3,5.445,5321.444,137.016,11.47,0.658,0
140,29,0,13,0,3,0,0,16.67,6624554,51.667,27.3,5.445,5321.444,137.016,11.47,0.658,0
140,30,1,14,1,4,0,0,16.67,6624554,51.667,27.3,5.445,5321.444,137.016,11.47,0.658,0
140,31,0,14,0,4,0,0,16.67,6624554,51.667,27.3,5.445,5321.444,137.016,11.47,0.658,0
140,32,0,14,0,4,0,0,16.67,6624554,51.667,27.3,5.445,5321.444,137.016,11.47,0.658,0
140,33,0,14,0,4,0,0,16.67,6624554,51.667,27.3,5.445,5321.444,137.016,11.47,0.658,0
140,34,0,14,1,5,0,0,16.67,6624554,51.667,27.3,5.445,5321.444,137.016,11.47,0.658,0
140,35,1,15,0,5,0,0,16.67,6624554,51.667,27.3,5.445,5321.444,137.016,11.47,0.658,0
140,36,1,16,0,5,0,0,16.67,6624554,51.667,27.3,5.445,5321.444,137.016,11.47,0.658,0
140,37,0,16,0,5,0,0,11.11,6624554,51.667,27.3,5.445,5321.444,137.016,11.47,0.658,0
140,38,0,16,0,5,0,0,11.11,6624554,51.667,27.3,5.445,5321.444,137.016,11.47,0.658,0
140,39,0,16,0,5,0,0,11.11,6624554,51.667,27.3,5.445,5321.444,137.016,11.47,0.658,0
140,40,0,16,0,5,0,0,11.11,6624554,51.667,27.3,5.445,5321.444,137.016,11.47,0.658,0
140,41,0,16,0,5,0,0,11.11,6624554,51.667,27.3,5.445,5321.444,137.016,11.47,0.658,0
140,42,0,16,0,5,0,0,11.11,6624554,51.667,27.3,5.445,5321.444,137.016,11.47,0.658,0
140,43,9,25,3,8,0,0,11.11,6624554,51.667,27.3,5.445,5321.444,137.016,11.47,0.658,0
140,44,0,25,0,8,0,0,11.11,6624554,51.667,27.3,5.445,5321.444,137.016,11.47,0.658,0
140,45,0,25,0,8,0,0,11.11,6624554,51.667,27.3,5.445,5321.444,137.016,11.47,0.658,0
140,46,0,25,0,8,0,0,11.11,6624554,51.667,27.3,5.445,5321.444,137.016,11.47,0.658,0
140,47,0,25,0,8,0,0,11.11,6624554,51.667,27.3,5.445,5321.444,137.016,11.47,0.658,0
140,48,0,25,0,8,0,0,11.11,6624554,51.667,27.3,5.445,5321.444,137.016,11.47,0.658,0
140,49,0,25,0,8,0,0,11.11,6624554,51.667,27.3,5.445,5321.444,137.016,11.47,0.658,0
140,50,0,25,0,8,0,0,11.11,6624554,51.667,27.3,5.445,5321.444,137.016,11.47,0.658,0
140,51,0,25,0,8,0,0,11.11,6624554,51.667,27.3,5.445,5321.444,137.016,11.47,0.658,0
140,52,0,25,0,8,0,0,11.11,6624554,51.667,27.3,5.445,5321.444,137.016,11.47,0.658,0
140,53,254,279,9,17,0,0,11.11,6624554,51.667,27.3,5.445,5321.444,137.016,11.47,0.658,0
140,54,0,279,0,17,0,0,11.11,6624554,51.667,27.3,5.445,5321.444,137.016,11.47,0.658,0
140,55,0,279,0,17,0,0,11.11,6624554,51.667,27.3,5.445,5321.444,137.016,11.47,0.658,0
140,56,0,279,0,17,0,0,11.11,6624554,51.667,27.3,5.445,5321.444,137.016,11.47,0.658,0
140,57,480,759,18,35,0,0,11.11,6624554,51.667,27.3,5.445,5321.444,137.016,11.47,0.658,0
140,58,0,759,0,35,0,0,11.11,6624554,51.667,27.3,5.445,5321.444,137.016,11.47,0.658,0
140,59,0,759,0,35,0,0,11.11,6624554,51.667,27.3,5.445,5321.444,137.016,11.47,0.658,0
140,60,0,759,0,35,0,0,11.11,6624554,51.667,27.3,5.445,5321.444,137.016,11.47,0.658,0
140,61,0,759,0,35,0,0,11.11,6624554,51.667,27.3,5.445,5321.444,137.016,11.47,0.658,0
140,62,0,759,0,35,0,0,11.11,6624554,51.667,27.3,5.445,5321.444,137.016,11.47,0.658,0
140,63,0,759,0,35,0,0,11.11,6624554,51.667,27.3,5.445,5321.444,137.016,11.47,0.658,0
140,64,359,1118,11,46,0,0,11.11,6624554,51.667,27.3,5.445,5321.444,137.016,11.47,0.658,0
140,65,0,1118,0,46,0,0,11.11,6624554,51.667,27.3,5.445,5321.444,137.016,11.47,0.658,0
140,66,0,1118,0,46,0,0,11.11,6624554,51.667,27.3,5.445,5321.444,137.016,11.47,0.658,0
140,67,0,1118,0,46,0,0,11.11,6624554,51.667,27.3,5.445,5321.444,137.016,11.47,0.658,0
140,68,191,1309,0,46,0,0,11.11,6624554,51.667,27.3,5.445,5321.444,137.016,11.47,0.658,0
140,69,0,1309,0,46,0,0,11.11,6624554,51.667,27.3,5.445,5321.444,137.016,11.47,0.658,0
140,70,0,1309,0,46,0,0,11.11,6624554,51.667,27.3,5.445,5321.444,137.016,11.47,0.658,0
140,71,0,1309,0,46,0,0,11.11,6624554,51.667,27.3,5.445,5321.444,137.016,11.47,0.658,0
140,72,155,1464,9,55,0,0,11.11,6624554,51.667,27.3,5.445,5321.444,137.016,11.47,0.658,0
140,73,0,1464,0,55,0,0,11.11,6624554,51.667,27.3,5.445,5321.444,137.016,11.47,0.658,0
140,74,191,1655,0,55,0,0,11.11,6624554,51.667,27.3,5.445,5321.444,137.016,11.47,0.658,0
140,75,0,1655,0,55,0,0,11.11,6624554,51.667,27.3,5.445,5321.444,137.016,11.47,0.658,0
140,76,0,1655,0,55,0,0,11.11,6624554,51.667,27.3,5.445,5321.444,137.016,11.47,0.658,0
140,77,0,1655,0,55,0,0,11.11,6624554,51.667,27.3,5.445,5321.444,137.016,11.47,0.658,0
140,78,168,1823,9,64,0,0,11.11,6624554,51.667,27.3,5.445,5321.444,137.016,11.47,0.658,0
140,79,191,2014,0,64,0,0,11.11,6624554,51.667,27.3,5.445,5321.444,137.016,11.47,0.658,0
140,80,0,2014,0,64,0,0,11.11,6624554,51.667,27.3,5.445,5321.444,137.016,11.47,0.658,0
140,81,0,2014,0,64,0,0,11.11,6624554,51.667,27.3,5.445,5321.444,137.016,11.47,0.658,0
140,82,0,2014,0,64,0,0,11.11,6624554,51.667,27.3,5.445,5321.444,137.016,11.47,0.658,0
140,83,0,2014,0,64,0,0,11.11,6624554,51.667,27.3,5.445,5321.444,137.016,11.47,0.658,0
140,84,0,2014,0,64,0,0,11.11,6624554,51.667,27.3,5.445,5321.444,137.016,11.47,0.658,0
140,85,156,2170,10,74,0,0,11.11,6624554,51.667,27.3,5.445,5321.444,137.016,11.47,0.658,0
140,86,0,2170,0,74,0,0,11.11,6624554,51.667,27.3,5.445,5321.444,137.016,11.47,0.658,0
140,87,0,2170,0,74,0,0,11.11,6624554,51.667,27.3,5.445,5321.444,137.016,11.47,0.658,0
140,88,0,2170,0,74,0,0,11.11,6624554,51.667,27.3,5.445,5321.444,137.016,11.47,0.658,0
140,89,0,2170,0,74,0,0,11.11,6624554,51.667,27.3,5.445,5321.444,137.016,11.47,0.658,0
140,90,0,2170,0,74,0,0,11.11,6624554,51.667,27.3,5.445,5321.444,137.016,11.47,0.658,0
140,91,0,2170,0,74,0,0,11.11,6624554,51.667,27.3,5.445,5321.444,137.016,11.47,0.658,0
140,92,349,2519,9,83,0,0,11.11,6624554,51.667,27.3,5.445,5321.444,137.016,11.47,0.658,0
140,93,0,2519,0,83,0,0,11.11,6624554,51.667,27.3,5.445,5321.444,137.016,11.47,0.658,0
140,94,0,2519,0,83,0,0,11.11,6624554,51.667,27.3,5.445,5321.444,137.016,11.47,0.658,0
140,95,0,2519,0,83,0,0,11.11,6624554,51.667,27.3,5.445,5321.444,137.016,11.47,0.658,0
140,96,0,2519,0,83,0,0,11.11,6624554,51.667,27.3,5.445,5321.444,137.016,11.47,0.658,0
140,97,0,2519,0,83,0,0,11.11,6624554,51.667,27.3,5.445,5321.444,137.016,11.47,0.658,0
140,98,0,2519,0,83,0,0,11.11,6624554,51.667,27.3,5.445,5321.444,137.016,11.47,0.658,0
140,99,327,2846,8,91,0,0,11.11,6624554,51.667,27.3,5.445,5321.444,137.016,11.47,0.658,0
140,100,0,2846,0,91,0,0,11.11,6624554,51.667,27.3,5.445,5321.444,137.016,11.47,0.658,0
140,101,0,2846,0,91,0,0,11.11,6624554,51.667,27.3,5.445,5321.444,137.016,11.47,0.658,0
140,102,0,2846,0,91,0,0,11.11,6624554,51.667,27.3,5.445,5321.444,137.016,11.47,0.658,0
140,103,0,2846,0,91,0,0,11.11,6624554,51.667,27.3,5.445,5321.444,137.016,11.47,0.658,0
140,104,0,2846,0,91,0,0,11.11,6624554,51.667,27.3,5.445,5321.444,137.016,11.47,0.658,0
140,105,0,2846,0,91,0,0,16.67,6624554,51.667,27.3,5.445,5321.444,137.016,11.47,0.658,0
140,106,301,3147,8,99,0,0,16.67,6624554,51.667,27.3,5.445,5321.444,137.016,11.47,0.658,0
140,107,0,3147,0,99,0,0,16.67,6624554,51.667,27.3,5.445,5321.444,137.016,11.47,0.658,0
140,108,0,3147,0,99,0,0,16.67,6624554,51.667,27.3,5.445,5321.444,137.016,11.47,0.658,0
140,109,0,3147,0,99,0,0,16.67,6624554,51.667,27.3,5.445,5321.444,137.016,11.47,0.658,0
140,110,0,3147,0,99,0,0,16.67,6624554,51.667,27.3,5.445,5321.444,137.016,11.47,0.658,0
140,111,0,3147,0,99,0,0,16.67,6624554,51.667,27.3,5.445,5321.444,137.016,11.47,0.658,0
140,112,0,3147,0,99,0,0,16.67,6624554,51.667,27.3,5.445,5321.444,137.016,11.47,0.658,0
140,113,292,3439,9,108,0,0,16.67,6624554,51.667,27.3,5.445,5321.444,137.016,11.47,0.658,0
140,114,0,3439,0,108,0,0,16.67,6624554,51.667,27.3,5.445,5321.444,137.016,11.47,0.658,0
140,115,0,3439,0,108,0,0,16.67,6624554,51.667,27.3,5.445,5321.444,137.016,11.47,0.658,0
140,116,0,3439,0,108,0,0,16.67,6624554,51.667,27.3,5.445,5321.444,137.016,11.47,0.658,0
140,117,0,3439,0,108,0,0,16.67,6624554,51.667,27.3,5.445,5321.444,137.016,11.47,0.658,0
140,118,0,3439,0,108,0,0,16.67,6624554,51.667,27.3,5.445,5321.444,137.016,11.47,0.658,0
140,119,0,3439,0,108,0,0,16.67,6624554,51.667,27.3,5.445,5321.444,137.016,11.47,0.658,0
140,120,233,3672,8,116,0,0,16.67,6624554,51.667,27.3,5.445,5321.444,137.016,11.47,0.658,0
140,121,0,3672,0,116,0,0,16.67,6624554,51.667,27.3,5.445,5321.444,137.016,11.47,0.658,0
140,122,0,3672,0,116,0,0,16.67,6624554,51.667,27.3,5.445,5321.444,137.016,11.47,0.658,0
140,123,0,3672,0,116,0,0,16.67,6624554,51.667,27.3,5.445,5321.444,137.016,11.47,0.658,0
140,124,0,3672,0,116,0,0,16.67,6624554,51.667,27.3,5.445,5321.444,137.016,11.47,0.658,0
140,125,0,3672,0,116,0,0,16.67,6624554,51.667,27.3,5.445,5321.444,137.016,11.47,0.658,0
140,126,0,3672,0,116,0,0,16.67,6624554,51.667,27.3,5.445,5321.444,137.016,11.47,0.658,0
140,127,230,3902,7,123,0,0,16.67,6624554,51.667,27.3,5.445,5321.444,137.016,11.47,0.658,0
140,128,0,3902,0,123,0,0,16.67,6624554,51.667,27.3,5.445,5321.444,137.016,11.47,0.658,0
140,129,0,3902,0,123,0,0,16.67,6624554,51.667,27.3,5.445,5321.444,137.016,11.47,0.658,0
140,130,0,3902,0,123,0,0,16.67,6624554,51.667,27.3,5.445,5321.444,137.016,11.47,0.658,0
140,131,0,3902,0,123,0,0,16.67,6624554,51.667,27.3,5.445,5321.444,137.016,11.47,0.658,0
140,132,0,3902,0,123,0,0,16.67,6624554,51.667,27.3,5.445,5321.444,137.016,11.47,0.658,0
140,133,0,3902,0,123,0,0,16.67,6624554,51.667,27.3,5.445,5321.444,137.016,11.47,0.658,0
140,134,213,4115,5,128,0,0,16.67,6624554,51.667,27.3,5.445,5321.444,137.016,11.47,0.658,0
140,135,0,4115,0,128,0,0,16.67,6624554,51.667,27.3,5.445,5321.444,137.016,11.47,0.658,0
140,136,0,4115,0,128,0,0,16.67,6624554,51.667,27.3,5.445,5321.444,137.016,11.47,0.658,0
140,137,0,4115,0,128,0,0,16.67,6624554,51.667,27.3,5.445,5321.444,137.016,11.47,0.658,0
140,138,0,4115,0,128,0,0,16.67,6624554,51.667,27.3,5.445,5321.444,137.016,11.47,0.658,0
140,139,0,4115,0,128,0,0,16.67,6624554,51.667,27.3,5.445,5321.444,137.016,11.47,0.658,0
140,140,0,4115,0,128,0,0,16.67,6624554,51.667,27.3,5.445,5321.444,137.016,11.47,0.658,0
140,141,196,4311,5,133,0,0,16.67,6624554,51.667,27.3,5.445,5321.444,137.016,11.47,0.658,0
140,142,0,4311,0,133,0,0,16.67,6624554,51.667,27.3,5.445,5321.444,137.016,11.47,0.658,0
140,143,0,4311,0,133,0,0,16.67,6624554,51.667,27.3,5.445,5321.444,137.016,11.47,0.658,0
140,144,0,4311,0,133,0,0,16.67,6624554,51.667,27.3,5.445,5321.444,137.016,11.47,0.658,0
140,145,0,4311,0,133,0,0,16.67,6624554,51.667,27.3,5.445,5321.444,137.016,11.47,0.658,0
140,146,0,4311,0,133,0,0,16.67,6624554,51.667,27.3,5.445,5321.444,137.016,11.47,0.658,0
140,147,0,4311,0,133,0,0,16.67,6624554,51.667,27.3,5.445,5321.444,137.016,11.47,0.658,0
140,148,183,4494,4,137,0,0,16.67,6624554,51.667,27.3,5.445,5321.444,137.016,11.47,0.658,0
140,149,0,4494,0,137,0,0,16.67,6624554,51.667,27.3,5.445,5321.444,137.016,11.47,0.658,0
140,150,0,4494,0,137,0,0,16.67,6624554,51.667,27.3,5.445,5321.444,137.016,11.47,0.658,0
140,151,0,4494,0,137,0,0,16.67,6624554,51.667,27.3,5.445,5321.444,137.016,11.47,0.658,0
140,152,0,4494,0,137,0,0,16.67,6624554,51.667,27.3,5.445,5321.444,137.016,11.47,0.658,0
140,153,0,4494,0,137,0,0,16.67,6624554,51.667,27.3,5.445,5321.444,137.016,11.47,0.658,0
140,154,0,4494,0,137,0,0,16.67,6624554,51.667,27.3,5.445,5321.444,137.016,11.47,0.658,0
140,155,174,4668,4,141,0,0,16.67,6624554,51.667,27.3,5.445,5321.444,137.016,11.47,0.658,0
140,156,0,4668,0,141,0,0,16.67,6624554,51.667,27.3,5.445,5321.444,137.016,11.47,0.658,0
140,157,0,4668,0,141,0,0,16.67,6624554,51.667,27.3,5.445,5321.444,137.016,11.47,0.658,0
140,158,0,4668,0,141,0,0,16.67,6624554,51.667,27.3,5.445,5321.444,137.016,11.47,0.658,0
140,159,0,4668,0,141,0,0,16.67,6624554,51.667,27.3,5.445,5321.444,137.016,11.47,0.658,0
140,160,0,4668,0,141,0,0,11.11,6624554,51.667,27.3,5.445,5321.444,137.016,11.47,0.658,0
140,161,0,4668,0,141,0,0,11.11,6624554,51.667,27.3,5.445,5321.444,137.016,11.47,0.658,0
140,162,150,4818,3,144,0,0,11.11,6624554,51.667,27.3,5.445,5321.444,137.016,11.47,0.658,0
140,163,0,4818,0,144,0,0,11.11,6624554,51.667,27.3,5.445,5321.444,137.016,11.47,0.658,0
140,164,0,4818,0,144,0,0,11.11,6624554,51.667,27.3,5.445,5321.444,137.016,11.47,0.658,0
140,165,0,4818,0,144,0,0,11.11,6624554,51.667,27.3,5.445,5321.444,137.016,11.47,0.658,0
140,166,0,4818,0,144,0,0,11.11,6624554,51.667,27.3,5.445,5321.444,137.016,11.47,0.658,0
140,167,0,4818,0,144,0,0,11.11,6624554,51.667,27.3,5.445,5321.444,137.016,11.47,0.658,0
140,168,0,4818,0,144,0,0,11.11,6624554,51.667,27.3,5.445,5321.444,137.016,11.47,0.658,0
140,169,143,4961,3,147,0,0,11.11,6624554,51.667,27.3,5.445,5321.444,137.016,11.47,0.658,0
140,170,0,4961,0,147,0,0,11.11,6624554,51.667,27.3,5.445,5321.444,137.016,11.47,0.658,0
140,171,0,4961,0,147,0,0,11.11,6624554,51.667,27.3,5.445,5321.444,137.016,11.47,0.658,0
140,172,0,4961,0,147,0,0,11.11,6624554,51.667,27.3,5.445,5321.444,137.016,11.47,0.658,0
140,173,0,4961,0,147,0,0,11.11,6624554,51.667,27.3,5.445,5321.444,137.016,11.47,0.658,0
140,174,0,4961,0,147,0,0,11.11,6624554,51.667,27.3,5.445,5321.444,137.016,11.47,0.658,0
140,175,0,4961,0,147,0,0,11.11,6624554,51.667,27.3,5.445,5321.444,137.016,11.47,0.658,0
140,176,112,5073,2,149,0,0,11.11,6624554,51.667,27.3,5.445,5321.444,137.016,11.47,0.658,0
140,177,0,5073,0,149,0,0,11.11,6624554,51.667,27.3,5.445,5321.444,137.016,11.47,0.658,0
140,178,0,5073,0,149,0,0,11.11,6624554,51.667,27.3,5.445,5321.444,137.016,11.47,0.658,0
140,179,0,5073,0,149,0,0,11.11,6624554,51.667,27.3,5.445,5321.444,137.016,11.47,0.658,0
140,180,0,5073,0,149,0,0,11.11,6624554,51.667,27.3,5.445,5321.444,137.016,11.47,0.658,0
140,181,0,5073,0,149,0,0,11.11,6624554,51.667,27.3,5.445,5321.444,137.016,11.47,0.658,0
140,182,0,5073,0,149,0,0,11.11,6624554,51.667,27.3,5.445,5321.444,137.016,11.47,0.658,0
140,183,97,5170,2,151,0,0,11.11,6624554,51.667,27.3,5.445,5321.444,137.016,11.47,0.658,0
140,184,0,5170,0,151,0,0,8.33,6624554,51.667,27.3,5.445,5321.444,137.016,11.47,0.658,0
140,185,0,5170,0,151,0,0,8.33,6624554,51.667,27.3,5.445,5321.444,137.016,11.47,0.658,0
140,186,0,5170,0,151,0,0,8.33,6624554,51.667,27.3,5.445,5321.444,137.016,11.47,0.658,0
140,187,0,5170,0,151,0,0,8.33,6624554,51.667,27.3,5.445,5321.444,137.016,11.47,0.658,0
140,188,0,5170,0,151,0,0,8.33,6624554,51.667,27.3,5.445,5321.444,137.016,11.47,0.658,0
140,189,0,5170,0,151,0,0,8.33,6624554,51.667,27.3,5.445,5321.444,137.016,11.47,0.658,0
140,190,94,5264,2,153,0,0,8.33,6624554,51.667,27.3,5.445,5321.444,137.016,11.47,0.658,0
140,191,0,5264,0,153,0,0,8.33,6624554,51.667,27.3,5.445,5321.444,137.016,11.47,0.658,0
140,192,0,5264,0,153,0,0,8.33,6624554,51.667,27.3,5.445,5321.444,137.016,11.47,0.658,0
140,193,0,5264,0,153,0,0,8.33,6624554,51.667,27.3,5.445,5321.444,137.016,11.47,0.658,0
140,194,0,5264,0,153,0,0,8.33,6624554,51.667,27.3,5.445,5321.444,137.016,11.47,0.658,0
140,195,0,5264,0,153,0,0,8.33,6624554,51.667,27.3,5.445,5321.444,137.016,11.47,0.658,0
140,196,0,5264,0,153,0,0,8.33,6624554,51.667,27.3,5.445,5321.444,137.016,11.47,0.658,0
140,197,89,5353,1,154,0,0,8.33,6624554,51.667,27.3,5.445,5321.444,137.016,11.47,0.658,0
140,198,0,5353,0,154,0,0,8.33,6624554,51.667,27.3,5.445,5321.444,137.016,11.47,0.658,0
140,199,0,5353,0,154,0,0,8.33,6624554,51.667,27.3,5.445,5321.444,137.016,11.47,0.658,0
140,200,0,5353,0,154,0,0,8.33,6624554,51.667,27.3,5.445,5321.444,137.016,11.47,0.658,0
140,201,0,5353,0,154,0,0,8.33,6624554,51.667,27.3,5.445,5321.444,137.016,11.47,0.658,0
140,202,0,5353,0,154,0,0,8.33,6624554,51.667,27.3,5.445,5321.444,137.016,11.47,0.658,0
140,203,0,5353,0,154,0,0,8.33,6624554,51.667,27.3,5.445,5321.444,137.016,11.47,0.658,0
140,204,81,5434,1,155,0,0,8.33,6624554,51.667,27.3,5.445,5321.444,137.016,11.47,0.658,0
141,1,0,20,0,3,0,0,61.11,24206636,16.955,15.1,2.553,926,238.339,2.42,0.354,0
141,2,54,74,2,5,0,0,61.11,24206636,16.955,15.1,2.553,926,238.339,2.42,0.354,0
141,3,0,74,0,5,0,0,61.11,24206636,16.955,15.1,2.553,926,238.339,2.42,0.354,0
141,4,24,98,0,5,0,0,61.11,24206636,16.955,15.1,2.553,926,238.339,2.42,0.354,0
141,5,22,120,0,5,0,0,61.11,24206636,16.955,15.1,2.553,926,238.339,2.42,0.354,0
141,6,64,184,5,10,0,0,61.11,24206636,16.955,15.1,2.553,926,238.339,2.42,0.354,0
141,7,69,253,0,10,0,0,61.11,24206636,16.955,15.1,2.553,926,238.339,2.42,0.354,0
141,8,25,278,1,11,0,0,61.11,24206636,16.955,15.1,2.553,926,238.339,2.42,0.354,0
141,9,64,342,0,11,0,0,61.11,24206636,16.955,15.1,2.553,926,238.339,2.42,0.354,0
141,10,68,410,0,11,0,0,61.11,24206636,16.955,15.1,2.553,926,238.339,2.42,0.354,0
141,11,28,438,0,11,0,0,61.11,24206636,16.955,15.1,2.553,926,238.339,2.42,0.354,0
141,12,53,491,0,11,0,0,61.11,24206636,16.955,15.1,2.553,926,238.339,2.42,0.354,0
141,13,38,529,1,12,0,0,61.11,24206636,16.955,15.1,2.553,926,238.339,2.42,0.354,0
141,14,19,548,1,13,0,0,61.11,24206636,16.955,15.1,2.553,926,238.339,2.42,0.354,0
141,15,22,570,1,14,0,0,61.11,24206636,16.955,15.1,2.553,926,238.339,2.42,0.354,0
141,16,14,584,0,14,0,0,61.11,24206636,16.955,15.1,2.553,926,238.339,2.42,0.354,0
141,17,25,609,1,15,0,0,61.11,24206636,16.955,15.1,2.553,926,238.339,2.42,0.354,0
141,18,18,627,3,18,0,0,61.11,24206636,16.955,15.1,2.553,926,238.339,2.42,0.354,0
141,19,12,639,1,19,0,0,61.11,24206636,16.955,15.1,2.553,926,238.339,2.42,0.354,0
141,20,9,648,1,20,0,0,61.11,24206636,16.955,15.1,2.553,926,238.339,2.42,0.354,0
141,21,7,655,0,20,0,0,61.11,24206636,16.955,15.1,2.553,926,238.339,2.42,0.354,0
141,22,0,655,0,20,0,0,61.11,24206636,16.955,15.1,2.553,926,238.339,2.42,0.354,0
141,23,7,662,2,22,0,0,61.11,24206636,16.955,15.1,2.553,926,238.339,2.42,0.354,0
141,24,9,671,2,24,0,0,61.11,24206636,16.955,15.1,2.553,926,238.339,2.42,0.354,0
141,25,10,681,0,24,0,0,61.11,24206636,16.955,15.1,2.553,926,238.339,2.42,0.354,0
141,26,3,684,3,27,0,0,61.11,24206636,16.955,15.1,2.553,926,238.339,2.42,0.354,0
141,27,12,696,2,29,0,0,61.11,24206636,16.955,15.1,2.553,926,238.339,2.42,0.354,0
141,28,5,701,0,29,0,0,61.11,24206636,16.955,15.1,2.553,926,238.339,2.42,0.354,0
141,29,8,709,2,31,0,0,61.11,24206636,16.955,15.1,2.553,926,238.339,2.42,0.354,0
141,30,4,713,1,32,0,0,61.11,24206636,16.955,15.1,2.553,926,238.339,2.42,0.354,0
141,31,6,719,0,32,0,0,61.11,24206636,16.955,15.1,2.553,926,238.339,2.42,0.354,0
141,32,9,728,1,33,0,0,61.11,24206636,16.955,15.1,2.553,926,238.339,2.42,0.354,0
141,33,8,736,2,35,0,0,61.11,24206636,16.955,15.1,2.553,926,238.339,2.42,0.354,0
141,34,14,750,1,36,0,0,61.11,24206636,16.955,15.1,2.553,926,238.339,2.42,0.354,0
141,35,5,755,1,37,0,0,61.11,24206636,16.955,15.1,2.553,926,238.339,2.42,0.354,0
141,36,8,763,1,38,0,0,61.11,24206636,16.955,15.1,2.553,926,238.339,2.42,0.354,0
141,37,7,770,0,38,0,0,61.11,24206636,16.955,15.1,2.553,926,238.339,2.42,0.354,0
141,38,11,781,4,42,0,0,61.11,24206636,16.955,15.1,2.553,926,238.339,2.42,0.354,0
141,39,14,795,2,44,0,0,61.11,24206636,16.955,15.1,2.553,926,238.339,2.42,0.354,0
141,40,20,815,1,45,0,0,61.11,24206636,16.955,15.1,2.553,926,238.339,2.42,0.354,0
141,41,6,821,1,46,0,0,61.11,24206636,16.955,15.1,2.553,926,238.339,2.42,0.354,0
141,42,11,832,0,46,0,0,61.11,24206636,16.955,15.1,2.553,926,238.339,2.42,0.354,0
141,43,22,854,1,47,0,0,33.33,24206636,16.955,15.1,2.553,926,238.339,2.42,0.354,0
141,44,6,860,2,49,0,0,33.33,24206636,16.955,15.1,2.553,926,238.339,2.42,0.354,0
141,45,16,876,1,50,0,0,33.33,24206636,16.955,15.1,2.553,926,238.339,2.42,0.354,0
141,46,9,885,1,51,0,0,33.33,24206636,16.955,15.1,2.553,926,238.339,2.42,0.354,0
141,47,4,889,0,51,0,0,33.33,24206636,16.955,15.1,2.553,926,238.339,2.42,0.354,0
141,48,15,904,3,54,0,0,33.33,24206636,16.955,15.1,2.553,926,238.339,2.42,0.354,0
141,49,5,909,1,55,0,0,33.33,24206636,16.955,15.1,2.553,926,238.339,2.42,0.354,0
141,50,5,914,0,55,0,0,33.33,24206636,16.955,15.1,2.553,926,238.339,2.42,0.354,0
141,51,6,920,3,58,0,0,33.33,24206636,16.955,15.1,2.553,926,238.339,2.42,0.354,0
141,52,4,924,2,60,0,0,33.33,24206636,16.955,15.1,2.553,926,238.339,2.42,0.354,0
141,53,13,937,0,60,0,0,33.33,24206636,16.955,15.1,2.553,926,238.339,2.42,0.354,0
141,54,6,943,1,61,0,0,33.33,24206636,16.955,15.1,2.553,926,238.339,2.42,0.354,0
141,55,2,945,0,61,0,0,33.33,24206636,16.955,15.1,2.553,926,238.339,2.42,0.354,0
141,56,6,951,1,62,0,0,33.33,24206636,16.955,15.1,2.553,926,238.339,2.42,0.354,0
141,57,1,952,1,63,0,0,33.33,24206636,16.955,15.1,2.553,926,238.339,2.42,0.354,0
141,58,3,955,1,64,0,0,33.33,24206636,16.955,15.1,2.553,926,238.339,2.42,0.354,0
141,59,0,955,0,64,0,0,33.33,24206636,16.955,15.1,2.553,926,238.339,2.42,0.354,0
141,60,0,955,0,64,0,0,33.33,24206636,16.955,15.1,2.553,926,238.339,2.42,0.354,0
141,61,1,956,0,64,0,0,33.33,24206636,16.955,15.1,2.553,926,238.339,2.42,0.354,0
141,62,2,958,0,64,0,0,22.22,24206636,16.955,15.1,2.553,926,238.339,2.42,0.354,0
141,63,0,958,1,65,0,0,22.22,24206636,16.955,15.1,2.553,926,238.339,2.42,0.354,0
141,64,2,960,0,65,0,0,22.22,24206636,16.955,15.1,2.553,926,238.339,2.42,0.354,0
141,65,1,961,0,65,0,0,22.22,24206636,16.955,15.1,2.553,926,238.339,2.42,0.354,0
141,66,2,963,0,65,0,0,22.22,24206636,16.955,15.1,2.553,926,238.339,2.42,0.354,0
141,67,3,966,0,65,0,0,22.22,24206636,16.955,15.1,2.553,926,238.339,2.42,0.354,0
141,68,4,970,0,65,0,0,22.22,24206636,16.955,15.1,2.553,926,238.339,2.42,0.354,0
141,69,3,973,0,65,0,0,22.22,24206636,16.955,15.1,2.553,926,238.339,2.42,0.354,0
141,70,0,973,0,65,0,0,22.22,24206636,16.955,15.1,2.553,926,238.339,2.42,0.354,0
141,71,1,974,0,65,0,0,22.22,24206636,16.955,15.1,2.553,926,238.339,2.42,0.354,0
141,72,0,974,0,65,0,0,22.22,24206636,16.955,15.1,2.553,926,238.339,2.42,0.354,0
141,73,0,974,0,65,0,0,22.22,24206636,16.955,15.1,2.553,926,238.339,2.42,0.354,0
141,74,4,978,0,65,0,0,22.22,24206636,16.955,15.1,2.553,926,238.339,2.42,0.354,0
141,75,2,980,1,66,0,0,22.22,24206636,16.955,15.1,2.553,926,238.339,2.42,0.354,0
141,76,0,980,0,66,0,0,22.22,24206636,16.955,15.1,2.553,926,238.339,2.42,0.354,0
141,77,0,980,0,66,0,0,22.22,24206636,16.955,15.1,2.553,926,238.339,2.42,0.354,0
141,78,36,1016,0,66,0,0,22.22,24206636,16.955,15.1,2.553,926,238.339,2.42,0.354,0
141,79,4,1020,1,67,0,0,22.22,24206636,16.955,15.1,2.553,926,238.339,2.42,0.354,0
141,80,0,1020,0,67,0,0,22.22,24206636,16.955,15.1,2.553,926,238.339,2.42,0.354,0
141,81,0,1020,0,67,0,0,22.22,24206636,16.955,15.1,2.553,926,238.339,2.42,0.354,0
141,82,15,1035,0,67,0,0,22.22,24206636,16.955,15.1,2.553,926,238.339,2.42,0.354,0
141,83,1,1036,0,67,0,0,22.22,24206636,16.955,15.1,2.553,926,238.339,2.42,0.354,0
141,84,10,1046,0,67,0,0,22.22,24206636,16.955,15.1,2.553,926,238.339,2.42,0.354,0
141,85,5,1051,0,67,0,0,22.22,24206636,16.955,15.1,2.553,926,238.339,2.42,0.354,0
141,86,5,1056,0,67,0,0,22.22,24206636,16.955,15.1,2.553,926,238.339,2.42,0.354,0
141,87,3,1059,0,67,0,0,22.22,24206636,16.955,15.1,2.553,926,238.339,2.42,0.354,0
141,88,3,1062,0,67,0,0,22.22,24206636,16.955,15.1,2.553,926,238.339,2.42,0.354,0
141,89,6,1068,0,67,0,0,22.22,24206636,16.955,15.1,2.553,926,238.339,2.42,0.354,0
141,90,6,1074,0,67,0,0,22.22,24206636,16.955,15.1,2.553,926,238.339,2.42,0.354,0
141,91,1,1075,0,67,0,0,22.22,24206636,16.955,15.1,2.553,926,238.339,2.42,0.354,0
141,92,0,1075,0,67,0,0,22.22,24206636,16.955,15.1,2.553,926,238.339,2.42,0.354,0
141,93,0,1075,0,67,0,0,22.22,24206636,16.955,15.1,2.553,926,238.339,2.42,0.354,0
141,94,6,1081,1,68,0,0,22.22,24206636,16.955,15.1,2.553,926,238.339,2.42,0.354,0
141,95,1,1082,0,68,0,0,22.22,24206636,16.955,15.1,2.553,926,238.339,2.42,0.354,0
141,96,0,1082,0,68,0,0,22.22,24206636,16.955,15.1,2.553,926,238.339,2.42,0.354,0
141,97,11,1093,0,68,0,0,22.22,24206636,16.955,15.1,2.553,926,238.339,2.42,0.354,0
141,98,0,1093,0,68,0,0,22.22,24206636,16.955,15.1,2.553,926,238.339,2.42,0.354,0
141,99,1,1094,0,68,0,0,22.22,24206636,16.955,15.1,2.553,926,238.339,2.42,0.354,0
141,100,3,1097,0,68,0,0,22.22,24206636,16.955,15.1,2.553,926,238.339,2.42,0.354,0
141,101,0,1097,0,68,0,0,22.22,24206636,16.955,15.1,2.553,926,238.339,2.42,0.354,0
141,102,2,1099,0,68,0,0,22.22,24206636,16.955,15.1,2.553,926,238.339,2.42,0.354,0
141,103,0,1099,0,68,0,0,22.22,24206636,16.955,15.1,2.553,926,238.339,2.42,0.354,0
141,104,0,1099,0,68,0,0,22.22,24206636,16.955,15.1,2.553,926,238.339,2.42,0.354,0
141,105,0,1099,0,68,0,0,22.22,24206636,16.955,15.1,2.553,926,238.339,2.42,0.354,0
141,106,0,1099,0,68,0,0,22.22,24206636,16.955,15.1,2.553,926,238.339,2.42,0.354,0
141,107,1,1100,1,69,0,0,22.22,24206636,16.955,15.1,2.553,926,238.339,2.42,0.354,0
141,108,2,1102,0,69,0,0,22.22,24206636,16.955,15.1,2.553,926,238.339,2.42,0.354,0
141,109,0,1102,0,69,0,0,22.22,24206636,16.955,15.1,2.553,926,238.339,2.42,0.354,0
141,110,2,1104,0,69,0,0,22.22,24206636,16.955,15.1,2.553,926,238.339,2.42,0.354,0
141,111,0,1104,0,69,0,0,22.22,24206636,16.955,15.1,2.553,926,238.339,2.42,0.354,0
141,112,1,1105,0,69,0,0,22.22,24206636,16.955,15.1,2.553,926,238.339,2.42,0.354,0
141,113,8,1113,0,69,0,0,22.22,24206636,16.955,15.1,2.553,926,238.339,2.42,0.354,0
141,114,9,1122,0,69,0,0,22.22,24206636,16.955,15.1,2.553,926,238.339,2.42,0.354,0
141,115,2,1124,0,69,0,0,22.22,24206636,16.955,15.1,2.553,926,238.339,2.42,0.354,0
141,116,0,1124,0,69,0,0,22.22,24206636,16.955,15.1,2.553,926,238.339,2.42,0.354,0
141,117,0,1124,0,69,0,0,22.22,24206636,16.955,15.1,2.553,926,238.339,2.42,0.354,0
141,118,8,1132,0,69,0,0,22.22,24206636,16.955,15.1,2.553,926,238.339,2.42,0.354,0
141,119,0,1132,0,69,0,0,22.22,24206636,16.955,15.1,2.553,926,238.339,2.42,0.354,0
141,120,0,1132,0,69,0,0,22.22,24206636,16.955,15.1,2.553,926,238.339,2.42,0.354,0
141,121,2,1134,0,69,0,0,22.22,24206636,16.955,15.1,2.553,926,238.339,2.42,0.354,0
141,122,0,1134,0,69,0,0,22.22,24206636,16.955,15.1,2.553,926,238.339,2.42,0.354,0
141,123,0,1134,0,69,0,0,22.22,24206636,16.955,15.1,2.553,926,238.339,2.42,0.354,0
141,124,2,1136,0,69,0,0,22.22,24206636,16.955,15.1,2.553,926,238.339,2.42,0.354,0
141,125,11,1147,0,69,0,0,22.22,24206636,16.955,15.1,2.553,926,238.339,2.42,0.354,0
141,126,5,1152,0,69,0,0,22.22,24206636,16.955,15.1,2.553,926,238.339,2.42,0.354,0
141,127,0,1152,0,69,0,0,22.22,24206636,16.955,15.1,2.553,926,238.339,2.42,0.354,0
141,128,0,1152,0,69,0,0,22.22,24206636,16.955,15.1,2.553,926,238.339,2.42,0.354,0
141,129,1,1153,0,69,0,0,22.22,24206636,16.955,15.1,2.553,926,238.339,2.42,0.354,0
141,130,0,1153,0,69,0,0,13.89,24206636,16.955,15.1,2.553,926,238.339,2.42,0.354,0
141,131,4,1157,0,69,0,0,13.89,24206636,16.955,15.1,2.553,926,238.339,2.42,0.354,0
141,132,1,1158,0,69,0,0,13.89,24206636,16.955,15.1,2.553,926,238.339,2.42,0.354,0
141,133,0,1158,0,69,0,0,13.89,24206636,16.955,15.1,2.553,926,238.339,2.42,0.354,0
141,134,0,1158,0,69,0,0,13.89,24206636,16.955,15.1,2.553,926,238.339,2.42,0.354,0
141,135,3,1161,0,69,0,0,13.89,24206636,16.955,15.1,2.553,926,238.339,2.42,0.354,0
141,136,0,1161,0,69,0,0,13.89,24206636,16.955,15.1,2.553,926,238.339,2.42,0.354,0
141,137,4,1165,0,69,0,0,13.89,24206636,16.955,15.1,2.553,926,238.339,2.42,0.354,0
141,138,0,1165,0,69,0,0,13.89,24206636,16.955,15.1,2.553,926,238.339,2.42,0.354,0
141,139,2,1167,0,69,0,0,13.89,24206636,16.955,15.1,2.553,926,238.339,2.42,0.354,0
141,140,0,1167,0,69,0,0,13.89,24206636,16.955,15.1,2.553,926,238.339,2.42,0.354,0
141,141,0,1167,0,69,0,0,13.89,24206636,16.955,15.1,2.553,926,238.339,2.42,0.354,0
141,142,0,1167,0,69,0,0,13.89,24206636,16.955,15.1,2.553,926,238.339,2.42,0.354,0
141,143,2,1169,0,69,0,0,13.89,24206636,16.955,15.1,2.553,926,238.339,2.42,0.354,0
141,144,3,1172,0,69,0,0,13.89,24206636,16.955,15.1,2.553,926,238.339,2.42,0.354,0
141,145,0,1172,0,69,0,0,13.89,24206636,16.955,15.1,2.553,926,238.339,2.42,0.354,0
141,146,0,1172,0,69,0,0,13.89,24206636,16.955,15.1,2.553,926,238.339,2.42,0.354,0
141,147,0,1172,0,69,0,0,13.89,24206636,16.955,15.1,2.553,926,238.339,2.42,0.354,0
141,148,1,1173,0,69,0,0,13.89,24206636,16.955,15.1,2.553,926,238.339,2.42,0.354,0
141,149,0,1173,0,69,0,0,13.89,24206636,16.955,15.1,2.553,926,238.339,2.42,0.354,0
141,150,0,1173,0,69,0,0,13.89,24206636,16.955,15.1,2.553,926,238.339,2.42,0.354,0
141,151,2,1175,0,69,0,0,13.89,24206636,16.955,15.1,2.553,926,238.339,2.42,0.354,0
141,152,0,1175,0,69,0,0,13.89,24206636,16.955,15.1,2.553,926,238.339,2.42,0.354,0
141,153,1,1176,0,69,0,0,13.89,24206636,16.955,15.1,2.553,926,238.339,2.42,0.354,0
141,154,0,1176,0,69,0,0,13.89,24206636,16.955,15.1,2.553,926,238.339,2.42,0.354,0
141,155,0,1176,0,69,0,0,13.89,24206636,16.955,15.1,2.553,926,238.339,2.42,0.354,0
141,156,1,1177,0,69,0,0,13.89,24206636,16.955,15.1,2.553,926,238.339,2.42,0.354,0
141,157,0,1177,0,69,0,0,13.89,24206636,16.955,15.1,2.553,926,238.339,2.42,0.354,0
141,158,0,1177,0,69,0,0,13.89,24206636,16.955,15.1,2.553,926,238.339,2.42,0.354,0
141,159,0,1177,0,69,0,0,11.11,24206636,16.955,15.1,2.553,926,238.339,2.42,0.354,0
141,160,0,1177,0,69,0,0,11.11,24206636,16.955,15.1,2.553,926,238.339,2.42,0.354,0
141,161,1,1178,0,69,0,0,11.11,24206636,16.955,15.1,2.553,926,238.339,2.42,0.354,0
141,162,0,1178,0,69,0,0,11.11,24206636,16.955,15.1,2.553,926,238.339,2.42,0.354,0
141,163,0,1178,0,69,0,0,11.11,24206636,16.955,15.1,2.553,926,238.339,2.42,0.354,0
141,164,0,1178,0,69,0,0,11.11,24206636,16.955,15.1,2.553,926,238.339,2.42,0.354,0
141,165,0,1178,0,69,0,0,11.11,24206636,16.955,15.1,2.553,926,238.339,2.42,0.354,0
141,166,0,1178,0,69,0,0,11.11,24206636,16.955,15.1,2.553,926,238.339,2.42,0.354,0
141,167,2,1180,0,69,0,0,11.11,24206636,16.955,15.1,2.553,926,238.339,2.42,0.354,0
141,168,0,1180,0,69,0,0,11.11,24206636,16.955,15.1,2.553,926,238.339,2.42,0.354,0
141,169,0,1180,0,69,0,0,11.11,24206636,16.955,15.1,2.553,926,238.339,2.42,0.354,0
141,170,0,1180,0,69,0,0,11.11,24206636,16.955,15.1,2.553,926,238.339,2.42,0.354,0
141,171,0,1180,0,69,0,0,11.11,24206636,16.955,15.1,2.553,926,238.339,2.42,0.354,0
141,172,2,1182,0,69,0,0,11.11,24206636,16.955,15.1,2.553,926,238.339,2.42,0.354,0
141,173,0,1182,0,69,0,0,11.11,24206636,16.955,15.1,2.553,926,238.339,2.42,0.354,0
141,174,6,1188,0,69,0,0,11.11,24206636,16.955,15.1,2.553,926,238.339,2.42,0.354,0
141,175,1,1189,0,69,0,0,11.11,24206636,16.955,15.1,2.553,926,238.339,2.42,0.354,0
141,176,4,1193,0,69,0,0,11.11,24206636,16.955,15.1,2.553,926,238.339,2.42,0.354,0
141,177,0,1193,0,69,0,0,11.11,24206636,16.955,15.1,2.553,926,238.339,2.42,0.354,0
141,178,1,1194,0,69,0,0,11.11,24206636,16.955,15.1,2.553,926,238.339,2.42,0.354,0
141,179,0,1194,0,69,0,0,11.11,24206636,16.955,15.1,2.553,926,238.339,2.42,0.354,0
141,180,0,1194,0,69,0,0,11.11,24206636,16.955,15.1,2.553,926,238.339,2.42,0.354,0
141,181,2,1196,0,69,0,0,11.11,24206636,16.955,15.1,2.553,926,238.339,2.42,0.354,0
141,182,0,1196,0,69,0,0,11.11,24206636,16.955,15.1,2.553,926,238.339,2.42,0.354,0
141,183,0,1196,0,69,0,0,11.11,24206636,16.955,15.1,2.553,926,238.339,2.42,0.354,0
141,184,1,1197,0,69,0,0,11.11,24206636,16.955,15.1,2.553,926,238.339,2.42,0.354,0
141,185,0,1197,0,69,0,0,11.11,24206636,16.955,15.1,2.553,926,238.339,2.42,0.354,0
141,186,1,1198,0,69,0,0,17.59,24206636,16.955,15.1,2.553,926,238.339,2.42,0.354,0
141,187,2,1200,0,69,0,0,17.59,24206636,16.955,15.1,2.553,926,238.339,2.42,0.354,0
141,188,0,1200,0,69,0,0,17.59,24206636,16.955,15.1,2.553,926,238.339,2.42,0.354,0
141,189,0,1200,0,69,0,0,17.59,24206636,16.955,15.1,2.553,926,238.339,2.42,0.354,0
141,190,0,1200,0,69,0,0,17.59,24206636,16.955,15.1,2.553,926,238.339,2.42,0.354,0
141,191,0,1200,0,69,0,0,17.59,24206636,16.955,15.1,2.553,926,238.339,2.42,0.354,0
141,192,1,1201,0,69,0,0,17.59,24206636,16.955,15.1,2.553,926,238.339,2.42,0.354,0
141,193,0,1201,0,69,0,0,17.59,24206636,16.955,15.1,2.553,926,238.339,2.42,0.354,0
141,194,0,1201,0,69,0,0,17.59,24206636,16.955,15.1,2.553,926,238.339,2.42,0.354,0
141,195,0,1201,0,69,0,0,17.59,24206636,16.955,15.1,2.553,926,238.339,2.42,0.354,0
141,196,1,1202,0,69,0,0,17.59,24206636,16.955,15.1,2.553,926,238.339,2.42,0.354,0
141,197,1,1203,0,69,0,0,17.59,24206636,16.955,15.1,2.553,926,238.339,2.42,0.354,0
141,198,2,1205,0,69,0,0,17.59,24206636,16.955,15.1,2.553,926,238.339,2.42,0.354,0
141,199,2,1207,0,69,0,0,17.59,24206636,16.955,15.1,2.553,926,238.339,2.42,0.354,0
141,200,2,1209,0,69,0,0,17.59,24206636,16.955,15.1,2.553,926,238.339,2.42,0.354,0
141,201,0,1209,0,69,0,0,17.59,24206636,16.955,15.1,2.553,926,238.339,2.42,0.354,0
141,202,1,1210,0,69,0,0,17.59,24206636,16.955,15.1,2.553,926,238.339,2.42,0.354,0
141,203,1,1211,0,69,0,0,17.59,24206636,16.955,15.1,2.553,926,238.339,2.42,0.354,0
141,204,1,1212,0,69,0,0,17.59,24206636,16.955,15.1,2.553,926,238.339,2.42,0.354,0
142,1,0,131,0,2,0,0,82.87,206139587,209.588,18.1,2.751,5338.454,181.013,2.42,0.532,2
142,2,20,151,0,2,0,0,82.87,206139587,209.588,18.1,2.751,5338.454,181.013,2.42,0.532,2
142,3,23,174,0,2,0,0,82.87,206139587,209.588,18.1,2.751,5338.454,181.013,2.42,0.532,2
142,4,16,190,0,2,0,0,82.87,206139587,209.588,18.1,2.751,5338.454,181.013,2.42,0.532,2
142,5,20,210,2,4,0,0,82.87,206139587,209.588,18.1,2.751,5338.454,181.013,2.42,0.532,2
142,6,22,232,1,5,0,0,82.87,206139587,209.588,18.1,2.751,5338.454,181.013,2.42,0.532,2
142,7,6,238,0,5,0,0,82.87,206139587,209.588,18.1,2.751,5338.454,181.013,2.42,0.532,2
142,8,16,254,1,6,0,5000,82.87,206139587,209.588,18.1,2.751,5338.454,181.013,2.42,0.532,2
142,9,22,276,0,6,0,5000,82.87,206139587,209.588,18.1,2.751,5338.454,181.013,2.42,0.532,2
142,10,12,288,1,7,0,5000,82.87,206139587,209.588,18.1,2.751,5338.454,181.013,2.42,0.532,2
142,11,17,305,0,7,0,5000,82.87,206139587,209.588,18.1,2.751,5338.454,181.013,2.42,0.532,2
142,12,13,318,3,10,0,5000,82.87,206139587,209.588,18.1,2.751,5338.454,181.013,2.42,0.532,2
142,13,5,323,0,10,0,5000,82.87,206139587,209.588,18.1,2.751,5338.454,181.013,2.42,0.532,2
142,14,20,343,0,10,0,5000,82.87,206139587,209.588,18.1,2.751,5338.454,181.013,2.42,0.532,2
142,15,30,373,1,11,0,5000,82.87,206139587,209.588,18.1,2.751,5338.454,181.013,2.42,0.532,2
142,16,34,407,1,12,0,6649,82.87,206139587,209.588,18.1,2.751,5338.454,181.013,2.42,0.532,2
142,17,35,442,1,13,504,7153,82.87,206139587,209.588,18.1,2.751,5338.454,181.013,2.42,0.532,2
142,18,51,493,4,17,0,7153,82.87,206139587,209.588,18.1,2.751,5338.454,181.013,2.42,0.532,2
142,19,49,542,2,19,0,7153,82.87,206139587,209.588,18.1,2.751,5338.454,181.013,2.42,0.532,2
142,20,85,627,2,21,0,7153,82.87,206139587,209.588,18.1,2.751,5338.454,181.013,2.42,0.532,2
142,21,38,665,1,22,0,7153,82.87,206139587,209.588,18.1,2.751,5338.454,181.013,2.42,0.532,2
142,22,117,782,3,25,0,7153,82.87,206139587,209.588,18.1,2.751,5338.454,181.013,2.42,0.532,2
142,23,91,873,3,28,0,10061,85.65,206139587,209.588,18.1,2.751,5338.454,181.013,2.42,0.532,2
142,24,108,981,3,31,0,10061,85.65,206139587,209.588,18.1,2.751,5338.454,181.013,2.42,0.532,2
142,25,114,1095,1,32,0,10918,85.65,206139587,209.588,18.1,2.751,5338.454,181.013,2.42,0.532,2
142,26,87,1182,3,35,0,10918,85.65,206139587,209.588,18.1,2.751,5338.454,181.013,2.42,0.532,2
142,27,91,1273,5,40,0,10918,85.65,206139587,209.588,18.1,2.751,5338.454,181.013,2.42,0.532,2
142,28,64,1337,0,40,0,12004,85.65,206139587,209.588,18.1,2.751,5338.454,181.013,2.42,0.532,2
142,29,195,1532,4,44,824,12828,85.65,206139587,209.588,18.1,2.751,5338.454,181.013,2.42,0.532,2
142,30,196,1728,7,51,0,12828,85.65,206139587,209.588,18.1,2.751,5338.454,181.013,2.42,0.532,2
142,31,204,1932,7,58,0,15759,85.65,206139587,209.588,18.1,2.751,5338.454,181.013,2.42,0.532,2
142,32,238,2170,10,68,0,15759,85.65,206139587,209.588,18.1,2.751,5338.454,181.013,2.42,0.532,2
142,33,218,2388,17,85,0,16588,85.65,206139587,209.588,18.1,2.751,5338.454,181.013,2.42,0.532,2
142,34,170,2558,2,87,1948,18536,80.56,206139587,209.588,18.1,2.751,5338.454,181.013,2.42,0.532,2
142,35,244,2802,6,93,976,19512,80.56,206139587,209.588,18.1,2.751,5338.454,181.013,2.42,0.532,2
142,36,148,2950,5,98,1696,21208,80.56,206139587,209.588,18.1,2.751,5338.454,181.013,2.42,0.532,2
142,37,195,3145,5,103,1284,22492,80.56,206139587,209.588,18.1,2.751,5338.454,181.013,2.42,0.532,2
142,38,381,3526,4,107,1343,23835,80.56,206139587,209.588,18.1,2.751,5338.454,181.013,2.42,0.532,2
142,39,386,3912,10,117,0,23835,80.56,206139587,209.588,18.1,2.751,5338.454,181.013,2.42,0.532,2
142,40,239,4151,11,128,0,23835,80.56,206139587,209.588,18.1,2.751,5338.454,181.013,2.42,0.532,2
142,41,248,4399,15,143,0,27078,80.56,206139587,209.588,18.1,2.751,5338.454,181.013,2.42,0.532,2
142,42,242,4641,7,150,1340,28418,80.56,206139587,209.588,18.1,2.751,5338.454,181.013,2.42,0.532,2
142,43,146,4787,8,158,990,29408,80.56,206139587,209.588,18.1,2.751,5338.454,181.013,2.42,0.532,2
142,44,184,4971,6,164,1249,30657,80.56,206139587,209.588,18.1,2.751,5338.454,181.013,2.42,0.532,2
142,45,191,5162,3,167,0,30657,80.56,206139587,209.588,18.1,2.751,5338.454,181.013,2.42,0.532,2
142,46,283,5445,4,171,0,32942,80.56,206139587,209.588,18.1,2.751,5338.454,181.013,2.42,0.532,2
142,47,176,5621,5,176,1028,33970,80.56,206139587,209.588,18.1,2.751,5338.454,181.013,2.42,0.532,2
142,48,338,5959,6,182,1375,35345,80.56,206139587,209.588,18.1,2.751,5338.454,181.013,2.42,0.532,2
142,49,216,6175,9,191,1554,36899,80.56,206139587,209.588,18.1,2.751,5338.454,181.013,2.42,0.532,2
142,50,226,6401,1,192,1332,38231,80.56,206139587,209.588,18.1,2.751,5338.454,181.013,2.42,0.532,2
142,51,276,6677,8,200,0,38231,80.56,206139587,209.588,18.1,2.751,5338.454,181.013,2.42,0.532,2
142,52,339,7016,11,211,0,41907,80.56,206139587,209.588,18.1,2.751,5338.454,181.013,2.42,0.532,2
142,53,245,7261,10,221,1421,43328,80.56,206139587,209.588,18.1,2.751,5338.454,181.013,2.42,0.532,2
142,54,265,7526,0,221,1130,44458,80.56,206139587,209.588,18.1,2.751,5338.454,181.013,2.42,0.532,2
142,55,313,7839,5,226,1225,45683,80.56,206139587,209.588,18.1,2.751,5338.454,181.013,2.42,0.532,2
142,56,229,8068,7,233,1120,46803,80.56,206139587,209.588,18.1,2.751,5338.454,181.013,2.42,0.532,2
142,57,276,8344,16,249,1741,48544,80.56,206139587,209.588,18.1,2.751,5338.454,181.013,2.42,0.532,2
142,58,389,8733,5,254,1422,49966,80.56,206139587,209.588,18.1,2.751,5338.454,181.013,2.42,0.532,2
142,59,182,8915,5,259,8760,58726,80.56,206139587,209.588,18.1,2.751,5338.454,181.013,2.42,0.532,2
142,60,387,9302,2,261,2099,60825,80.56,206139587,209.588,18.1,2.751,5338.454,181.013,2.42,0.532,2
142,61,553,9855,12,273,0,60825,80.56,206139587,209.588,18.1,2.751,5338.454,181.013,2.42,0.532,2
142,62,307,10162,14,287,0,63882,80.56,206139587,209.588,18.1,2.751,5338.454,181.013,2.42,0.532,2
142,63,416,10578,12,299,2003,65885,80.56,206139587,209.588,18.1,2.751,5338.454,181.013,2.42,0.532,2
142,64,241,10819,15,314,3916,69801,80.56,206139587,209.588,18.1,2.751,5338.454,181.013,2.42,0.532,2
142,65,347,11166,1,315,1535,71336,80.56,206139587,209.588,18.1,2.751,5338.454,181.013,2.42,0.532,2
142,66,350,11516,8,323,1728,73064,80.56,206139587,209.588,18.1,2.751,5338.454,181.013,2.42,0.532,2
142,67,328,11844,10,333,1935,74999,80.56,206139587,209.588,18.1,2.751,5338.454,181.013,2.42,0.532,2
142,68,389,12233,9,342,1803,76802,80.56,206139587,209.588,18.1,2.751,5338.454,181.013,2.42,0.532,2
142,69,253,12486,12,354,1442,78244,80.56,206139587,209.588,18.1,2.751,5338.454,181.013,2.42,0.532,2
142,70,315,12801,7,361,1704,79948,80.56,206139587,209.588,18.1,2.751,5338.454,181.013,2.42,0.532,2
142,71,663,13464,4,365,2987,82935,80.56,206139587,209.588,18.1,2.751,5338.454,181.013,2.42,0.532,2
142,72,409,13873,17,382,2440,85375,80.56,206139587,209.588,18.1,2.751,5338.454,181.013,2.42,0.532,2
142,73,681,14554,5,387,0,85375,80.56,206139587,209.588,18.1,2.751,5338.454,181.013,2.42,0.532,2
142,74,627,15181,12,399,0,90464,80.56,206139587,209.588,18.1,2.751,5338.454,181.013,2.42,0.532,2
142,75,501,15682,8,407,2460,92924,80.56,206139587,209.588,18.1,2.751,5338.454,181.013,2.42,0.532,2
142,76,403,16085,13,420,1399,94323,80.56,206139587,209.588,18.1,2.751,5338.454,181.013,2.42,0.532,2
142,77,573,16658,4,424,2079,96402,76.39,206139587,209.588,18.1,2.751,5338.454,181.013,2.42,0.532,2
142,78,490,17148,31,455,0,96402,76.39,206139587,209.588,18.1,2.751,5338.454,181.013,2.42,0.532,2
142,79,587,17735,14,469,0,106006,76.39,206139587,209.588,18.1,2.751,5338.454,181.013,2.42,0.532,2
142,80,745,18480,6,475,2542,108548,76.39,206139587,209.588,18.1,2.751,5338.454,181.013,2.42,0.532,2
142,81,667,19147,12,487,2504,111052,76.39,206139587,209.588,18.1,2.751,5338.454,181.013,2.42,0.532,2
142,82,661,19808,19,506,2523,113575,76.39,206139587,209.588,18.1,2.751,5338.454,181.013,2.42,0.532,2
142,83,436,20244,12,518,2185,115760,76.39,206139587,209.588,18.1,2.751,5338.454,181.013,2.42,0.532,2
142,84,675,20919,7,525,1809,117569,76.39,206139587,209.588,18.1,2.751,5338.454,181.013,2.42,0.532,2
142,85,452,21371,8,533,2539,120108,76.39,206139587,209.588,18.1,2.751,5338.454,181.013,2.42,0.532,2
142,86,649,22020,9,542,2047,122155,76.39,206139587,209.588,18.1,2.751,5338.454,181.013,2.42,0.532,2
142,87,594,22614,7,549,0,122155,76.39,206139587,209.588,18.1,2.751,5338.454,181.013,2.42,0.532,2
142,88,684,23298,5,554,0,127158,76.39,206139587,209.588,18.1,2.751,5338.454,181.013,2.42,0.532,2
142,89,779,24077,4,558,3006,130164,76.39,206139587,209.588,18.1,2.751,5338.454,181.013,2.42,0.532,2
142,90,490,24567,7,565,2140,132304,76.39,206139587,209.588,18.1,2.751,5338.454,181.013,2.42,0.532,2
142,91,566,25133,8,573,1953,134257,76.39,206139587,209.588,18.1,2.751,5338.454,181.013,2.42,0.532,2
142,92,561,25694,17,590,4205,138462,68.06,206139587,209.588,18.1,2.751,5338.454,181.013,2.42,0.532,2
142,93,790,26484,13,603,3063,141525,68.06,206139587,209.588,18.1,2.751,5338.454,181.013,2.42,0.532,2
142,94,626,27110,13,616,3308,144833,68.06,206139587,209.588,18.1,2.751,5338.454,181.013,2.42,0.532,2
142,95,454,27564,12,628,3355,148188,68.06,206139587,209.588,18.1,2.751,5338.454,181.013,2.42,0.532,2
142,96,603,28167,6,634,2933,151121,68.06,206139587,209.588,18.1,2.751,5338.454,181.013,2.42,0.532,2
142,97,544,28711,11,645,1831,152952,68.06,206139587,209.588,18.1,2.751,5338.454,181.013,2.42,0.532,2
142,98,575,29286,9,654,0,152952,68.06,206139587,209.588,18.1,2.751,5338.454,181.013,2.42,0.532,2
142,99,503,29789,15,669,0,169629,68.06,206139587,209.588,18.1,2.751,5338.454,181.013,2.42,0.532,2
142,100,460,30249,15,684,2302,171931,68.06,206139587,209.588,18.1,2.751,5338.454,181.013,2.42,0.532,2
142,101,499,30748,5,689,3725,175656,68.06,206139587,209.588,18.1,2.751,5338.454,181.013,2.42,0.532,2
142,102,575,31323,20,709,2609,178265,68.06,206139587,209.588,18.1,2.751,5338.454,181.013,2.42,0.532,2
142,103,664,31987,15,724,2983,181248,68.06,206139587,209.588,18.1,2.751,5338.454,181.013,2.42,0.532,2
142,104,571,32558,16,740,2046,183294,68.06,206139587,209.588,18.1,2.751,5338.454,181.013,2.42,0.532,2
142,105,595,33153,4,744,0,183294,68.06,206139587,209.588,18.1,2.751,5338.454,181.013,2.42,0.532,2
142,106,463,33616,10,754,0,199016,68.06,206139587,209.588,18.1,2.751,5338.454,181.013,2.42,0.532,2
142,107,643,34259,6,760,3081,202097,68.06,206139587,209.588,18.1,2.751,5338.454,181.013,2.42,0.532,2
142,108,595,34854,9,769,4325,206422,68.06,206139587,209.588,18.1,2.751,5338.454,181.013,2.42,0.532,2
142,109,600,35454,3,772,3024,209446,68.06,206139587,209.588,18.1,2.751,5338.454,181.013,2.42,0.532,2
142,110,653,36107,6,778,2755,212201,68.06,206139587,209.588,18.1,2.751,5338.454,181.013,2.42,0.532,2
142,111,556,36663,11,789,0,212201,68.06,206139587,209.588,18.1,2.751,5338.454,181.013,2.42,0.532,2
142,112,562,37225,12,801,0,218223,68.06,206139587,209.588,18.1,2.751,5338.454,181.013,2.42,0.532,2
142,113,576,37801,4,805,29602,247825,68.06,206139587,209.588,18.1,2.751,5338.454,181.013,2.42,0.532,2
142,114,543,38344,8,813,4068,251893,68.06,206139587,209.588,18.1,2.751,5338.454,181.013,2.42,0.532,2
142,115,604,38948,20,833,4145,256038,68.06,206139587,209.588,18.1,2.751,5338.454,181.013,2.42,0.532,2
142,116,591,39539,12,845,3478,259516,68.06,206139587,209.588,18.1,2.751,5338.454,181.013,2.42,0.532,2
142,117,438,39977,11,856,3063,262579,68.06,206139587,209.588,18.1,2.751,5338.454,181.013,2.42,0.532,2
142,118,555,40532,2,858,5263,267842,68.06,206139587,209.588,18.1,2.751,5338.454,181.013,2.42,0.532,2
142,119,648,41180,2,860,4906,272748,68.06,206139587,209.588,18.1,2.751,5338.454,181.013,2.42,0.532,2
142,120,624,41804,8,868,3305,276053,68.06,206139587,209.588,18.1,2.751,5338.454,181.013,2.42,0.532,2
142,121,404,42208,5,873,3622,279675,68.06,206139587,209.588,18.1,2.751,5338.454,181.013,2.42,0.532,2
142,122,481,42689,5,878,0,279675,69.44,206139587,209.588,18.1,2.751,5338.454,181.013,2.42,0.532,2
142,123,462,43151,1,879,0,286091,69.44,206139587,209.588,18.1,2.751,5338.454,181.013,2.42,0.532,2
142,124,386,43537,4,883,1441,287532,69.44,206139587,209.588,18.1,2.751,5338.454,181.013,2.42,0.532,2
142,125,304,43841,5,888,1601,289133,69.44,206139587,209.588,18.1,2.751,5338.454,181.013,2.42,0.532,2
142,126,288,44129,8,896,15088,304221,69.44,206139587,209.588,18.1,2.751,5338.454,181.013,2.42,0.532,2
142,127,304,44433,14,910,0,304221,69.44,206139587,209.588,18.1,2.751,5338.454,181.013,2.42,0.532,2
142,128,457,44890,17,927,0,306894,69.44,206139587,209.588,18.1,2.751,5338.454,181.013,2.42,0.532,2
142,129,354,45244,3,930,3835,310729,69.44,206139587,209.588,18.1,2.751,5338.454,181.013,2.42,0.532,2
142,130,443,45687,6,936,3903,314632,69.44,206139587,209.588,18.1,2.751,5338.454,181.013,2.42,0.532,2
142,131,453,46140,6,942,2864,317496,69.44,206139587,209.588,18.1,2.751,5338.454,181.013,2.42,0.532,2
142,132,437,46577,3,945,2355,319851,69.44,206139587,209.588,18.1,2.751,5338.454,181.013,2.42,0.532,2
142,133,290,46867,5,950,0,319851,69.44,206139587,209.588,18.1,2.751,5338.454,181.013,2.42,0.532,2
142,134,423,47290,6,956,0,338084,69.44,206139587,209.588,18.1,2.751,5338.454,181.013,2.42,0.532,2
142,135,453,47743,0,956,3337,341421,69.44,206139587,209.588,18.1,2.751,5338.454,181.013,2.42,0.532,2
142,136,373,48116,10,966,2976,344397,59.26,206139587,209.588,18.1,2.751,5338.454,181.013,2.42,0.532,2
142,137,329,48445,7,973,0,344397,59.26,206139587,209.588,18.1,2.751,5338.454,181.013,2.42,0.532,2
142,138,325,48770,1,974,0,350589,59.26,206139587,209.588,18.1,2.751,5338.454,181.013,2.42,0.532,2
142,139,298,49068,1,975,2036,352625,59.26,206139587,209.588,18.1,2.751,5338.454,181.013,2.42,0.532,2
142,140,417,49485,2,977,2571,355196,59.26,206139587,209.588,18.1,2.751,5338.454,181.013,2.42,0.532,2
142,141,410,49895,4,981,8135,363331,59.26,206139587,209.588,18.1,2.751,5338.454,181.013,2.42,0.532,2
142,142,593,50488,4,985,2913,366244,59.26,206139587,209.588,18.1,2.751,5338.454,181.013,2.42,0.532,2
142,143,476,50964,7,992,3660,369904,59.26,206139587,209.588,18.1,2.751,5338.454,181.013,2.42,0.532,2
142,144,340,51304,4,996,4173,374077,59.26,206139587,209.588,18.1,2.751,5338.454,181.013,2.42,0.532,2
142,145,601,51905,1,997,3946,378023,59.26,206139587,209.588,18.1,2.751,5338.454,181.013,2.42,0.532,2
142,146,322,52227,5,1002,1519,379542,59.26,206139587,209.588,18.1,2.751,5338.454,181.013,2.42,0.532,2
142,147,321,52548,2,1004,3588,383130,59.26,206139587,209.588,18.1,2.751,5338.454,181.013,2.42,0.532,2
142,148,252,52800,3,1007,5216,388346,59.26,206139587,209.588,18.1,2.751,5338.454,181.013,2.42,0.532,2
142,149,221,53021,3,1010,3156,391502,59.26,206139587,209.588,18.1,2.751,5338.454,181.013,2.42,0.532,2
142,150,296,53317,1,1011,3022,394524,59.26,206139587,209.588,18.1,2.751,5338.454,181.013,2.42,0.532,2
142,151,160,53477,0,1011,3780,398304,59.26,206139587,209.588,18.1,2.751,5338.454,181.013,2.42,0.532,2
142,152,250,53727,0,1011,3766,402070,59.26,206139587,209.588,18.1,2.751,5338.454,181.013,2.42,0.532,2
142,153,138,53865,2,1013,1277,403347,59.26,206139587,209.588,18.1,2.751,5338.454,181.013,2.42,0.532,2
142,154,143,54008,0,1013,0,403347,59.26,206139587,209.588,18.1,2.751,5338.454,181.013,2.42,0.532,2
142,155,239,54247,10,1023,0,411077,59.26,206139587,209.588,18.1,2.751,5338.454,181.013,2.42,0.532,2
142,156,216,54463,4,1027,2188,413265,59.26,206139587,209.588,18.1,2.751,5338.454,181.013,2.42,0.532,2
142,157,124,54587,21,1048,0,413265,59.26,206139587,209.588,18.1,2.751,5338.454,181.013,2.42,0.532,2
142,158,156,54743,3,1051,0,417398,59.26,206139587,209.588,18.1,2.751,5338.454,181.013,2.42,0.532,2
142,159,162,54905,3,1054,3145,420543,59.26,206139587,209.588,18.1,2.751,5338.454,181.013,2.42,0.532,2
142,160,100,55005,3,1057,3643,424186,59.26,206139587,209.588,18.1,2.751,5338.454,181.013,2.42,0.532,2
142,161,155,55160,4,1061,2617,426803,59.26,206139587,209.588,18.1,2.751,5338.454,181.013,2.42,0.532,2
142,162,296,55456,6,1067,3909,430712,59.26,206139587,209.588,18.1,2.751,5338.454,181.013,2.42,0.532,2
142,163,176,55632,3,1070,2494,433206,59.26,206139587,209.588,18.1,2.751,5338.454,181.013,2.42,0.532,2
142,164,197,55829,5,1075,3025,436231,53.7,206139587,209.588,18.1,2.751,5338.454,181.013,2.42,0.532,2
142,165,188,56017,1,1076,1904,438135,53.7,206139587,209.588,18.1,2.751,5338.454,181.013,2.42,0.532,2
142,166,160,56177,2,1078,2113,440248,53.7,206139587,209.588,18.1,2.751,5338.454,181.013,2.42,0.532,2
142,167,79,56256,4,1082,1827,442075,53.7,206139587,209.588,18.1,2.751,5338.454,181.013,2.42,0.532,2
142,168,132,56388,1,1083,1912,443987,53.7,206139587,209.588,18.1,2.751,5338.454,181.013,2.42,0.532,2
142,169,90,56478,5,1088,0,443987,53.7,206139587,209.588,18.1,2.751,5338.454,181.013,2.42,0.532,2
142,170,126,56604,3,1091,0,443987,53.7,206139587,209.588,18.1,2.751,5338.454,181.013,2.42,0.532,2
142,171,131,56735,2,1093,0,472191,53.7,206139587,209.588,18.1,2.751,5338.454,181.013,2.42,0.532,2
142,172,221,56956,1,1094,0,472191,53.7,206139587,209.588,18.1,2.751,5338.454,181.013,2.42,0.532,2
142,173,189,57145,1,1095,0,472191,53.7,206139587,209.588,18.1,2.751,5338.454,181.013,2.42,0.532,2
142,174,97,57242,3,1098,0,480874,53.7,206139587,209.588,18.1,2.751,5338.454,181.013,2.42,0.532,2
142,175,195,57437,2,1100,0,480874,53.7,206139587,209.588,18.1,2.751,5338.454,181.013,2.42,0.532,2
142,176,176,57613,0,1100,0,484051,53.7,206139587,209.588,18.1,2.751,5338.454,181.013,2.42,0.532,2
142,177,111,57724,2,1102,0,484051,53.7,206139587,209.588,18.1,2.751,5338.454,181.013,2.42,0.532,2
142,178,125,57849,0,1102,0,494577,48.15,206139587,209.588,18.1,2.751,5338.454,181.013,2.42,0.532,2
142,179,213,58062,1,1103,7968,502545,48.15,206139587,209.588,18.1,2.751,5338.454,181.013,2.42,0.532,2
142,180,136,58198,3,1106,0,502545,48.15,206139587,209.588,18.1,2.751,5338.454,181.013,2.42,0.532,2
142,181,126,58324,2,1108,0,507006,48.15,206139587,209.588,18.1,2.751,5338.454,181.013,2.42,0.532,2
142,182,136,58460,3,1111,2549,509555,48.15,206139587,209.588,18.1,2.751,5338.454,181.013,2.42,0.532,2
142,183,187,58647,0,1111,0,509555,48.15,206139587,209.588,18.1,2.751,5338.454,181.013,2.42,0.532,2
142,184,201,58848,1,1112,0,509555,48.15,206139587,209.588,18.1,2.751,5338.454,181.013,2.42,0.532,2
142,185,153,59001,0,1112,0,509555,48.15,206139587,209.588,18.1,2.751,5338.454,181.013,2.42,0.532,2
142,186,126,59127,0,1112,0,520797,48.15,206139587,209.588,18.1,2.751,5338.454,181.013,2.42,0.532,2
142,187,160,59287,1,1113,11968,532765,48.15,206139587,209.588,18.1,2.751,5338.454,181.013,2.42,0.532,2
142,188,58,59345,0,1113,3930,536695,48.15,206139587,209.588,18.1,2.751,5338.454,181.013,2.42,0.532,2
142,189,120,59465,0,1113,0,536695,48.15,206139587,209.588,18.1,2.751,5338.454,181.013,2.42,0.532,2
142,190,118,59583,0,1113,0,543415,48.15,206139587,209.588,18.1,2.751,5338.454,181.013,2.42,0.532,2
142,191,155,59738,0,1113,1949,545364,48.15,206139587,209.588,18.1,2.751,5338.454,181.013,2.42,0.532,2
142,192,103,59841,0,1113,0,545364,48.15,206139587,209.588,18.1,2.751,5338.454,181.013,2.42,0.532,2
142,193,151,59992,0,1113,0,551362,48.15,206139587,209.588,18.1,2.751,5338.454,181.013,2.42,0.532,2
142,194,111,60103,2,1115,1675,553037,48.15,206139587,209.588,18.1,2.751,5338.454,181.013,2.42,0.532,2
142,195,163,60266,0,1115,969,554006,40.74,206139587,209.588,18.1,2.751,5338.454,181.013,2.42,0.532,2
142,196,164,60430,0,1115,4307,558313,40.74,206139587,209.588,18.1,2.751,5338.454,181.013,2.42,0.532,2
142,197,225,60655,1,1116,6623,564936,40.74,206139587,209.588,18.1,2.751,5338.454,181.013,2.42,0.532,2
142,198,179,60834,0,1116,2921,567857,40.74,206139587,209.588,18.1,2.751,5338.454,181.013,2.42,0.532,2
142,199,0,60834,0,1116,4848,572705,40.74,206139587,209.588,18.1,2.751,5338.454,181.013,2.42,0.532,2
142,200,360,61194,3,1119,3479,576184,40.74,206139587,209.588,18.1,2.751,5338.454,181.013,2.42,0.532,2
142,201,113,61307,4,1123,2657,578841,40.74,206139587,209.588,18.1,2.751,5338.454,181.013,2.42,0.532,2
142,202,133,61440,2,1125,0,578841,40.74,206139587,209.588,18.1,2.751,5338.454,181.013,2.42,0.532,2
142,203,118,61558,0,1125,0,590635,40.74,206139587,209.588,18.1,2.751,5338.454,181.013,2.42,0.532,2
142,204,72,61630,0,1125,0,590635,40.74,206139587,209.588,18.1,2.751,5338.454,181.013,2.42,0.532,2
144,1,221,4447,2,28,3936,86819,79.63,5421242,14.462,39.7,16.821,64800.057,114.316,5.31,0.953,0
144,2,218,4665,4,32,3560,90379,79.63,5421242,14.462,39.7,16.821,64800.057,114.316,5.31,0.953,0
144,3,270,4935,10,42,3557,93936,79.63,5421242,14.462,39.7,16.821,64800.057,114.316,5.31,0.953,0
144,4,273,5208,2,44,1386,95322,79.63,5421242,14.462,39.7,16.821,64800.057,114.316,5.31,0.953,0
144,5,302,5510,6,50,1117,96439,79.63,5421242,14.462,39.7,16.821,64800.057,114.316,5.31,0.953,0
144,6,130,5640,8,58,3530,99969,79.63,5421242,14.462,39.7,16.821,64800.057,114.316,5.31,0.953,0
144,7,115,5755,1,59,2969,102938,79.63,5421242,14.462,39.7,16.821,64800.057,114.316,5.31,0.953,0
144,8,108,5863,10,69,2276,105214,79.63,5421242,14.462,39.7,16.821,64800.057,114.316,5.31,0.953,0
144,9,147,6010,11,80,1331,106545,79.63,5421242,14.462,39.7,16.821,64800.057,114.316,5.31,0.953,0
144,10,150,6160,8,88,1354,107899,79.63,5421242,14.462,39.7,16.821,64800.057,114.316,5.31,0.953,0
144,11,84,6244,4,92,1419,109318,79.63,5421242,14.462,39.7,16.821,64800.057,114.316,5.31,0.953,0
144,12,76,6320,6,98,1245,110563,79.63,5421242,14.462,39.7,16.821,64800.057,114.316,5.31,0.953,0
144,13,95,6415,5,103,1317,111880,79.63,5421242,14.462,39.7,16.821,64800.057,114.316,5.31,0.953,0
144,14,73,6488,11,114,3369,115249,79.63,5421242,14.462,39.7,16.821,64800.057,114.316,5.31,0.953,0
144,15,78,6566,13,127,3429,118678,79.63,5421242,14.462,39.7,16.821,64800.057,114.316,5.31,0.953,0
144,16,111,6677,3,130,3109,121787,79.63,5421242,14.462,39.7,16.821,64800.057,114.316,5.31,0.953,0
144,17,114,6791,6,136,3131,124918,79.63,5421242,14.462,39.7,16.821,64800.057,114.316,5.31,0.953,0
144,18,0,6791,0,136,1175,126093,79.63,5421242,14.462,39.7,16.821,64800.057,114.316,5.31,0.953,0
144,19,193,6984,12,148,1143,127236,79.63,5421242,14.462,39.7,16.821,64800.057,114.316,5.31,0.953,0
144,20,84,7068,6,154,3776,131012,70.37,5421242,14.462,39.7,16.821,64800.057,114.316,5.31,0.953,0
144,21,45,7113,0,154,3581,134593,67.59,5421242,14.462,39.7,16.821,64800.057,114.316,5.31,0.953,0
144,22,53,7166,9,163,3346,137939,67.59,5421242,14.462,39.7,16.821,64800.057,114.316,5.31,0.953,0
144,23,84,7250,6,169,2975,140914,67.59,5421242,14.462,39.7,16.821,64800.057,114.316,5.31,0.953,0
144,24,95,7345,11,180,3281,144195,67.59,5421242,14.462,39.7,16.821,64800.057,114.316,5.31,0.953,0
144,25,63,7408,11,191,1132,145327,67.59,5421242,14.462,39.7,16.821,64800.057,114.316,5.31,0.953,0
144,26,59,7467,2,193,972,146299,67.59,5421242,14.462,39.7,16.821,64800.057,114.316,5.31,0.953,0
144,27,38,7505,0,193,4104,150403,67.59,5421242,14.462,39.7,16.821,64800.057,114.316,5.31,0.953,0
144,28,28,7533,0,193,4114,154517,67.59,5421242,14.462,39.7,16.821,64800.057,114.316,5.31,0.953,0
144,29,72,7605,2,195,3954,158471,67.59,5421242,14.462,39.7,16.821,64800.057,114.316,5.31,0.953,0
144,30,62,7667,7,202,4435,162906,67.59,5421242,14.462,39.7,16.821,64800.057,114.316,5.31,0.953,0
144,31,43,7710,2,204,1511,164417,67.59,5421242,14.462,39.7,16.821,64800.057,114.316,5.31,0.953,0
144,32,49,7759,0,204,1555,165972,67.59,5421242,14.462,39.7,16.821,64800.057,114.316,5.31,0.953,0
144,33,0,7759,0,204,1260,167232,67.59,5421242,14.462,39.7,16.821,64800.057,114.316,5.31,0.953,0
144,34,50,7809,4,208,4729,171961,67.59,5421242,14.462,39.7,16.821,64800.057,114.316,5.31,0.953,0
144,35,38,7847,0,208,4321,176282,67.59,5421242,14.462,39.7,16.821,64800.057,114.316,5.31,0.953,0
144,36,56,7903,1,209,4284,180566,67.59,5421242,14.462,39.7,16.821,64800.057,114.316,5.31,0.953,0
144,37,50,7953,0,209,3754,184320,67.59,5421242,14.462,39.7,16.821,64800.057,114.316,5.31,0.953,0
144,38,42,7995,0,209,3800,188120,67.59,5421242,14.462,39.7,16.821,64800.057,114.316,5.31,0.953,0
144,39,39,8034,4,213,1299,189419,67.59,5421242,14.462,39.7,16.821,64800.057,114.316,5.31,0.953,0
144,40,35,8069,0,213,1000,190419,67.59,5421242,14.462,39.7,16.821,64800.057,114.316,5.31,0.953,0
144,41,30,8099,4,217,4396,194815,60.19,5421242,14.462,39.7,16.821,64800.057,114.316,5.31,0.953,0
144,42,7,8106,7,224,4794,199609,60.19,5421242,14.462,39.7,16.821,64800.057,114.316,5.31,0.953,0
144,43,29,8135,4,228,4468,204077,60.19,5421242,14.462,39.7,16.821,64800.057,114.316,5.31,0.953,0
144,44,23,8158,1,229,4198,208275,54.63,5421242,14.462,39.7,16.821,64800.057,114.316,5.31,0.953,0
144,45,17,8175,3,232,4172,212447,54.63,5421242,14.462,39.7,16.821,64800.057,114.316,5.31,0.953,0
144,46,22,8197,0,232,1301,213748,54.63,5421242,14.462,39.7,16.821,64800.057,114.316,5.31,0.953,0
144,47,0,8197,0,232,663,214411,54.63,5421242,14.462,39.7,16.821,64800.057,114.316,5.31,0.953,0
144,48,0,8197,0,232,4404,218815,54.63,5421242,14.462,39.7,16.821,64800.057,114.316,5.31,0.953,0
144,49,52,8249,1,233,4656,223471,54.63,5421242,14.462,39.7,16.821,64800.057,114.316,5.31,0.953,0
144,50,8,8257,0,233,3947,227418,54.63,5421242,14.462,39.7,16.821,64800.057,114.316,5.31,0.953,0
144,51,11,8268,1,234,1144,228562,54.63,5421242,14.462,39.7,16.821,64800.057,114.316,5.31,0.953,0
144,52,0,8268,0,234,3342,231904,54.63,5421242,14.462,39.7,16.821,64800.057,114.316,5.31,0.953,0
144,53,41,8309,1,235,1039,232943,54.63,5421242,14.462,39.7,16.821,64800.057,114.316,5.31,0.953,0
144,54,0,8309,0,235,897,233840,54.63,5421242,14.462,39.7,16.821,64800.057,114.316,5.31,0.953,0
144,55,0,8309,0,235,4070,237910,54.63,5421242,14.462,39.7,16.821,64800.057,114.316,5.31,0.953,0
144,56,43,8352,0,235,3452,241362,54.63,5421242,14.462,39.7,16.821,64800.057,114.316,5.31,0.953,0
144,57,12,8364,0,235,3278,244640,54.63,5421242,14.462,39.7,16.821,64800.057,114.316,5.31,0.953,0
144,58,19,8383,0,235,2781,247421,54.63,5421242,14.462,39.7,16.821,64800.057,114.316,5.31,0.953,0
144,59,18,8401,1,236,2589,250010,54.63,5421242,14.462,39.7,16.821,64800.057,114.316,5.31,0.953,0
144,60,10,8411,0,236,813,250823,54.63,5421242,14.462,39.7,16.821,64800.057,114.316,5.31,0.953,0
144,61,0,8411,0,236,638,251461,54.63,5421242,14.462,39.7,16.821,64800.057,114.316,5.31,0.953,0
144,62,0,8411,0,236,742,252203,54.63,5421242,14.462,39.7,16.821,64800.057,114.316,5.31,0.953,0
144,63,0,8411,0,236,3844,256047,39.81,5421242,14.462,39.7,16.821,64800.057,114.316,5.31,0.953,0
144,64,35,8446,1,237,3129,259176,39.81,5421242,14.462,39.7,16.821,64800.057,114.316,5.31,0.953,0
144,65,0,8446,0,237,2916,262092,39.81,5421242,14.462,39.7,16.821,64800.057,114.316,5.31,0.953,0
144,66,31,8477,1,238,2928,265020,39.81,5421242,14.462,39.7,16.821,64800.057,114.316,5.31,0.953,0
144,67,27,8504,0,238,947,265967,39.81,5421242,14.462,39.7,16.821,64800.057,114.316,5.31,0.953,0
144,68,0,8504,0,238,933,266900,39.81,5421242,14.462,39.7,16.821,64800.057,114.316,5.31,0.953,0
144,69,0,8504,0,238,5748,272648,39.81,5421242,14.462,39.7,16.821,64800.057,114.316,5.31,0.953,0
144,70,43,8547,1,239,5660,278308,39.81,5421242,14.462,39.7,16.821,64800.057,114.316,5.31,0.953,0
144,71,16,8563,0,239,4558,282866,39.81,5421242,14.462,39.7,16.821,64800.057,114.316,5.31,0.953,0
144,72,13,8576,0,239,4868,287734,39.81,5421242,14.462,39.7,16.821,64800.057,114.316,5.31,0.953,0
144,73,18,8594,3,242,4628,292362,39.81,5421242,14.462,39.7,16.821,64800.057,114.316,5.31,0.953,0
144,74,12,8606,0,242,1244,293606,39.81,5421242,14.462,39.7,16.821,64800.057,114.316,5.31,0.953,0
144,75,0,8606,0,242,1133,294739,39.81,5421242,14.462,39.7,16.821,64800.057,114.316,5.31,0.953,0
144,76,0,8606,0,242,5845,300584,37.04,5421242,14.462,39.7,16.821,64800.057,114.316,5.31,0.953,0
144,77,25,8631,0,242,5449,306033,37.04,5421242,14.462,39.7,16.821,64800.057,114.316,5.31,0.953,0
144,78,0,8631,0,242,4980,311013,37.04,5421242,14.462,39.7,16.821,64800.057,114.316,5.31,0.953,0
144,79,29,8660,1,243,4553,315566,37.04,5421242,14.462,39.7,16.821,64800.057,114.316,5.31,0.953,0
144,80,32,8692,1,244,3796,319362,37.04,5421242,14.462,39.7,16.821,64800.057,114.316,5.31,0.953,0
144,81,0,8692,0,244,1058,320420,37.04,5421242,14.462,39.7,16.821,64800.057,114.316,5.31,0.953,0
144,82,16,8708,0,244,1028,321448,37.04,5421242,14.462,39.7,16.821,64800.057,114.316,5.31,0.953,0
144,83,0,8708,0,244,5030,326478,37.04,5421242,14.462,39.7,16.821,64800.057,114.316,5.31,0.953,0
144,84,37,8745,4,248,4656,331134,37.04,5421242,14.462,39.7,16.821,64800.057,114.316,5.31,0.953,0
144,85,6,8751,0,248,4596,335730,37.04,5421242,14.462,39.7,16.821,64800.057,114.316,5.31,0.953,0
144,86,26,8777,1,249,4152,339882,37.04,5421242,14.462,39.7,16.821,64800.057,114.316,5.31,0.953,0
144,87,16,8793,0,249,3903,343785,37.04,5421242,14.462,39.7,16.821,64800.057,114.316,5.31,0.953,0
144,88,22,8815,0,249,1109,344894,37.04,5421242,14.462,39.7,16.821,64800.057,114.316,5.31,0.953,0
144,89,0,8815,0,249,986,345880,37.04,5421242,14.462,39.7,16.821,64800.057,114.316,5.31,0.953,0
144,90,0,8815,0,249,5883,351763,37.04,5421242,14.462,39.7,16.821,64800.057,114.316,5.31,0.953,0
144,91,40,8855,0,249,4975,356738,37.04,5421242,14.462,39.7,16.821,64800.057,114.316,5.31,0.953,0
144,92,10,8865,1,250,5075,361813,37.04,5421242,14.462,39.7,16.821,64800.057,114.316,5.31,0.953,0
144,93,22,8887,1,251,4690,366503,37.04,5421242,14.462,39.7,16.821,64800.057,114.316,5.31,0.953,0
144,94,8,8895,0,251,4464,370967,37.04,5421242,14.462,39.7,16.821,64800.057,114.316,5.31,0.953,0
144,95,0,8895,0,251,1421,372388,37.04,5421242,14.462,39.7,16.821,64800.057,114.316,5.31,0.953,0
144,96,0,8895,0,251,1189,373577,37.04,5421242,14.462,39.7,16.821,64800.057,114.316,5.31,0.953,0
144,97,0,8895,0,251,6249,379826,37.04,5421242,14.462,39.7,16.821,64800.057,114.316,5.31,0.953,0
144,98,35,8930,0,251,5316,385142,37.04,5421242,14.462,39.7,16.821,64800.057,114.316,5.31,0.953,0
144,99,6,8936,0,251,5221,390363,37.04,5421242,14.462,39.7,16.821,64800.057,114.316,5.31,0.953,0
144,100,11,8947,0,251,4714,395077,37.04,5421242,14.462,39.7,16.821,64800.057,114.316,5.31,0.953,0
144,101,7,8954,1,252,4641,399718,37.04,5421242,14.462,39.7,16.821,64800.057,114.316,5.31,0.953,0
144,102,11,8965,0,252,1375,401093,37.04,5421242,14.462,39.7,16.821,64800.057,114.316,5.31,0.953,0
144,103,0,8965,0,252,1195,402288,37.04,5421242,14.462,39.7,16.821,64800.057,114.316,5.31,0.953,0
144,104,0,8965,0,252,6285,408573,37.04,5421242,14.462,39.7,16.821,64800.057,114.316,5.31,0.953,0
144,105,16,8981,1,253,5223,413796,37.04,5421242,14.462,39.7,16.821,64800.057,114.316,5.31,0.953,0
144,106,3,8984,0,253,5354,419150,37.04,5421242,14.462,39.7,16.821,64800.057,114.316,5.31,0.953,0
144,107,17,9001,0,253,4539,423689,37.04,5421242,14.462,39.7,16.821,64800.057,114.316,5.31,0.953,0
144,108,10,9011,1,254,4105,427794,37.04,5421242,14.462,39.7,16.821,64800.057,114.316,5.31,0.953,0
144,109,4,9015,1,255,1410,429204,37.04,5421242,14.462,39.7,16.821,64800.057,114.316,5.31,0.953,0
144,110,0,9015,0,255,1344,430548,37.04,5421242,14.462,39.7,16.821,64800.057,114.316,5.31,0.953,0
144,111,0,9015,0,255,5953,436501,37.04,5421242,14.462,39.7,16.821,64800.057,114.316,5.31,0.953,0
144,112,13,9028,0,255,4792,441293,37.04,5421242,14.462,39.7,16.821,64800.057,114.316,5.31,0.953,0
144,113,10,9038,0,255,4860,446153,37.04,5421242,14.462,39.7,16.821,64800.057,114.316,5.31,0.953,0
144,114,15,9053,0,255,4470,450623,37.04,5421242,14.462,39.7,16.821,64800.057,114.316,5.31,0.953,0
144,115,9,9062,0,255,4505,455128,37.04,5421242,14.462,39.7,16.821,64800.057,114.316,5.31,0.953,0
144,116,23,9085,0,255,1700,456828,37.04,5421242,14.462,39.7,16.821,64800.057,114.316,5.31,0.953,0
144,117,0,9085,0,255,1467,458295,37.04,5421242,14.462,39.7,16.821,64800.057,114.316,5.31,0.953,0
144,118,0,9085,0,255,6838,465133,37.04,5421242,14.462,39.7,16.821,64800.057,114.316,5.31,0.953,0
144,119,32,9117,0,255,5883,471016,37.04,5421242,14.462,39.7,16.821,64800.057,114.316,5.31,0.953,0
144,120,15,9132,0,255,5852,476868,37.04,5421242,14.462,39.7,16.821,64800.057,114.316,5.31,0.953,0
144,121,18,9150,0,255,5539,482407,37.04,5421242,14.462,39.7,16.821,64800.057,114.316,5.31,0.953,0
144,122,22,9172,0,255,5430,487837,37.04,5421242,14.462,39.7,16.821,64800.057,114.316,5.31,0.953,0
144,123,36,9208,0,255,2107,489944,37.04,5421242,14.462,39.7,16.821,64800.057,114.316,5.31,0.953,0
144,124,0,9208,0,255,1897,491841,37.04,5421242,14.462,39.7,16.821,64800.057,114.316,5.31,0.953,0
144,125,0,9208,0,255,9292,501133,37.04,5421242,14.462,39.7,16.821,64800.057,114.316,5.31,0.953,0
144,126,60,9268,1,256,8406,509539,37.04,5421242,14.462,39.7,16.821,64800.057,114.316,5.31,0.953,0
144,127,65,9333,0,256,8705,518244,37.04,5421242,14.462,39.7,16.821,64800.057,114.316,5.31,0.953,0
144,128,29,9362,0,256,8628,526872,37.04,5421242,14.462,39.7,16.821,64800.057,114.316,5.31,0.953,0
144,129,47,9409,0,256,8401,535273,37.04,5421242,14.462,39.7,16.821,64800.057,114.316,5.31,0.953,0
144,130,59,9468,0,256,3295,538568,37.04,5421242,14.462,39.7,16.821,64800.057,114.316,5.31,0.953,0
144,131,0,9468,0,256,3162,541730,37.04,5421242,14.462,39.7,16.821,64800.057,114.316,5.31,0.953,0
144,132,0,9468,0,256,13392,555122,37.04,5421242,14.462,39.7,16.821,64800.057,114.316,5.31,0.953,0
144,133,170,9638,0,256,12955,568077,37.04,5421242,14.462,39.7,16.821,64800.057,114.316,5.31,0.953,0
144,134,46,9684,0,256,13401,581478,37.04,5421242,14.462,39.7,16.821,64800.057,114.316,5.31,0.953,0
144,135,66,9750,0,256,13196,594674,37.04,5421242,14.462,39.7,16.821,64800.057,114.316,5.31,0.953,0
144,136,33,9783,1,257,13724,608398,37.04,5421242,14.462,39.7,16.821,64800.057,114.316,5.31,0.953,0
144,137,67,9850,4,261,6013,614411,37.04,5421242,14.462,39.7,16.821,64800.057,114.316,5.31,0.953,0
144,138,0,9850,0,261,5281,619692,37.04,5421242,14.462,39.7,16.821,64800.057,114.316,5.31,0.953,0
144,139,0,9850,0,261,18181,637873,37.04,5421242,14.462,39.7,16.821,64800.057,114.316,5.31,0.953,0
144,140,154,10004,0,261,16862,654735,37.04,5421242,14.462,39.7,16.821,64800.057,114.316,5.31,0.953,0
144,141,56,10060,1,262,16426,671161,37.04,5421242,14.462,39.7,16.821,64800.057,114.316,5.31,0.953,0
144,142,51,10111,0,262,15539,686700,37.04,5421242,14.462,39.7,16.821,64800.057,114.316,5.31,0.953,0
144,143,51,10162,2,264,15029,701729,34.26,5421242,14.462,39.7,16.821,64800.057,114.316,5.31,0.953,0
144,144,35,10197,0,264,6768,708497,34.26,5421242,14.462,39.7,16.821,64800.057,114.316,5.31,0.953,0
144,145,0,10197,0,264,6905,715402,34.26,5421242,14.462,39.7,16.821,64800.057,114.316,5.31,0.953,0
144,146,0,10197,0,264,20986,736388,34.26,5421242,14.462,39.7,16.821,64800.057,114.316,5.31,0.953,0
144,147,126,10323,0,264,19261,755649,34.26,5421242,14.462,39.7,16.821,64800.057,114.316,5.31,0.953,0
144,148,72,10395,0,264,18710,774359,34.26,5421242,14.462,39.7,16.821,64800.057,114.316,5.31,0.953,0
144,149,59,10454,0,264,17182,791541,34.26,5421242,14.462,39.7,16.821,64800.057,114.316,5.31,0.953,0
144,150,51,10505,0,264,16318,807859,34.26,5421242,14.462,39.7,16.821,64800.057,114.316,5.31,0.953,0
144,151,38,10543,0,264,6310,814169,34.26,5421242,14.462,39.7,16.821,64800.057,114.316,5.31,0.953,0
144,152,0,10543,0,264,6726,820895,34.26,5421242,14.462,39.7,16.821,64800.057,114.316,5.31,0.953,0
144,153,0,10543,0,264,22492,843387,34.26,5421242,14.462,39.7,16.821,64800.057,114.316,5.31,0.953,0
144,154,101,10644,0,264,20310,863697,34.26,5421242,14.462,39.7,16.821,64800.057,114.316,5.31,0.953,0
144,155,139,10783,0,264,19003,882700,34.26,5421242,14.462,39.7,16.821,64800.057,114.316,5.31,0.953,0
144,156,88,10871,0,264,17421,900121,34.26,5421242,14.462,39.7,16.821,64800.057,114.316,5.31,0.953,0
144,157,164,11035,0,264,15374,915495,34.26,5421242,14.462,39.7,16.821,64800.057,114.316,5.31,0.953,0
144,158,85,11120,0,264,5958,921453,34.26,5421242,14.462,39.7,16.821,64800.057,114.316,5.31,0.953,0
144,159,0,11120,0,264,6345,927798,34.26,5421242,14.462,39.7,16.821,64800.057,114.316,5.31,0.953,0
144,160,0,11120,0,264,20706,948504,34.26,5421242,14.462,39.7,16.821,64800.057,114.316,5.31,0.953,0
144,161,267,11387,0,264,18794,967298,34.26,5421242,14.462,39.7,16.821,64800.057,114.316,5.31,0.953,0
144,162,132,11519,0,264,17759,985057,34.26,5421242,14.462,39.7,16.821,64800.057,114.316,5.31,0.953,0
144,163,105,11624,0,264,15612,1000669,34.26,5421242,14.462,39.7,16.821,64800.057,114.316,5.31,0.953,0
144,164,122,11746,1,265,14756,1015425,34.26,5421242,14.462,39.7,16.821,64800.057,114.316,5.31,0.953,0
144,165,120,11866,0,265,7019,1022444,34.26,5421242,14.462,39.7,16.821,64800.057,114.316,5.31,0.953,0
144,166,0,11866,0,265,6699,1029143,34.26,5421242,14.462,39.7,16.821,64800.057,114.316,5.31,0.953,0
144,167,0,11866,0,265,21317,1050460,34.26,5421242,14.462,39.7,16.821,64800.057,114.316,5.31,0.953,0
144,168,289,12155,0,265,18947,1069407,34.26,5421242,14.462,39.7,16.821,64800.057,114.316,5.31,0.953,0
144,169,122,12277,0,265,17558,1086965,34.26,5421242,14.462,39.7,16.821,64800.057,114.316,5.31,0.953,0
144,170,116,12393,0,265,15176,1102141,34.26,5421242,14.462,39.7,16.821,64800.057,114.316,5.31,0.953,0
144,171,106,12499,1,266,13968,1116109,34.26,5421242,14.462,39.7,16.821,64800.057,114.316,5.31,0.953,0
144,172,146,12645,1,267,5792,1121901,34.26,5421242,14.462,39.7,16.821,64800.057,114.316,5.31,0.953,0
144,173,0,12645,0,267,5748,1127649,34.26,5421242,14.462,39.7,16.821,64800.057,114.316,5.31,0.953,0
144,174,0,12645,0,267,20612,1148261,28.7,5421242,14.462,39.7,16.821,64800.057,114.316,5.31,0.953,0
144,175,251,12896,0,267,16683,1164944,28.7,5421242,14.462,39.7,16.821,64800.057,114.316,5.31,0.953,0
144,176,104,13000,0,267,16200,1181144,28.7,5421242,14.462,39.7,16.821,64800.057,114.316,5.31,0.953,0
144,177,152,13152,0,267,14311,1195455,28.7,5421242,14.462,39.7,16.821,64800.057,114.316,5.31,0.953,0
144,178,123,13275,3,270,13744,1209199,28.7,5421242,14.462,39.7,16.821,64800.057,114.316,5.31,0.953,0
144,179,131,13406,0,270,5952,1215151,28.7,5421242,14.462,39.7,16.821,64800.057,114.316,5.31,0.953,0
144,180,0,13406,0,270,5922,1221073,28.7,5421242,14.462,39.7,16.821,64800.057,114.316,5.31,0.953,0
144,181,0,13406,0,270,19014,1240087,28.7,5421242,14.462,39.7,16.821,64800.057,114.316,5.31,0.953,0
144,182,292,13698,4,274,15369,1255456,28.7,5421242,14.462,39.7,16.821,64800.057,114.316,5.31,0.953,0
144,183,90,13788,0,274,14793,1270249,28.7,5421242,14.462,39.7,16.821,64800.057,114.316,5.31,0.953,0
144,184,126,13914,0,274,12855,1283104,28.7,5421242,14.462,39.7,16.821,64800.057,114.316,5.31,0.953,0
144,185,113,14027,0,274,12975,1296079,28.7,5421242,14.462,39.7,16.821,64800.057,114.316,5.31,0.953,0
144,186,122,14149,1,275,5731,1301810,28.7,5421242,14.462,39.7,16.821,64800.057,114.316,5.31,0.953,0
144,187,0,14149,0,275,5994,1307804,28.7,5421242,14.462,39.7,16.821,64800.057,114.316,5.31,0.953,0
144,188,0,14149,0,275,19055,1326859,28.7,5421242,14.462,39.7,16.821,64800.057,114.316,5.31,0.953,0
144,189,308,14457,0,275,14902,1341761,28.7,5421242,14.462,39.7,16.821,64800.057,114.316,5.31,0.953,0
144,190,147,14604,0,275,14204,1355965,28.7,5421242,14.462,39.7,16.821,64800.057,114.316,5.31,0.953,0
144,191,180,14784,0,275,13027,1368992,28.7,5421242,14.462,39.7,16.821,64800.057,114.316,5.31,0.953,0
144,192,228,15012,0,275,12605,1381597,28.7,5421242,14.462,39.7,16.821,64800.057,114.316,5.31,0.953,0
144,193,209,15221,0,275,5855,1387452,28.7,5421242,14.462,39.7,16.821,64800.057,114.316,5.31,0.953,0
144,194,0,15221,0,275,6420,1393872,28.7,5421242,14.462,39.7,16.821,64800.057,114.316,5.31,0.953,0
144,195,0,15221,0,275,19615,1413487,28.7,5421242,14.462,39.7,16.821,64800.057,114.316,5.31,0.953,0
144,196,303,15524,1,276,15691,1429178,28.7,5421242,14.462,39.7,16.821,64800.057,114.316,5.31,0.953,0
144,197,115,15639,1,277,15103,1444281,28.7,5421242,14.462,39.7,16.821,64800.057,114.316,5.31,0.953,0
144,198,152,15791,0,277,13605,1457886,28.7,5421242,14.462,39.7,16.821,64800.057,114.316,5.31,0.953,0
144,199,162,15953,1,278,12435,1470321,28.7,5421242,14.462,39.7,16.821,64800.057,114.316,5.31,0.953,0
144,200,183,16136,0,278,4566,1474887,28.7,5421242,14.462,39.7,16.821,64800.057,114.316,5.31,0.953,0
144,201,0,16136,0,278,0,1474887,28.7,5421242,14.462,39.7,16.821,64800.057,114.316,5.31,0.953,0
144,202,0,16136,0,278,0,1474887,28.7,5421242,14.462,39.7,16.821,64800.057,114.316,5.31,0.953,0
144,203,320,16456,0,278,0,1474887,28.7,5421242,14.462,39.7,16.821,64800.057,114.316,5.31,0.953,0
144,204,147,16603,0,278,0,1474887,28.7,5421242,14.462,39.7,16.821,64800.057,114.316,5.31,0.953,0
145,1,13,192,1,1,0,0,85.19,5106622,14.98,30.7,2.355,37960.709,266.342,12.61,0.821,0
145,2,18,210,0,1,0,0,85.19,5106622,14.98,30.7,2.355,37960.709,266.342,12.61,0.821,0
145,3,21,231,0,1,0,0,85.19,5106622,14.98,30.7,2.355,37960.709,266.342,12.61,0.821,0
145,4,0,231,0,1,0,0,85.19,5106622,14.98,30.7,2.355,37960.709,266.342,12.61,0.821,0
145,5,46,277,1,2,0,0,85.19,5106622,14.98,30.7,2.355,37960.709,266.342,12.61,0.821,0
145,6,21,298,0,2,0,0,85.19,5106622,14.98,30.7,2.355,37960.709,266.342,12.61,0.821,0
145,7,73,371,0,2,0,0,85.19,5106622,14.98,30.7,2.355,37960.709,266.342,12.61,0.821,0
145,8,48,419,0,2,0,0,85.19,5106622,14.98,30.7,2.355,37960.709,266.342,12.61,0.821,0
145,9,0,419,0,2,0,0,85.19,5106622,14.98,30.7,2.355,37960.709,266.342,12.61,0.821,0
145,10,38,457,1,3,0,0,92.59,5106622,14.98,30.7,2.355,37960.709,266.342,12.61,0.821,0
145,11,27,484,0,3,0,0,92.59,5106622,14.98,30.7,2.355,37960.709,266.342,12.61,0.821,0
145,12,62,546,0,3,0,0,92.59,5106622,14.98,30.7,2.355,37960.709,266.342,12.61,0.821,0
145,13,53,599,1,4,0,0,92.59,5106622,14.98,30.7,2.355,37960.709,266.342,12.61,0.821,0
145,14,214,813,0,4,0,0,92.59,5106622,14.98,30.7,2.355,37960.709,266.342,12.61,0.821,0
145,15,97,910,0,4,0,0,92.59,5106622,14.98,30.7,2.355,37960.709,266.342,12.61,0.821,0
145,16,0,910,0,4,0,0,92.59,5106622,14.98,30.7,2.355,37960.709,266.342,12.61,0.821,0
145,17,109,1019,0,4,0,0,92.59,5106622,14.98,30.7,2.355,37960.709,266.342,12.61,0.821,0
145,18,50,1069,2,6,0,0,92.59,5106622,14.98,30.7,2.355,37960.709,266.342,12.61,0.821,0
145,19,111,1180,0,6,0,0,92.59,5106622,14.98,30.7,2.355,37960.709,266.342,12.61,0.821,0
145,20,86,1266,1,7,0,0,92.59,5106622,14.98,30.7,2.355,37960.709,266.342,12.61,0.821,0
145,21,242,1508,1,8,0,0,92.59,5106622,14.98,30.7,2.355,37960.709,266.342,12.61,0.821,0
145,22,0,1508,0,8,0,0,92.59,5106622,14.98,30.7,2.355,37960.709,266.342,12.61,0.821,0
145,23,106,1614,0,8,0,0,92.59,5106622,14.98,30.7,2.355,37960.709,266.342,12.61,0.821,0
145,24,102,1716,1,9,0,0,92.59,5106622,14.98,30.7,2.355,37960.709,266.342,12.61,0.821,0
145,25,74,1790,1,10,0,0,92.59,5106622,14.98,30.7,2.355,37960.709,266.342,12.61,0.821,0
145,26,115,1905,0,10,0,0,92.59,5106622,14.98,30.7,2.355,37960.709,266.342,12.61,0.821,0
145,27,93,1998,0,10,0,0,92.59,5106622,14.98,30.7,2.355,37960.709,266.342,12.61,0.821,0
145,28,51,2049,0,10,0,0,92.59,5106622,14.98,30.7,2.355,37960.709,266.342,12.61,0.821,0
145,29,82,2131,0,10,0,0,92.59,5106622,14.98,30.7,2.355,37960.709,266.342,12.61,0.821,0
145,30,143,2274,0,10,0,0,87.96,5106622,14.98,30.7,2.355,37960.709,266.342,12.61,0.821,0
145,31,74,2348,1,11,0,0,87.96,5106622,14.98,30.7,2.355,37960.709,266.342,12.61,0.821,0
145,32,99,2447,0,11,0,0,87.96,5106622,14.98,30.7,2.355,37960.709,266.342,12.61,0.821,0
145,33,36,2483,1,12,0,0,87.96,5106622,14.98,30.7,2.355,37960.709,266.342,12.61,0.821,0
145,34,85,2568,0,12,0,0,87.96,5106622,14.98,30.7,2.355,37960.709,266.342,12.61,0.821,0
145,35,69,2637,0,12,0,0,87.96,5106622,14.98,30.7,2.355,37960.709,266.342,12.61,0.821,0
145,36,98,2735,0,12,0,0,87.96,5106622,14.98,30.7,2.355,37960.709,266.342,12.61,0.821,0
145,37,168,2903,1,13,0,0,87.96,5106622,14.98,30.7,2.355,37960.709,266.342,12.61,0.821,0
145,38,55,2958,1,14,0,0,87.96,5106622,14.98,30.7,2.355,37960.709,266.342,12.61,0.821,0
145,39,154,3112,1,15,0,0,87.96,5106622,14.98,30.7,2.355,37960.709,266.342,12.61,0.821,0
145,40,112,3224,2,17,0,0,87.96,5106622,14.98,30.7,2.355,37960.709,266.342,12.61,0.821,0
145,41,175,3399,0,17,0,0,87.96,5106622,14.98,30.7,2.355,37960.709,266.342,12.61,0.821,0
145,42,175,3574,0,17,0,0,87.96,5106622,14.98,30.7,2.355,37960.709,266.342,12.61,0.821,0
145,43,147,3721,0,17,0,0,87.96,5106622,14.98,30.7,2.355,37960.709,266.342,12.61,0.821,0
145,44,298,4019,0,17,0,0,87.96,5106622,14.98,30.7,2.355,37960.709,266.342,12.61,0.821,0
145,45,322,4341,2,19,0,0,87.96,5106622,14.98,30.7,2.355,37960.709,266.342,12.61,0.821,0
145,46,284,4625,0,19,0,0,87.96,5106622,14.98,30.7,2.355,37960.709,266.342,12.61,0.821,0
145,47,404,5029,2,21,0,0,87.96,5106622,14.98,30.7,2.355,37960.709,266.342,12.61,0.821,0
145,48,157,5186,1,22,0,0,87.96,5106622,14.98,30.7,2.355,37960.709,266.342,12.61,0.821,0
145,49,193,5379,4,26,0,0,87.96,5106622,14.98,30.7,2.355,37960.709,266.342,12.61,0.821,0
145,50,292,5671,1,27,0,0,87.96,5106622,14.98,30.7,2.355,37960.709,266.342,12.61,0.821,0
145,51,372,6043,3,30,0,0,86.11,5106622,14.98,30.7,2.355,37960.709,266.342,12.61,0.821,0
145,52,327,6370,1,31,0,0,86.11,5106622,14.98,30.7,2.355,37960.709,266.342,12.61,0.821,0
145,53,424,6794,1,32,0,0,86.11,5106622,14.98,30.7,2.355,37960.709,266.342,12.61,0.821,0
145,54,463,7257,4,36,0,0,86.11,5106622,14.98,30.7,2.355,37960.709,266.342,12.61,0.821,0
145,55,513,7770,1,37,0,0,86.11,5106622,14.98,30.7,2.355,37960.709,266.342,12.61,0.821,0
145,56,0,7770,0,37,0,0,86.11,5106622,14.98,30.7,2.355,37960.709,266.342,12.61,0.821,0
145,57,348,8118,0,37,0,0,86.11,5106622,14.98,30.7,2.355,37960.709,266.342,12.61,0.821,0
145,58,255,8373,1,38,0,0,86.11,5106622,14.98,30.7,2.355,37960.709,266.342,12.61,0.821,0
145,59,636,9009,2,40,0,0,86.11,5106622,14.98,30.7,2.355,37960.709,266.342,12.61,0.821,0
145,60,811,9820,0,40,0,0,86.11,5106622,14.98,30.7,2.355,37960.709,266.342,12.61,0.821,0
145,61,603,10423,2,42,0,0,86.11,5106622,14.98,30.7,2.355,37960.709,266.342,12.61,0.821,0
145,62,1014,11437,5,47,0,0,86.11,5106622,14.98,30.7,2.355,37960.709,266.342,12.61,0.821,0
145,63,786,12223,3,50,0,0,86.11,5106622,14.98,30.7,2.355,37960.709,266.342,12.61,0.821,0
145,64,576,12799,9,59,0,0,86.11,5106622,14.98,30.7,2.355,37960.709,266.342,12.61,0.821,0
145,65,738,13537,8,67,2546,0,86.11,5106622,14.98,30.7,2.355,37960.709,266.342,12.61,0.821,0
145,66,779,14316,0,67,2463,0,86.11,5106622,14.98,30.7,2.355,37960.709,266.342,12.61,0.821,0
145,67,770,15086,5,72,3128,0,86.11,5106622,14.98,30.7,2.355,37960.709,266.342,12.61,0.821,0
145,68,930,16016,0,72,2907,0,86.11,5106622,14.98,30.7,2.355,37960.709,266.342,12.61,0.821,0
145,69,866,16882,3,75,2697,0,86.11,5106622,14.98,30.7,2.355,37960.709,266.342,12.61,0.821,0
145,70,604,17486,6,81,2688,0,86.11,5106622,14.98,30.7,2.355,37960.709,266.342,12.61,0.821,0
145,71,712,18198,2,83,2658,0,86.11,5106622,14.98,30.7,2.355,37960.709,266.342,12.61,0.821,0
145,72,689,18887,1,84,2747,0,86.11,5106622,14.98,30.7,2.355,37960.709,266.342,12.61,0.821,0
145,73,1067,19954,5,89,3502,0,86.11,5106622,14.98,30.7,2.355,37960.709,266.342,12.61,0.821,0
145,74,1117,21071,7,96,3135,0,87.96,5106622,14.98,30.7,2.355,37960.709,266.342,12.61,0.821,0
145,75,1006,22077,3,99,3596,0,87.96,5106622,14.98,30.7,2.355,37960.709,266.342,12.61,0.821,0
145,76,1404,23481,5,104,3283,0,87.96,5106622,14.98,30.7,2.355,37960.709,266.342,12.61,0.821,0
145,77,1043,24524,4,108,2627,0,87.96,5106622,14.98,30.7,2.355,37960.709,266.342,12.61,0.821,0
145,78,745,25269,6,114,2797,0,87.96,5106622,14.98,30.7,2.355,37960.709,266.342,12.61,0.821,0
145,79,810,26079,2,116,2347,0,87.96,5106622,14.98,30.7,2.355,37960.709,266.342,12.61,0.821,0
145,80,739,26818,3,119,3317,0,87.96,5106622,14.98,30.7,2.355,37960.709,266.342,12.61,0.821,0
145,81,852,27670,6,125,2448,0,87.96,5106622,14.98,30.7,2.355,37960.709,266.342,12.61,0.821,0
145,82,896,28566,3,128,2804,0,87.96,5106622,14.98,30.7,2.355,37960.709,266.342,12.61,0.821,0
145,83,905,29471,3,131,4544,0,87.96,5106622,14.98,30.7,2.355,37960.709,266.342,12.61,0.821,0
145,84,1605,31076,6,137,3940,0,87.96,5106622,14.98,30.7,2.355,37960.709,266.342,12.61,0.821,0
145,85,1318,32394,3,140,3585,0,87.96,5106622,14.98,30.7,2.355,37960.709,266.342,12.61,0.821,0
145,86,1142,33536,2,142,3835,0,87.96,5106622,14.98,30.7,2.355,37960.709,266.342,12.61,0.821,0
145,87,1366,34902,2,144,4013,0,87.96,5106622,14.98,30.7,2.355,37960.709,266.342,12.61,0.821,0
145,88,1132,36034,9,153,2508,0,87.96,5106622,14.98,30.7,2.355,37960.709,266.342,12.61,0.821,0
145,89,919,36953,6,159,3292,0,87.96,5106622,14.98,30.7,2.355,37960.709,266.342,12.61,0.821,0
145,90,1197,38150,4,163,3191,0,87.96,5106622,14.98,30.7,2.355,37960.709,266.342,12.61,0.821,0
145,91,910,39060,6,169,3121,0,87.96,5106622,14.98,30.7,2.355,37960.709,266.342,12.61,0.821,0
145,92,1010,40070,7,176,3533,0,87.96,5106622,14.98,30.7,2.355,37960.709,266.342,12.61,0.821,0
145,93,1124,41194,9,185,4049,0,87.96,5106622,14.98,30.7,2.355,37960.709,266.342,12.61,0.821,0
145,94,1361,42555,3,188,3834,0,87.96,5106622,14.98,30.7,2.355,37960.709,266.342,12.61,0.821,0
145,95,1374,43929,5,193,2992,0,87.96,5106622,14.98,30.7,2.355,37960.709,266.342,12.61,0.821,0
145,96,1177,45106,10,203,3515,0,87.96,5106622,14.98,30.7,2.355,37960.709,266.342,12.61,0.821,0
145,97,1072,46178,10,213,3852,0,87.96,5106622,14.98,30.7,2.355,37960.709,266.342,12.61,0.821,0
145,98,1557,47735,5,218,4007,0,87.96,5106622,14.98,30.7,2.355,37960.709,266.342,12.61,0.821,0
145,99,1262,48997,6,224,3987,0,87.96,5106622,14.98,30.7,2.355,37960.709,266.342,12.61,0.821,0
145,100,1210,50207,9,233,5456,0,87.96,5106622,14.98,30.7,2.355,37960.709,266.342,12.61,0.821,0
145,101,1518,51725,3,236,4574,0,87.96,5106622,14.98,30.7,2.355,37960.709,266.342,12.61,0.821,0
145,102,1889,53614,8,244,3833,0,87.96,5106622,14.98,30.7,2.355,37960.709,266.342,12.61,0.821,0
145,103,1083,54697,4,248,3570,0,87.96,5106622,14.98,30.7,2.355,37960.709,266.342,12.61,0.821,0
145,104,1318,56015,9,257,6173,0,87.96,5106622,14.98,30.7,2.355,37960.709,266.342,12.61,0.821,0
145,105,2164,58179,2,259,4044,0,87.96,5106622,14.98,30.7,2.355,37960.709,266.342,12.61,0.821,0
145,106,1389,59568,14,273,4613,0,87.96,5106622,14.98,30.7,2.355,37960.709,266.342,12.61,0.821,0
145,107,1679,61247,8,281,4704,0,87.96,5106622,14.98,30.7,2.355,37960.709,266.342,12.61,0.821,0
145,108,1327,62574,9,290,4721,0,87.96,5106622,14.98,30.7,2.355,37960.709,266.342,12.61,0.821,0
145,109,1619,64193,8,298,3976,0,87.96,5106622,14.98,30.7,2.355,37960.709,266.342,12.61,0.821,0
145,110,1311,65504,10,308,3943,0,87.96,5106622,14.98,30.7,2.355,37960.709,266.342,12.61,0.821,0
145,111,1157,66661,10,318,3957,0,87.96,5106622,14.98,30.7,2.355,37960.709,266.342,12.61,0.821,0
145,112,1739,68400,8,326,4701,0,87.96,5106622,14.98,30.7,2.355,37960.709,266.342,12.61,0.821,0
145,113,1487,69887,11,337,4798,0,87.96,5106622,14.98,30.7,2.355,37960.709,266.342,12.61,0.821,0
145,114,1660,71547,12,349,3344,0,86.11,5106622,14.98,30.7,2.355,37960.709,266.342,12.61,0.821,0
145,115,1099,72646,6,355,3138,0,86.11,5106622,14.98,30.7,2.355,37960.709,266.342,12.61,0.821,0
145,116,1145,73791,4,359,3076,0,100,5106622,14.98,30.7,2.355,37960.709,266.342,12.61,0.821,0
145,117,1067,74858,12,371,3187,0,100,5106622,14.98,30.7,2.355,37960.709,266.342,12.61,0.821,0
145,118,1147,76005,13,384,3504,0,94.44,5106622,14.98,30.7,2.355,37960.709,266.342,12.61,0.821,0
145,119,1053,77058,9,393,1904,0,94.44,5106622,14.98,30.7,2.355,37960.709,266.342,12.61,0.821,0
145,120,846,77904,9,402,1314,0,94.44,5106622,14.98,30.7,2.355,37960.709,266.342,12.61,0.821,0
145,121,665,78569,10,412,1940,0,94.44,5106622,14.98,30.7,2.355,37960.709,266.342,12.61,0.821,0
145,122,590,79159,9,421,0,0,94.44,5106622,14.98,30.7,2.355,37960.709,266.342,12.61,0.821,0
145,123,0,79159,0,421,0,0,94.44,5106622,14.98,30.7,2.355,37960.709,266.342,12.61,0.821,0
145,124,0,79159,0,421,0,0,94.44,5106622,14.98,30.7,2.355,37960.709,266.342,12.61,0.821,0
145,125,0,79159,0,421,0,0,94.44,5106622,14.98,30.7,2.355,37960.709,266.342,12.61,0.821,0
145,126,0,79159,0,421,0,0,94.44,5106622,14.98,30.7,2.355,37960.709,266.342,12.61,0.821,0
145,127,0,79159,0,421,2682,0,94.44,5106622,14.98,30.7,2.355,37960.709,266.342,12.61,0.821,0
145,128,1127,80286,67,488,0,0,94.44,5106622,14.98,30.7,2.355,37960.709,266.342,12.61,0.821,0
145,129,427,80713,4,492,0,0,94.44,5106622,14.98,30.7,2.355,37960.709,266.342,12.61,0.821,0
145,130,354,81067,10,502,0,0,89.81,5106622,14.98,30.7,2.355,37960.709,266.342,12.61,0.821,0
145,131,290,81357,7,509,0,0,89.81,5106622,14.98,30.7,2.355,37960.709,266.342,12.61,0.821,0
145,132,223,81580,4,513,0,0,89.81,5106622,14.98,30.7,2.355,37960.709,266.342,12.61,0.821,0
145,133,207,81787,8,521,0,0,89.81,5106622,14.98,30.7,2.355,37960.709,266.342,12.61,0.821,0
145,134,263,82050,12,533,0,0,89.81,5106622,14.98,30.7,2.355,37960.709,266.342,12.61,0.821,0
145,135,249,82299,6,539,0,0,89.81,5106622,14.98,30.7,2.355,37960.709,266.342,12.61,0.821,0
145,136,232,82531,12,551,0,0,89.81,5106622,14.98,30.7,2.355,37960.709,266.342,12.61,0.821,0
145,137,212,82743,6,557,0,0,89.81,5106622,14.98,30.7,2.355,37960.709,266.342,12.61,0.821,0
145,138,181,82924,5,562,0,0,89.81,5106622,14.98,30.7,2.355,37960.709,266.342,12.61,0.821,0
145,139,162,83086,10,572,0,0,89.81,5106622,14.98,30.7,2.355,37960.709,266.342,12.61,0.821,0
145,140,140,83226,16,588,0,0,86.11,5106622,14.98,30.7,2.355,37960.709,266.342,12.61,0.821,0
145,141,192,83418,9,597,0,0,86.11,5106622,14.98,30.7,2.355,37960.709,266.342,12.61,0.821,0
145,142,188,83606,6,603,0,0,86.11,5106622,14.98,30.7,2.355,37960.709,266.342,12.61,0.821,0
145,143,163,83769,6,609,0,0,86.11,5106622,14.98,30.7,2.355,37960.709,266.342,12.61,0.821,0
145,144,0,83769,0,609,0,0,86.11,5106622,14.98,30.7,2.355,37960.709,266.342,12.61,0.821,0
145,145,0,83769,0,609,0,0,86.11,5106622,14.98,30.7,2.355,37960.709,266.342,12.61,0.821,0
145,146,0,83769,0,609,0,0,86.11,5106622,14.98,30.7,2.355,37960.709,266.342,12.61,0.821,0
145,147,740,84509,28,637,0,0,86.11,5106622,14.98,30.7,2.355,37960.709,266.342,12.61,0.821,0
145,148,143,84652,5,642,0,0,86.11,5106622,14.98,30.7,2.355,37960.709,266.342,12.61,0.821,0
145,149,166,84818,4,646,0,0,86.11,5106622,14.98,30.7,2.355,37960.709,266.342,12.61,0.821,0
145,150,187,85005,4,650,0,0,86.11,5106622,14.98,30.7,2.355,37960.709,266.342,12.61,0.821,0
145,151,0,85005,0,650,0,0,86.11,5106622,14.98,30.7,2.355,37960.709,266.342,12.61,0.821,0
145,152,0,85005,0,650,0,0,86.11,5106622,14.98,30.7,2.355,37960.709,266.342,12.61,0.821,0
145,153,539,85544,27,677,0,0,86.11,5106622,14.98,30.7,2.355,37960.709,266.342,12.61,0.821,0
145,154,178,85722,8,685,0,0,86.11,5106622,14.98,30.7,2.355,37960.709,266.342,12.61,0.821,0
145,155,206,85928,4,689,0,0,86.11,5106622,14.98,30.7,2.355,37960.709,266.342,12.61,0.821,0
145,156,0,85928,0,689,0,0,86.11,5106622,14.98,30.7,2.355,37960.709,266.342,12.61,0.821,0
145,157,452,86380,16,705,0,0,86.11,5106622,14.98,30.7,2.355,37960.709,266.342,12.61,0.821,0
145,158,0,86380,0,705,0,0,86.11,5106622,14.98,30.7,2.355,37960.709,266.342,12.61,0.821,0
145,159,0,86380,0,705,0,0,86.11,5106622,14.98,30.7,2.355,37960.709,266.342,12.61,0.821,0
145,160,692,87072,23,728,0,0,86.11,5106622,14.98,30.7,2.355,37960.709,266.342,12.61,0.821,0
145,161,256,87328,6,734,0,0,86.11,5106622,14.98,30.7,2.355,37960.709,266.342,12.61,0.821,0
145,162,262,87590,8,742,0,0,86.11,5106622,14.98,30.7,2.355,37960.709,266.342,12.61,0.821,0
145,163,349,87939,9,751,0,0,86.11,5106622,14.98,30.7,2.355,37960.709,266.342,12.61,0.821,0
145,164,398,88337,11,762,0,0,86.11,5106622,14.98,30.7,2.355,37960.709,266.342,12.61,0.821,0
145,165,0,88337,0,762,0,0,86.11,5106622,14.98,30.7,2.355,37960.709,266.342,12.61,0.821,0
145,166,0,88337,0,762,0,0,86.11,5106622,14.98,30.7,2.355,37960.709,266.342,12.61,0.821,0
145,167,1409,89746,18,780,0,0,86.11,5106622,14.98,30.7,2.355,37960.709,266.342,12.61,0.821,0
145,168,476,90222,10,790,0,0,86.11,5106622,14.98,30.7,2.355,37960.709,266.342,12.61,0.821,0
145,169,438,90660,7,797,0,0,86.11,5106622,14.98,30.7,2.355,37960.709,266.342,12.61,0.821,0
145,170,536,91196,8,805,0,0,86.11,5106622,14.98,30.7,2.355,37960.709,266.342,12.61,0.821,0
145,171,557,91753,13,818,0,0,86.11,5106622,14.98,30.7,2.355,37960.709,266.342,12.61,0.821,0
145,172,0,91753,0,818,0,0,86.11,5106622,14.98,30.7,2.355,37960.709,266.342,12.61,0.821,0
145,173,0,91753,0,818,0,0,86.11,5106622,14.98,30.7,2.355,37960.709,266.342,12.61,0.821,0
145,174,1722,93475,28,846,0,0,86.11,5106622,14.98,30.7,2.355,37960.709,266.342,12.61,0.821,0
145,175,576,94051,7,853,0,0,86.11,5106622,14.98,30.7,2.355,37960.709,266.342,12.61,0.821,0
145,176,660,94711,12,865,0,0,86.11,5106622,14.98,30.7,2.355,37960.709,266.342,12.61,0.821,0
145,177,628,95339,10,875,0,0,86.11,5106622,14.98,30.7,2.355,37960.709,266.342,12.61,0.821,0
145,178,568,95907,10,885,0,0,86.11,5106622,14.98,30.7,2.355,37960.709,266.342,12.61,0.821,0
145,179,0,95907,0,885,0,0,86.11,5106622,14.98,30.7,2.355,37960.709,266.342,12.61,0.821,0
145,180,0,95907,0,885,0,0,86.11,5106622,14.98,30.7,2.355,37960.709,266.342,12.61,0.821,0
145,181,1543,97450,24,909,0,0,86.11,5106622,14.98,30.7,2.355,37960.709,266.342,12.61,0.821,0
145,182,607,98057,15,924,0,0,86.11,5106622,14.98,30.7,2.355,37960.709,266.342,12.61,0.821,0
145,183,528,98585,11,935,0,0,86.11,5106622,14.98,30.7,2.355,37960.709,266.342,12.61,0.821,0
145,184,0,98585,0,935,0,0,86.11,5106622,14.98,30.7,2.355,37960.709,266.342,12.61,0.821,0
145,185,0,98585,0,935,0,0,86.11,5106622,14.98,30.7,2.355,37960.709,266.342,12.61,0.821,0
145,186,0,98585,0,935,0,0,86.11,5106622,14.98,30.7,2.355,37960.709,266.342,12.61,0.821,0
145,187,0,98585,0,935,0,0,86.11,5106622,14.98,30.7,2.355,37960.709,266.342,12.61,0.821,0
145,188,2685,101270,42,977,0,0,86.11,5106622,14.98,30.7,2.355,37960.709,266.342,12.61,0.821,0
145,189,544,101814,8,985,0,0,86.11,5106622,14.98,30.7,2.355,37960.709,266.342,12.61,0.821,0
145,190,834,102648,5,990,0,0,86.11,5106622,14.98,30.7,2.355,37960.709,266.342,12.61,0.821,0
145,191,817,103465,10,1000,0,0,86.11,5106622,14.98,30.7,2.355,37960.709,266.342,12.61,0.821,0
145,192,664,104129,9,1009,0,0,86.11,5106622,14.98,30.7,2.355,37960.709,266.342,12.61,0.821,0
145,193,0,104129,0,1009,0,0,86.11,5106622,14.98,30.7,2.355,37960.709,266.342,12.61,0.821,0
145,194,0,104129,0,1009,0,0,84.26,5106622,14.98,30.7,2.355,37960.709,266.342,12.61,0.821,0
145,195,1761,105890,29,1038,0,0,84.26,5106622,14.98,30.7,2.355,37960.709,266.342,12.61,0.821,0
145,196,685,106575,8,1046,0,0,84.26,5106622,14.98,30.7,2.355,37960.709,266.342,12.61,0.821,0
145,197,638,107213,7,1053,0,0,84.26,5106622,14.98,30.7,2.355,37960.709,266.342,12.61,0.821,0
145,198,563,107776,8,1061,0,0,84.26,5106622,14.98,30.7,2.355,37960.709,266.342,12.61,0.821,0
145,199,520,108296,10,1071,0,0,84.26,5106622,14.98,30.7,2.355,37960.709,266.342,12.61,0.821,0
145,200,0,108296,0,1071,0,0,84.26,5106622,14.98,30.7,2.355,37960.709,266.342,12.61,0.821,0
145,201,0,108296,0,1071,0,0,84.26,5106622,14.98,30.7,2.355,37960.709,266.342,12.61,0.821,0
145,202,1657,109953,30,1101,0,0,84.26,5106622,14.98,30.7,2.355,37960.709,266.342,12.61,0.821,0
145,203,641,110594,13,1114,0,0,84.26,5106622,14.98,30.7,2.355,37960.709,266.342,12.61,0.821,0
145,204,439,111033,8,1122,0,0,84.26,5106622,14.98,30.7,2.355,37960.709,266.342,12.61,0.821,0
146,1,414,2039,8,26,1357,17324,96.3,220892331,255.573,23.5,4.495,5034.708,423.031,8.35,0.562,2
146,2,252,2291,5,31,12984,30308,96.3,220892331,255.573,23.5,4.495,5034.708,423.031,8.35,0.562,2
146,3,0,2291,0,31,2622,32930,96.3,220892331,255.573,23.5,4.495,5034.708,423.031,8.35,0.562,2
146,4,0,2291,0,31,1955,34885,96.3,220892331,255.573,23.5,4.495,5034.708,423.031,8.35,0.562,2
146,5,159,2450,4,35,990,35875,96.3,220892331,255.573,23.5,4.495,5034.708,423.031,8.35,0.562,2
146,6,827,3277,15,50,3308,39183,96.3,220892331,255.573,23.5,4.495,5034.708,423.031,8.35,0.562,2
146,7,587,3864,4,54,2976,42159,96.3,220892331,255.573,23.5,4.495,5034.708,423.031,8.35,0.562,2
146,8,208,4072,4,58,2737,44896,96.3,220892331,255.573,23.5,4.495,5034.708,423.031,8.35,0.562,2
146,9,250,4322,5,63,9810,54706,96.3,220892331,255.573,23.5,4.495,5034.708,423.031,8.35,0.562,2
146,10,279,4601,3,66,3130,57836,96.3,220892331,255.573,23.5,4.495,5034.708,423.031,8.35,0.562,2
146,11,187,4788,5,71,3965,61801,96.3,220892331,255.573,23.5,4.495,5034.708,423.031,8.35,0.562,2
146,12,250,5038,15,86,3313,65114,96.3,220892331,255.573,23.5,4.495,5034.708,423.031,8.35,0.562,2
146,13,336,5374,7,93,4814,69928,96.3,220892331,255.573,23.5,4.495,5034.708,423.031,8.35,0.562,2
146,14,342,5716,3,96,3511,73439,96.3,220892331,255.573,23.5,4.495,5034.708,423.031,8.35,0.562,2
146,15,272,5988,11,107,5540,78979,92.59,220892331,255.573,23.5,4.495,5034.708,423.031,8.35,0.562,2
146,16,517,6505,17,124,5725,84704,92.59,220892331,255.573,23.5,4.495,5034.708,423.031,8.35,0.562,2
146,17,520,7025,11,135,7844,92548,92.59,220892331,255.573,23.5,4.495,5034.708,423.031,8.35,0.562,2
146,18,456,7481,8,143,5974,98522,92.59,220892331,255.573,23.5,4.495,5034.708,423.031,8.35,0.562,2
146,19,512,7993,16,159,5780,104302,92.59,220892331,255.573,23.5,4.495,5034.708,423.031,8.35,0.562,2
146,20,425,8418,17,176,0,104302,92.59,220892331,255.573,23.5,4.495,5034.708,423.031,8.35,0.562,2
146,21,798,9216,16,192,0,111806,92.59,220892331,255.573,23.5,4.495,5034.708,423.031,8.35,0.562,2
146,22,533,9749,17,209,6214,118020,92.59,220892331,255.573,23.5,4.495,5034.708,423.031,8.35,0.562,2
146,23,0,9749,0,209,6529,124549,92.59,220892331,255.573,23.5,4.495,5034.708,423.031,8.35,0.562,2
146,24,1406,11155,28,237,6816,131365,89.81,220892331,255.573,23.5,4.495,5034.708,423.031,8.35,0.562,2
146,25,785,11940,16,253,6782,138147,89.81,220892331,255.573,23.5,4.495,5034.708,423.031,8.35,0.562,2
146,26,783,12723,16,269,6218,144365,89.81,220892331,255.573,23.5,4.495,5034.708,423.031,8.35,0.562,2
146,27,605,13328,12,281,6391,150756,89.81,220892331,255.573,23.5,4.495,5034.708,423.031,8.35,0.562,2
146,28,751,14079,20,301,6467,157223,89.81,220892331,255.573,23.5,4.495,5034.708,423.031,8.35,0.562,2
146,29,806,14885,26,327,8688,165911,89.81,220892331,255.573,23.5,4.495,5034.708,423.031,8.35,0.562,2
146,30,874,15759,19,346,8249,174160,89.81,220892331,255.573,23.5,4.495,5034.708,423.031,8.35,0.562,2
146,31,1058,16817,39,385,7971,182131,89.81,220892331,255.573,23.5,4.495,5034.708,423.031,8.35,0.562,2
146,32,1297,18114,32,417,11728,193859,89.81,220892331,255.573,23.5,4.495,5034.708,423.031,8.35,0.562,2
146,33,989,19103,23,440,9166,203025,89.81,220892331,255.573,23.5,4.495,5034.708,423.031,8.35,0.562,2
146,34,1083,20186,22,462,9486,212511,89.81,220892331,255.573,23.5,4.495,5034.708,423.031,8.35,0.562,2
146,35,1315,21501,24,486,9893,222404,89.81,220892331,255.573,23.5,4.495,5034.708,423.031,8.35,0.562,2
146,36,1049,22550,40,526,10178,232582,89.81,220892331,255.573,23.5,4.495,5034.708,423.031,8.35,0.562,2
146,37,1523,24073,38,564,12196,244778,89.81,220892331,255.573,23.5,4.495,5034.708,423.031,8.35,0.562,2
146,38,1764,25837,30,594,12469,257247,89.81,220892331,255.573,23.5,4.495,5034.708,423.031,8.35,0.562,2
146,39,1637,27474,24,618,12778,270025,89.81,220892331,255.573,23.5,4.495,5034.708,423.031,8.35,0.562,2
146,40,1991,29465,21,639,13492,283517,89.81,220892331,255.573,23.5,4.495,5034.708,423.031,8.35,0.562,2
146,41,1476,30941,28,667,11377,294894,89.81,220892331,255.573,23.5,4.495,5034.708,423.031,8.35,0.562,2
146,42,1140,32081,39,706,10957,305851,89.81,220892331,255.573,23.5,4.495,5034.708,423.031,8.35,0.562,2
146,43,2255,34336,31,737,11848,317699,89.81,220892331,255.573,23.5,4.495,5034.708,423.031,8.35,0.562,2
146,44,1452,35788,33,770,13051,330750,89.81,220892331,255.573,23.5,4.495,5034.708,423.031,8.35,0.562,2
146,45,1430,37218,33,803,13700,344450,89.81,220892331,255.573,23.5,4.495,5034.708,423.031,8.35,0.562,2
146,46,1581,38799,31,834,14814,359264,78.7,220892331,255.573,23.5,4.495,5034.708,423.031,8.35,0.562,2
146,47,1352,40151,39,873,14146,373410,85.19,220892331,255.573,23.5,4.495,5034.708,423.031,8.35,0.562,2
146,48,1974,42125,30,903,13925,387335,85.19,220892331,255.573,23.5,4.495,5034.708,423.031,8.35,0.562,2
146,49,1841,43966,36,939,12957,400292,85.19,220892331,255.573,23.5,4.495,5034.708,423.031,8.35,0.562,2
146,50,1932,45898,46,985,13962,414254,85.19,220892331,255.573,23.5,4.495,5034.708,423.031,8.35,0.562,2
146,51,2193,48091,32,1017,15346,429600,82.41,220892331,255.573,23.5,4.495,5034.708,423.031,8.35,0.562,2
146,52,2603,50694,50,1067,16387,445987,82.41,220892331,255.573,23.5,4.495,5034.708,423.031,8.35,0.562,2
146,53,1743,52437,34,1101,14705,460692,82.41,220892331,255.573,23.5,4.495,5034.708,423.031,8.35,0.562,2
146,54,2164,54601,32,1133,12915,473607,82.41,220892331,255.573,23.5,4.495,5034.708,423.031,8.35,0.562,2
146,55,1748,56349,34,1167,10049,483656,82.41,220892331,255.573,23.5,4.495,5034.708,423.031,8.35,0.562,2
146,56,1356,57705,30,1197,7252,490908,82.41,220892331,255.573,23.5,4.495,5034.708,423.031,8.35,0.562,2
146,57,1446,59151,28,1225,8491,499399,82.41,220892331,255.573,23.5,4.495,5034.708,423.031,8.35,0.562,2
146,58,2076,61227,35,1260,8687,508086,82.41,220892331,255.573,23.5,4.495,5034.708,423.031,8.35,0.562,2
146,59,2801,64028,57,1317,11931,520017,82.41,220892331,255.573,23.5,4.495,5034.708,423.031,8.35,0.562,2
146,60,2429,66457,78,1395,12020,532037,82.41,220892331,255.573,23.5,4.495,5034.708,423.031,8.35,0.562,2
146,61,3039,69496,88,1483,14993,547030,82.41,220892331,255.573,23.5,4.495,5034.708,423.031,8.35,0.562,2
146,62,2964,72460,60,1543,14106,561136,82.41,220892331,255.573,23.5,4.495,5034.708,423.031,8.35,0.562,2
146,63,3938,76398,78,1621,16838,577974,82.41,220892331,255.573,23.5,4.495,5034.708,423.031,8.35,0.562,2
146,64,4065,80463,67,1688,17370,595344,82.41,220892331,255.573,23.5,4.495,5034.708,423.031,8.35,0.562,2
146,65,4801,85264,82,1770,20167,615511,69.44,220892331,255.573,23.5,4.495,5034.708,423.031,8.35,0.562,2
146,66,3985,89249,68,1838,22812,638323,69.44,220892331,255.573,23.5,4.495,5034.708,423.031,8.35,0.562,2
146,67,4734,93983,97,1935,22185,660508,69.44,220892331,255.573,23.5,4.495,5034.708,423.031,8.35,0.562,2
146,68,4960,98943,67,2002,23100,683608,61.11,220892331,255.573,23.5,4.495,5034.708,423.031,8.35,0.562,2
146,69,4728,103671,65,2067,22225,705833,61.11,220892331,255.573,23.5,4.495,5034.708,423.031,8.35,0.562,2
146,70,4646,108317,105,2172,24620,730453,61.11,220892331,255.573,23.5,4.495,5034.708,423.031,8.35,0.562,2
146,71,5385,113702,83,2255,23799,754252,61.11,220892331,255.573,23.5,4.495,5034.708,423.031,8.35,0.562,2
146,72,5834,119536,101,2356,26573,780825,61.11,220892331,255.573,23.5,4.495,5034.708,423.031,8.35,0.562,2
146,73,6397,125933,107,2463,28344,809169,61.11,220892331,255.573,23.5,4.495,5034.708,423.031,8.35,0.562,2
146,74,6472,132405,88,2551,29850,839019,61.11,220892331,255.573,23.5,4.495,5034.708,423.031,8.35,0.562,2
146,75,6825,139230,81,2632,29546,868565,61.11,220892331,255.573,23.5,4.495,5034.708,423.031,8.35,0.562,2
146,76,5248,144478,97,2729,29085,897650,61.11,220892331,255.573,23.5,4.495,5034.708,423.031,8.35,0.562,2
146,77,4443,148921,110,2839,25015,922665,61.11,220892331,255.573,23.5,4.495,5034.708,423.031,8.35,0.562,2
146,78,5839,154760,136,2975,28117,950782,61.11,220892331,255.573,23.5,4.495,5034.708,423.031,8.35,0.562,2
146,79,5358,160118,118,3093,31230,982012,61.11,220892331,255.573,23.5,4.495,5034.708,423.031,8.35,0.562,2
146,80,4944,165062,136,3229,29094,1011106,61.11,220892331,255.573,23.5,4.495,5034.708,423.031,8.35,0.562,2
146,81,6604,171666,153,3382,31681,1042787,58.33,220892331,255.573,23.5,4.495,5034.708,423.031,8.35,0.562,2
146,82,4951,176617,119,3501,28855,1071642,58.33,220892331,255.573,23.5,4.495,5034.708,423.031,8.35,0.562,2
146,83,4471,181088,89,3590,30520,1102162,60.19,220892331,255.573,23.5,4.495,5034.708,423.031,8.35,0.562,2
146,84,3946,185034,105,3695,24599,1126761,60.19,220892331,255.573,23.5,4.495,5034.708,423.031,8.35,0.562,2
146,85,3892,188926,60,3755,23380,1150141,60.19,220892331,255.573,23.5,4.495,5034.708,423.031,8.35,0.562,2
146,86,4044,192970,148,3903,21835,1171976,60.19,220892331,255.573,23.5,4.495,5034.708,423.031,8.35,0.562,2
146,87,2775,195745,59,3962,21041,1193017,60.19,220892331,255.573,23.5,4.495,5034.708,423.031,8.35,0.562,2
146,88,3138,198883,73,4035,21123,1214140,60.19,220892331,255.573,23.5,4.495,5034.708,423.031,8.35,0.562,2
146,89,4072,202955,83,4118,25013,1239153,60.19,220892331,255.573,23.5,4.495,5034.708,423.031,8.35,0.562,2
146,90,3557,206512,49,4167,23009,1262162,60.19,220892331,255.573,23.5,4.495,5034.708,423.031,8.35,0.562,2
146,91,2825,209337,137,4304,20930,1283092,60.19,220892331,255.573,23.5,4.495,5034.708,423.031,8.35,0.562,2
146,92,4133,213470,91,4395,22418,1305510,60.19,220892331,255.573,23.5,4.495,5034.708,423.031,8.35,0.562,2
146,93,4339,217809,78,4473,22128,1327638,66.67,220892331,255.573,23.5,4.495,5034.708,423.031,8.35,0.562,2
146,94,4087,221896,78,4551,23135,1350773,66.67,220892331,255.573,23.5,4.495,5034.708,423.031,8.35,0.562,2
146,95,3387,225283,68,4619,22052,1372825,66.67,220892331,255.573,23.5,4.495,5034.708,423.031,8.35,0.562,2
146,96,3191,228474,93,4712,25527,1398352,66.67,220892331,255.573,23.5,4.495,5034.708,423.031,8.35,0.562,2
146,97,3344,231818,50,4762,22271,1420623,66.67,220892331,255.573,23.5,4.495,5034.708,423.031,8.35,0.562,2
146,98,2691,234509,77,4839,24530,1445153,66.67,220892331,255.573,23.5,4.495,5034.708,423.031,8.35,0.562,2
146,99,2980,237489,83,4922,21951,1467104,66.67,220892331,255.573,23.5,4.495,5034.708,423.031,8.35,0.562,2
146,100,3359,240848,61,4983,24333,1491437,66.67,220892331,255.573,23.5,4.495,5034.708,423.031,8.35,0.562,2
146,101,2751,243599,75,5058,23421,1514858,66.67,220892331,255.573,23.5,4.495,5034.708,423.031,8.35,0.562,2
146,102,2752,246351,65,5123,23569,1538427,66.67,220892331,255.573,23.5,4.495,5034.708,423.031,8.35,0.562,2
146,103,2521,248872,74,5197,24211,1562638,66.67,220892331,255.573,23.5,4.495,5034.708,423.031,8.35,0.562,2
146,104,2753,251625,69,5266,22532,1585170,66.67,220892331,255.573,23.5,4.495,5034.708,423.031,8.35,0.562,2
146,105,1979,253604,54,5320,21020,1606190,66.67,220892331,255.573,23.5,4.495,5034.708,423.031,8.35,0.562,2
146,106,2165,255769,66,5386,21749,1627939,66.67,220892331,255.573,23.5,4.495,5034.708,423.031,8.35,0.562,2
146,107,2145,257914,40,5426,24244,1652183,66.67,220892331,255.573,23.5,4.495,5034.708,423.031,8.35,0.562,2
146,108,2085,259999,49,5475,23907,1676090,66.67,220892331,255.573,23.5,4.495,5034.708,423.031,8.35,0.562,2
146,109,1918,261917,47,5522,23011,1699101,66.67,220892331,255.573,23.5,4.495,5034.708,423.031,8.35,0.562,2
146,110,1579,263496,46,5568,22559,1721660,66.67,220892331,255.573,23.5,4.495,5034.708,423.031,8.35,0.562,2
146,111,1587,265083,31,5599,19108,1740768,66.67,220892331,255.573,23.5,4.495,5034.708,423.031,8.35,0.562,2
146,112,1013,266096,40,5639,17783,1758551,66.67,220892331,255.573,23.5,4.495,5034.708,423.031,8.35,0.562,2
146,113,1332,267428,38,5677,18331,1776882,66.67,220892331,255.573,23.5,4.495,5034.708,423.031,8.35,0.562,2
146,114,1763,269191,32,5709,22408,1799290,66.67,220892331,255.573,23.5,4.495,5034.708,423.031,8.35,0.562,2
146,115,1209,270400,54,5763,22006,1821296,66.67,220892331,255.573,23.5,4.495,5034.708,423.031,8.35,0.562,2
146,116,1487,271887,24,5787,23630,1844926,66.67,220892331,255.573,23.5,4.495,5034.708,423.031,8.35,0.562,2
146,117,1226,273113,35,5822,23254,1868180,66.67,220892331,255.573,23.5,4.495,5034.708,423.031,8.35,0.562,2
146,118,1176,274289,20,5842,41666,1909846,66.67,220892331,255.573,23.5,4.495,5034.708,423.031,8.35,0.562,2
146,119,936,275225,23,5865,21256,1931102,66.67,220892331,255.573,23.5,4.495,5034.708,423.031,8.35,0.562,2
146,120,1063,276288,27,5892,21628,1952730,66.67,220892331,255.573,23.5,4.495,5034.708,423.031,8.35,0.562,2
146,121,1114,277402,32,5924,20507,1973237,66.67,220892331,255.573,23.5,4.495,5034.708,423.031,8.35,0.562,2
146,122,903,278305,27,5951,0,1973237,66.67,220892331,255.573,23.5,4.495,5034.708,423.031,8.35,0.562,2
146,123,0,278305,0,5951,0,2010170,66.67,220892331,255.573,23.5,4.495,5034.708,423.031,8.35,0.562,2
146,124,0,278305,0,5951,11026,2021196,66.67,220892331,255.573,23.5,4.495,5034.708,423.031,8.35,0.562,2
146,125,1724,280029,33,5984,10759,2031955,66.67,220892331,255.573,23.5,4.495,5034.708,423.031,8.35,0.562,2
146,126,432,280461,15,5999,11915,2043870,66.67,220892331,255.573,23.5,4.495,5034.708,423.031,8.35,0.562,2
146,127,675,281136,15,6014,0,2043870,66.67,220892331,255.573,23.5,4.495,5034.708,423.031,8.35,0.562,2
146,128,727,281863,21,6035,0,2058872,66.67,220892331,255.573,23.5,4.495,5034.708,423.031,8.35,0.562,2
146,129,782,282645,17,6052,20461,2079333,66.67,220892331,255.573,23.5,4.495,5034.708,423.031,8.35,0.562,2
146,130,842,283487,16,6068,24366,2103699,66.67,220892331,255.573,23.5,4.495,5034.708,423.031,8.35,0.562,2
146,131,634,284121,14,6082,23390,2127089,66.67,220892331,255.573,23.5,4.495,5034.708,423.031,8.35,0.562,2
146,132,539,284660,15,6097,20495,2147584,47.69,220892331,255.573,23.5,4.495,5034.708,423.031,8.35,0.562,2
146,133,531,285191,15,6112,18227,2165811,47.69,220892331,255.573,23.5,4.495,5034.708,423.031,8.35,0.562,2
146,134,730,285921,17,6129,20631,2186442,47.69,220892331,255.573,23.5,4.495,5034.708,423.031,8.35,0.562,2
146,135,753,286674,10,6139,19222,2205664,47.69,220892331,255.573,23.5,4.495,5034.708,423.031,8.35,0.562,2
146,136,626,287300,14,6153,23745,2229409,47.69,220892331,255.573,23.5,4.495,5034.708,423.031,8.35,0.562,2
146,137,747,288047,9,6162,23722,2253131,47.69,220892331,255.573,23.5,4.495,5034.708,423.031,8.35,0.562,2
146,138,670,288717,6,6168,24022,2277153,47.69,220892331,255.573,23.5,4.495,5034.708,423.031,8.35,0.562,2
146,139,498,289215,7,6175,22448,2299601,47.69,220892331,255.573,23.5,4.495,5034.708,423.031,8.35,0.562,2
146,140,617,289832,15,6190,17612,2317213,47.69,220892331,255.573,23.5,4.495,5034.708,423.031,8.35,0.562,2
146,141,0,289832,0,6190,22859,2340072,47.69,220892331,255.573,23.5,4.495,5034.708,423.031,8.35,0.562,2
146,142,1126,290958,19,6209,23680,2363752,47.69,220892331,255.573,23.5,4.495,5034.708,423.031,8.35,0.562,2
146,143,630,291588,10,6219,25613,2389365,47.69,220892331,255.573,23.5,4.495,5034.708,423.031,8.35,0.562,2
146,144,586,292174,12,6231,25537,2414902,47.69,220892331,255.573,23.5,4.495,5034.708,423.031,8.35,0.562,2
146,145,591,292765,4,6235,24956,2439858,47.69,220892331,255.573,23.5,4.495,5034.708,423.031,8.35,0.562,2
146,146,0,292765,0,6235,23655,2463513,47.69,220892331,255.573,23.5,4.495,5034.708,423.031,8.35,0.562,2
146,147,946,293711,20,6255,24231,2487744,47.69,220892331,255.573,23.5,4.495,5034.708,423.031,8.35,0.562,2
146,148,482,294193,12,6267,24593,2512337,47.69,220892331,255.573,23.5,4.495,5034.708,423.031,8.35,0.562,2
146,149,445,294638,7,6274,23441,2535778,47.69,220892331,255.573,23.5,4.495,5034.708,423.031,8.35,0.562,2
146,150,415,295053,9,6283,23483,2559261,47.69,220892331,255.573,23.5,4.495,5034.708,423.031,8.35,0.562,2
146,151,319,295372,1,6284,22434,2581695,47.69,220892331,255.573,23.5,4.495,5034.708,423.031,8.35,0.562,2
146,152,264,295636,4,6288,21434,2603129,47.69,220892331,255.573,23.5,4.495,5034.708,423.031,8.35,0.562,2
146,153,213,295849,6,6294,18017,2621146,47.69,220892331,255.573,23.5,4.495,5034.708,423.031,8.35,0.562,2
146,154,300,296149,4,6298,20922,2642068,47.69,220892331,255.573,23.5,4.495,5034.708,423.031,8.35,0.562,2
146,155,441,296590,20,6318,20440,2662508,47.69,220892331,255.573,23.5,4.495,5034.708,423.031,8.35,0.562,2
146,156,424,297014,10,6328,21744,2684252,47.69,220892331,255.573,23.5,4.495,5034.708,423.031,8.35,0.562,2
146,157,498,297512,7,6335,23218,2707470,47.69,220892331,255.573,23.5,4.495,5034.708,423.031,8.35,0.562,2
146,158,513,298025,5,6340,24855,2732325,47.69,220892331,255.573,23.5,4.495,5034.708,423.031,8.35,0.562,2
146,159,484,298509,2,6342,25384,2757709,47.69,220892331,255.573,23.5,4.495,5034.708,423.031,8.35,0.562,2
146,160,394,298903,3,6345,20980,2778689,47.69,220892331,255.573,23.5,4.495,5034.708,423.031,8.35,0.562,2
146,161,330,299233,5,6350,23521,2802210,47.69,220892331,255.573,23.5,4.495,5034.708,423.031,8.35,0.562,2
146,162,426,299659,9,6359,22830,2825040,47.69,220892331,255.573,23.5,4.495,5034.708,423.031,8.35,0.562,2
146,163,196,299855,6,6365,25081,2850121,47.69,220892331,255.573,23.5,4.495,5034.708,423.031,8.35,0.562,2
146,164,516,300371,5,6370,29534,2879655,47.69,220892331,255.573,23.5,4.495,5034.708,423.031,8.35,0.562,2
146,165,584,300955,3,6373,28724,2908379,47.69,220892331,255.573,23.5,4.495,5034.708,423.031,8.35,0.562,2
146,166,526,301481,6,6379,31411,2939790,47.69,220892331,255.573,23.5,4.495,5034.708,423.031,8.35,0.562,2
146,167,539,302020,4,6383,28823,2968613,47.69,220892331,255.573,23.5,4.495,5034.708,423.031,8.35,0.562,2
146,168,404,302424,6,6389,27277,2995890,43.98,220892331,255.573,23.5,4.495,5034.708,423.031,8.35,0.562,2
146,169,665,303089,4,6393,29097,3024987,43.98,220892331,255.573,23.5,4.495,5034.708,423.031,8.35,0.562,2
146,170,545,303634,6,6399,31808,3056795,41.2,220892331,255.573,23.5,4.495,5034.708,423.031,8.35,0.562,2
146,171,752,304386,9,6408,33865,3090660,41.2,220892331,255.573,23.5,4.495,5034.708,423.031,8.35,0.562,2
146,172,645,305031,7,6415,35720,3126380,41.2,220892331,255.573,23.5,4.495,5034.708,423.031,8.35,0.562,2
146,173,640,305671,1,6416,34544,3160924,41.2,220892331,255.573,23.5,4.495,5034.708,423.031,8.35,0.562,2
146,174,633,306304,4,6420,33393,3194317,41.2,220892331,255.573,23.5,4.495,5034.708,423.031,8.35,0.562,2
146,175,582,306886,4,6424,36155,3230472,41.2,220892331,255.573,23.5,4.495,5034.708,423.031,8.35,0.562,2
146,176,532,307418,8,6432,33744,3264216,41.2,220892331,255.573,23.5,4.495,5034.708,423.031,8.35,0.562,2
146,177,799,308217,5,6437,42299,3306515,41.2,220892331,255.573,23.5,4.495,5034.708,423.031,8.35,0.562,2
146,178,798,309015,7,6444,37504,3344019,41.2,220892331,255.573,23.5,4.495,5034.708,423.031,8.35,0.562,2
146,179,566,309581,7,6451,40167,3384186,41.2,220892331,255.573,23.5,4.495,5034.708,423.031,8.35,0.562,2
146,180,694,310275,6,6457,36468,3420654,41.2,220892331,255.573,23.5,4.495,5034.708,423.031,8.35,0.562,2
146,181,566,310841,9,6466,28887,3449541,41.2,220892331,255.573,23.5,4.495,5034.708,423.031,8.35,0.562,2
146,182,675,311516,8,6474,32665,3482206,41.2,220892331,255.573,23.5,4.495,5034.708,423.031,8.35,0.562,2
146,183,747,312263,5,6479,32031,3514237,37.5,220892331,255.573,23.5,4.495,5034.708,423.031,8.35,0.562,2
146,184,543,312806,5,6484,34239,3548476,37.5,220892331,255.573,23.5,4.495,5034.708,423.031,8.35,0.562,2
146,185,625,313431,15,6499,31697,3580173,37.5,220892331,255.573,23.5,4.495,5034.708,423.031,8.35,0.562,2
146,186,553,313984,8,6507,35071,3615244,37.5,220892331,255.573,23.5,4.495,5034.708,423.031,8.35,0.562,2
146,187,632,314616,6,6513,29518,3644762,37.5,220892331,255.573,23.5,4.495,5034.708,423.031,8.35,0.562,2
146,188,0,314616,0,6513,33772,3678534,37.5,220892331,255.573,23.5,4.495,5034.708,423.031,8.35,0.562,2
146,189,1111,315727,10,6523,24073,3702607,37.5,220892331,255.573,23.5,4.495,5034.708,423.031,8.35,0.562,2
146,190,624,316351,12,6535,27614,3730221,37.5,220892331,255.573,23.5,4.495,5034.708,423.031,8.35,0.562,2
146,191,583,316934,9,6544,31168,3761389,37.5,220892331,255.573,23.5,4.495,5034.708,423.031,8.35,0.562,2
146,192,661,317595,8,6552,33898,3795287,37.5,220892331,255.573,23.5,4.495,5034.708,423.031,8.35,0.562,2
146,193,671,318266,6,6558,33665,3828952,37.5,220892331,255.573,23.5,4.495,5034.708,423.031,8.35,0.562,2
146,194,666,318932,12,6570,28893,3857845,37.5,220892331,255.573,23.5,4.495,5034.708,423.031,8.35,0.562,2
146,195,0,318932,0,6570,26951,3884796,37.5,220892331,255.573,23.5,4.495,5034.708,423.031,8.35,0.562,2
146,196,916,319848,18,6588,30022,3914818,37.5,220892331,255.573,23.5,4.495,5034.708,423.031,8.35,0.562,2
146,197,615,320463,13,6601,28916,3943734,37.5,220892331,255.573,23.5,4.495,5034.708,423.031,8.35,0.562,2
146,198,755,321218,13,6614,31862,3975596,37.5,220892331,255.573,23.5,4.495,5034.708,423.031,8.35,0.562,2
146,199,659,321877,7,6621,33901,4009497,37.5,220892331,255.573,23.5,4.495,5034.708,423.031,8.35,0.562,2
146,200,575,322452,17,6638,32465,4041962,37.5,220892331,255.573,23.5,4.495,5034.708,423.031,8.35,0.562,2
146,201,567,323019,16,6654,32062,4074024,37.5,220892331,255.573,23.5,4.495,5034.708,423.031,8.35,0.562,2
146,202,433,323452,5,6659,27091,4101115,37.5,220892331,255.573,23.5,4.495,5034.708,423.031,8.35,0.562,2
146,203,0,323452,0,6659,0,4101115,37.5,220892331,255.573,23.5,4.495,5034.708,423.031,8.35,0.562,2
146,204,1292,324744,33,6692,0,4101115,37.5,220892331,255.573,23.5,4.495,5034.708,423.031,8.35,0.562,2
147,1,2,117,0,1,0,0,96.3,5101416,778.202,20.4,3.043,4449.898,265.91,10.59,0.686,0
147,2,17,134,0,1,0,0,96.3,5101416,778.202,20.4,3.043,4449.898,265.91,10.59,0.686,0
147,3,21,155,0,1,0,0,96.3,5101416,778.202,20.4,3.043,4449.898,265.91,10.59,0.686,0
147,4,0,155,0,1,0,0,96.3,5101416,778.202,20.4,3.043,4449.898,265.91,10.59,0.686,0
147,5,,155,,1,0,0,96.3,5101416,778.202,20.4,3.043,4449.898,265.91,10.59,0.686,0
147,6,62,217,0,1,0,0,96.3,5101416,778.202,20.4,3.043,4449.898,265.91,10.59,0.686,0
147,7,36,253,0,1,0,0,96.3,5101416,778.202,20.4,3.043,4449.898,265.91,10.59,0.686,0
147,8,7,260,0,1,0,0,96.3,5101416,778.202,20.4,3.043,4449.898,265.91,10.59,0.686,0
147,9,3,263,0,1,0,0,96.3,5101416,778.202,20.4,3.043,4449.898,265.91,10.59,0.686,0
147,10,0,263,0,1,0,0,96.3,5101416,778.202,20.4,3.043,4449.898,265.91,10.59,0.686,0
147,11,3,266,1,2,0,0,96.3,5101416,778.202,20.4,3.043,4449.898,265.91,10.59,0.686,0
147,12,2,268,0,2,0,0,96.3,5101416,778.202,20.4,3.043,4449.898,265.91,10.59,0.686,0
147,13,0,268,0,2,0,0,96.3,5101416,778.202,20.4,3.043,4449.898,265.91,10.59,0.686,0
147,14,0,268,0,2,0,0,96.3,5101416,778.202,20.4,3.043,4449.898,265.91,10.59,0.686,0
147,15,19,287,0,2,0,0,96.3,5101416,778.202,20.4,3.043,4449.898,265.91,10.59,0.686,0
147,16,4,291,0,2,0,0,96.3,5101416,778.202,20.4,3.043,4449.898,265.91,10.59,0.686,0
147,17,3,294,0,2,0,0,96.3,5101416,778.202,20.4,3.043,4449.898,265.91,10.59,0.686,0
147,18,13,307,0,2,0,0,96.3,5101416,778.202,20.4,3.043,4449.898,265.91,10.59,0.686,0
147,19,6,313,0,2,0,0,96.3,5101416,778.202,20.4,3.043,4449.898,265.91,10.59,0.686,0
147,20,9,322,0,2,0,0,96.3,5101416,778.202,20.4,3.043,4449.898,265.91,10.59,0.686,0
147,21,7,329,0,2,0,0,96.3,5101416,778.202,20.4,3.043,4449.898,265.91,10.59,0.686,0
147,22,0,329,0,2,0,0,96.3,5101416,778.202,20.4,3.043,4449.898,265.91,10.59,0.686,0
147,23,6,335,0,2,0,0,96.3,5101416,778.202,20.4,3.043,4449.898,265.91,10.59,0.686,0
147,24,1,336,0,2,0,0,96.3,5101416,778.202,20.4,3.043,4449.898,265.91,10.59,0.686,0
147,25,4,340,0,2,0,0,96.3,5101416,778.202,20.4,3.043,4449.898,265.91,10.59,0.686,0
147,26,2,342,0,2,0,0,96.3,5101416,778.202,20.4,3.043,4449.898,265.91,10.59,0.686,0
147,27,153,495,0,2,0,0,96.3,5101416,778.202,20.4,3.043,4449.898,265.91,10.59,0.686,0
147,28,0,495,0,2,0,0,96.3,5101416,778.202,20.4,3.043,4449.898,265.91,10.59,0.686,0
147,29,0,495,0,2,0,0,96.3,5101416,778.202,20.4,3.043,4449.898,265.91,10.59,0.686,0
147,30,12,507,0,2,0,0,96.3,5101416,778.202,20.4,3.043,4449.898,265.91,10.59,0.686,0
147,31,0,507,2,4,0,0,96.3,5101416,778.202,20.4,3.043,4449.898,265.91,10.59,0.686,0
147,32,10,517,0,4,0,0,96.3,5101416,778.202,20.4,3.043,4449.898,265.91,10.59,0.686,0
147,33,0,517,0,4,0,0,96.3,5101416,778.202,20.4,3.043,4449.898,265.91,10.59,0.686,0
147,34,5,522,0,4,0,0,96.3,5101416,778.202,20.4,3.043,4449.898,265.91,10.59,0.686,0
147,35,2,524,0,4,0,0,96.3,5101416,778.202,20.4,3.043,4449.898,265.91,10.59,0.686,0
147,36,14,538,0,4,0,0,96.3,5101416,778.202,20.4,3.043,4449.898,265.91,10.59,0.686,0
147,37,8,546,0,4,0,0,96.3,5101416,778.202,20.4,3.043,4449.898,265.91,10.59,0.686,0
147,38,1,547,0,4,0,0,96.3,5101416,778.202,20.4,3.043,4449.898,265.91,10.59,0.686,0
147,39,0,547,0,4,0,0,96.3,5101416,778.202,20.4,3.043,4449.898,265.91,10.59,0.686,0
147,40,0,547,0,4,0,0,96.3,5101416,778.202,20.4,3.043,4449.898,265.91,10.59,0.686,0
147,41,0,547,0,4,0,0,96.3,5101416,778.202,20.4,3.043,4449.898,265.91,10.59,0.686,0
147,42,0,547,0,4,0,0,96.3,5101416,778.202,20.4,3.043,4449.898,265.91,10.59,0.686,0
147,43,0,547,0,4,0,0,96.3,5101416,778.202,20.4,3.043,4449.898,265.91,10.59,0.686,0
147,44,1,548,0,4,0,0,96.3,5101416,778.202,20.4,3.043,4449.898,265.91,10.59,0.686,0
147,45,0,548,0,4,0,0,96.3,5101416,778.202,20.4,3.043,4449.898,265.91,10.59,0.686,0
147,46,6,554,0,4,0,0,96.3,5101416,778.202,20.4,3.043,4449.898,265.91,10.59,0.686,0
147,47,0,554,0,4,0,0,96.3,5101416,778.202,20.4,3.043,4449.898,265.91,10.59,0.686,0
147,48,6,560,0,4,0,0,96.3,5101416,778.202,20.4,3.043,4449.898,265.91,10.59,0.686,0
147,49,7,567,0,4,0,0,96.3,5101416,778.202,20.4,3.043,4449.898,265.91,10.59,0.686,0
147,50,3,570,0,4,0,0,96.3,5101416,778.202,20.4,3.043,4449.898,265.91,10.59,0.686,0
147,51,7,577,0,4,0,0,96.3,5101416,778.202,20.4,3.043,4449.898,265.91,10.59,0.686,0
147,52,25,602,0,4,0,0,96.3,5101416,778.202,20.4,3.043,4449.898,265.91,10.59,0.686,0
147,53,0,602,0,4,0,0,96.3,5101416,778.202,20.4,3.043,4449.898,265.91,10.59,0.686,0
147,54,0,602,1,5,0,0,96.3,5101416,778.202,20.4,3.043,4449.898,265.91,10.59,0.686,0
147,55,0,602,0,5,0,0,96.3,5101416,778.202,20.4,3.043,4449.898,265.91,10.59,0.686,0
147,56,0,602,0,5,0,0,80.56,5101416,778.202,20.4,3.043,4449.898,265.91,10.59,0.686,0
147,57,3,605,0,5,0,0,80.56,5101416,778.202,20.4,3.043,4449.898,265.91,10.59,0.686,0
147,58,8,613,0,5,0,0,80.56,5101416,778.202,20.4,3.043,4449.898,265.91,10.59,0.686,0
147,59,12,625,0,5,0,0,80.56,5101416,778.202,20.4,3.043,4449.898,265.91,10.59,0.686,0
147,60,0,625,0,5,0,0,80.56,5101416,778.202,20.4,3.043,4449.898,265.91,10.59,0.686,0
147,61,1,626,0,5,0,0,80.56,5101416,778.202,20.4,3.043,4449.898,265.91,10.59,0.686,0
147,62,1,627,0,5,0,0,80.56,5101416,778.202,20.4,3.043,4449.898,265.91,10.59,0.686,0
147,63,1,628,0,5,0,0,80.56,5101416,778.202,20.4,3.043,4449.898,265.91,10.59,0.686,0
147,64,2,630,0,5,0,0,80.56,5101416,778.202,20.4,3.043,4449.898,265.91,10.59,0.686,0
147,65,5,635,0,5,0,0,80.56,5101416,778.202,20.4,3.043,4449.898,265.91,10.59,0.686,0
147,66,8,643,0,5,0,0,80.56,5101416,778.202,20.4,3.043,4449.898,265.91,10.59,0.686,0
147,67,0,643,0,5,0,0,80.56,5101416,778.202,20.4,3.043,4449.898,265.91,10.59,0.686,0
147,68,0,643,0,5,0,0,80.56,5101416,778.202,20.4,3.043,4449.898,265.91,10.59,0.686,0
147,69,8,651,0,5,0,0,80.56,5101416,778.202,20.4,3.043,4449.898,265.91,10.59,0.686,0
147,70,1,652,0,5,0,0,80.56,5101416,778.202,20.4,3.043,4449.898,265.91,10.59,0.686,0
147,71,9,661,0,5,0,0,80.56,5101416,778.202,20.4,3.043,4449.898,265.91,10.59,0.686,0
147,72,4,665,0,5,0,0,80.56,5101416,778.202,20.4,3.043,4449.898,265.91,10.59,0.686,0
147,73,2,667,0,5,0,0,80.56,5101416,778.202,20.4,3.043,4449.898,265.91,10.59,0.686,0
147,74,2,669,0,5,0,0,80.56,5101416,778.202,20.4,3.043,4449.898,265.91,10.59,0.686,0
147,75,4,673,0,5,0,0,80.56,5101416,778.202,20.4,3.043,4449.898,265.91,10.59,0.686,0
147,76,0,673,0,5,0,0,80.56,5101416,778.202,20.4,3.043,4449.898,265.91,10.59,0.686,0
147,77,13,686,0,5,0,0,80.56,5101416,778.202,20.4,3.043,4449.898,265.91,10.59,0.686,0
147,78,4,690,0,5,0,0,80.56,5101416,778.202,20.4,3.043,4449.898,265.91,10.59,0.686,0
147,79,11,701,0,5,0,0,80.56,5101416,778.202,20.4,3.043,4449.898,265.91,10.59,0.686,0
147,80,94,795,0,5,0,0,80.56,5101416,778.202,20.4,3.043,4449.898,265.91,10.59,0.686,0
147,81,63,858,0,5,0,0,80.56,5101416,778.202,20.4,3.043,4449.898,265.91,10.59,0.686,0
147,82,121,979,0,5,0,0,80.56,5101416,778.202,20.4,3.043,4449.898,265.91,10.59,0.686,0
147,83,43,1022,0,5,0,0,80.56,5101416,778.202,20.4,3.043,4449.898,265.91,10.59,0.686,0
147,84,174,1196,0,5,0,0,80.56,5101416,778.202,20.4,3.043,4449.898,265.91,10.59,0.686,0
147,85,179,1375,0,5,0,0,80.56,5101416,778.202,20.4,3.043,4449.898,265.91,10.59,0.686,0
147,86,159,1534,0,5,0,0,80.56,5101416,778.202,20.4,3.043,4449.898,265.91,10.59,0.686,0
147,87,54,1588,0,5,0,0,80.56,5101416,778.202,20.4,3.043,4449.898,265.91,10.59,0.686,0
147,88,207,1795,0,5,0,0,80.56,5101416,778.202,20.4,3.043,4449.898,265.91,10.59,0.686,0
147,89,258,2053,1,6,0,0,80.56,5101416,778.202,20.4,3.043,4449.898,265.91,10.59,0.686,0
147,90,195,2248,1,7,0,0,80.56,5101416,778.202,20.4,3.043,4449.898,265.91,10.59,0.686,0
147,91,195,2443,1,8,0,0,80.56,5101416,778.202,20.4,3.043,4449.898,265.91,10.59,0.686,0
147,92,322,2765,1,9,0,0,80.56,5101416,778.202,20.4,3.043,4449.898,265.91,10.59,0.686,0
147,93,330,3095,2,11,0,0,83.33,5101416,778.202,20.4,3.043,4449.898,265.91,10.59,0.686,0
147,94,322,3417,0,11,0,0,83.33,5101416,778.202,20.4,3.043,4449.898,265.91,10.59,0.686,0
147,95,272,3689,4,15,0,0,83.33,5101416,778.202,20.4,3.043,4449.898,265.91,10.59,0.686,0
147,96,561,4250,1,16,0,0,83.33,5101416,778.202,20.4,3.043,4449.898,265.91,10.59,0.686,0
147,97,208,4458,4,20,0,0,83.33,5101416,778.202,20.4,3.043,4449.898,265.91,10.59,0.686,0
147,98,328,4786,1,21,0,0,83.33,5101416,778.202,20.4,3.043,4449.898,265.91,10.59,0.686,0
147,99,306,5092,1,22,0,0,83.33,5101416,778.202,20.4,3.043,4449.898,265.91,10.59,0.686,0
147,100,475,5567,3,25,0,0,83.33,5101416,778.202,20.4,3.043,4449.898,265.91,10.59,0.686,0
147,101,262,5829,2,27,0,0,83.33,5101416,778.202,20.4,3.043,4449.898,265.91,10.59,0.686,0
147,102,396,6225,3,30,0,0,83.33,5101416,778.202,20.4,3.043,4449.898,265.91,10.59,0.686,0
147,103,472,6697,2,32,0,0,83.33,5101416,778.202,20.4,3.043,4449.898,265.91,10.59,0.686,0
147,104,341,7038,5,37,0,0,83.33,5101416,778.202,20.4,3.043,4449.898,265.91,10.59,0.686,0
147,105,403,7441,4,41,0,0,83.33,5101416,778.202,20.4,3.043,4449.898,265.91,10.59,0.686,0
147,106,293,7734,6,47,0,0,83.33,5101416,778.202,20.4,3.043,4449.898,265.91,10.59,0.686,0
147,107,420,8154,0,47,0,0,83.33,5101416,778.202,20.4,3.043,4449.898,265.91,10.59,0.686,0
147,108,463,8617,2,49,0,0,83.33,5101416,778.202,20.4,3.043,4449.898,265.91,10.59,0.686,0
147,109,439,9056,6,55,0,0,83.33,5101416,778.202,20.4,3.043,4449.898,265.91,10.59,0.686,0
147,110,531,9587,3,58,0,0,83.33,5101416,778.202,20.4,3.043,4449.898,265.91,10.59,0.686,0
147,111,465,10052,4,62,0,0,83.33,5101416,778.202,20.4,3.043,4449.898,265.91,10.59,0.686,0
147,112,468,10520,4,66,0,0,83.33,5101416,778.202,20.4,3.043,4449.898,265.91,10.59,0.686,0
147,113,403,10923,1,67,0,0,83.33,5101416,778.202,20.4,3.043,4449.898,265.91,10.59,0.686,0
147,114,357,11280,0,67,0,0,83.33,5101416,778.202,20.4,3.043,4449.898,265.91,10.59,0.686,0
147,115,602,11882,3,70,0,0,83.33,5101416,778.202,20.4,3.043,4449.898,265.91,10.59,0.686,0
147,116,545,12427,1,71,0,0,83.33,5101416,778.202,20.4,3.043,4449.898,265.91,10.59,0.686,0
147,117,382,12809,3,74,0,0,83.33,5101416,778.202,20.4,3.043,4449.898,265.91,10.59,0.686,0
147,118,320,13129,4,78,0,0,83.33,5101416,778.202,20.4,3.043,4449.898,265.91,10.59,0.686,0
147,119,328,13457,1,79,0,0,77.78,5101416,778.202,20.4,3.043,4449.898,265.91,10.59,0.686,0
147,120,481,13938,2,81,0,0,83.33,5101416,778.202,20.4,3.043,4449.898,265.91,10.59,0.686,0
147,121,520,14458,1,82,0,0,83.33,5101416,778.202,20.4,3.043,4449.898,265.91,10.59,0.686,0
147,122,380,14838,2,84,0,0,83.33,5101416,778.202,20.4,3.043,4449.898,265.91,10.59,0.686,0
147,123,394,15232,1,85,0,0,83.33,5101416,778.202,20.4,3.043,4449.898,265.91,10.59,0.686,0
147,124,323,15555,0,85,0,0,83.33,5101416,778.202,20.4,3.043,4449.898,265.91,10.59,0.686,0
147,125,225,15780,2,87,0,0,83.33,5101416,778.202,20.4,3.043,4449.898,265.91,10.59,0.686,0
147,126,244,16024,0,87,0,0,83.33,5101416,778.202,20.4,3.043,4449.898,265.91,10.59,0.686,0
147,127,604,16628,0,87,0,0,83.33,5101416,778.202,20.4,3.043,4449.898,265.91,10.59,0.686,0
147,128,353,16981,4,91,0,0,83.33,5101416,778.202,20.4,3.043,4449.898,265.91,10.59,0.686,0
147,129,453,17434,1,92,0,0,83.33,5101416,778.202,20.4,3.043,4449.898,265.91,10.59,0.686,0
147,130,514,17948,5,97,0,0,83.33,5101416,778.202,20.4,3.043,4449.898,265.91,10.59,0.686,0
147,131,426,18374,6,103,0,0,83.33,5101416,778.202,20.4,3.043,4449.898,265.91,10.59,0.686,0
147,132,277,18651,0,103,0,0,83.33,5101416,778.202,20.4,3.043,4449.898,265.91,10.59,0.686,0
147,133,470,19121,7,110,0,0,83.33,5101416,778.202,20.4,3.043,4449.898,265.91,10.59,0.686,0
147,134,473,19594,3,113,0,0,83.33,5101416,778.202,20.4,3.043,4449.898,265.91,10.59,0.686,0
147,135,499,20093,1,114,0,0,83.33,5101416,778.202,20.4,3.043,4449.898,265.91,10.59,0.686,0
147,136,432,20525,1,115,0,0,83.33,5101416,778.202,20.4,3.043,4449.898,265.91,10.59,0.686,0
147,137,531,21056,1,116,0,0,83.33,5101416,778.202,20.4,3.043,4449.898,265.91,10.59,0.686,0
147,138,498,21554,3,119,0,0,83.33,5101416,778.202,20.4,3.043,4449.898,265.91,10.59,0.686,0
147,139,381,21935,2,121,0,0,83.33,5101416,778.202,20.4,3.043,4449.898,265.91,10.59,0.686,0
147,140,456,22391,0,121,0,0,83.33,5101416,778.202,20.4,3.043,4449.898,265.91,10.59,0.686,0
147,141,612,23003,3,124,0,0,83.33,5101416,778.202,20.4,3.043,4449.898,265.91,10.59,0.686,0
147,142,424,23427,3,127,0,0,83.33,5101416,778.202,20.4,3.043,4449.898,265.91,10.59,0.686,0
147,143,514,23941,4,131,0,0,83.33,5101416,778.202,20.4,3.043,4449.898,265.91,10.59,0.686,0
147,144,457,24398,4,135,0,0,83.33,5101416,778.202,20.4,3.043,4449.898,265.91,10.59,0.686,0
147,145,309,24707,3,138,0,0,83.33,5101416,778.202,20.4,3.043,4449.898,265.91,10.59,0.686,0
147,146,317,25024,5,143,0,0,83.33,5101416,778.202,20.4,3.043,4449.898,265.91,10.59,0.686,0
147,147,564,25588,4,147,0,0,83.33,5101416,778.202,20.4,3.043,4449.898,265.91,10.59,0.686,0
147,148,574,26162,3,150,0,0,83.33,5101416,778.202,20.4,3.043,4449.898,265.91,10.59,0.686,0
147,149,602,26764,1,151,0,0,83.33,5101416,778.202,20.4,3.043,4449.898,265.91,10.59,0.686,0
147,150,622,27386,7,158,4115,0,83.33,5101416,778.202,20.4,3.043,4449.898,265.91,10.59,0.686,0
147,151,724,28110,2,160,7996,0,83.33,5101416,778.202,20.4,3.043,4449.898,265.91,10.59,0.686,0
147,152,417,28527,4,164,4135,0,83.33,5101416,778.202,20.4,3.043,4449.898,265.91,10.59,0.686,0
147,153,536,29063,2,166,4433,0,83.33,5101416,778.202,20.4,3.043,4449.898,265.91,10.59,0.686,0
147,154,806,29869,7,173,4433,0,83.33,5101416,778.202,20.4,3.043,4449.898,265.91,10.59,0.686,0
147,155,621,30490,7,180,5418,0,83.33,5101416,778.202,20.4,3.043,4449.898,265.91,10.59,0.686,0
147,156,843,31333,4,184,5076,0,83.33,5101416,778.202,20.4,3.043,4449.898,265.91,10.59,0.686,0
147,157,755,32088,5,189,5621,0,83.33,5101416,778.202,20.4,3.043,4449.898,265.91,10.59,0.686,0
147,158,729,32817,3,192,3697,0,83.33,5101416,778.202,20.4,3.043,4449.898,265.91,10.59,0.686,0
147,159,592,33409,7,199,4129,0,83.33,5101416,778.202,20.4,3.043,4449.898,265.91,10.59,0.686,0
147,160,603,34012,4,203,5328,0,83.33,5101416,778.202,20.4,3.043,4449.898,265.91,10.59,0.686,0
147,161,789,34801,4,207,5560,0,83.33,5101416,778.202,20.4,3.043,4449.898,265.91,10.59,0.686,0
147,162,717,35518,8,215,5471,0,83.33,5101416,778.202,20.4,3.043,4449.898,265.91,10.59,0.686,0
147,163,696,36214,2,217,5714,0,83.33,5101416,778.202,20.4,3.043,4449.898,265.91,10.59,0.686,0
147,164,1000,37214,7,224,5981,0,83.33,5101416,778.202,20.4,3.043,4449.898,265.91,10.59,0.686,0
147,165,652,37866,10,234,4919,0,83.33,5101416,778.202,20.4,3.043,4449.898,265.91,10.59,0.686,0
147,166,650,38516,4,238,6602,0,83.33,5101416,778.202,20.4,3.043,4449.898,265.91,10.59,0.686,0
147,167,994,39510,12,250,7000,0,83.33,5101416,778.202,20.4,3.043,4449.898,265.91,10.59,0.686,0
147,168,788,40298,5,255,0,0,83.33,5101416,778.202,20.4,3.043,4449.898,265.91,10.59,0.686,0
147,169,1115,41413,6,261,7113,0,83.33,5101416,778.202,20.4,3.043,4449.898,265.91,10.59,0.686,0
147,170,966,42379,15,276,5937,0,83.33,5101416,778.202,20.4,3.043,4449.898,265.91,10.59,0.686,0
147,171,966,43345,2,278,6734,0,87.04,5101416,778.202,20.4,3.043,4449.898,265.91,10.59,0.686,0
147,172,692,44037,8,286,4494,0,87.04,5101416,778.202,20.4,3.043,4449.898,265.91,10.59,0.686,0
147,173,726,44763,5,291,6948,0,85.19,5101416,778.202,20.4,3.043,4449.898,265.91,10.59,0.686,0
147,174,683,45446,9,300,6201,0,85.19,5101416,778.202,20.4,3.043,4449.898,265.91,10.59,0.686,0
147,175,611,46057,9,309,4978,0,85.19,5101416,778.202,20.4,3.043,4449.898,265.91,10.59,0.686,0
147,176,557,46614,5,314,5156,0,85.19,5101416,778.202,20.4,3.043,4449.898,265.91,10.59,0.686,0
147,177,503,47117,3,317,5028,0,85.19,5101416,778.202,20.4,3.043,4449.898,265.91,10.59,0.686,0
147,178,713,47830,5,322,3283,0,85.19,5101416,778.202,20.4,3.043,4449.898,265.91,10.59,0.686,0
147,179,452,48282,5,327,3177,0,85.19,5101416,778.202,20.4,3.043,4449.898,265.91,10.59,0.686,0
147,180,290,48572,7,334,3898,0,85.19,5101416,778.202,20.4,3.043,4449.898,265.91,10.59,0.686,0
147,181,621,49193,9,343,4516,0,82.41,5101416,778.202,20.4,3.043,4449.898,265.91,10.59,0.686,0
147,182,502,49695,10,353,0,0,82.41,5101416,778.202,20.4,3.043,4449.898,265.91,10.59,0.686,0
147,183,420,50115,7,360,4009,0,82.41,5101416,778.202,20.4,3.043,4449.898,265.91,10.59,0.686,0
147,184,426,50541,8,368,4066,0,82.41,5101416,778.202,20.4,3.043,4449.898,265.91,10.59,0.686,0
147,185,521,51062,8,376,3886,0,82.41,5101416,778.202,20.4,3.043,4449.898,265.91,10.59,0.686,0
147,186,545,51607,3,379,2885,0,82.41,5101416,778.202,20.4,3.043,4449.898,265.91,10.59,0.686,0
147,187,406,52013,11,390,4211,0,82.41,5101416,778.202,20.4,3.043,4449.898,265.91,10.59,0.686,0
147,188,420,52433,1,391,4157,0,82.41,5101416,778.202,20.4,3.043,4449.898,265.91,10.59,0.686,0
147,189,521,52954,11,402,4493,0,82.41,5101416,778.202,20.4,3.043,4449.898,265.91,10.59,0.686,0
147,190,475,53429,10,412,4285,0,82.41,5101416,778.202,20.4,3.043,4449.898,265.91,10.59,0.686,0
147,191,510,53939,6,418,3488,0,82.41,5101416,778.202,20.4,3.043,4449.898,265.91,10.59,0.686,0
147,192,416,54355,4,422,3892,0,82.41,5101416,778.202,20.4,3.043,4449.898,265.91,10.59,0.686,0
147,193,498,54853,9,431,2918,0,82.41,5101416,778.202,20.4,3.043,4449.898,265.91,10.59,0.686,0
147,194,281,55134,11,442,2550,0,82.41,5101416,778.202,20.4,3.043,4449.898,265.91,10.59,0.686,0
147,195,422,55556,3,445,3767,0,82.41,5101416,778.202,20.4,3.043,4449.898,265.91,10.59,0.686,0
147,196,395,55951,10,455,4002,0,82.41,5101416,778.202,20.4,3.043,4449.898,265.91,10.59,0.686,0
147,197,516,56467,4,459,4097,0,82.41,5101416,778.202,20.4,3.043,4449.898,265.91,10.59,0.686,0
147,198,532,56999,6,465,4661,0,82.41,5101416,778.202,20.4,3.043,4449.898,265.91,10.59,0.686,0
147,199,442,57441,8,473,3829,0,82.41,5101416,778.202,20.4,3.043,4449.898,265.91,10.59,0.686,0
147,200,397,57838,1,474,2954,0,82.41,5101416,778.202,20.4,3.043,4449.898,265.91,10.59,0.686,0
147,201,312,58150,0,474,3536,0,82.41,5101416,778.202,20.4,3.043,4449.898,265.91,10.59,0.686,0
147,202,389,58539,5,479,0,0,82.41,5101416,778.202,20.4,3.043,4449.898,265.91,10.59,0.686,0
147,203,543,59082,2,481,0,0,82.41,5101416,778.202,20.4,3.043,4449.898,265.91,10.59,0.686,0
147,204,513,59595,13,494,0,0,82.41,5101416,778.202,20.4,3.043,4449.898,265.91,10.59,0.686,0
148,1,106,1181,4,30,389,7333,79.63,4314768,55.133,29.7,7.918,22267.037,128.346,8.33,0.789,0
148,2,136,1317,2,32,608,7941,79.63,4314768,55.133,29.7,7.918,22267.037,128.346,8.33,0.789,0
148,3,158,1475,5,37,753,8694,90.74,4314768,55.133,29.7,7.918,22267.037,128.346,8.33,0.789,0
148,4,198,1673,4,41,562,9256,90.74,4314768,55.133,29.7,7.918,22267.037,128.346,8.33,0.789,0
148,5,128,1801,5,46,493,9749,90.74,4314768,55.133,29.7,7.918,22267.037,128.346,8.33,0.789,0
148,6,187,1988,8,54,548,10297,90.74,4314768,55.133,29.7,7.918,22267.037,128.346,8.33,0.789,0
148,7,112,2100,1,55,384,10681,90.74,4314768,55.133,29.7,7.918,22267.037,128.346,8.33,0.789,0
148,8,149,2249,4,59,1095,11776,90.74,4314768,55.133,29.7,7.918,22267.037,128.346,8.33,0.789,0
148,9,279,2528,4,63,676,12452,90.74,4314768,55.133,29.7,7.918,22267.037,128.346,8.33,0.789,0
148,10,224,2752,3,66,1046,13498,90.74,4314768,55.133,29.7,7.918,22267.037,128.346,8.33,0.789,0
148,11,222,2974,8,74,862,14360,90.74,4314768,55.133,29.7,7.918,22267.037,128.346,8.33,0.789,0
148,12,260,3234,5,79,625,14985,90.74,4314768,55.133,29.7,7.918,22267.037,128.346,8.33,0.789,0
148,13,166,3400,8,87,412,15397,90.74,4314768,55.133,29.7,7.918,22267.037,128.346,8.33,0.789,0
148,14,72,3472,7,94,486,15883,90.74,4314768,55.133,29.7,7.918,22267.037,128.346,8.33,0.789,0
148,15,102,3574,1,95,785,16668,90.74,4314768,55.133,29.7,7.918,22267.037,128.346,8.33,0.789,0
148,16,177,3751,8,103,962,17630,90.74,4314768,55.133,29.7,7.918,22267.037,128.346,8.33,0.789,0
148,17,265,4016,6,109,711,18341,90.74,4314768,55.133,29.7,7.918,22267.037,128.346,8.33,0.789,0
148,18,194,4210,7,116,497,18838,93.52,4314768,55.133,29.7,7.918,22267.037,128.346,8.33,0.789,0
148,19,63,4273,4,120,1013,19851,93.52,4314768,55.133,29.7,7.918,22267.037,128.346,8.33,0.789,0
148,20,194,4467,6,126,830,20681,93.52,4314768,55.133,29.7,7.918,22267.037,128.346,8.33,0.789,0
148,21,191,4658,10,136,871,21552,93.52,4314768,55.133,29.7,7.918,22267.037,128.346,8.33,0.789,0
148,22,163,4821,5,141,1150,22702,93.52,4314768,55.133,29.7,7.918,22267.037,128.346,8.33,0.789,0
148,23,171,4992,3,144,442,23144,93.52,4314768,55.133,29.7,7.918,22267.037,128.346,8.33,0.789,0
148,24,174,5166,2,146,759,23903,93.52,4314768,55.133,29.7,7.918,22267.037,128.346,8.33,0.789,0
148,25,172,5338,8,154,1021,24924,93.52,4314768,55.133,29.7,7.918,22267.037,128.346,8.33,0.789,0
148,26,200,5538,5,159,1199,26123,93.52,4314768,55.133,29.7,7.918,22267.037,128.346,8.33,0.789,0
148,27,241,5779,6,165,1098,27221,93.52,4314768,55.133,29.7,7.918,22267.037,128.346,8.33,0.789,0
148,28,242,6021,2,167,913,28134,93.52,4314768,55.133,29.7,7.918,22267.037,128.346,8.33,0.789,0
148,29,179,6200,9,176,1011,29145,93.52,4314768,55.133,29.7,7.918,22267.037,128.346,8.33,0.789,0
148,30,178,6378,2,178,884,30029,93.52,4314768,55.133,29.7,7.918,22267.037,128.346,8.33,0.789,0
148,31,154,6532,10,188,1048,31077,93.52,4314768,55.133,29.7,7.918,22267.037,128.346,8.33,0.789,0
148,32,188,6720,4,192,1467,32544,93.52,4314768,55.133,29.7,7.918,22267.037,128.346,8.33,0.789,0
148,33,370,7090,5,197,996,33540,93.52,4314768,55.133,29.7,7.918,22267.037,128.346,8.33,0.789,0
148,34,107,7197,3,200,992,34532,93.52,4314768,55.133,29.7,7.918,22267.037,128.346,8.33,0.789,0
148,35,190,7387,3,203,915,35447,93.52,4314768,55.133,29.7,7.918,22267.037,128.346,8.33,0.789,0
148,36,136,7523,7,210,1412,36859,93.52,4314768,55.133,29.7,7.918,22267.037,128.346,8.33,0.789,0
148,37,208,7731,8,218,1044,37903,93.52,4314768,55.133,29.7,7.918,22267.037,128.346,8.33,0.789,0
148,38,137,7868,7,225,1197,39100,93.52,4314768,55.133,29.7,7.918,22267.037,128.346,8.33,0.789,0
148,39,202,8070,6,231,1265,40365,93.52,4314768,55.133,29.7,7.918,22267.037,128.346,8.33,0.789,0
148,40,212,8282,6,237,827,41192,93.52,4314768,55.133,29.7,7.918,22267.037,128.346,8.33,0.789,0
148,41,166,8448,7,244,980,42172,93.52,4314768,55.133,29.7,7.918,22267.037,128.346,8.33,0.789,0
148,42,168,8616,5,249,2389,44561,93.52,4314768,55.133,29.7,7.918,22267.037,128.346,8.33,0.789,0
148,43,167,8783,3,252,0,44561,89.81,4314768,55.133,29.7,7.918,22267.037,128.346,8.33,0.789,0
148,44,161,8944,4,256,0,45221,89.81,4314768,55.133,29.7,7.918,22267.037,128.346,8.33,0.789,0
148,45,174,9118,4,260,868,46089,89.81,4314768,55.133,29.7,7.918,22267.037,128.346,8.33,0.789,0
148,46,150,9268,6,266,1295,47384,89.81,4314768,55.133,29.7,7.918,22267.037,128.346,8.33,0.789,0
148,47,181,9449,3,269,1215,48599,89.81,4314768,55.133,29.7,7.918,22267.037,128.346,8.33,0.789,0
148,48,157,9606,6,275,713,49312,89.81,4314768,55.133,29.7,7.918,22267.037,128.346,8.33,0.789,0
148,49,120,9726,4,279,697,50009,89.81,4314768,55.133,29.7,7.918,22267.037,128.346,8.33,0.789,0
148,50,141,9867,2,281,789,50798,89.81,4314768,55.133,29.7,7.918,22267.037,128.346,8.33,0.789,0
148,51,110,9977,6,287,1250,52048,89.81,4314768,55.133,29.7,7.918,22267.037,128.346,8.33,0.789,0
148,52,139,10116,4,291,1025,53073,89.81,4314768,55.133,29.7,7.918,22267.037,128.346,8.33,0.789,0
148,53,151,10267,4,295,1669,54742,89.81,4314768,55.133,29.7,7.918,22267.037,128.346,8.33,0.789,0
148,54,310,10577,4,299,1456,56198,89.81,4314768,55.133,29.7,7.918,22267.037,128.346,8.33,0.789,0
148,55,349,10926,7,306,1056,57254,89.81,4314768,55.133,29.7,7.918,22267.037,128.346,8.33,0.789,0
148,56,257,11183,4,310,1213,58467,89.81,4314768,55.133,29.7,7.918,22267.037,128.346,8.33,0.789,0
148,57,264,11447,3,313,1253,59720,89.81,4314768,55.133,29.7,7.918,22267.037,128.346,8.33,0.789,0
148,58,281,11728,2,315,1253,60973,89.81,4314768,55.133,29.7,7.918,22267.037,128.346,8.33,0.789,0
148,59,403,12131,5,320,1407,62380,89.81,4314768,55.133,29.7,7.918,22267.037,128.346,8.33,0.789,0
148,60,400,12531,6,326,1487,63867,89.81,4314768,55.133,29.7,7.918,22267.037,128.346,8.33,0.789,0
148,61,487,13018,4,330,1470,65337,89.81,4314768,55.133,29.7,7.918,22267.037,128.346,8.33,0.789,0
148,62,445,13463,6,336,928,66265,89.81,4314768,55.133,29.7,7.918,22267.037,128.346,8.33,0.789,0
148,63,374,13837,8,344,830,67095,89.81,4314768,55.133,29.7,7.918,22267.037,128.346,8.33,0.789,0
148,64,258,14095,8,352,1619,68714,89.81,4314768,55.133,29.7,7.918,22267.037,128.346,8.33,0.789,0
148,65,514,14609,5,357,1531,70245,89.81,4314768,55.133,29.7,7.918,22267.037,128.346,8.33,0.789,0
148,66,435,15044,6,363,1495,71740,89.81,4314768,55.133,29.7,7.918,22267.037,128.346,8.33,0.789,0
148,67,419,15463,7,370,1744,73484,91.67,4314768,55.133,29.7,7.918,22267.037,128.346,8.33,0.789,0
148,68,541,16004,16,386,1573,75057,83.33,4314768,55.133,29.7,7.918,22267.037,128.346,8.33,0.789,0
148,69,421,16425,7,393,1656,76713,83.33,4314768,55.133,29.7,7.918,22267.037,128.346,8.33,0.789,0
148,70,429,16854,5,398,1419,78132,83.33,4314768,55.133,29.7,7.918,22267.037,128.346,8.33,0.789,0
148,71,379,17233,5,403,2041,80173,83.33,4314768,55.133,29.7,7.918,22267.037,128.346,8.33,0.789,0
148,72,656,17889,10,413,2218,82391,83.33,4314768,55.133,29.7,7.918,22267.037,128.346,8.33,0.789,0
148,73,697,18586,5,418,2029,84420,83.33,4314768,55.133,29.7,7.918,22267.037,128.346,8.33,0.789,0
148,74,625,19211,3,421,2666,87086,83.33,4314768,55.133,29.7,7.918,22267.037,128.346,8.33,0.789,0
148,75,848,20059,8,429,1880,88966,83.33,4314768,55.133,29.7,7.918,22267.037,128.346,8.33,0.789,0
148,76,627,20686,8,437,1984,90950,83.33,4314768,55.133,29.7,7.918,22267.037,128.346,8.33,0.789,0
148,77,736,21422,11,448,1645,92595,83.33,4314768,55.133,29.7,7.918,22267.037,128.346,8.33,0.789,0
148,78,540,21962,9,457,2086,94681,83.33,4314768,55.133,29.7,7.918,22267.037,128.346,8.33,0.789,0
148,79,635,22597,13,470,2449,97130,83.33,4314768,55.133,29.7,7.918,22267.037,128.346,8.33,0.789,0
148,80,754,23351,5,475,2820,99950,83.33,4314768,55.133,29.7,7.918,22267.037,128.346,8.33,0.789,0
148,81,923,24274,10,485,2766,102716,83.33,4314768,55.133,29.7,7.918,22267.037,128.346,8.33,0.789,0
148,82,948,25222,8,493,2410,105126,83.33,4314768,55.133,29.7,7.918,22267.037,128.346,8.33,0.789,0
148,83,808,26030,8,501,2075,107201,83.33,4314768,55.133,29.7,7.918,22267.037,128.346,8.33,0.789,0
148,84,722,26752,20,521,1701,108902,83.33,4314768,55.133,29.7,7.918,22267.037,128.346,8.33,0.789,0
148,85,562,27314,15,536,2295,111197,83.33,4314768,55.133,29.7,7.918,22267.037,128.346,8.33,0.789,0
148,86,716,28030,11,547,3224,114421,83.33,4314768,55.133,29.7,7.918,22267.037,128.346,8.33,0.789,0
148,87,1007,29037,17,564,3029,117450,83.33,4314768,55.133,29.7,7.918,22267.037,128.346,8.33,0.789,0
148,88,868,29905,11,575,2351,119801,83.33,4314768,55.133,29.7,7.918,22267.037,128.346,8.33,0.789,0
148,89,753,30658,17,592,2908,122709,83.33,4314768,55.133,29.7,7.918,22267.037,128.346,8.33,0.789,0
148,90,1028,31686,12,604,3200,125909,83.33,4314768,55.133,29.7,7.918,22267.037,128.346,8.33,0.789,0
148,91,1099,32785,16,620,1977,127886,83.33,4314768,55.133,29.7,7.918,22267.037,128.346,8.33,0.789,0
148,92,765,33550,11,631,2670,130556,83.33,4314768,55.133,29.7,7.918,22267.037,128.346,8.33,0.789,0
148,93,913,34463,14,645,2347,132903,83.33,4314768,55.133,29.7,7.918,22267.037,128.346,8.33,0.789,0
148,94,774,35237,22,667,2261,135164,83.33,4314768,55.133,29.7,7.918,22267.037,128.346,8.33,0.789,0
148,95,758,35995,31,698,5637,140801,83.33,4314768,55.133,29.7,7.918,22267.037,128.346,8.33,0.789,0
148,96,988,36983,22,720,1166,141967,83.33,4314768,55.133,29.7,7.918,22267.037,128.346,8.33,0.789,0
148,97,1166,38149,27,747,3172,145139,83.33,4314768,55.133,29.7,7.918,22267.037,128.346,8.33,0.789,0
148,98,1185,39334,23,770,2421,147560,83.33,4314768,55.133,29.7,7.918,22267.037,128.346,8.33,0.789,0
148,99,957,40291,29,799,2584,150144,83.33,4314768,55.133,29.7,7.918,22267.037,128.346,8.33,0.789,0
148,100,960,41251,20,819,2498,152642,83.33,4314768,55.133,29.7,7.918,22267.037,128.346,8.33,0.789,0
148,101,965,42216,20,839,3022,155664,83.33,4314768,55.133,29.7,7.918,22267.037,128.346,8.33,0.789,0
148,102,1041,43257,24,863,2906,158570,83.33,4314768,55.133,29.7,7.918,22267.037,128.346,8.33,0.789,0
148,103,1075,44332,30,893,3435,162005,83.33,4314768,55.133,29.7,7.918,22267.037,128.346,8.33,0.789,0
148,104,1301,45633,16,909,3584,165589,83.33,4314768,55.133,29.7,7.918,22267.037,128.346,8.33,0.789,0
148,105,1540,47173,23,932,2575,168164,83.33,4314768,55.133,29.7,7.918,22267.037,128.346,8.33,0.789,0
148,106,923,48096,28,960,3278,171442,83.33,4314768,55.133,29.7,7.918,22267.037,128.346,8.33,0.789,0
148,107,1147,49243,22,982,3435,174877,83.33,4314768,55.133,29.7,7.918,22267.037,128.346,8.33,0.789,0
148,108,1130,50373,18,1000,2942,177819,83.33,4314768,55.133,29.7,7.918,22267.037,128.346,8.33,0.789,0
148,109,1035,51408,38,1038,2477,180296,83.33,4314768,55.133,29.7,7.918,22267.037,128.346,8.33,0.789,0
148,110,853,52261,33,1071,3770,184066,83.33,4314768,55.133,29.7,7.918,22267.037,128.346,8.33,0.789,0
148,111,1207,53468,25,1096,2920,186986,81.48,4314768,55.133,29.7,7.918,22267.037,128.346,8.33,0.789,0
148,112,958,54426,31,1127,2213,189199,81.48,4314768,55.133,29.7,7.918,22267.037,128.346,8.33,0.789,0
148,113,727,55153,32,1159,2553,191752,84.26,4314768,55.133,29.7,7.918,22267.037,128.346,8.33,0.789,0
148,114,753,55906,21,1180,3021,194773,84.26,4314768,55.133,29.7,7.918,22267.037,128.346,8.33,0.789,0
148,115,911,56817,29,1209,3472,198245,84.26,4314768,55.133,29.7,7.918,22267.037,128.346,8.33,0.789,0
148,116,1176,57993,41,1250,2690,200935,84.26,4314768,55.133,29.7,7.918,22267.037,128.346,8.33,0.789,0
148,117,871,58864,25,1275,4274,205209,84.26,4314768,55.133,29.7,7.918,22267.037,128.346,8.33,0.789,0
148,118,1432,60296,19,1294,3450,208659,80.56,4314768,55.133,29.7,7.918,22267.037,128.346,8.33,0.789,0
148,119,1146,61442,28,1322,2279,210938,80.56,4314768,55.133,29.7,7.918,22267.037,128.346,8.33,0.789,0
148,120,781,62223,27,1349,3167,214105,80.56,4314768,55.133,29.7,7.918,22267.037,128.346,8.33,0.789,0
148,121,1046,63269,25,1374,3218,217323,80.56,4314768,55.133,29.7,7.918,22267.037,128.346,8.33,0.789,0
148,122,922,64191,23,1397,3098,220421,80.56,4314768,55.133,29.7,7.918,22267.037,128.346,8.33,0.789,0
148,123,1065,65256,24,1421,3668,224089,80.56,4314768,55.133,29.7,7.918,22267.037,128.346,8.33,0.789,0
148,124,1127,66383,28,1449,3220,227309,80.56,4314768,55.133,29.7,7.918,22267.037,128.346,8.33,0.789,0
148,125,1070,67453,22,1471,2649,229958,80.56,4314768,55.133,29.7,7.918,22267.037,128.346,8.33,0.789,0
148,126,1003,68456,26,1497,2559,232517,80.56,4314768,55.133,29.7,7.918,22267.037,128.346,8.33,0.789,0
148,127,968,69424,25,1522,2557,235074,80.56,4314768,55.133,29.7,7.918,22267.037,128.346,8.33,0.789,0
148,128,807,70231,31,1553,3608,238682,80.56,4314768,55.133,29.7,7.918,22267.037,128.346,8.33,0.789,0
148,129,1187,71418,21,1574,3373,242055,80.56,4314768,55.133,29.7,7.918,22267.037,128.346,8.33,0.789,0
148,130,1142,72560,17,1591,3174,245229,80.56,4314768,55.133,29.7,7.918,22267.037,128.346,8.33,0.789,0
148,131,1091,73651,18,1609,2861,248090,80.56,4314768,55.133,29.7,7.918,22267.037,128.346,8.33,0.789,0
148,132,841,74492,30,1639,2488,250578,80.56,4314768,55.133,29.7,7.918,22267.037,128.346,8.33,0.789,0
148,133,902,75394,25,1664,3129,253707,83.33,4314768,55.133,29.7,7.918,22267.037,128.346,8.33,0.789,0
148,134,1070,76464,16,1680,2742,256449,83.33,4314768,55.133,29.7,7.918,22267.037,128.346,8.33,0.789,0
148,135,913,77377,23,1703,3134,259583,83.33,4314768,55.133,29.7,7.918,22267.037,128.346,8.33,0.789,0
148,136,1069,78446,19,1722,2692,262275,83.33,4314768,55.133,29.7,7.918,22267.037,128.346,8.33,0.789,0
148,137,956,79402,12,1734,3667,265942,83.33,4314768,55.133,29.7,7.918,22267.037,128.346,8.33,0.789,0
148,138,1263,80665,12,1746,3752,269694,83.33,4314768,55.133,29.7,7.918,22267.037,128.346,8.33,0.789,0
148,139,1275,81940,21,1767,2198,271892,83.33,4314768,55.133,29.7,7.918,22267.037,128.346,8.33,0.789,0
148,140,603,82543,21,1788,2421,274313,83.33,4314768,55.133,29.7,7.918,22267.037,128.346,8.33,0.789,0
148,141,247,82790,21,1809,5711,280024,83.33,4314768,55.133,29.7,7.918,22267.037,128.346,8.33,0.789,0
148,142,964,83754,18,1827,4321,284345,83.33,4314768,55.133,29.7,7.918,22267.037,128.346,8.33,0.789,0
148,143,101,83855,17,1844,4320,288665,81.48,4314768,55.133,29.7,7.918,22267.037,128.346,8.33,0.789,0
148,144,537,84392,15,1859,5312,293977,81.48,4314768,55.133,29.7,7.918,22267.037,128.346,8.33,0.789,0
148,145,1088,85480,19,1878,7584,301561,81.48,4314768,55.133,29.7,7.918,22267.037,128.346,8.33,0.789,0
148,146,1420,86900,14,1892,3149,304710,81.48,4314768,55.133,29.7,7.918,22267.037,128.346,8.33,0.789,0
148,147,585,87485,14,1906,4907,309617,81.48,4314768,55.133,29.7,7.918,22267.037,128.346,8.33,0.789,0
148,148,896,88381,13,1919,3612,313229,81.48,4314768,55.133,29.7,7.918,22267.037,128.346,8.33,0.789,0
148,149,701,89082,13,1932,4705,317934,81.48,4314768,55.133,29.7,7.918,22267.037,128.346,8.33,0.789,0
148,150,900,89982,16,1948,5115,323049,81.48,4314768,55.133,29.7,7.918,22267.037,128.346,8.33,0.789,0
148,151,642,90624,18,1966,4786,327835,81.48,4314768,55.133,29.7,7.918,22267.037,128.346,8.33,0.789,0
148,152,713,91337,17,1983,2914,330749,81.48,4314768,55.133,29.7,7.918,22267.037,128.346,8.33,0.789,0
148,153,728,92065,12,1995,5596,336345,81.48,4314768,55.133,29.7,7.918,22267.037,128.346,8.33,0.789,0
148,154,917,92982,7,2002,3514,339859,81.48,4314768,55.133,29.7,7.918,22267.037,128.346,8.33,0.789,0
148,155,570,93552,16,2018,3740,343599,81.48,4314768,55.133,29.7,7.918,22267.037,128.346,8.33,0.789,0
148,156,532,94084,12,2030,3522,347121,81.48,4314768,55.133,29.7,7.918,22267.037,128.346,8.33,0.789,0
148,157,830,94914,16,2046,5100,352221,81.48,4314768,55.133,29.7,7.918,22267.037,128.346,8.33,0.789,0
148,158,682,95596,17,2063,5412,357633,81.48,4314768,55.133,29.7,7.918,22267.037,128.346,8.33,0.789,0
148,159,709,96305,12,2075,4949,362582,81.48,4314768,55.133,29.7,7.918,22267.037,128.346,8.33,0.789,0
148,160,738,97043,11,2086,3290,365872,81.48,4314768,55.133,29.7,7.918,22267.037,128.346,8.33,0.789,0
148,161,535,97578,13,2099,5177,371049,81.48,4314768,55.133,29.7,7.918,22267.037,128.346,8.33,0.789,0
148,162,829,98407,8,2107,4851,375900,81.48,4314768,55.133,29.7,7.918,22267.037,128.346,8.33,0.789,0
148,163,635,99042,9,2116,5075,380975,81.48,4314768,55.133,29.7,7.918,22267.037,128.346,8.33,0.789,0
148,164,673,99715,11,2127,5007,385982,81.48,4314768,55.133,29.7,7.918,22267.037,128.346,8.33,0.789,0
148,165,615,100330,13,2140,5196,391178,81.48,4314768,55.133,29.7,7.918,22267.037,128.346,8.33,0.789,0
148,166,711,101041,15,2155,4469,395647,81.48,4314768,55.133,29.7,7.918,22267.037,128.346,8.33,0.789,0
148,167,704,101745,11,2166,2875,398522,87.04,4314768,55.133,29.7,7.918,22267.037,128.346,8.33,0.789,0
148,168,459,102204,7,2173,4740,403262,87.04,4314768,55.133,29.7,7.918,22267.037,128.346,8.33,0.789,0
148,169,628,102832,14,2187,5453,408715,87.04,4314768,55.133,29.7,7.918,22267.037,128.346,8.33,0.789,0
148,170,634,103466,11,2198,5355,414070,87.04,4314768,55.133,29.7,7.918,22267.037,128.346,8.33,0.789,0
148,171,672,104138,15,2213,5434,419504,87.04,4314768,55.133,29.7,7.918,22267.037,128.346,8.33,0.789,0
148,172,741,104879,16,2229,5788,425292,87.04,4314768,55.133,29.7,7.918,22267.037,128.346,8.33,0.789,0
148,173,722,105601,18,2247,4966,430258,87.04,4314768,55.133,29.7,7.918,22267.037,128.346,8.33,0.789,0
148,174,602,106203,10,2257,3898,434156,87.04,4314768,55.133,29.7,7.918,22267.037,128.346,8.33,0.789,0
148,175,607,106810,15,2272,4543,438699,87.04,4314768,55.133,29.7,7.918,22267.037,128.346,8.33,0.789,0
148,176,474,107284,13,2285,5520,444219,87.04,4314768,55.133,29.7,7.918,22267.037,128.346,8.33,0.789,0
148,177,706,107990,6,2291,6150,450369,87.04,4314768,55.133,29.7,7.918,22267.037,128.346,8.33,0.789,0
148,178,736,108726,6,2297,5532,455901,87.04,4314768,55.133,29.7,7.918,22267.037,128.346,8.33,0.789,0
148,179,705,109431,14,2311,5288,461189,87.04,4314768,55.133,29.7,7.918,22267.037,128.346,8.33,0.789,0
148,180,677,110108,12,2323,3584,464773,87.04,4314768,55.133,29.7,7.918,22267.037,128.346,8.33,0.789,0
148,181,447,110555,17,2340,4476,469249,87.04,4314768,55.133,29.7,7.918,22267.037,128.346,8.33,0.789,0
148,182,722,111277,8,2348,4234,473483,87.04,4314768,55.133,29.7,7.918,22267.037,128.346,8.33,0.789,0
148,183,576,111853,16,2364,5212,478695,87.04,4314768,55.133,29.7,7.918,22267.037,128.346,8.33,0.789,0
148,184,742,112595,8,2372,5803,484498,87.04,4314768,55.133,29.7,7.918,22267.037,128.346,8.33,0.789,0
148,185,747,113342,15,2387,5429,489927,87.04,4314768,55.133,29.7,7.918,22267.037,128.346,8.33,0.789,0
148,186,620,113962,19,2406,5573,495500,87.04,4314768,55.133,29.7,7.918,22267.037,128.346,8.33,0.789,0
148,187,691,114653,8,2414,5249,500749,87.04,4314768,55.133,29.7,7.918,22267.037,128.346,8.33,0.789,0
148,188,633,115286,9,2423,4143,504892,87.04,4314768,55.133,29.7,7.918,22267.037,128.346,8.33,0.789,0
148,189,633,115919,7,2430,5925,510817,87.04,4314768,55.133,29.7,7.918,22267.037,128.346,8.33,0.789,0
148,190,683,116602,10,2440,6215,517032,87.04,4314768,55.133,29.7,7.918,22267.037,128.346,8.33,0.789,0
148,191,698,117300,8,2448,5836,522868,87.04,4314768,55.133,29.7,7.918,22267.037,128.346,8.33,0.789,0
148,192,754,118054,15,2463,6728,529596,84.26,4314768,55.133,29.7,7.918,22267.037,128.346,8.33,0.789,0
148,193,787,118841,11,2474,7029,536625,84.26,4314768,55.133,29.7,7.918,22267.037,128.346,8.33,0.789,0
148,194,825,119666,8,2482,4560,541185,84.26,4314768,55.133,29.7,7.918,22267.037,128.346,8.33,0.789,0
148,195,647,120313,9,2491,4072,545257,59.26,4314768,55.133,29.7,7.918,22267.037,128.346,8.33,0.789,0
148,196,489,120802,11,2502,5135,550392,59.26,4314768,55.133,29.7,7.918,22267.037,128.346,8.33,0.789,0
148,197,494,121296,9,2511,6622,557014,59.26,4314768,55.133,29.7,7.918,22267.037,128.346,8.33,0.789,0
148,198,832,122128,8,2519,6976,563990,59.26,4314768,55.133,29.7,7.918,22267.037,128.346,8.33,0.789,0
148,199,755,122883,10,2529,6472,570462,59.26,4314768,55.133,29.7,7.918,22267.037,128.346,8.33,0.789,0
148,200,615,123498,17,2546,4188,574650,59.26,4314768,55.133,29.7,7.918,22267.037,128.346,8.33,0.789,0
148,201,609,124107,11,2557,4774,579424,59.26,4314768,55.133,29.7,7.918,22267.037,128.346,8.33,0.789,0
148,202,638,124745,7,2564,0,579424,59.26,4314768,55.133,29.7,7.918,22267.037,128.346,8.33,0.789,0
148,203,436,125181,10,2574,0,579424,59.26,4314768,55.133,29.7,7.918,22267.037,128.346,8.33,0.789,0
148,204,558,125739,11,2585,0,579424,59.26,4314768,55.133,29.7,7.918,22267.037,128.346,8.33,0.789,0
149,1,0,1,0,0,0,0,74.07,8947027,18.22,22.6,3.808,3823.194,561.494,17.65,0.544,0
149,2,0,1,0,0,0,0,74.07,8947027,18.22,22.6,3.808,3823.194,561.494,17.65,0.544,0
149,3,0,1,0,0,0,0,74.07,8947027,18.22,22.6,3.808,3823.194,561.494,17.65,0.544,0
149,4,0,1,0,0,0,0,74.07,8947027,18.22,22.6,3.808,3823.194,561.494,17.65,0.544,0
149,5,0,1,0,0,0,0,74.07,8947027,18.22,22.6,3.808,3823.194,561.494,17.65,0.544,0
149,6,0,1,0,0,0,0,74.07,8947027,18.22,22.6,3.808,3823.194,561.494,17.65,0.544,0
149,7,0,1,0,0,0,0,65.74,8947027,18.22,22.6,3.808,3823.194,561.494,17.65,0.544,0
149,8,1,2,0,0,0,0,76.85,8947027,18.22,22.6,3.808,3823.194,561.494,17.65,0.544,0
149,9,0,2,0,0,0,0,82.41,8947027,18.22,22.6,3.808,3823.194,561.494,17.65,0.544,0
149,10,0,2,0,0,0,0,82.41,8947027,18.22,22.6,3.808,3823.194,561.494,17.65,0.544,0
149,11,0,2,0,0,0,0,82.41,8947027,18.22,22.6,3.808,3823.194,561.494,17.65,0.544,0
149,12,0,2,0,0,0,0,82.41,8947027,18.22,22.6,3.808,3823.194,561.494,17.65,0.544,0
149,13,0,2,0,0,0,0,82.41,8947027,18.22,22.6,3.808,3823.194,561.494,17.65,0.544,0
149,14,0,2,0,0,0,0,76.85,8947027,18.22,22.6,3.808,3823.194,561.494,17.65,0.544,0
149,15,0,2,0,0,0,0,76.85,8947027,18.22,22.6,3.808,3823.194,561.494,17.65,0.544,0
149,16,0,2,0,0,0,0,83.8,8947027,18.22,22.6,3.808,3823.194,561.494,17.65,0.544,0
149,17,5,7,0,0,0,0,83.8,8947027,18.22,22.6,3.808,3823.194,561.494,17.65,0.544,0
149,18,0,7,0,0,0,0,83.8,8947027,18.22,22.6,3.808,3823.194,561.494,17.65,0.544,0
149,19,0,7,0,0,0,0,83.8,8947027,18.22,22.6,3.808,3823.194,561.494,17.65,0.544,0
149,20,0,7,0,0,0,0,83.8,8947027,18.22,22.6,3.808,3823.194,561.494,17.65,0.544,0
149,21,0,7,0,0,0,0,83.8,8947027,18.22,22.6,3.808,3823.194,561.494,17.65,0.544,0
149,22,0,7,0,0,0,0,83.8,8947027,18.22,22.6,3.808,3823.194,561.494,17.65,0.544,0
149,23,1,8,0,0,0,0,83.8,8947027,18.22,22.6,3.808,3823.194,561.494,17.65,0.544,0
149,24,0,8,0,0,0,0,83.8,8947027,18.22,22.6,3.808,3823.194,561.494,17.65,0.544,0
149,25,0,8,0,0,0,0,78.24,8947027,18.22,22.6,3.808,3823.194,561.494,17.65,0.544,0
149,26,0,8,0,0,0,0,78.24,8947027,18.22,22.6,3.808,3823.194,561.494,17.65,0.544,0
149,27,0,8,0,0,0,0,70.83,8947027,18.22,22.6,3.808,3823.194,561.494,17.65,0.544,0
149,28,0,8,0,0,0,0,70.83,8947027,18.22,22.6,3.808,3823.194,561.494,17.65,0.544,0
149,29,0,8,0,0,0,0,70.83,8947027,18.22,22.6,3.808,3823.194,561.494,17.65,0.544,0
149,30,0,8,0,0,0,0,70.83,8947027,18.22,22.6,3.808,3823.194,561.494,17.65,0.544,0
149,31,0,8,0,0,0,0,68.06,8947027,18.22,22.6,3.808,3823.194,561.494,17.65,0.544,0
149,32,0,8,0,0,0,0,68.06,8947027,18.22,22.6,3.808,3823.194,561.494,17.65,0.544,0
149,33,0,8,0,0,0,0,68.06,8947027,18.22,22.6,3.808,3823.194,561.494,17.65,0.544,0
149,34,0,8,0,0,0,0,60.65,8947027,18.22,22.6,3.808,3823.194,561.494,17.65,0.544,0
149,35,0,8,0,0,0,0,60.65,8947027,18.22,22.6,3.808,3823.194,561.494,17.65,0.544,0
149,36,0,8,0,0,0,0,60.65,8947027,18.22,22.6,3.808,3823.194,561.494,17.65,0.544,0
149,37,0,8,0,0,0,0,60.65,8947027,18.22,22.6,3.808,3823.194,561.494,17.65,0.544,0
149,38,0,8,0,0,0,0,60.65,8947027,18.22,22.6,3.808,3823.194,561.494,17.65,0.544,0
149,39,0,8,0,0,0,0,60.65,8947027,18.22,22.6,3.808,3823.194,561.494,17.65,0.544,0
149,40,0,8,0,0,0,0,60.65,8947027,18.22,22.6,3.808,3823.194,561.494,17.65,0.544,0
149,41,0,8,0,0,0,0,60.65,8947027,18.22,22.6,3.808,3823.194,561.494,17.65,0.544,0
149,42,0,8,0,0,0,0,60.65,8947027,18.22,22.6,3.808,3823.194,561.494,17.65,0.544,0
149,43,0,8,0,0,0,0,52.31,8947027,18.22,22.6,3.808,3823.194,561.494,17.65,0.544,0
149,44,0,8,0,0,0,0,52.31,8947027,18.22,22.6,3.808,3823.194,561.494,17.65,0.544,0
149,45,0,8,0,0,0,0,52.31,8947027,18.22,22.6,3.808,3823.194,561.494,17.65,0.544,0
149,46,0,8,0,0,0,0,52.31,8947027,18.22,22.6,3.808,3823.194,561.494,17.65,0.544,0
149,47,0,8,0,0,0,0,52.31,8947027,18.22,22.6,3.808,3823.194,561.494,17.65,0.544,0
149,48,0,8,0,0,0,0,52.31,8947027,18.22,22.6,3.808,3823.194,561.494,17.65,0.544,0
149,49,0,8,0,0,0,0,52.31,8947027,18.22,22.6,3.808,3823.194,561.494,17.65,0.544,0
149,50,0,8,0,0,0,0,52.31,8947027,18.22,22.6,3.808,3823.194,561.494,17.65,0.544,0
149,51,0,8,0,0,0,0,52.31,8947027,18.22,22.6,3.808,3823.194,561.494,17.65,0.544,0
149,52,0,8,0,0,0,0,52.31,8947027,18.22,22.6,3.808,3823.194,561.494,17.65,0.544,0
149,53,0,8,0,0,0,0,52.31,8947027,18.22,22.6,3.808,3823.194,561.494,17.65,0.544,0
149,54,0,8,0,0,0,0,52.31,8947027,18.22,22.6,3.808,3823.194,561.494,17.65,0.544,0
149,55,0,8,0,0,0,0,52.31,8947027,18.22,22.6,3.808,3823.194,561.494,17.65,0.544,0
149,56,0,8,0,0,0,0,52.31,8947027,18.22,22.6,3.808,3823.194,561.494,17.65,0.544,0
149,57,0,8,0,0,0,0,52.31,8947027,18.22,22.6,3.808,3823.194,561.494,17.65,0.544,0
149,58,0,8,0,0,0,0,52.31,8947027,18.22,22.6,3.808,3823.194,561.494,17.65,0.544,0
149,59,0,8,0,0,0,0,52.31,8947027,18.22,22.6,3.808,3823.194,561.494,17.65,0.544,0
149,60,0,8,0,0,0,0,52.31,8947027,18.22,22.6,3.808,3823.194,561.494,17.65,0.544,0
149,61,0,8,0,0,0,0,52.31,8947027,18.22,22.6,3.808,3823.194,561.494,17.65,0.544,0
149,62,0,8,0,0,0,0,52.31,8947027,18.22,22.6,3.808,3823.194,561.494,17.65,0.544,0
149,63,0,8,0,0,0,0,52.31,8947027,18.22,22.6,3.808,3823.194,561.494,17.65,0.544,0
149,64,0,8,0,0,0,0,52.31,8947027,18.22,22.6,3.808,3823.194,561.494,17.65,0.544,0
149,65,0,8,0,0,0,0,52.31,8947027,18.22,22.6,3.808,3823.194,561.494,17.65,0.544,0
149,66,0,8,0,0,0,0,52.31,8947027,18.22,22.6,3.808,3823.194,561.494,17.65,0.544,0
149,67,0,8,0,0,0,0,52.31,8947027,18.22,22.6,3.808,3823.194,561.494,17.65,0.544,0
149,68,0,8,0,0,0,0,52.31,8947027,18.22,22.6,3.808,3823.194,561.494,17.65,0.544,0
149,69,0,8,0,0,0,0,52.31,8947027,18.22,22.6,3.808,3823.194,561.494,17.65,0.544,0
149,70,0,8,0,0,0,0,52.31,8947027,18.22,22.6,3.808,3823.194,561.494,17.65,0.544,0
149,71,0,8,0,0,0,0,52.31,8947027,18.22,22.6,3.808,3823.194,561.494,17.65,0.544,0
149,72,0,8,0,0,0,0,52.31,8947027,18.22,22.6,3.808,3823.194,561.494,17.65,0.544,0
149,73,0,8,0,0,0,0,52.31,8947027,18.22,22.6,3.808,3823.194,561.494,17.65,0.544,0
149,74,0,8,0,0,0,0,52.31,8947027,18.22,22.6,3.808,3823.194,561.494,17.65,0.544,0
149,75,0,8,0,0,0,0,52.31,8947027,18.22,22.6,3.808,3823.194,561.494,17.65,0.544,0
149,76,0,8,0,0,0,0,52.31,8947027,18.22,22.6,3.808,3823.194,561.494,17.65,0.544,0
149,77,0,8,0,0,0,0,52.31,8947027,18.22,22.6,3.808,3823.194,561.494,17.65,0.544,0
149,78,0,8,0,0,0,0,52.31,8947027,18.22,22.6,3.808,3823.194,561.494,17.65,0.544,0
149,79,0,8,0,0,0,0,52.31,8947027,18.22,22.6,3.808,3823.194,561.494,17.65,0.544,0
149,80,0,8,0,0,0,0,52.31,8947027,18.22,22.6,3.808,3823.194,561.494,17.65,0.544,0
149,81,0,8,0,0,0,0,52.31,8947027,18.22,22.6,3.808,3823.194,561.494,17.65,0.544,0
149,82,0,8,0,0,0,0,52.31,8947027,18.22,22.6,3.808,3823.194,561.494,17.65,0.544,0
149,83,1,9,0,0,0,0,52.31,8947027,18.22,22.6,3.808,3823.194,561.494,17.65,0.544,0
149,84,0,9,0,0,0,0,45.37,8947027,18.22,22.6,3.808,3823.194,561.494,17.65,0.544,0
149,85,0,9,0,0,0,0,45.37,8947027,18.22,22.6,3.808,3823.194,561.494,17.65,0.544,0
149,86,1,10,0,0,0,0,45.37,8947027,18.22,22.6,3.808,3823.194,561.494,17.65,0.544,0
149,87,1,11,0,0,0,0,45.37,8947027,18.22,22.6,3.808,3823.194,561.494,17.65,0.544,0
149,88,0,11,0,0,0,0,45.37,8947027,18.22,22.6,3.808,3823.194,561.494,17.65,0.544,0
149,89,0,11,0,0,0,0,45.37,8947027,18.22,22.6,3.808,3823.194,561.494,17.65,0.544,0
149,90,0,11,0,0,0,0,45.37,8947027,18.22,22.6,3.808,3823.194,561.494,17.65,0.544,0
149,91,0,11,0,0,0,0,45.37,8947027,18.22,22.6,3.808,3823.194,561.494,17.65,0.544,0
149,92,0,11,0,0,0,0,45.37,8947027,18.22,22.6,3.808,3823.194,561.494,17.65,0.544,0
149,93,0,11,0,0,0,0,45.37,8947027,18.22,22.6,3.808,3823.194,561.494,17.65,0.544,0
149,94,0,11,0,0,0,0,45.37,8947027,18.22,22.6,3.808,3823.194,561.494,17.65,0.544,0
149,95,0,11,0,0,0,0,45.37,8947027,18.22,22.6,3.808,3823.194,561.494,17.65,0.544,0
149,96,0,11,0,0,0,0,45.37,8947027,18.22,22.6,3.808,3823.194,561.494,17.65,0.544,0
149,97,0,11,0,0,0,0,45.37,8947027,18.22,22.6,3.808,3823.194,561.494,17.65,0.544,0
149,98,0,11,0,0,0,0,45.37,8947027,18.22,22.6,3.808,3823.194,561.494,17.65,0.544,0
149,99,0,11,0,0,0,0,45.37,8947027,18.22,22.6,3.808,3823.194,561.494,17.65,0.544,0
149,100,0,11,0,0,0,0,45.37,8947027,18.22,22.6,3.808,3823.194,561.494,17.65,0.544,0
149,101,0,11,0,0,0,0,45.37,8947027,18.22,22.6,3.808,3823.194,561.494,17.65,0.544,0
149,102,0,11,0,0,0,0,45.37,8947027,18.22,22.6,3.808,3823.194,561.494,17.65,0.544,0
149,103,0,11,0,0,0,0,45.37,8947027,18.22,22.6,3.808,3823.194,561.494,17.65,0.544,0
149,104,0,11,0,0,0,0,45.37,8947027,18.22,22.6,3.808,3823.194,561.494,17.65,0.544,0
149,105,0,11,0,0,0,0,45.37,8947027,18.22,22.6,3.808,3823.194,561.494,17.65,0.544,0
149,106,0,11,0,0,0,0,45.37,8947027,18.22,22.6,3.808,3823.194,561.494,17.65,0.544,0
149,107,0,11,0,0,0,0,45.37,8947027,18.22,22.6,3.808,3823.194,561.494,17.65,0.544,0
149,108,0,11,0,0,0,0,45.37,8947027,18.22,22.6,3.808,3823.194,561.494,17.65,0.544,0
149,109,4,15,0,0,0,0,45.37,8947027,18.22,22.6,3.808,3823.194,561.494,17.65,0.544,0
149,110,0,15,0,0,0,0,45.37,8947027,18.22,22.6,3.808,3823.194,561.494,17.65,0.544,0
149,111,2,17,0,0,0,0,45.37,8947027,18.22,22.6,3.808,3823.194,561.494,17.65,0.544,0
149,112,2,19,0,0,0,0,45.37,8947027,18.22,22.6,3.808,3823.194,561.494,17.65,0.544,0
149,113,8,27,0,0,0,0,45.37,8947027,18.22,22.6,3.808,3823.194,561.494,17.65,0.544,0
149,114,3,30,0,0,0,0,45.37,8947027,18.22,22.6,3.808,3823.194,561.494,17.65,0.544,0
149,115,1,31,0,0,0,0,45.37,8947027,18.22,22.6,3.808,3823.194,561.494,17.65,0.544,0
149,116,1,32,0,0,0,0,45.37,8947027,18.22,22.6,3.808,3823.194,561.494,17.65,0.544,0
149,117,7,39,0,0,0,0,45.37,8947027,18.22,22.6,3.808,3823.194,561.494,17.65,0.544,0
149,118,23,62,0,0,0,0,45.37,8947027,18.22,22.6,3.808,3823.194,561.494,17.65,0.544,0
149,119,0,62,0,0,0,0,45.37,8947027,18.22,22.6,3.808,3823.194,561.494,17.65,0.544,0
149,120,1,63,1,1,0,0,45.37,8947027,18.22,22.6,3.808,3823.194,561.494,17.65,0.544,0
149,121,0,63,1,2,0,0,45.37,8947027,18.22,22.6,3.808,3823.194,561.494,17.65,0.544,0
149,122,9,72,0,2,0,0,45.37,8947027,18.22,22.6,3.808,3823.194,561.494,17.65,0.544,0
149,123,0,72,0,2,0,0,45.37,8947027,18.22,22.6,3.808,3823.194,561.494,17.65,0.544,0
149,124,19,91,0,2,0,0,45.37,8947027,18.22,22.6,3.808,3823.194,561.494,17.65,0.544,0
149,125,19,110,0,2,0,0,45.37,8947027,18.22,22.6,3.808,3823.194,561.494,17.65,0.544,0
149,126,1,111,0,2,0,0,52.78,8947027,18.22,22.6,3.808,3823.194,561.494,17.65,0.544,0
149,127,3,114,0,2,0,0,52.78,8947027,18.22,22.6,3.808,3823.194,561.494,17.65,0.544,0
149,128,39,153,0,2,0,0,52.78,8947027,18.22,22.6,3.808,3823.194,561.494,17.65,0.544,0
149,129,10,163,1,3,0,0,80.56,8947027,18.22,22.6,3.808,3823.194,561.494,17.65,0.544,0
149,130,25,188,0,3,0,0,80.56,8947027,18.22,22.6,3.808,3823.194,561.494,17.65,0.544,0
149,131,0,188,0,3,0,0,80.56,8947027,18.22,22.6,3.808,3823.194,561.494,17.65,0.544,0
149,132,26,214,0,3,0,0,80.56,8947027,18.22,22.6,3.808,3823.194,561.494,17.65,0.544,0
149,133,0,214,0,3,0,0,80.56,8947027,18.22,22.6,3.808,3823.194,561.494,17.65,0.544,0
149,134,0,214,0,3,0,0,52.78,8947027,18.22,22.6,3.808,3823.194,561.494,17.65,0.544,0
149,135,55,269,0,3,0,0,55.56,8947027,18.22,22.6,3.808,3823.194,561.494,17.65,0.544,0
149,136,2,271,0,3,0,0,55.56,8947027,18.22,22.6,3.808,3823.194,561.494,17.65,0.544,0
149,137,0,271,0,3,0,0,55.56,8947027,18.22,22.6,3.808,3823.194,561.494,17.65,0.544,0
149,138,0,271,0,3,0,0,55.56,8947027,18.22,22.6,3.808,3823.194,561.494,17.65,0.544,0
149,139,52,323,0,3,0,0,43.52,8947027,18.22,22.6,3.808,3823.194,561.494,17.65,0.544,0
149,140,10,333,0,3,0,0,43.52,8947027,18.22,22.6,3.808,3823.194,561.494,17.65,0.544,0
149,141,14,347,0,3,0,0,43.52,8947027,18.22,22.6,3.808,3823.194,561.494,17.65,0.544,0
149,142,12,359,0,3,0,0,43.52,8947027,18.22,22.6,3.808,3823.194,561.494,17.65,0.544,0
149,143,2,361,1,4,0,0,43.52,8947027,18.22,22.6,3.808,3823.194,561.494,17.65,0.544,0
149,144,0,361,0,4,0,0,43.52,8947027,18.22,22.6,3.808,3823.194,561.494,17.65,0.544,0
149,145,0,361,0,4,0,0,43.52,8947027,18.22,22.6,3.808,3823.194,561.494,17.65,0.544,0
149,146,40,401,0,4,0,0,43.52,8947027,18.22,22.6,3.808,3823.194,561.494,17.65,0.544,0
149,147,0,401,0,4,0,0,43.52,8947027,18.22,22.6,3.808,3823.194,561.494,17.65,0.544,0
149,148,18,419,0,4,0,0,43.52,8947027,18.22,22.6,3.808,3823.194,561.494,17.65,0.544,0
149,149,0,419,0,4,0,0,43.52,8947027,18.22,22.6,3.808,3823.194,561.494,17.65,0.544,0
149,150,5,424,0,4,0,0,43.52,8947027,18.22,22.6,3.808,3823.194,561.494,17.65,0.544,0
149,151,29,453,1,5,0,0,43.52,8947027,18.22,22.6,3.808,3823.194,561.494,17.65,0.544,0
149,152,6,459,0,5,0,0,43.52,8947027,18.22,22.6,3.808,3823.194,561.494,17.65,0.544,0
149,153,0,459,0,5,0,0,43.52,8947027,18.22,22.6,3.808,3823.194,561.494,17.65,0.544,0
149,154,0,459,0,5,0,0,43.52,8947027,18.22,22.6,3.808,3823.194,561.494,17.65,0.544,0
149,155,1,460,0,5,0,0,43.52,8947027,18.22,22.6,3.808,3823.194,561.494,17.65,0.544,0
149,156,11,471,0,5,0,0,43.52,8947027,18.22,22.6,3.808,3823.194,561.494,17.65,0.544,0
149,157,0,471,0,5,0,0,43.52,8947027,18.22,22.6,3.808,3823.194,561.494,17.65,0.544,0
149,158,0,471,0,5,0,0,43.52,8947027,18.22,22.6,3.808,3823.194,561.494,17.65,0.544,0
149,159,17,488,0,5,0,0,43.52,8947027,18.22,22.6,3.808,3823.194,561.494,17.65,0.544,0
149,160,9,497,0,5,0,0,43.52,8947027,18.22,22.6,3.808,3823.194,561.494,17.65,0.544,0
149,161,0,497,0,5,0,0,43.52,8947027,18.22,22.6,3.808,3823.194,561.494,17.65,0.544,0
149,162,6,503,0,5,0,0,43.52,8947027,18.22,22.6,3.808,3823.194,561.494,17.65,0.544,0
149,163,1,504,0,5,0,0,43.52,8947027,18.22,22.6,3.808,3823.194,561.494,17.65,0.544,0
149,164,3,507,0,5,0,0,43.52,8947027,18.22,22.6,3.808,3823.194,561.494,17.65,0.544,0
149,165,0,507,0,5,0,0,43.52,8947027,18.22,22.6,3.808,3823.194,561.494,17.65,0.544,0
149,166,3,510,1,6,0,0,43.52,8947027,18.22,22.6,3.808,3823.194,561.494,17.65,0.544,0
149,167,1,511,0,6,0,0,43.52,8947027,18.22,22.6,3.808,3823.194,561.494,17.65,0.544,0
149,168,0,511,0,6,0,0,43.52,8947027,18.22,22.6,3.808,3823.194,561.494,17.65,0.544,0
149,169,0,511,0,6,0,0,43.52,8947027,18.22,22.6,3.808,3823.194,561.494,17.65,0.544,0
149,170,5,516,0,6,0,0,43.52,8947027,18.22,22.6,3.808,3823.194,561.494,17.65,0.544,0
149,171,0,516,0,6,0,0,43.52,8947027,18.22,22.6,3.808,3823.194,561.494,17.65,0.544,0
149,172,0,516,0,6,0,0,43.52,8947027,18.22,22.6,3.808,3823.194,561.494,17.65,0.544,0
149,173,0,516,0,6,0,0,43.52,8947027,18.22,22.6,3.808,3823.194,561.494,17.65,0.544,0
149,174,1,517,1,7,0,0,43.52,8947027,18.22,22.6,3.808,3823.194,561.494,17.65,0.544,0
149,175,9,526,0,7,0,0,43.52,8947027,18.22,22.6,3.808,3823.194,561.494,17.65,0.544,0
149,176,1,527,0,7,0,0,43.52,8947027,18.22,22.6,3.808,3823.194,561.494,17.65,0.544,0
149,177,4,531,0,7,0,0,43.52,8947027,18.22,22.6,3.808,3823.194,561.494,17.65,0.544,0
149,178,0,531,0,7,0,0,25,8947027,18.22,22.6,3.808,3823.194,561.494,17.65,0.544,0
149,179,1,532,0,7,0,0,25,8947027,18.22,22.6,3.808,3823.194,561.494,17.65,0.544,0
149,180,0,532,0,7,0,0,25,8947027,18.22,22.6,3.808,3823.194,561.494,17.65,0.544,0
149,181,0,532,0,7,0,0,25,8947027,18.22,22.6,3.808,3823.194,561.494,17.65,0.544,0
149,182,0,532,0,7,0,0,25,8947027,18.22,22.6,3.808,3823.194,561.494,17.65,0.544,0
149,183,2,534,0,7,0,0,25,8947027,18.22,22.6,3.808,3823.194,561.494,17.65,0.544,0
149,184,0,534,0,7,0,0,25,8947027,18.22,22.6,3.808,3823.194,561.494,17.65,0.544,0
149,185,5,539,0,7,0,0,25,8947027,18.22,22.6,3.808,3823.194,561.494,17.65,0.544,0
149,186,0,539,0,7,0,0,25,8947027,18.22,22.6,3.808,3823.194,561.494,17.65,0.544,0
149,187,1,540,0,7,0,0,25,8947027,18.22,22.6,3.808,3823.194,561.494,17.65,0.544,0
149,188,0,540,0,7,0,0,25,8947027,18.22,22.6,3.808,3823.194,561.494,17.65,0.544,0
149,189,1,541,0,7,0,0,25,8947027,18.22,22.6,3.808,3823.194,561.494,17.65,0.544,0
149,190,0,541,0,7,0,0,25,8947027,18.22,22.6,3.808,3823.194,561.494,17.65,0.544,0
149,191,0,541,0,7,0,0,25,8947027,18.22,22.6,3.808,3823.194,561.494,17.65,0.544,0
149,192,8,549,0,7,0,0,25,8947027,18.22,22.6,3.808,3823.194,561.494,17.65,0.544,0
149,193,0,549,0,7,0,0,25,8947027,18.22,22.6,3.808,3823.194,561.494,17.65,0.544,0
149,194,0,549,0,7,0,0,25,8947027,18.22,22.6,3.808,3823.194,561.494,17.65,0.544,0
149,195,5,554,0,7,0,0,25,8947027,18.22,22.6,3.808,3823.194,561.494,17.65,0.544,0
149,196,11,565,0,7,0,0,25,8947027,18.22,22.6,3.808,3823.194,561.494,17.65,0.544,0
149,197,10,575,0,7,0,0,25,8947027,18.22,22.6,3.808,3823.194,561.494,17.65,0.544,0
149,198,3,578,0,7,0,0,25,8947027,18.22,22.6,3.808,3823.194,561.494,17.65,0.544,0
149,199,0,578,0,7,0,0,25,8947027,18.22,22.6,3.808,3823.194,561.494,17.65,0.544,0
149,200,0,578,0,7,0,0,25,8947027,18.22,22.6,3.808,3823.194,561.494,17.65,0.544,0
149,201,3,581,0,7,0,0,25,8947027,18.22,22.6,3.808,3823.194,561.494,17.65,0.544,0
149,202,0,581,0,7,0,0,25,8947027,18.22,22.6,3.808,3823.194,561.494,17.65,0.544,0
149,203,0,581,0,7,0,0,25,8947027,18.22,22.6,3.808,3823.194,561.494,17.65,0.544,0
149,204,0,581,0,7,0,0,25,8947027,18.22,22.6,3.808,3823.194,561.494,17.65,0.544,0
150,1,4,69,0,3,95,1173,93.52,7132530,17.144,26.5,6.378,8827.01,199.128,8.27,0.702,0
150,2,0,69,0,3,116,1289,93.52,7132530,17.144,26.5,6.378,8827.01,199.128,8.27,0.702,0
150,3,8,77,0,3,165,1454,93.52,7132530,17.144,26.5,6.378,8827.01,199.128,8.27,0.702,0
150,4,19,96,0,3,192,1646,93.52,7132530,17.144,26.5,6.378,8827.01,199.128,8.27,0.702,0
150,5,8,104,0,3,200,1846,93.52,7132530,17.144,26.5,6.378,8827.01,199.128,8.27,0.702,0
150,6,9,113,2,5,162,2008,93.52,7132530,17.144,26.5,6.378,8827.01,199.128,8.27,0.702,0
150,7,0,113,0,5,212,2220,93.52,7132530,17.144,26.5,6.378,8827.01,199.128,8.27,0.702,0
150,8,2,115,0,5,242,2462,93.52,7132530,17.144,26.5,6.378,8827.01,199.128,8.27,0.702,0
150,9,9,124,0,5,223,2685,94.44,7132530,17.144,26.5,6.378,8827.01,199.128,8.27,0.702,0
150,10,5,129,1,6,220,2905,94.44,7132530,17.144,26.5,6.378,8827.01,199.128,8.27,0.702,0
150,11,4,133,0,6,230,3135,94.44,7132530,17.144,26.5,6.378,8827.01,199.128,8.27,0.702,0
150,12,1,134,0,6,259,3394,94.44,7132530,17.144,26.5,6.378,8827.01,199.128,8.27,0.702,0
150,13,13,147,0,6,248,3642,94.44,7132530,17.144,26.5,6.378,8827.01,199.128,8.27,0.702,0
150,14,12,159,1,7,246,3888,94.44,7132530,17.144,26.5,6.378,8827.01,199.128,8.27,0.702,0
150,15,2,161,1,8,379,4267,94.44,7132530,17.144,26.5,6.378,8827.01,199.128,8.27,0.702,0
150,16,13,174,0,8,345,4612,94.44,7132530,17.144,26.5,6.378,8827.01,199.128,8.27,0.702,0
150,17,0,174,0,8,338,4950,94.44,7132530,17.144,26.5,6.378,8827.01,199.128,8.27,0.702,0
150,18,28,202,0,8,304,5254,94.44,7132530,17.144,26.5,6.378,8827.01,199.128,8.27,0.702,0
150,19,0,202,0,8,247,5501,94.44,7132530,17.144,26.5,6.378,8827.01,199.128,8.27,0.702,0
150,20,4,206,0,8,377,5878,94.44,7132530,17.144,26.5,6.378,8827.01,199.128,8.27,0.702,0
150,21,2,208,0,8,414,6292,94.44,7132530,17.144,26.5,6.378,8827.01,199.128,8.27,0.702,0
150,22,5,213,1,9,306,6598,94.44,7132530,17.144,26.5,6.378,8827.01,199.128,8.27,0.702,0
150,23,0,213,0,9,319,6917,94.44,7132530,17.144,26.5,6.378,8827.01,199.128,8.27,0.702,0
150,24,7,220,0,9,405,7322,94.44,7132530,17.144,26.5,6.378,8827.01,199.128,8.27,0.702,0
150,25,3,223,0,9,308,7630,94.44,7132530,17.144,26.5,6.378,8827.01,199.128,8.27,0.702,0
150,26,5,228,0,9,295,7925,94.44,7132530,17.144,26.5,6.378,8827.01,199.128,8.27,0.702,0
150,27,0,228,0,9,519,8444,94.44,7132530,17.144,26.5,6.378,8827.01,199.128,8.27,0.702,0
150,28,2,230,0,9,447,8891,94.44,7132530,17.144,26.5,6.378,8827.01,199.128,8.27,0.702,0
150,29,9,239,0,9,563,9454,94.44,7132530,17.144,26.5,6.378,8827.01,199.128,8.27,0.702,0
150,30,10,249,0,9,449,9903,94.44,7132530,17.144,26.5,6.378,8827.01,199.128,8.27,0.702,0
150,31,17,266,1,10,439,10342,94.44,7132530,17.144,26.5,6.378,8827.01,199.128,8.27,0.702,0
150,32,67,333,0,10,424,10766,94.44,7132530,17.144,26.5,6.378,8827.01,199.128,8.27,0.702,0
150,33,37,370,0,10,340,11106,94.44,7132530,17.144,26.5,6.378,8827.01,199.128,8.27,0.702,0
150,34,26,396,0,10,349,11455,94.44,7132530,17.144,26.5,6.378,8827.01,199.128,8.27,0.702,0
150,35,19,415,0,10,458,11913,94.44,7132530,17.144,26.5,6.378,8827.01,199.128,8.27,0.702,0
150,36,16,431,0,10,584,12497,94.44,7132530,17.144,26.5,6.378,8827.01,199.128,8.27,0.702,0
150,37,9,440,0,10,599,13096,94.44,7132530,17.144,26.5,6.378,8827.01,199.128,8.27,0.702,0
150,38,22,462,0,10,750,13846,94.44,7132530,17.144,26.5,6.378,8827.01,199.128,8.27,0.702,0
150,39,101,563,0,10,800,14646,94.44,7132530,17.144,26.5,6.378,8827.01,199.128,8.27,0.702,0
150,40,126,689,0,10,800,15446,94.44,7132530,17.144,26.5,6.378,8827.01,199.128,8.27,0.702,0
150,41,24,713,0,10,709,16155,94.44,7132530,17.144,26.5,6.378,8827.01,199.128,8.27,0.702,0
150,42,11,724,0,10,762,16917,94.44,7132530,17.144,26.5,6.378,8827.01,199.128,8.27,0.702,0
150,43,13,737,0,10,672,17589,94.44,7132530,17.144,26.5,6.378,8827.01,199.128,8.27,0.702,0
150,44,3,740,1,11,595,18184,94.44,7132530,17.144,26.5,6.378,8827.01,199.128,8.27,0.702,0
150,45,14,754,0,11,672,18856,94.44,7132530,17.144,26.5,6.378,8827.01,199.128,8.27,0.702,0
150,46,5,759,0,11,452,19308,94.44,7132530,17.144,26.5,6.378,8827.01,199.128,8.27,0.702,0
150,47,19,778,0,11,816,20124,94.44,7132530,17.144,26.5,6.378,8827.01,199.128,8.27,0.702,0
150,48,8,786,0,11,305,20429,94.44,7132530,17.144,26.5,6.378,8827.01,199.128,8.27,0.702,0
150,49,2,788,0,11,692,21121,94.44,7132530,17.144,26.5,6.378,8827.01,199.128,8.27,0.702,0
150,50,41,829,0,11,421,21542,94.44,7132530,17.144,26.5,6.378,8827.01,199.128,8.27,0.702,0
150,51,4,833,0,11,445,21987,94.44,7132530,17.144,26.5,6.378,8827.01,199.128,8.27,0.702,0
150,52,3,836,0,11,881,22868,94.44,7132530,17.144,26.5,6.378,8827.01,199.128,8.27,0.702,0
150,53,2,838,0,11,937,23805,94.44,7132530,17.144,26.5,6.378,8827.01,199.128,8.27,0.702,0
150,54,12,850,0,11,1007,24812,94.44,7132530,17.144,26.5,6.378,8827.01,199.128,8.27,0.702,0
150,55,12,862,0,11,404,25216,81.48,7132530,17.144,26.5,6.378,8827.01,199.128,8.27,0.702,0
150,56,3,865,0,11,953,26169,81.48,7132530,17.144,26.5,6.378,8827.01,199.128,8.27,0.702,0
150,57,12,877,0,11,591,26760,81.48,7132530,17.144,26.5,6.378,8827.01,199.128,8.27,0.702,0
150,58,7,884,0,11,665,27425,81.48,7132530,17.144,26.5,6.378,8827.01,199.128,8.27,0.702,0
150,59,16,900,0,11,912,28337,81.48,7132530,17.144,26.5,6.378,8827.01,199.128,8.27,0.702,0
150,60,17,917,0,11,816,29153,81.48,7132530,17.144,26.5,6.378,8827.01,199.128,8.27,0.702,0
150,61,47,964,0,11,851,30004,81.48,7132530,17.144,26.5,6.378,8827.01,199.128,8.27,0.702,0
150,62,22,986,0,11,830,30834,81.48,7132530,17.144,26.5,6.378,8827.01,199.128,8.27,0.702,0
150,63,9,995,0,11,1272,32106,81.48,7132530,17.144,26.5,6.378,8827.01,199.128,8.27,0.702,0
150,64,18,1013,0,11,975,33081,81.48,7132530,17.144,26.5,6.378,8827.01,199.128,8.27,0.702,0
150,65,57,1070,0,11,1159,34240,81.48,7132530,17.144,26.5,6.378,8827.01,199.128,8.27,0.702,0
150,66,16,1086,0,11,1018,35258,81.48,7132530,17.144,26.5,6.378,8827.01,199.128,8.27,0.702,0
150,67,1,1087,0,11,1115,36373,81.48,7132530,17.144,26.5,6.378,8827.01,199.128,8.27,0.702,0
150,68,3,1090,0,11,1159,37532,81.48,7132530,17.144,26.5,6.378,8827.01,199.128,8.27,0.702,0
150,69,45,1135,0,11,1410,38942,81.48,7132530,17.144,26.5,6.378,8827.01,199.128,8.27,0.702,0
150,70,10,1145,0,11,1090,40032,81.48,7132530,17.144,26.5,6.378,8827.01,199.128,8.27,0.702,0
150,71,42,1187,0,11,1670,41702,83.33,7132530,17.144,26.5,6.378,8827.01,199.128,8.27,0.702,0
150,72,15,1202,0,11,1590,43292,83.33,7132530,17.144,26.5,6.378,8827.01,199.128,8.27,0.702,0
150,73,28,1230,0,11,1840,45132,83.33,7132530,17.144,26.5,6.378,8827.01,199.128,8.27,0.702,0
150,74,24,1254,0,11,1476,46608,83.33,7132530,17.144,26.5,6.378,8827.01,199.128,8.27,0.702,0
150,75,7,1261,0,11,1473,48081,83.33,7132530,17.144,26.5,6.378,8827.01,199.128,8.27,0.702,0
150,76,28,1289,0,11,648,48729,83.33,7132530,17.144,26.5,6.378,8827.01,199.128,8.27,0.702,0
150,77,0,1289,1,12,1249,49978,83.33,7132530,17.144,26.5,6.378,8827.01,199.128,8.27,0.702,0
150,78,14,1303,1,13,1200,51178,83.33,7132530,17.144,26.5,6.378,8827.01,199.128,8.27,0.702,0
150,79,5,1308,0,13,1471,52649,83.33,7132530,17.144,26.5,6.378,8827.01,199.128,8.27,0.702,0
150,80,22,1330,0,13,1629,54278,83.33,7132530,17.144,26.5,6.378,8827.01,199.128,8.27,0.702,0
150,81,6,1336,0,13,1549,55827,83.33,7132530,17.144,26.5,6.378,8827.01,199.128,8.27,0.702,0
150,82,26,1362,0,13,1165,56992,83.33,7132530,17.144,26.5,6.378,8827.01,199.128,8.27,0.702,0
150,83,17,1379,0,13,903,57895,83.33,7132530,17.144,26.5,6.378,8827.01,199.128,8.27,0.702,0
150,84,13,1392,0,13,1559,59454,83.33,7132530,17.144,26.5,6.378,8827.01,199.128,8.27,0.702,0
150,85,30,1422,0,13,1357,60811,83.33,7132530,17.144,26.5,6.378,8827.01,199.128,8.27,0.702,0
150,86,106,1528,0,13,1573,62384,81.48,7132530,17.144,26.5,6.378,8827.01,199.128,8.27,0.702,0
150,87,41,1569,0,13,1590,63974,81.48,7132530,17.144,26.5,6.378,8827.01,199.128,8.27,0.702,0
150,88,142,1711,0,13,1631,65605,81.48,7132530,17.144,26.5,6.378,8827.01,199.128,8.27,0.702,0
150,89,231,1942,2,15,1361,66966,81.48,7132530,17.144,26.5,6.378,8827.01,199.128,8.27,0.702,0
150,90,185,2127,0,15,1061,68027,81.48,7132530,17.144,26.5,6.378,8827.01,199.128,8.27,0.702,0
150,91,64,2191,1,16,1316,69343,81.48,7132530,17.144,26.5,6.378,8827.01,199.128,8.27,0.702,0
150,92,30,2221,1,17,1347,70690,81.48,7132530,17.144,26.5,6.378,8827.01,199.128,8.27,0.702,0
150,93,39,2260,2,19,1629,72319,81.48,7132530,17.144,26.5,6.378,8827.01,199.128,8.27,0.702,0
150,94,43,2303,0,19,1769,74088,81.48,7132530,17.144,26.5,6.378,8827.01,199.128,8.27,0.702,0
150,95,46,2349,0,19,1989,76077,81.48,7132530,17.144,26.5,6.378,8827.01,199.128,8.27,0.702,0
150,96,36,2385,1,20,1802,77879,75.93,7132530,17.144,26.5,6.378,8827.01,199.128,8.27,0.702,0
150,97,42,2427,0,20,1486,79365,75.93,7132530,17.144,26.5,6.378,8827.01,199.128,8.27,0.702,0
150,98,29,2456,0,20,2076,81441,75.93,7132530,17.144,26.5,6.378,8827.01,199.128,8.27,0.702,0
150,99,46,2502,0,20,1533,82974,75.93,7132530,17.144,26.5,6.378,8827.01,199.128,8.27,0.702,0
150,100,52,2554,0,20,2017,84991,75.93,7132530,17.144,26.5,6.378,8827.01,199.128,8.27,0.702,0
150,101,84,2638,0,20,2212,87203,75.93,7132530,17.144,26.5,6.378,8827.01,199.128,8.27,0.702,0
150,102,98,2736,0,20,2141,89344,75.93,7132530,17.144,26.5,6.378,8827.01,199.128,8.27,0.702,0
150,103,84,2820,1,21,1937,91281,75.93,7132530,17.144,26.5,6.378,8827.01,199.128,8.27,0.702,0
150,104,128,2948,1,22,1161,92442,75.93,7132530,17.144,26.5,6.378,8827.01,199.128,8.27,0.702,0
150,105,32,2980,3,25,1886,94328,75.93,7132530,17.144,26.5,6.378,8827.01,199.128,8.27,0.702,0
150,106,94,3074,0,25,1732,96060,75.93,7132530,17.144,26.5,6.378,8827.01,199.128,8.27,0.702,0
150,107,124,3198,0,25,2028,98088,75.93,7132530,17.144,26.5,6.378,8827.01,199.128,8.27,0.702,0
150,108,144,3342,2,27,2227,100315,75.93,7132530,17.144,26.5,6.378,8827.01,199.128,8.27,0.702,0
150,109,115,3457,1,28,2469,102784,75.93,7132530,17.144,26.5,6.378,8827.01,199.128,8.27,0.702,0
150,110,172,3629,1,29,2338,105122,75.93,7132530,17.144,26.5,6.378,8827.01,199.128,8.27,0.702,0
150,111,92,3721,2,31,1223,106345,78.7,7132530,17.144,26.5,6.378,8827.01,199.128,8.27,0.702,0
150,112,27,3748,2,33,1688,108033,78.7,7132530,17.144,26.5,6.378,8827.01,199.128,8.27,0.702,0
150,113,69,3817,2,35,1841,109874,78.7,7132530,17.144,26.5,6.378,8827.01,199.128,8.27,0.702,0
150,114,183,4000,1,36,2165,112039,78.7,7132530,17.144,26.5,6.378,8827.01,199.128,8.27,0.702,0
150,115,113,4113,0,36,2006,114045,78.7,7132530,17.144,26.5,6.378,8827.01,199.128,8.27,0.702,0
150,116,111,4224,2,38,1861,115906,78.7,7132530,17.144,26.5,6.378,8827.01,199.128,8.27,0.702,0
150,117,104,4328,2,40,1656,117562,78.7,7132530,17.144,26.5,6.378,8827.01,199.128,8.27,0.702,0
150,118,116,4444,1,41,1694,119256,78.7,7132530,17.144,26.5,6.378,8827.01,199.128,8.27,0.702,0
150,119,104,4548,2,43,1687,120943,78.7,7132530,17.144,26.5,6.378,8827.01,199.128,8.27,0.702,0
150,120,126,4674,2,45,1886,122829,78.7,7132530,17.144,26.5,6.378,8827.01,199.128,8.27,0.702,0
150,121,192,4866,1,46,2532,125361,78.7,7132530,17.144,26.5,6.378,8827.01,199.128,8.27,0.702,0
150,122,341,5207,1,47,2249,127610,78.7,7132530,17.144,26.5,6.378,8827.01,199.128,8.27,0.702,0
150,123,131,5338,2,49,1099,128709,78.7,7132530,17.144,26.5,6.378,8827.01,199.128,8.27,0.702,0
150,124,147,5485,3,52,1015,129724,78.7,7132530,17.144,26.5,6.378,8827.01,199.128,8.27,0.702,0
150,125,159,5644,0,52,1062,130786,78.7,7132530,17.144,26.5,6.378,8827.01,199.128,8.27,0.702,0
150,126,80,5724,3,55,1325,132111,78.7,7132530,17.144,26.5,6.378,8827.01,199.128,8.27,0.702,0
150,127,128,5852,4,59,1711,133822,78.7,7132530,17.144,26.5,6.378,8827.01,199.128,8.27,0.702,0
150,128,208,6060,2,61,1455,135277,78.7,7132530,17.144,26.5,6.378,8827.01,199.128,8.27,0.702,0
150,129,315,6375,5,66,1002,136279,78.7,7132530,17.144,26.5,6.378,8827.01,199.128,8.27,0.702,0
150,130,133,6508,3,69,1021,137300,78.7,7132530,17.144,26.5,6.378,8827.01,199.128,8.27,0.702,0
150,131,197,6705,3,72,1115,138415,78.7,7132530,17.144,26.5,6.378,8827.01,199.128,8.27,0.702,0
150,132,202,6907,3,75,1821,140236,78.7,7132530,17.144,26.5,6.378,8827.01,199.128,8.27,0.702,0
150,133,327,7234,7,82,2158,142394,78.7,7132530,17.144,26.5,6.378,8827.01,199.128,8.27,0.702,0
150,134,285,7519,4,86,2123,144517,78.7,7132530,17.144,26.5,6.378,8827.01,199.128,8.27,0.702,0
150,135,499,8018,7,93,1767,146284,78.7,7132530,17.144,26.5,6.378,8827.01,199.128,8.27,0.702,0
150,136,371,8389,4,97,3065,149349,78.7,7132530,17.144,26.5,6.378,8827.01,199.128,8.27,0.702,0
150,137,688,9077,11,108,2078,151427,78.7,7132530,17.144,26.5,6.378,8827.01,199.128,8.27,0.702,0
150,138,304,9381,19,127,2965,154392,78.7,7132530,17.144,26.5,6.378,8827.01,199.128,8.27,0.702,0
150,139,410,9791,11,138,2219,156611,78.7,7132530,17.144,26.5,6.378,8827.01,199.128,8.27,0.702,0
150,140,344,10135,7,145,3055,159666,78.7,7132530,17.144,26.5,6.378,8827.01,199.128,8.27,0.702,0
150,141,471,10606,16,161,2657,162323,78.7,7132530,17.144,26.5,6.378,8827.01,199.128,8.27,0.702,0
150,142,527,11133,4,165,3787,166110,78.7,7132530,17.144,26.5,6.378,8827.01,199.128,8.27,0.702,0
150,143,684,11817,5,170,3150,169260,78.7,7132530,17.144,26.5,6.378,8827.01,199.128,8.27,0.702,0
150,144,719,12536,12,182,2292,171552,78.7,7132530,17.144,26.5,6.378,8827.01,199.128,8.27,0.702,0
150,145,438,12974,10,192,1788,173340,78.7,7132530,17.144,26.5,6.378,8827.01,199.128,8.27,0.702,0
150,146,259,13233,13,205,2312,175652,78.7,7132530,17.144,26.5,6.378,8827.01,199.128,8.27,0.702,0
150,147,369,13602,14,219,2119,177771,81.48,7132530,17.144,26.5,6.378,8827.01,199.128,8.27,0.702,0
150,148,626,14228,12,231,2835,180606,81.48,7132530,17.144,26.5,6.378,8827.01,199.128,8.27,0.702,0
150,149,644,14872,16,247,2185,182791,81.48,7132530,17.144,26.5,6.378,8827.01,199.128,8.27,0.702,0
150,150,418,15290,18,265,3130,185921,81.48,7132530,17.144,26.5,6.378,8827.01,199.128,8.27,0.702,0
150,151,584,15874,15,280,2638,188559,81.48,7132530,17.144,26.5,6.378,8827.01,199.128,8.27,0.702,0
150,152,600,16474,14,294,1610,190169,81.48,7132530,17.144,26.5,6.378,8827.01,199.128,8.27,0.702,0
150,153,721,17195,14,308,2296,192465,81.48,7132530,17.144,26.5,6.378,8827.01,199.128,8.27,0.702,0
150,154,467,17662,18,326,3089,195554,81.48,7132530,17.144,26.5,6.378,8827.01,199.128,8.27,0.702,0
150,155,676,18338,22,348,3066,198620,81.48,7132530,17.144,26.5,6.378,8827.01,199.128,8.27,0.702,0
150,156,800,19138,10,358,3130,201750,81.48,7132530,17.144,26.5,6.378,8827.01,199.128,8.27,0.702,0
150,157,821,19959,15,373,2470,204220,81.48,7132530,17.144,26.5,6.378,8827.01,199.128,8.27,0.702,0
150,158,695,20654,25,398,2263,206483,81.48,7132530,17.144,26.5,6.378,8827.01,199.128,8.27,0.702,0
150,159,1217,21871,14,412,2719,209202,81.48,7132530,17.144,26.5,6.378,8827.01,199.128,8.27,0.702,0
150,160,615,22486,23,435,2754,211956,81.48,7132530,17.144,26.5,6.378,8827.01,199.128,8.27,0.702,0
150,161,867,23353,14,449,3020,214976,81.48,7132530,17.144,26.5,6.378,8827.01,199.128,8.27,0.702,0
150,162,861,24214,14,463,2667,217643,81.48,7132530,17.144,26.5,6.378,8827.01,199.128,8.27,0.702,0
150,163,812,25026,11,474,2650,220293,81.48,7132530,17.144,26.5,6.378,8827.01,199.128,8.27,0.702,0
150,164,605,25631,11,485,3010,223303,81.48,7132530,17.144,26.5,6.378,8827.01,199.128,8.27,0.702,0
150,165,881,26512,11,496,3708,227011,81.48,7132530,17.144,26.5,6.378,8827.01,199.128,8.27,0.702,0
150,166,812,27324,18,514,2981,229992,81.48,7132530,17.144,26.5,6.378,8827.01,199.128,8.27,0.702,0
150,167,493,27817,11,525,2523,232515,81.48,7132530,17.144,26.5,6.378,8827.01,199.128,8.27,0.702,0
150,168,550,28367,14,539,3105,235620,81.48,7132530,17.144,26.5,6.378,8827.01,199.128,8.27,0.702,0
150,169,931,29298,13,552,3552,239172,81.48,7132530,17.144,26.5,6.378,8827.01,199.128,8.27,0.702,0
150,170,1121,30419,14,566,2665,241837,81.48,7132530,17.144,26.5,6.378,8827.01,199.128,8.27,0.702,0
150,171,694,31113,18,584,3434,245271,81.48,7132530,17.144,26.5,6.378,8827.01,199.128,8.27,0.702,0
150,172,1014,32127,27,611,3105,248376,81.48,7132530,17.144,26.5,6.378,8827.01,199.128,8.27,0.702,0
150,173,888,33015,25,636,2506,250882,81.48,7132530,17.144,26.5,6.378,8827.01,199.128,8.27,0.702,0
150,174,505,33520,23,659,2061,252943,81.48,7132530,17.144,26.5,6.378,8827.01,199.128,8.27,0.702,0
150,175,740,34260,17,676,2908,255851,81.48,7132530,17.144,26.5,6.378,8827.01,199.128,8.27,0.702,0
150,176,568,34828,29,705,2977,258828,81.48,7132530,17.144,26.5,6.378,8827.01,199.128,8.27,0.702,0
150,177,743,35571,22,727,2735,261563,81.48,7132530,17.144,26.5,6.378,8827.01,199.128,8.27,0.702,0
150,178,833,36404,16,743,2468,264031,81.48,7132530,17.144,26.5,6.378,8827.01,199.128,8.27,0.702,0
150,179,822,37226,18,761,3031,267062,81.48,7132530,17.144,26.5,6.378,8827.01,199.128,8.27,0.702,0
150,180,696,37922,21,782,2648,269710,81.48,7132530,17.144,26.5,6.378,8827.01,199.128,8.27,0.702,0
150,181,762,38684,21,803,2784,272494,81.48,7132530,17.144,26.5,6.378,8827.01,199.128,8.27,0.702,0
150,182,748,39432,15,818,2061,274555,81.48,7132530,17.144,26.5,6.378,8827.01,199.128,8.27,0.702,0
150,183,669,40101,23,841,2937,277492,81.48,7132530,17.144,26.5,6.378,8827.01,199.128,8.27,0.702,0
150,184,657,40758,16,857,3417,280909,81.48,7132530,17.144,26.5,6.378,8827.01,199.128,8.27,0.702,0
150,185,1041,41799,12,869,2628,283537,81.48,7132530,17.144,26.5,6.378,8827.01,199.128,8.27,0.702,0
150,186,885,42684,21,890,2725,286262,81.48,7132530,17.144,26.5,6.378,8827.01,199.128,8.27,0.702,0
150,187,768,43452,23,913,2240,288502,81.48,7132530,17.144,26.5,6.378,8827.01,199.128,8.27,0.702,0
150,188,730,44182,16,929,2005,290507,67.59,7132530,17.144,26.5,6.378,8827.01,199.128,8.27,0.702,0
150,189,533,44715,18,947,2867,293374,67.59,7132530,17.144,26.5,6.378,8827.01,199.128,8.27,0.702,0
150,190,932,45647,19,966,3162,296536,67.59,7132530,17.144,26.5,6.378,8827.01,199.128,8.27,0.702,0
150,191,788,46435,23,989,3021,299557,67.59,7132530,17.144,26.5,6.378,8827.01,199.128,8.27,0.702,0
150,192,881,47316,23,1012,3100,302657,67.59,7132530,17.144,26.5,6.378,8827.01,199.128,8.27,0.702,0
150,193,959,48275,33,1045,2895,305552,67.59,7132530,17.144,26.5,6.378,8827.01,199.128,8.27,0.702,0
150,194,703,48978,20,1065,2891,308443,67.59,7132530,17.144,26.5,6.378,8827.01,199.128,8.27,0.702,0
150,195,697,49675,12,1077,2883,311326,67.59,7132530,17.144,26.5,6.378,8827.01,199.128,8.27,0.702,0
150,196,669,50344,19,1096,2727,314053,67.59,7132530,17.144,26.5,6.378,8827.01,199.128,8.27,0.702,0
150,197,853,51197,12,1108,3031,317084,67.59,7132530,17.144,26.5,6.378,8827.01,199.128,8.27,0.702,0
150,198,648,51845,23,1131,2922,320006,64.81,7132530,17.144,26.5,6.378,8827.01,199.128,8.27,0.702,0
150,199,751,52596,19,1150,2972,322978,64.81,7132530,17.144,26.5,6.378,8827.01,199.128,8.27,0.702,0
150,200,886,53482,16,1166,0,322978,64.81,7132530,17.144,26.5,6.378,8827.01,199.128,8.27,0.702,0
150,201,533,54015,13,1179,0,322978,64.81,7132530,17.144,26.5,6.378,8827.01,199.128,8.27,0.702,0
150,202,709,54724,9,1188,0,322978,64.81,7132530,17.144,26.5,6.378,8827.01,199.128,8.27,0.702,0
150,203,728,55452,19,1207,0,322978,64.81,7132530,17.144,26.5,6.378,8827.01,199.128,8.27,0.702,0
150,204,621,56073,24,1231,0,322978,64.81,7132530,17.144,26.5,6.378,8827.01,199.128,8.27,0.702,0
151,1,115,1065,6,30,931,16518,94.44,32971846,25.129,29.1,7.151,12236.706,85.755,5.95,0.75,4
151,2,258,1323,17,47,816,17334,94.44,32971846,25.129,29.1,7.151,12236.706,85.755,5.95,0.75,4
151,3,91,1414,8,55,507,17841,94.44,32971846,25.129,29.1,7.151,12236.706,85.755,5.95,0.75,4
151,4,181,1595,6,61,1569,19410,94.44,32971846,25.129,29.1,7.151,12236.706,85.755,5.95,0.75,4
151,5,151,1746,12,73,1004,20414,94.44,32971846,25.129,29.1,7.151,12236.706,85.755,5.95,0.75,4
151,6,535,2281,10,83,1141,21555,94.44,32971846,25.129,29.1,7.151,12236.706,85.755,5.95,0.75,4
151,7,280,2561,9,92,1700,23255,94.44,32971846,25.129,29.1,7.151,12236.706,85.755,5.95,0.75,4
151,8,393,2954,15,107,1155,24410,94.44,32971846,25.129,29.1,7.151,12236.706,85.755,5.95,0.75,4
151,9,1388,4342,14,121,1233,25643,94.44,32971846,25.129,29.1,7.151,12236.706,85.755,5.95,0.75,4
151,10,914,5256,17,138,1876,27519,94.44,32971846,25.129,29.1,7.151,12236.706,85.755,5.95,0.75,4
151,11,641,5897,31,169,3715,31234,94.44,32971846,25.129,29.1,7.151,12236.706,85.755,5.95,0.75,4
151,12,951,6848,12,181,1410,32644,94.44,32971846,25.129,29.1,7.151,12236.706,85.755,5.95,0.75,4
151,13,671,7519,12,193,722,33366,94.44,32971846,25.129,29.1,7.151,12236.706,85.755,5.95,0.75,4
151,14,0,7519,0,193,1535,34901,94.44,32971846,25.129,29.1,7.151,12236.706,85.755,5.95,0.75,4
151,15,2784,10303,37,230,1189,36090,94.44,32971846,25.129,29.1,7.151,12236.706,85.755,5.95,0.75,4
151,16,1172,11475,24,254,1272,37362,94.44,32971846,25.129,29.1,7.151,12236.706,85.755,5.95,0.75,4
151,17,1016,12491,20,274,1100,38462,94.44,32971846,25.129,29.1,7.151,12236.706,85.755,5.95,0.75,4
151,18,998,13489,26,300,1566,40028,94.44,32971846,25.129,29.1,7.151,12236.706,85.755,5.95,0.75,4
151,19,931,14420,48,348,1328,41356,94.44,32971846,25.129,29.1,7.151,12236.706,85.755,5.95,0.75,4
151,20,1208,15628,52,400,1392,42748,94.44,32971846,25.129,29.1,7.151,12236.706,85.755,5.95,0.75,4
151,21,697,16325,45,445,1673,44421,94.44,32971846,25.129,29.1,7.151,12236.706,85.755,5.95,0.75,4
151,22,1512,17837,39,484,1294,45715,94.44,32971846,25.129,29.1,7.151,12236.706,85.755,5.95,0.75,4
151,23,1413,19250,46,530,1909,47624,94.44,32971846,25.129,29.1,7.151,12236.706,85.755,5.95,0.75,4
151,24,1664,20914,42,572,1922,49546,94.44,32971846,25.129,29.1,7.151,12236.706,85.755,5.95,0.75,4
151,25,734,21648,62,634,1770,51316,94.44,32971846,25.129,29.1,7.151,12236.706,85.755,5.95,0.75,4
151,26,3683,25331,66,700,1356,52672,94.44,32971846,25.129,29.1,7.151,12236.706,85.755,5.95,0.75,4
151,27,2186,27517,28,728,1868,54540,94.44,32971846,25.129,29.1,7.151,12236.706,85.755,5.95,0.75,4
151,28,1182,28699,54,782,1856,56396,94.44,32971846,25.129,29.1,7.151,12236.706,85.755,5.95,0.75,4
151,29,2491,31190,72,854,1722,58118,94.44,32971846,25.129,29.1,7.151,12236.706,85.755,5.95,0.75,4
151,30,2741,33931,89,943,2263,60381,94.44,32971846,25.129,29.1,7.151,12236.706,85.755,5.95,0.75,4
151,31,3045,36976,108,1051,2155,62536,96.3,32971846,25.129,29.1,7.151,12236.706,85.755,5.95,0.75,4
151,32,3483,40459,73,1124,1642,64178,96.3,32971846,25.129,29.1,7.151,12236.706,85.755,5.95,0.75,4
151,33,2075,42534,76,1200,1614,65792,96.3,32971846,25.129,29.1,7.151,12236.706,85.755,5.95,0.75,4
151,34,3394,45928,86,1286,1771,67563,96.3,32971846,25.129,29.1,7.151,12236.706,85.755,5.95,0.75,4
151,35,1444,47372,58,1344,2781,70344,96.3,32971846,25.129,29.1,7.151,12236.706,85.755,5.95,0.75,4
151,36,3817,51189,100,1444,2500,72844,96.3,32971846,25.129,29.1,7.151,12236.706,85.755,5.95,0.75,4
151,37,3628,54817,89,1533,2058,74902,96.3,32971846,25.129,29.1,7.151,12236.706,85.755,5.95,0.75,4
151,38,3709,58526,94,1627,891,75793,96.3,32971846,25.129,29.1,7.151,12236.706,85.755,5.95,0.75,4
151,39,3321,61847,87,1714,4113,79906,96.3,32971846,25.129,29.1,7.151,12236.706,85.755,5.95,0.75,4
151,40,3168,65015,100,1814,3770,83676,96.3,32971846,25.129,29.1,7.151,12236.706,85.755,5.95,0.75,4
151,41,2292,67307,75,1889,1918,85594,92.59,32971846,25.129,29.1,7.151,12236.706,85.755,5.95,0.75,4
151,42,1515,68822,72,1961,2197,87791,92.59,32971846,25.129,29.1,7.151,12236.706,85.755,5.95,0.75,4
151,43,3237,72059,96,2057,2307,90098,92.59,32971846,25.129,29.1,7.151,12236.706,85.755,5.95,0.75,4
151,44,4247,76306,112,2169,2627,92725,92.59,32971846,25.129,29.1,7.151,12236.706,85.755,5.95,0.75,4
151,45,4298,80604,98,2267,4022,96747,92.59,32971846,25.129,29.1,7.151,12236.706,85.755,5.95,0.75,4
151,46,3891,84495,126,2393,3295,100042,92.59,32971846,25.129,29.1,7.151,12236.706,85.755,5.95,0.75,4
151,47,4046,88541,130,2523,2797,102839,92.59,32971846,25.129,29.1,7.151,12236.706,85.755,5.95,0.75,4
151,48,3732,92273,125,2648,2788,105627,92.59,32971846,25.129,29.1,7.151,12236.706,85.755,5.95,0.75,4
151,49,2660,94933,141,2789,2854,108481,92.59,32971846,25.129,29.1,7.151,12236.706,85.755,5.95,0.75,4
151,50,4550,99483,125,2914,3872,112353,92.59,32971846,25.129,29.1,7.151,12236.706,85.755,5.95,0.75,4
151,51,4537,104020,110,3024,3128,115481,92.59,32971846,25.129,29.1,7.151,12236.706,85.755,5.95,0.75,4
151,52,4749,108769,124,3148,7268,122749,92.59,32971846,25.129,29.1,7.151,12236.706,85.755,5.95,0.75,4
151,53,2929,111698,96,3244,800,123549,92.59,32971846,25.129,29.1,7.151,12236.706,85.755,5.95,0.75,4
151,54,4056,115754,129,3373,1342,124891,92.59,32971846,25.129,29.1,7.151,12236.706,85.755,5.95,0.75,4
151,55,4205,119959,83,3456,2563,127454,89.81,32971846,25.129,29.1,7.151,12236.706,85.755,5.95,0.75,4
151,56,4020,123979,173,3629,3603,131057,89.81,32971846,25.129,29.1,7.151,12236.706,85.755,5.95,0.75,4
151,57,5772,129751,159,3788,2788,133845,89.81,32971846,25.129,29.1,7.151,12236.706,85.755,5.95,0.75,4
151,58,6154,135905,195,3983,3718,137563,89.81,32971846,25.129,29.1,7.151,12236.706,85.755,5.95,0.75,4
151,59,5874,141779,116,4099,3042,140605,89.81,32971846,25.129,29.1,7.151,12236.706,85.755,5.95,0.75,4
151,60,6506,148285,131,4230,3562,144167,89.81,32971846,25.129,29.1,7.151,12236.706,85.755,5.95,0.75,4
151,61,7386,155671,141,4371,1458,145625,89.81,32971846,25.129,29.1,7.151,12236.706,85.755,5.95,0.75,4
151,62,8805,164476,135,4506,3834,149459,89.81,32971846,25.129,29.1,7.151,12236.706,85.755,5.95,0.75,4
151,63,5563,170039,128,4634,2769,152228,89.81,32971846,25.129,29.1,7.151,12236.706,85.755,5.95,0.75,4
151,64,0,170039,0,4634,1545,153773,89.81,32971846,25.129,29.1,7.151,12236.706,85.755,5.95,0.75,4
151,65,8875,178914,260,4894,2410,156183,89.81,32971846,25.129,29.1,7.151,12236.706,85.755,5.95,0.75,4
151,66,4284,183198,137,5031,2986,159169,89.81,32971846,25.129,29.1,7.151,12236.706,85.755,5.95,0.75,4
151,67,4202,187400,131,5162,4369,163538,89.81,32971846,25.129,29.1,7.151,12236.706,85.755,5.95,0.75,4
151,68,4358,191758,139,5301,4750,168288,89.81,32971846,25.129,29.1,7.151,12236.706,85.755,5.95,0.75,4
151,69,4757,196515,164,5465,3431,171719,89.81,32971846,25.129,29.1,7.151,12236.706,85.755,5.95,0.75,4
151,70,3181,199696,106,5571,4033,175752,89.81,32971846,25.129,29.1,7.151,12236.706,85.755,5.95,0.75,4
151,71,4040,203736,167,5738,3612,179364,89.81,32971846,25.129,29.1,7.151,12236.706,85.755,5.95,0.75,4
151,72,5087,208823,165,5903,3779,183143,89.81,32971846,25.129,29.1,7.151,12236.706,85.755,5.95,0.75,4
151,73,5965,214788,206,6109,4294,187437,89.81,32971846,25.129,29.1,7.151,12236.706,85.755,5.95,0.75,4
151,74,5961,220749,199,6308,3635,191072,89.81,32971846,25.129,29.1,7.151,12236.706,85.755,5.95,0.75,4
151,75,4383,225132,190,6498,3523,194595,89.81,32971846,25.129,29.1,7.151,12236.706,85.755,5.95,0.75,4
151,76,4604,229736,190,6688,4222,198817,89.81,32971846,25.129,29.1,7.151,12236.706,85.755,5.95,0.75,4
151,77,3256,232992,172,6860,3435,202252,89.81,32971846,25.129,29.1,7.151,12236.706,85.755,5.95,0.75,4
151,78,4164,237156,196,7056,4171,206423,89.81,32971846,25.129,29.1,7.151,12236.706,85.755,5.95,0.75,4
151,79,3752,240908,201,7257,3670,210093,89.81,32971846,25.129,29.1,7.151,12236.706,85.755,5.95,0.75,4
151,80,3480,244388,204,7461,1904,211997,89.81,32971846,25.129,29.1,7.151,12236.706,85.755,5.95,0.75,4
151,81,3537,247925,199,7660,3936,215933,89.81,32971846,25.129,29.1,7.151,12236.706,85.755,5.95,0.75,4
151,82,3413,251338,201,7861,2282,218215,89.81,32971846,25.129,29.1,7.151,12236.706,85.755,5.95,0.75,4
151,83,3598,254936,184,8045,4025,222240,89.81,32971846,25.129,29.1,7.151,12236.706,85.755,5.95,0.75,4
151,84,0,254936,0,8045,5153,227393,89.81,32971846,25.129,29.1,7.151,12236.706,85.755,5.95,0.75,4
151,85,5874,260810,359,8404,5337,232730,89.81,32971846,25.129,29.1,7.151,12236.706,85.755,5.95,0.75,4
151,86,3879,264689,182,8586,5158,237888,89.81,32971846,25.129,29.1,7.151,12236.706,85.755,5.95,0.75,4
151,87,3913,268602,175,8761,4921,242809,89.81,32971846,25.129,29.1,7.151,12236.706,85.755,5.95,0.75,4
151,88,3762,272364,178,8939,2506,245315,89.81,32971846,25.129,29.1,7.151,12236.706,85.755,5.95,0.75,4
151,89,3625,275989,196,9135,2096,247411,89.81,32971846,25.129,29.1,7.151,12236.706,85.755,5.95,0.75,4
151,90,3430,279419,182,9317,2863,250274,89.81,32971846,25.129,29.1,7.151,12236.706,85.755,5.95,0.75,4
151,91,2946,282365,187,9504,2464,252738,89.81,32971846,25.129,29.1,7.151,12236.706,85.755,5.95,0.75,4
151,92,2848,285213,173,9677,3261,255999,80.56,32971846,25.129,29.1,7.151,12236.706,85.755,5.95,0.75,4
151,93,3264,288477,183,9860,3037,259036,80.56,32971846,25.129,29.1,7.151,12236.706,85.755,5.95,0.75,4
151,94,3527,292004,185,10045,2567,261603,78.7,32971846,25.129,29.1,7.151,12236.706,85.755,5.95,0.75,4
151,95,3595,295599,181,10226,3188,264791,78.7,32971846,25.129,29.1,7.151,12236.706,85.755,5.95,0.75,4
151,96,3481,299080,186,10412,3343,268134,78.7,32971846,25.129,29.1,7.151,12236.706,85.755,5.95,0.75,4
151,97,3638,302718,177,10589,3813,271947,78.7,32971846,25.129,29.1,7.151,12236.706,85.755,5.95,0.75,4
151,98,2985,305703,183,10772,4673,276620,78.7,32971846,25.129,29.1,7.151,12236.706,85.755,5.95,0.75,4
151,99,3575,309278,180,10952,3153,279773,78.7,32971846,25.129,29.1,7.151,12236.706,85.755,5.95,0.75,4
151,100,3633,312911,181,11133,4113,283886,78.7,32971846,25.129,29.1,7.151,12236.706,85.755,5.95,0.75,4
151,101,3537,316448,181,11314,3078,286964,78.7,32971846,25.129,29.1,7.151,12236.706,85.755,5.95,0.75,4
151,102,3198,319646,186,11500,3270,290234,75.93,32971846,25.129,29.1,7.151,12236.706,85.755,5.95,0.75,4
151,103,3064,322710,182,11682,3261,293495,75.93,32971846,25.129,29.1,7.151,12236.706,85.755,5.95,0.75,4
151,104,3616,326326,188,11870,4274,297769,75.93,32971846,25.129,29.1,7.151,12236.706,85.755,5.95,0.75,4
151,105,3797,330123,184,12054,6555,304324,75.93,32971846,25.129,29.1,7.151,12236.706,85.755,5.95,0.75,4
151,106,3744,333867,175,12229,5422,309746,75.93,32971846,25.129,29.1,7.151,12236.706,85.755,5.95,0.75,4
151,107,3857,337724,188,12417,6100,315846,75.93,32971846,25.129,29.1,7.151,12236.706,85.755,5.95,0.75,4
151,108,3862,341586,198,12615,5815,321661,75.93,32971846,25.129,29.1,7.151,12236.706,85.755,5.95,0.75,4
151,109,3951,345537,184,12799,4849,326510,75.93,32971846,25.129,29.1,7.151,12236.706,85.755,5.95,0.75,4
151,110,3963,349500,199,12998,3243,329753,75.93,32971846,25.129,29.1,7.151,12236.706,85.755,5.95,0.75,4
151,111,4090,353590,189,13187,4758,334511,75.93,32971846,25.129,29.1,7.151,12236.706,85.755,5.95,0.75,4
151,112,4091,357681,197,13384,4587,339098,75.93,32971846,25.129,29.1,7.151,12236.706,85.755,5.95,0.75,4
151,113,4406,362087,195,13579,5430,344528,75.93,32971846,25.129,29.1,7.151,12236.706,85.755,5.95,0.75,4
151,114,4463,366550,188,13767,4893,349421,75.93,32971846,25.129,29.1,7.151,12236.706,85.755,5.95,0.75,4
151,115,4546,371096,3887,17654,6245,355666,81.48,32971846,25.129,29.1,7.151,12236.706,85.755,5.95,0.75,4
151,116,4865,375961,189,17843,4752,360418,81.48,32971846,25.129,29.1,7.151,12236.706,85.755,5.95,0.75,4
151,117,3923,379884,187,18030,3893,364311,81.48,32971846,25.129,29.1,7.151,12236.706,85.755,5.95,0.75,4
151,118,4913,384797,199,18229,4769,369080,81.48,32971846,25.129,29.1,7.151,12236.706,85.755,5.95,0.75,4
151,119,4920,389717,189,18418,3799,372879,81.48,32971846,25.129,29.1,7.151,12236.706,85.755,5.95,0.75,4
151,120,5288,395005,194,18612,3870,376749,81.48,32971846,25.129,29.1,7.151,12236.706,85.755,5.95,0.75,4
151,121,5678,400683,204,18816,5926,382675,81.48,32971846,25.129,29.1,7.151,12236.706,85.755,5.95,0.75,4
151,122,6809,407492,205,19021,5852,388527,81.48,32971846,25.129,29.1,7.151,12236.706,85.755,5.95,0.75,4
151,123,7243,414735,196,19217,5845,394372,81.48,32971846,25.129,29.1,7.151,12236.706,85.755,5.95,0.75,4
151,124,7448,422183,191,19408,3670,398042,81.48,32971846,25.129,29.1,7.151,12236.706,85.755,5.95,0.75,4
151,125,6667,428850,206,19614,4175,402217,81.48,32971846,25.129,29.1,7.151,12236.706,85.755,5.95,0.75,4
151,126,4250,433100,197,19811,5974,408191,81.48,32971846,25.129,29.1,7.151,12236.706,85.755,5.95,0.75,4
151,127,6790,439890,196,20007,4884,413075,81.48,32971846,25.129,29.1,7.151,12236.706,85.755,5.95,0.75,4
151,128,7734,447624,221,20228,6913,419988,81.48,32971846,25.129,29.1,7.151,12236.706,85.755,5.95,0.75,4
151,129,7785,455409,196,20424,4262,424250,81.48,32971846,25.129,29.1,7.151,12236.706,85.755,5.95,0.75,4
151,130,8466,463875,225,20649,6120,430370,81.48,32971846,25.129,29.1,7.151,12236.706,85.755,5.95,0.75,4
151,131,7137,471012,195,20844,5006,435376,81.48,32971846,25.129,29.1,7.151,12236.706,85.755,5.95,0.75,4
151,132,7012,478024,228,21072,3728,439104,81.48,32971846,25.129,29.1,7.151,12236.706,85.755,5.95,0.75,4
151,133,5109,483133,204,21276,8033,447137,81.48,32971846,25.129,29.1,7.151,12236.706,85.755,5.95,0.75,4
151,134,6547,489680,225,21501,9322,456459,85.19,32971846,25.129,29.1,7.151,12236.706,85.755,5.95,0.75,4
151,135,8875,498555,212,21713,7736,464195,85.19,32971846,25.129,29.1,7.151,12236.706,85.755,5.95,0.75,4
151,136,9441,507996,3935,25648,8488,472683,85.19,32971846,25.129,29.1,7.151,12236.706,85.755,5.95,0.75,4
151,137,8300,516296,208,25856,10411,483094,85.19,32971846,25.129,29.1,7.151,12236.706,85.755,5.95,0.75,4
151,138,9507,525803,219,26075,6547,489641,85.19,32971846,25.129,29.1,7.151,12236.706,85.755,5.95,0.75,4
151,139,10143,535946,206,26281,8216,497857,85.19,32971846,25.129,29.1,7.151,12236.706,85.755,5.95,0.75,4
151,140,5547,541493,200,26481,9044,506901,85.19,32971846,25.129,29.1,7.151,12236.706,85.755,5.95,0.75,4
151,141,7828,549321,177,26658,8459,515360,85.19,32971846,25.129,29.1,7.151,12236.706,85.755,5.95,0.75,4
151,142,9099,558420,176,26834,8457,523817,85.19,32971846,25.129,29.1,7.151,12236.706,85.755,5.95,0.75,4
151,143,8639,567059,200,27034,8280,532097,85.19,32971846,25.129,29.1,7.151,12236.706,85.755,5.95,0.75,4
151,144,9008,576067,211,27245,6886,538983,85.19,32971846,25.129,29.1,7.151,12236.706,85.755,5.95,0.75,4
151,145,9169,585236,208,27453,5249,544232,85.19,32971846,25.129,29.1,7.151,12236.706,85.755,5.95,0.75,4
151,146,9090,594326,210,27663,5127,549359,85.19,32971846,25.129,29.1,7.151,12236.706,85.755,5.95,0.75,4
151,147,6112,600438,150,27813,3570,552929,85.19,32971846,25.129,29.1,7.151,12236.706,85.755,5.95,0.75,4
151,148,6944,607382,188,28001,7776,560705,85.19,32971846,25.129,29.1,7.151,12236.706,85.755,5.95,0.75,4
151,149,5996,613378,123,28124,7399,568104,85.19,32971846,25.129,29.1,7.151,12236.706,85.755,5.95,0.75,4
151,150,8619,621997,153,28277,8457,576561,85.19,32971846,25.129,29.1,7.151,12236.706,85.755,5.95,0.75,4
151,151,7964,629961,194,28471,7671,584232,85.19,32971846,25.129,29.1,7.151,12236.706,85.755,5.95,0.75,4
151,152,9474,639435,136,28607,5659,589891,85.19,32971846,25.129,29.1,7.151,12236.706,85.755,5.95,0.75,4
151,153,7731,647166,181,28788,5335,595226,85.19,32971846,25.129,29.1,7.151,12236.706,85.755,5.95,0.75,4
151,154,4871,652037,156,28944,5300,600526,85.19,32971846,25.129,29.1,7.151,12236.706,85.755,5.95,0.75,4
151,155,5092,657129,124,29068,7466,607992,85.19,32971846,25.129,29.1,7.151,12236.706,85.755,5.95,0.75,4
151,156,6308,663437,191,29259,7748,615740,85.19,32971846,25.129,29.1,7.151,12236.706,85.755,5.95,0.75,4
151,157,6708,670145,146,29405,8256,623996,85.19,32971846,25.129,29.1,7.151,12236.706,85.755,5.95,0.75,4
151,158,6703,676848,149,29554,6525,630521,85.19,32971846,25.129,29.1,7.151,12236.706,85.755,5.95,0.75,4
151,159,6854,683702,133,29687,0,630521,85.19,32971846,25.129,29.1,7.151,12236.706,85.755,5.95,0.75,4
151,160,6275,689977,151,29838,0,630521,85.19,32971846,25.129,29.1,7.151,12236.706,85.755,5.95,0.75,4
151,161,1598,691575,138,29976,0,630521,85.19,32971846,25.129,29.1,7.151,12236.706,85.755,5.95,0.75,4
151,162,4615,696190,147,30123,0,630521,85.19,32971846,25.129,29.1,7.151,12236.706,85.755,5.95,0.75,4
151,163,6586,702776,113,30236,0,630521,85.19,32971846,25.129,29.1,7.151,12236.706,85.755,5.95,0.75,4
151,164,7291,710067,108,30344,0,630521,85.19,32971846,25.129,29.1,7.151,12236.706,85.755,5.95,0.75,4
151,165,6603,716670,126,30470,0,630521,85.19,32971846,25.129,29.1,7.151,12236.706,85.755,5.95,0.75,4
151,166,6162,722832,123,30593,0,630521,85.19,32971846,25.129,29.1,7.151,12236.706,85.755,5.95,0.75,4
151,167,6787,729619,117,30710,0,630521,85.19,32971846,25.129,29.1,7.151,12236.706,85.755,5.95,0.75,4
151,168,4241,733860,102,30812,0,630521,85.19,32971846,25.129,29.1,7.151,12236.706,85.755,5.95,0.75,4
151,169,4160,738020,115,30927,0,630521,85.19,32971846,25.129,29.1,7.151,12236.706,85.755,5.95,0.75,4
151,170,6380,744400,124,31051,0,630521,85.19,32971846,25.129,29.1,7.151,12236.706,85.755,5.95,0.75,4
151,171,5698,750098,95,31146,0,630521,85.19,32971846,25.129,29.1,7.151,12236.706,85.755,5.95,0.75,4
151,172,6314,756412,137,31283,0,630521,85.19,32971846,25.129,29.1,7.151,12236.706,85.755,5.95,0.75,4
151,173,6453,762865,86,31369,0,630521,85.19,32971846,25.129,29.1,7.151,12236.706,85.755,5.95,0.75,4
151,174,6030,768895,0,31369,0,630521,85.19,32971846,25.129,29.1,7.151,12236.706,85.755,5.95,0.75,4
151,175,4001,772896,105,31474,0,630521,85.19,32971846,25.129,29.1,7.151,12236.706,85.755,5.95,0.75,4
151,176,3650,776546,112,31586,0,630521,85.19,32971846,25.129,29.1,7.151,12236.706,85.755,5.95,0.75,4
151,177,6149,782695,284,31870,0,630521,85.19,32971846,25.129,29.1,7.151,12236.706,85.755,5.95,0.75,4
151,178,6235,788930,68,31938,0,630521,85.19,32971846,25.129,29.1,7.151,12236.706,85.755,5.95,0.75,4
151,179,5654,794584,99,32037,0,630521,85.19,32971846,25.129,29.1,7.151,12236.706,85.755,5.95,0.75,4
151,180,5558,800142,105,32142,0,630521,85.19,32971846,25.129,29.1,7.151,12236.706,85.755,5.95,0.75,4
151,181,5160,805302,120,32262,0,630521,85.19,32971846,25.129,29.1,7.151,12236.706,85.755,5.95,0.75,4
151,182,3412,808714,62,32324,0,630521,85.19,32971846,25.129,29.1,7.151,12236.706,85.755,5.95,0.75,4
151,183,3054,811768,72,32396,0,630521,85.19,32971846,25.129,29.1,7.151,12236.706,85.755,5.95,0.75,4
151,184,3061,814829,67,32463,0,630521,82.41,32971846,25.129,29.1,7.151,12236.706,85.755,5.95,0.75,4
151,185,3468,818297,72,32535,0,630521,82.41,32971846,25.129,29.1,7.151,12236.706,85.755,5.95,0.75,4
151,186,3267,821564,74,32609,0,630521,82.41,32971846,25.129,29.1,7.151,12236.706,85.755,5.95,0.75,4
151,187,3421,824985,56,32665,0,630521,82.41,32971846,25.129,29.1,7.151,12236.706,85.755,5.95,0.75,4
151,188,3184,828169,77,32742,0,630521,82.41,32971846,25.129,29.1,7.151,12236.706,85.755,5.95,0.75,4
151,189,1830,829999,92,32834,0,630521,82.41,32971846,25.129,29.1,7.151,12236.706,85.755,5.95,0.75,4
151,190,2930,832929,80,32914,0,630521,82.41,32971846,25.129,29.1,7.151,12236.706,85.755,5.95,0.75,4
151,191,2733,835662,95,33009,0,630521,82.41,32971846,25.129,29.1,7.151,12236.706,85.755,5.95,0.75,4
151,192,2952,838614,89,33098,0,630521,82.41,32971846,25.129,29.1,7.151,12236.706,85.755,5.95,0.75,4
151,193,4741,843355,60,33158,0,630521,82.41,32971846,25.129,29.1,7.151,12236.706,85.755,5.95,0.75,4
151,194,2733,846088,65,33223,0,630521,82.41,32971846,25.129,29.1,7.151,12236.706,85.755,5.95,0.75,4
151,195,3283,849371,82,33305,0,630521,82.41,32971846,25.129,29.1,7.151,12236.706,85.755,5.95,0.75,4
151,196,1800,851171,52,33357,0,630521,82.41,32971846,25.129,29.1,7.151,12236.706,85.755,5.95,0.75,4
151,197,2803,853974,62,33419,0,630521,82.41,32971846,25.129,29.1,7.151,12236.706,85.755,5.95,0.75,4
151,198,2977,856951,93,33512,0,630521,82.41,32971846,25.129,29.1,7.151,12236.706,85.755,5.95,0.75,4
151,199,2789,859740,65,33577,0,630521,82.41,32971846,25.129,29.1,7.151,12236.706,85.755,5.95,0.75,4
151,200,2677,862417,71,33648,0,630521,82.41,32971846,25.129,29.1,7.151,12236.706,85.755,5.95,0.75,4
151,201,3132,865549,54,33702,0,630521,82.41,32971846,25.129,29.1,7.151,12236.706,85.755,5.95,0.75,4
151,202,3126,868675,57,33759,0,630521,82.41,32971846,25.129,29.1,7.151,12236.706,85.755,5.95,0.75,4
151,203,2201,870876,61,33820,0,630521,82.41,32971846,25.129,29.1,7.151,12236.706,85.755,5.95,0.75,4
151,204,3242,874118,55,33875,0,630521,82.41,32971846,25.129,29.1,7.151,12236.706,85.755,5.95,0.75,4
152,1,0,2084,0,88,0,0,100,109581085,351.873,25.2,4.803,7599.188,370.437,7.07,0.699,3
152,2,227,2311,8,96,0,0,100,109581085,351.873,25.2,4.803,7599.188,370.437,7.07,0.699,3
152,3,322,2633,11,107,0,20276,100,109581085,351.873,25.2,4.803,7599.188,370.437,7.07,0.699,3
152,4,385,3018,29,136,2407,22683,100,109581085,351.873,25.2,4.803,7599.188,370.437,7.07,0.699,3
152,5,76,3094,8,144,344,23027,100,109581085,351.873,25.2,4.803,7599.188,370.437,7.07,0.699,3
152,6,152,3246,8,152,1700,24727,100,109581085,351.873,25.2,4.803,7599.188,370.437,7.07,0.699,3
152,7,414,3660,11,163,1685,26412,100,109581085,351.873,25.2,4.803,7599.188,370.437,7.07,0.699,3
152,8,104,3764,14,177,3125,29537,100,109581085,351.873,25.2,4.803,7599.188,370.437,7.07,0.699,3
152,9,106,3870,5,182,1989,31526,100,109581085,351.873,25.2,4.803,7599.188,370.437,7.07,0.699,3
152,10,206,4076,21,203,1244,32770,100,109581085,351.873,25.2,4.803,7599.188,370.437,7.07,0.699,3
152,11,0,4076,0,203,1302,34072,100,109581085,351.873,25.2,4.803,7599.188,370.437,7.07,0.699,3
152,12,352,4428,44,247,1710,35782,100,109581085,351.873,25.2,4.803,7599.188,370.437,7.07,0.699,3
152,13,220,4648,50,297,2387,38169,100,109581085,351.873,25.2,4.803,7599.188,370.437,7.07,0.699,3
152,14,284,4932,18,315,1829,39998,100,109581085,351.873,25.2,4.803,7599.188,370.437,7.07,0.699,3
152,15,291,5223,20,335,2625,42623,100,109581085,351.873,25.2,4.803,7599.188,370.437,7.07,0.699,3
152,16,230,5453,14,349,3490,46113,100,109581085,351.873,25.2,4.803,7599.188,370.437,7.07,0.699,3
152,17,207,5660,13,362,3421,49534,100,109581085,351.873,25.2,4.803,7599.188,370.437,7.07,0.699,3
152,18,218,5878,25,387,3657,53191,100,109581085,351.873,25.2,4.803,7599.188,370.437,7.07,0.699,3
152,19,209,6087,10,397,2317,55508,100,109581085,351.873,25.2,4.803,7599.188,370.437,7.07,0.699,3
152,20,172,6259,12,409,2323,57831,100,109581085,351.873,25.2,4.803,7599.188,370.437,7.07,0.699,3
152,21,200,6459,19,428,2870,60701,100,109581085,351.873,25.2,4.803,7599.188,370.437,7.07,0.699,3
152,22,140,6599,9,437,3620,64321,100,109581085,351.873,25.2,4.803,7599.188,370.437,7.07,0.699,3
152,23,111,6710,9,446,3726,68047,100,109581085,351.873,25.2,4.803,7599.188,370.437,7.07,0.699,3
152,24,271,6981,16,462,4167,72214,100,109581085,351.873,25.2,4.803,7599.188,370.437,7.07,0.699,3
152,25,211,7192,15,477,4417,76631,100,109581085,351.873,25.2,4.803,7599.188,370.437,7.07,0.699,3
152,26,102,7294,17,494,3876,80507,100,109581085,351.873,25.2,4.803,7599.188,370.437,7.07,0.699,3
152,27,285,7579,7,501,4428,84935,100,109581085,351.873,25.2,4.803,7599.188,370.437,7.07,0.699,3
152,28,198,7777,10,511,4434,89369,100,109581085,351.873,25.2,4.803,7599.188,370.437,7.07,0.699,3
152,29,181,7958,19,530,5019,94388,100,109581085,351.873,25.2,4.803,7599.188,370.437,7.07,0.699,3
152,30,254,8212,28,558,4802,99190,100,109581085,351.873,25.2,4.803,7599.188,370.437,7.07,0.699,3
152,31,276,8488,10,568,3932,103122,96.3,109581085,351.873,25.2,4.803,7599.188,370.437,7.07,0.699,3
152,32,284,8772,11,579,5208,108330,96.3,109581085,351.873,25.2,4.803,7599.188,370.437,7.07,0.699,3
152,33,156,8928,24,603,4487,112817,96.3,109581085,351.873,25.2,4.803,7599.188,370.437,7.07,0.699,3
152,34,295,9223,4,607,5464,118281,96.3,109581085,351.873,25.2,4.803,7599.188,370.437,7.07,0.699,3
152,35,262,9485,16,623,6555,124836,96.3,109581085,351.873,25.2,4.803,7599.188,370.437,7.07,0.699,3
152,36,199,9684,14,637,5137,129973,96.3,109581085,351.873,25.2,4.803,7599.188,370.437,7.07,0.699,3
152,37,320,10004,21,658,5401,135374,96.3,109581085,351.873,25.2,4.803,7599.188,370.437,7.07,0.699,3
152,38,339,10343,27,685,5532,140906,96.3,109581085,351.873,25.2,4.803,7599.188,370.437,7.07,0.699,3
152,39,120,10463,11,696,7130,148036,96.3,109581085,351.873,25.2,4.803,7599.188,370.437,7.07,0.699,3
152,40,147,10610,8,704,8757,156793,96.3,109581085,351.873,25.2,4.803,7599.188,370.437,7.07,0.699,3
152,41,184,10794,15,719,8514,165307,96.3,109581085,351.873,25.2,4.803,7599.188,370.437,7.07,0.699,3
152,42,292,11086,7,726,8512,173819,96.3,109581085,351.873,25.2,4.803,7599.188,370.437,7.07,0.699,3
152,43,264,11350,25,751,8766,182585,96.3,109581085,351.873,25.2,4.803,7599.188,370.437,7.07,0.699,3
152,44,268,11618,21,772,16620,199205,96.3,109581085,351.873,25.2,4.803,7599.188,370.437,7.07,0.699,3
152,45,258,11876,18,790,10529,209734,96.3,109581085,351.873,25.2,4.803,7599.188,370.437,7.07,0.699,3
152,46,215,12091,16,806,9490,219224,96.3,109581085,351.873,25.2,4.803,7599.188,370.437,7.07,0.699,3
152,47,214,12305,11,817,9095,228319,96.3,109581085,351.873,25.2,4.803,7599.188,370.437,7.07,0.699,3
152,48,208,12513,7,824,5394,233713,96.3,109581085,351.873,25.2,4.803,7599.188,370.437,7.07,0.699,3
152,49,205,12718,7,831,7354,241067,96.3,109581085,351.873,25.2,4.803,7599.188,370.437,7.07,0.699,3
152,50,224,12942,6,837,8215,249282,96.3,109581085,351.873,25.2,4.803,7599.188,370.437,7.07,0.699,3
152,51,279,13221,5,842,8690,257972,96.3,109581085,351.873,25.2,4.803,7599.188,370.437,7.07,0.699,3
152,52,213,13434,4,846,8999,266971,96.3,109581085,351.873,25.2,4.803,7599.188,370.437,7.07,0.699,3
152,53,163,13597,11,857,7645,274616,96.3,109581085,351.873,25.2,4.803,7599.188,370.437,7.07,0.699,3
152,54,180,13777,6,863,5892,280508,96.3,109581085,351.873,25.2,4.803,7599.188,370.437,7.07,0.699,3
152,55,258,14035,5,868,5421,285929,96.3,109581085,351.873,25.2,4.803,7599.188,370.437,7.07,0.699,3
152,56,284,14319,5,873,7290,293219,96.3,109581085,351.873,25.2,4.803,7599.188,370.437,7.07,0.699,3
152,57,350,14669,13,886,7722,300941,96.3,109581085,351.873,25.2,4.803,7599.188,370.437,7.07,0.699,3
152,58,380,15049,18,904,9283,310224,96.3,109581085,351.873,25.2,4.803,7599.188,370.437,7.07,0.699,3
152,59,539,15588,17,921,8530,318754,77.78,109581085,351.873,25.2,4.803,7599.188,370.437,7.07,0.699,3
152,60,1046,16634,21,942,9390,328144,77.78,109581085,351.873,25.2,4.803,7599.188,370.437,7.07,0.699,3
152,61,590,17224,8,950,8973,337117,77.78,109581085,351.873,25.2,4.803,7599.188,370.437,7.07,0.699,3
152,62,862,18086,7,957,7453,344570,77.78,109581085,351.873,25.2,4.803,7599.188,370.437,7.07,0.699,3
152,63,552,18638,3,960,10655,355225,77.78,109581085,351.873,25.2,4.803,7599.188,370.437,7.07,0.699,3
152,64,359,18997,6,966,10743,365968,77.78,109581085,351.873,25.2,4.803,7599.188,370.437,7.07,0.699,3
152,65,751,19748,8,974,10306,376274,77.78,109581085,351.873,25.2,4.803,7599.188,370.437,7.07,0.699,3
152,66,634,20382,10,984,10498,386772,77.78,109581085,351.873,25.2,4.803,7599.188,370.437,7.07,0.699,3
152,67,244,20626,3,987,11932,398704,77.78,109581085,351.873,25.2,4.803,7599.188,370.437,7.07,0.699,3
152,68,714,21340,7,994,8127,406831,77.78,109581085,351.873,25.2,4.803,7599.188,370.437,7.07,0.699,3
152,69,555,21895,9,1003,10092,416923,77.78,109581085,351.873,25.2,4.803,7599.188,370.437,7.07,0.699,3
152,70,579,22474,8,1011,10482,427405,77.78,109581085,351.873,25.2,4.803,7599.188,370.437,7.07,0.699,3
152,71,518,22992,6,1017,9913,437318,77.78,109581085,351.873,25.2,4.803,7599.188,370.437,7.07,0.699,3
152,72,740,23732,10,1027,9927,447245,77.78,109581085,351.873,25.2,4.803,7599.188,370.437,7.07,0.699,3
152,73,443,24175,9,1036,11459,458704,77.78,109581085,351.873,25.2,4.803,7599.188,370.437,7.07,0.699,3
152,74,612,24787,16,1052,11631,470335,77.78,109581085,351.873,25.2,4.803,7599.188,370.437,7.07,0.699,3
152,75,605,25392,22,1074,8499,478834,77.78,109581085,351.873,25.2,4.803,7599.188,370.437,7.07,0.699,3
152,76,538,25930,14,1088,8648,487482,83.33,109581085,351.873,25.2,4.803,7599.188,370.437,7.07,0.699,3
152,77,490,26420,10,1098,9876,497358,83.33,109581085,351.873,25.2,4.803,7599.188,370.437,7.07,0.699,3
152,78,361,26781,5,1103,14715,512073,83.33,109581085,351.873,25.2,4.803,7599.188,370.437,7.07,0.699,3
152,79,457,27238,5,1108,11192,523265,83.33,109581085,351.873,25.2,4.803,7599.188,370.437,7.07,0.699,3
152,80,561,27799,8,1116,14933,538198,83.33,109581085,351.873,25.2,4.803,7599.188,370.437,7.07,0.699,3
152,81,660,28459,14,1130,13205,551403,83.33,109581085,351.873,25.2,4.803,7599.188,370.437,7.07,0.699,3
152,82,941,29400,20,1150,11111,562514,83.33,109581085,351.873,25.2,4.803,7599.188,370.437,7.07,0.699,3
152,83,652,30052,19,1169,11731,574245,83.33,109581085,351.873,25.2,4.803,7599.188,370.437,7.07,0.699,3
152,84,630,30682,8,1177,14993,589238,83.33,109581085,351.873,25.2,4.803,7599.188,370.437,7.07,0.699,3
152,85,1143,31825,9,1186,13063,602301,83.33,109581085,351.873,25.2,4.803,7599.188,370.437,7.07,0.699,3
152,86,470,32295,18,1204,15004,617305,83.33,109581085,351.873,25.2,4.803,7599.188,370.437,7.07,0.699,3
152,87,774,33069,8,1212,15918,633223,83.33,109581085,351.873,25.2,4.803,7599.188,370.437,7.07,0.699,3
152,88,1004,34073,12,1224,16747,649970,83.33,109581085,351.873,25.2,4.803,7599.188,370.437,7.07,0.699,3
152,89,730,34803,12,1236,14395,664365,83.33,109581085,351.873,25.2,4.803,7599.188,370.437,7.07,0.699,3
152,90,652,35455,8,1244,16904,681269,83.33,109581085,351.873,25.2,4.803,7599.188,370.437,7.07,0.699,3
152,91,983,36438,11,1255,14956,696225,83.33,109581085,351.873,25.2,4.803,7599.188,370.437,7.07,0.699,3
152,92,1076,37514,11,1266,18338,714563,83.33,109581085,351.873,25.2,4.803,7599.188,370.437,7.07,0.699,3
152,93,997,38511,4,1270,17694,732257,83.33,109581085,351.873,25.2,4.803,7599.188,370.437,7.07,0.699,3
152,94,294,38805,4,1274,18820,751077,83.33,109581085,351.873,25.2,4.803,7599.188,370.437,7.07,0.699,3
152,95,1531,40336,6,1280,20868,771945,83.33,109581085,351.873,25.2,4.803,7599.188,370.437,7.07,0.699,3
152,96,1494,41830,10,1290,15455,787400,83.33,109581085,351.873,25.2,4.803,7599.188,370.437,7.07,0.699,3
152,97,0,41830,0,1290,17068,804468,83.33,109581085,351.873,25.2,4.803,7599.188,370.437,7.07,0.699,3
152,98,4503,46333,13,1303,22319,826787,80.56,109581085,351.873,25.2,4.803,7599.188,370.437,7.07,0.699,3
152,99,1540,47873,6,1309,21771,848558,80.56,109581085,351.873,25.2,4.803,7599.188,370.437,7.07,0.699,3
152,100,2486,50359,5,1314,23876,872434,80.56,109581085,351.873,25.2,4.803,7599.188,370.437,7.07,0.699,3
152,101,1395,51754,4,1318,22078,894512,80.56,109581085,351.873,25.2,4.803,7599.188,370.437,7.07,0.699,3
152,102,1160,52914,42,1360,24643,919155,80.56,109581085,351.873,25.2,4.803,7599.188,370.437,7.07,0.699,3
152,103,1308,54222,12,1372,16293,935448,80.56,109581085,351.873,25.2,4.803,7599.188,370.437,7.07,0.699,3
152,104,2037,56259,162,1534,18463,953911,80.56,109581085,351.873,25.2,4.803,7599.188,370.437,7.07,0.699,3
152,105,747,57006,65,1599,20320,974231,80.56,109581085,351.873,25.2,4.803,7599.188,370.437,7.07,0.699,3
152,106,539,57545,4,1603,22280,996511,80.56,109581085,351.873,25.2,4.803,7599.188,370.437,7.07,0.699,3
152,107,1305,58850,11,1614,26932,1023443,80.56,109581085,351.873,25.2,4.803,7599.188,370.437,7.07,0.699,3
152,108,2416,61266,29,1643,26921,1050364,80.56,109581085,351.873,25.2,4.803,7599.188,370.437,7.07,0.699,3
152,109,1735,63001,17,1660,26696,1077060,80.56,109581085,351.873,25.2,4.803,7599.188,370.437,7.07,0.699,3
152,110,2303,65304,113,1773,21579,1098639,80.56,109581085,351.873,25.2,4.803,7599.188,370.437,7.07,0.699,3
152,111,2152,67456,58,1831,21774,1120413,80.56,109581085,351.873,25.2,4.803,7599.188,370.437,7.07,0.699,3
152,112,1442,68898,4,1835,26087,1146500,80.56,109581085,351.873,25.2,4.803,7599.188,370.437,7.07,0.699,3
152,113,1866,70764,2,1837,29353,1175853,80.56,109581085,351.873,25.2,4.803,7599.188,370.437,7.07,0.699,3
152,114,1505,72269,6,1843,30745,1206598,76.85,109581085,351.873,25.2,4.803,7599.188,370.437,7.07,0.699,3
152,115,2121,74390,28,1871,31965,1238563,76.85,109581085,351.873,25.2,4.803,7599.188,370.437,7.07,0.699,3
152,116,2054,76444,8,1879,36295,1274858,76.85,109581085,351.873,25.2,4.803,7599.188,370.437,7.07,0.699,3
152,117,1968,78412,18,1897,26295,1301153,76.85,109581085,351.873,25.2,4.803,7599.188,370.437,7.07,0.699,3
152,118,2036,80448,35,1932,29357,1330510,76.85,109581085,351.873,25.2,4.803,7599.188,370.437,7.07,0.699,3
152,119,1592,82040,13,1945,29318,1359828,76.85,109581085,351.873,25.2,4.803,7599.188,370.437,7.07,0.699,3
152,120,1633,83673,2,1947,35951,1395779,76.85,109581085,351.873,25.2,4.803,7599.188,370.437,7.07,0.699,3
152,121,1813,85486,15,1962,35962,1431741,76.85,109581085,351.873,25.2,4.803,7599.188,370.437,7.07,0.699,3
152,122,3888,89374,21,1983,32070,1463811,76.85,109581085,351.873,25.2,4.803,7599.188,370.437,7.07,0.699,3
152,123,3980,93354,40,2023,30260,1494071,76.85,109581085,351.873,25.2,4.803,7599.188,370.437,7.07,0.699,3
152,124,4878,98232,16,2039,23668,1517739,76.85,109581085,351.873,25.2,4.803,7599.188,370.437,7.07,0.699,3
152,125,4953,103185,20,2059,29835,1547574,79.63,109581085,351.873,25.2,4.803,7599.188,370.437,7.07,0.699,3
152,126,3145,106330,45,2104,26461,1574035,79.63,109581085,351.873,25.2,4.803,7599.188,370.437,7.07,0.699,3
152,127,6263,112593,11,2115,28331,1602366,79.63,109581085,351.873,25.2,4.803,7599.188,370.437,7.07,0.699,3
152,128,3387,115980,8,2123,31835,1634201,79.63,109581085,351.873,25.2,4.803,7599.188,370.437,7.07,0.699,3
152,129,3480,119460,27,2150,37803,1672004,79.63,109581085,351.873,25.2,4.803,7599.188,370.437,7.07,0.699,3
152,130,3294,122754,18,2168,35690,1707694,79.63,109581085,351.873,25.2,4.803,7599.188,370.437,7.07,0.699,3
152,131,4131,126885,41,2209,28776,1736470,79.63,109581085,351.873,25.2,4.803,7599.188,370.437,7.07,0.699,3
152,132,3028,129913,61,2270,34328,1770798,79.63,109581085,351.873,25.2,4.803,7599.188,370.437,7.07,0.699,3
152,133,6725,136638,23,2293,26929,1797727,79.63,109581085,351.873,25.2,4.803,7599.188,370.437,7.07,0.699,3
152,134,2900,139538,19,2312,31435,1829162,79.63,109581085,351.873,25.2,4.803,7599.188,370.437,7.07,0.699,3
152,135,4211,143749,92,2404,34189,1863351,79.63,109581085,351.873,25.2,4.803,7599.188,370.437,7.07,0.699,3
152,136,3777,147526,22,2426,36674,1900025,79.63,109581085,351.873,25.2,4.803,7599.188,370.437,7.07,0.699,3
152,137,6134,153660,16,2442,37567,1937592,79.63,109581085,351.873,25.2,4.803,7599.188,370.437,7.07,0.699,3
152,138,4258,157918,158,2600,29997,1967589,79.63,109581085,351.873,25.2,4.803,7599.188,370.437,7.07,0.699,3
152,139,3335,161253,65,2665,31500,1999089,79.63,109581085,351.873,25.2,4.803,7599.188,370.437,7.07,0.699,3
152,140,3221,164474,16,2681,31625,2030714,68.52,109581085,351.873,25.2,4.803,7599.188,370.437,7.07,0.699,3
152,141,4739,169213,6,2687,36171,2066885,59.26,109581085,351.873,25.2,4.803,7599.188,370.437,7.07,0.699,3
152,142,4561,173774,108,2795,35380,2102265,59.26,109581085,351.873,25.2,4.803,7599.188,370.437,7.07,0.699,3
152,143,4248,178022,88,2883,38376,2140641,59.26,109581085,351.873,25.2,4.803,7599.188,370.437,7.07,0.699,3
152,144,4343,182365,57,2940,36168,2176809,59.26,109581085,351.873,25.2,4.803,7599.188,370.437,7.07,0.699,3
152,145,4884,187249,26,2966,26607,2203416,59.26,109581085,351.873,25.2,4.803,7599.188,370.437,7.07,0.699,3
152,146,2352,189601,32,2998,28417,2231833,59.26,109581085,351.873,25.2,4.803,7599.188,370.437,7.07,0.699,3
152,147,4651,194252,12,3010,27875,2259708,56.48,109581085,351.873,25.2,4.803,7599.188,370.437,7.07,0.699,3
152,148,2912,197164,28,3038,39685,2299393,56.48,109581085,351.873,25.2,4.803,7599.188,370.437,7.07,0.699,3
152,149,5197,202361,99,3137,39922,2339315,56.48,109581085,351.873,25.2,4.803,7599.188,370.437,7.07,0.699,3
152,150,3220,205581,97,3234,38722,2378037,56.48,109581085,351.873,25.2,4.803,7599.188,370.437,7.07,0.699,3
152,151,3963,209544,91,3325,36107,2414144,56.48,109581085,351.873,25.2,4.803,7599.188,370.437,7.07,0.699,3
152,152,3587,213131,94,3419,33613,2447757,56.48,109581085,351.873,25.2,4.803,7599.188,370.437,7.07,0.699,3
152,153,4265,217396,101,3520,32481,2480238,56.48,109581085,351.873,25.2,4.803,7599.188,370.437,7.07,0.699,3
152,154,3423,220819,43,3563,31616,2511854,56.48,109581085,351.873,25.2,4.803,7599.188,370.437,7.07,0.699,3
152,155,3445,224264,34,3597,37297,2549151,56.48,109581085,351.873,25.2,4.803,7599.188,370.437,7.07,0.699,3
152,156,2176,226440,26,3623,38395,2587546,56.48,109581085,351.873,25.2,4.803,7599.188,370.437,7.07,0.699,3
152,157,1963,228403,65,3688,38935,2626481,56.48,109581085,351.873,25.2,4.803,7599.188,370.437,7.07,0.699,3
152,158,0,228403,0,3688,39279,2665760,56.48,109581085,351.873,25.2,4.803,7599.188,370.437,7.07,0.699,3
152,159,6167,234570,102,3790,31890,2697650,56.48,109581085,351.873,25.2,4.803,7599.188,370.437,7.07,0.699,3
152,160,2795,237365,85,3875,34766,2732416,56.48,109581085,351.873,25.2,4.803,7599.188,370.437,7.07,0.699,3
152,161,1362,238727,15,3890,34679,2767095,56.48,109581085,351.873,25.2,4.803,7599.188,370.437,7.07,0.699,3
152,162,3260,241987,26,3916,39055,2806150,56.48,109581085,351.873,25.2,4.803,7599.188,370.437,7.07,0.699,3
152,163,3156,245143,70,3986,42625,2848775,56.48,109581085,351.873,25.2,4.803,7599.188,370.437,7.07,0.699,3
152,164,3804,248947,80,4066,44825,2893600,56.48,109581085,351.873,25.2,4.803,7599.188,370.437,7.07,0.699,3
152,165,4017,252964,42,4108,41933,2935533,56.48,109581085,351.873,25.2,4.803,7599.188,370.437,7.07,0.699,3
152,166,4899,257863,184,4292,30093,2965626,56.48,109581085,351.873,25.2,4.803,7599.188,370.437,7.07,0.699,3
152,167,3353,261216,79,4371,28902,2994528,56.48,109581085,351.873,25.2,4.803,7599.188,370.437,7.07,0.699,3
152,168,4672,265888,259,4630,35000,3029528,56.48,109581085,351.873,25.2,4.803,7599.188,370.437,7.07,0.699,3
152,169,3519,269407,33,4663,37347,3066875,56.48,109581085,351.873,25.2,4.803,7599.188,370.437,7.07,0.699,3
152,170,3527,272934,69,4732,39260,3106135,56.48,109581085,351.873,25.2,4.803,7599.188,370.437,7.07,0.699,3
152,171,3355,276289,53,4785,41469,3147604,56.48,109581085,351.873,25.2,4.803,7599.188,370.437,7.07,0.699,3
152,172,3237,279526,45,4830,38324,3185928,56.48,109581085,351.873,25.2,4.803,7599.188,370.437,7.07,0.699,3
152,173,3934,283460,100,4930,25781,3211709,56.48,109581085,351.873,25.2,4.803,7599.188,370.437,7.07,0.699,3
152,174,3283,286743,54,4984,29301,3241010,54.63,109581085,351.873,25.2,4.803,7599.188,370.437,7.07,0.699,3
152,175,3447,290190,15,4999,33901,3274911,54.63,109581085,351.873,25.2,4.803,7599.188,370.437,7.07,0.699,3
152,176,1599,291789,50,5049,38200,3313111,54.63,109581085,351.873,25.2,4.803,7599.188,370.437,7.07,0.699,3
152,177,2802,294591,42,5091,39433,3352544,54.63,109581085,351.873,25.2,4.803,7599.188,370.437,7.07,0.699,3
152,178,2164,296755,36,5127,37123,3389667,54.63,109581085,351.873,25.2,4.803,7599.188,370.437,7.07,0.699,3
152,179,2606,299361,69,5196,36798,3426465,54.63,109581085,351.873,25.2,4.803,7599.188,370.437,7.07,0.699,3
152,180,1895,301256,88,5284,27640,3454105,54.63,109581085,351.873,25.2,4.803,7599.188,370.437,7.07,0.699,3
152,181,2970,304226,60,5344,25939,3480044,54.63,109581085,351.873,25.2,4.803,7599.188,370.437,7.07,0.699,3
152,182,3062,307288,37,5381,32628,3512672,54.63,109581085,351.873,25.2,4.803,7599.188,370.437,7.07,0.699,3
152,183,2015,309303,67,5448,37575,3550247,54.63,109581085,351.873,25.2,4.803,7599.188,370.437,7.07,0.699,3
152,184,0,309303,0,5448,39132,3589379,58.33,109581085,351.873,25.2,4.803,7599.188,370.437,7.07,0.699,3
152,185,4776,314079,114,5562,37749,3627128,58.33,109581085,351.873,25.2,4.803,7599.188,370.437,7.07,0.699,3
152,186,2599,316678,54,5616,38452,3665580,58.33,109581085,351.873,25.2,4.803,7599.188,370.437,7.07,0.699,3
152,187,2652,319330,62,5678,26775,3692355,58.33,109581085,351.873,25.2,4.803,7599.188,370.437,7.07,0.699,3
152,188,3167,322497,98,5776,29117,3721472,47.22,109581085,351.873,25.2,4.803,7599.188,370.437,7.07,0.699,3
152,189,2265,324762,64,5840,33949,3755421,47.22,109581085,351.873,25.2,4.803,7599.188,370.437,7.07,0.699,3
152,190,2071,326833,25,5865,36891,3792312,47.22,109581085,351.873,25.2,4.803,7599.188,370.437,7.07,0.699,3
152,191,2804,329637,60,5925,35525,3827837,47.22,109581085,351.873,25.2,4.803,7599.188,370.437,7.07,0.699,3
152,192,2232,331869,144,6069,38088,3865925,47.22,109581085,351.873,25.2,4.803,7599.188,370.437,7.07,0.699,3
152,193,2901,334770,83,6152,39137,3905062,47.22,109581085,351.873,25.2,4.803,7599.188,370.437,7.07,0.699,3
152,194,2156,336926,86,6238,29526,3934588,47.22,109581085,351.873,25.2,4.803,7599.188,370.437,7.07,0.699,3
152,195,2415,339341,83,6321,26395,3960983,47.22,109581085,351.873,25.2,4.803,7599.188,370.437,7.07,0.699,3
152,196,3475,342816,11,6332,33428,3994411,47.22,109581085,351.873,25.2,4.803,7599.188,370.437,7.07,0.699,3
152,197,1897,344713,40,6372,36404,4030815,47.22,109581085,351.873,25.2,4.803,7599.188,370.437,7.07,0.699,3
152,198,1823,346536,77,6449,37202,4068017,47.22,109581085,351.873,25.2,4.803,7599.188,370.437,7.07,0.699,3
152,199,2162,348698,48,6497,28191,4096208,47.22,109581085,351.873,25.2,4.803,7599.188,370.437,7.07,0.699,3
152,200,3052,351750,34,6531,28787,4124995,47.22,109581085,351.873,25.2,4.803,7599.188,370.437,7.07,0.699,3
152,201,2588,354338,72,6603,17200,4142195,47.22,109581085,351.873,25.2,4.803,7599.188,370.437,7.07,0.699,3
152,202,2280,356618,49,6652,0,4142195,47.22,109581085,351.873,25.2,4.803,7599.188,370.437,7.07,0.699,3
152,203,2551,359169,23,6675,0,4142195,47.22,109581085,351.873,25.2,4.803,7599.188,370.437,7.07,0.699,3
152,204,1606,360775,15,6690,0,4142195,47.22,109581085,351.873,25.2,4.803,7599.188,370.437,7.07,0.699,3
153,1,256,2311,2,33,0,0,81.48,37846605,124.027,41.8,16.763,27216.445,227.331,5.91,0.865,4
153,2,243,2554,10,43,0,0,81.48,37846605,124.027,41.8,16.763,27216.445,227.331,5.91,0.865,4
153,3,392,2946,14,57,0,0,81.48,37846605,124.027,41.8,16.763,27216.445,227.331,5.91,0.865,4
153,4,437,3383,14,71,0,0,81.48,37846605,124.027,41.8,16.763,27216.445,227.331,5.91,0.865,4
153,5,244,3627,8,79,0,0,81.48,37846605,124.027,41.8,16.763,27216.445,227.331,5.91,0.865,4
153,6,475,4102,15,94,0,0,81.48,37846605,124.027,41.8,16.763,27216.445,227.331,5.91,0.865,4
153,7,311,4413,13,107,0,0,81.48,37846605,124.027,41.8,16.763,27216.445,227.331,5.91,0.865,4
153,8,435,4848,22,129,0,0,81.48,37846605,124.027,41.8,16.763,27216.445,227.331,5.91,0.865,4
153,9,357,5205,30,159,0,0,83.33,37846605,124.027,41.8,16.763,27216.445,227.331,5.91,0.865,4
153,10,370,5575,15,174,0,0,83.33,37846605,124.027,41.8,16.763,27216.445,227.331,5.91,0.865,4
153,11,380,5955,7,181,0,0,83.33,37846605,124.027,41.8,16.763,27216.445,227.331,5.91,0.865,4
153,12,401,6356,27,208,0,0,83.33,37846605,124.027,41.8,16.763,27216.445,227.331,5.91,0.865,4
153,13,318,6674,24,232,0,0,83.33,37846605,124.027,41.8,16.763,27216.445,227.331,5.91,0.865,4
153,14,260,6934,13,245,0,0,83.33,37846605,124.027,41.8,16.763,27216.445,227.331,5.91,0.865,4
153,15,268,7202,18,263,0,0,83.33,37846605,124.027,41.8,16.763,27216.445,227.331,5.91,0.865,4
153,16,380,7582,23,286,0,0,83.33,37846605,124.027,41.8,16.763,27216.445,227.331,5.91,0.865,4
153,17,336,7918,28,314,0,0,83.33,37846605,124.027,41.8,16.763,27216.445,227.331,5.91,0.865,4
153,18,461,8379,18,332,0,0,83.33,37846605,124.027,41.8,16.763,27216.445,227.331,5.91,0.865,4
153,19,363,8742,15,347,0,0,83.33,37846605,124.027,41.8,16.763,27216.445,227.331,5.91,0.865,4
153,20,545,9287,13,360,0,0,83.33,37846605,124.027,41.8,16.763,27216.445,227.331,5.91,0.865,4
153,21,306,9593,20,380,0,0,83.33,37846605,124.027,41.8,16.763,27216.445,227.331,5.91,0.865,4
153,22,263,9856,21,401,0,0,83.33,37846605,124.027,41.8,16.763,27216.445,227.331,5.91,0.865,4
153,23,313,10169,25,426,0,0,83.33,37846605,124.027,41.8,16.763,27216.445,227.331,5.91,0.865,4
153,24,342,10511,28,454,0,0,83.33,37846605,124.027,41.8,16.763,27216.445,227.331,5.91,0.865,4
153,25,381,10892,40,494,0,0,83.33,37846605,124.027,41.8,16.763,27216.445,227.331,5.91,0.865,4
153,26,381,11273,30,524,0,0,83.33,37846605,124.027,41.8,16.763,27216.445,227.331,5.91,0.865,4
153,27,344,11617,11,535,0,0,83.33,37846605,124.027,41.8,16.763,27216.445,227.331,5.91,0.865,4
153,28,285,11902,27,562,0,281787,83.33,37846605,124.027,41.8,16.763,27216.445,227.331,5.91,0.865,4
153,29,316,12218,34,596,12802,294589,83.33,37846605,124.027,41.8,16.763,27216.445,227.331,5.91,0.865,4
153,30,422,12640,28,624,12509,307098,83.33,37846605,124.027,41.8,16.763,27216.445,227.331,5.91,0.865,4
153,31,237,12877,20,644,15651,322749,83.33,37846605,124.027,41.8,16.763,27216.445,227.331,5.91,0.865,4
153,32,228,13105,7,651,10613,333362,83.33,37846605,124.027,41.8,16.763,27216.445,227.331,5.91,0.865,4
153,33,270,13375,13,664,9382,342744,83.33,37846605,124.027,41.8,16.763,27216.445,227.331,5.91,0.865,4
153,34,318,13693,14,678,7304,350048,83.33,37846605,124.027,41.8,16.763,27216.445,227.331,5.91,0.865,4
153,35,313,14006,20,698,9642,359690,83.33,37846605,124.027,41.8,16.763,27216.445,227.331,5.91,0.865,4
153,36,425,14431,18,716,15004,374694,83.33,37846605,124.027,41.8,16.763,27216.445,227.331,5.91,0.865,4
153,37,309,14740,17,733,14382,389076,83.33,37846605,124.027,41.8,16.763,27216.445,227.331,5.91,0.865,4
153,38,307,15047,22,755,16206,405282,83.33,37846605,124.027,41.8,16.763,27216.445,227.331,5.91,0.865,4
153,39,319,15366,21,776,15886,421168,83.33,37846605,124.027,41.8,16.763,27216.445,227.331,5.91,0.865,4
153,40,285,15651,9,785,15473,436641,83.33,37846605,124.027,41.8,16.763,27216.445,227.331,5.91,0.865,4
153,41,345,15996,15,800,13613,450254,83.33,37846605,124.027,41.8,16.763,27216.445,227.331,5.91,0.865,4
153,42,330,16326,11,811,15722,465976,83.33,37846605,124.027,41.8,16.763,27216.445,227.331,5.91,0.865,4
153,43,595,16921,28,839,19193,485169,83.33,37846605,124.027,41.8,16.763,27216.445,227.331,5.91,0.865,4
153,44,283,17204,22,861,21564,506733,83.33,37846605,124.027,41.8,16.763,27216.445,227.331,5.91,0.865,4
153,45,411,17615,22,883,20162,526895,83.33,37846605,124.027,41.8,16.763,27216.445,227.331,5.91,0.865,4
153,46,401,18016,24,907,22897,549792,83.33,37846605,124.027,41.8,16.763,27216.445,227.331,5.91,0.865,4
153,47,241,18257,8,915,17263,567055,83.33,37846605,124.027,41.8,16.763,27216.445,227.331,5.91,0.865,4
153,48,272,18529,10,925,14416,581471,83.33,37846605,124.027,41.8,16.763,27216.445,227.331,5.91,0.865,4
153,49,356,18885,11,936,16254,597725,83.33,37846605,124.027,41.8,16.763,27216.445,227.331,5.91,0.865,4
153,50,383,19268,12,948,20242,617967,83.33,37846605,124.027,41.8,16.763,27216.445,227.331,5.91,0.865,4
153,51,471,19739,14,962,21556,639523,83.33,37846605,124.027,41.8,16.763,27216.445,227.331,5.91,0.865,4
153,52,404,20143,10,972,21277,660800,83.33,37846605,124.027,41.8,16.763,27216.445,227.331,5.91,0.865,4
153,53,476,20619,10,982,26280,687080,83.33,37846605,124.027,41.8,16.763,27216.445,227.331,5.91,0.865,4
153,54,312,20931,11,993,14889,701969,83.33,37846605,124.027,41.8,16.763,27216.445,227.331,5.91,0.865,4
153,55,395,21326,3,996,10706,712675,79.63,37846605,124.027,41.8,16.763,27216.445,227.331,5.91,0.865,4
153,56,305,21631,11,1007,21026,733701,79.63,37846605,124.027,41.8,16.763,27216.445,227.331,5.91,0.865,4
153,57,443,22074,17,1024,19974,753675,79.63,37846605,124.027,41.8,16.763,27216.445,227.331,5.91,0.865,4
153,58,399,22473,4,1028,19950,773625,79.63,37846605,124.027,41.8,16.763,27216.445,227.331,5.91,0.865,4
153,59,352,22825,10,1038,24851,798476,79.63,37846605,124.027,41.8,16.763,27216.445,227.331,5.91,0.865,4
153,60,330,23155,13,1051,23335,821811,64.81,37846605,124.027,41.8,16.763,27216.445,227.331,5.91,0.865,4
153,61,416,23571,10,1061,14487,836298,64.81,37846605,124.027,41.8,16.763,27216.445,227.331,5.91,0.865,4
153,62,215,23786,3,1064,14119,850417,64.81,37846605,124.027,41.8,16.763,27216.445,227.331,5.91,0.865,4
153,63,379,24165,10,1074,12466,862883,53.7,37846605,124.027,41.8,16.763,27216.445,227.331,5.91,0.865,4
153,64,230,24395,18,1092,19024,881907,53.7,37846605,124.027,41.8,16.763,27216.445,227.331,5.91,0.865,4
153,65,292,24687,23,1115,21579,903486,53.7,37846605,124.027,41.8,16.763,27216.445,227.331,5.91,0.865,4
153,66,361,25048,2,1117,21410,924896,53.7,37846605,124.027,41.8,16.763,27216.445,227.331,5.91,0.865,4
153,67,371,25419,20,1137,20752,945648,53.7,37846605,124.027,41.8,16.763,27216.445,227.331,5.91,0.865,4
153,68,567,25986,16,1153,15664,961312,53.7,37846605,124.027,41.8,16.763,27216.445,227.331,5.91,0.865,4
153,69,575,26561,4,1157,12241,973553,53.7,37846605,124.027,41.8,16.763,27216.445,227.331,5.91,0.865,4
153,70,599,27160,9,1166,14798,988351,53.7,37846605,124.027,41.8,16.763,27216.445,227.331,5.91,0.865,4
153,71,400,27560,17,1183,19368,1007719,53.7,37846605,124.027,41.8,16.763,27216.445,227.331,5.91,0.865,4
153,72,197,27757,23,1206,16542,1024261,53.7,37846605,124.027,41.8,16.763,27216.445,227.331,5.91,0.865,4
153,73,444,28201,9,1215,19378,1043639,53.7,37846605,124.027,41.8,16.763,27216.445,227.331,5.91,0.865,4
153,74,376,28577,7,1222,15563,1059202,53.7,37846605,124.027,41.8,16.763,27216.445,227.331,5.91,0.865,4
153,75,440,29017,15,1237,17049,1076251,53.7,37846605,124.027,41.8,16.763,27216.445,227.331,5.91,0.865,4
153,76,375,29392,10,1247,10676,1086927,50.93,37846605,124.027,41.8,16.763,27216.445,227.331,5.91,0.865,4
153,77,396,29788,9,1256,16403,1103330,50.93,37846605,124.027,41.8,16.763,27216.445,227.331,5.91,0.865,4
153,78,407,30195,16,1272,22982,1126312,50.93,37846605,124.027,41.8,16.763,27216.445,227.331,5.91,0.865,4
153,79,506,30701,14,1286,20906,1147218,50.93,37846605,124.027,41.8,16.763,27216.445,227.331,5.91,0.865,4
153,80,314,31015,30,1316,23543,1170761,50.93,37846605,124.027,41.8,16.763,27216.445,227.331,5.91,0.865,4
153,81,301,31316,18,1334,19640,1190401,50.93,37846605,124.027,41.8,16.763,27216.445,227.331,5.91,0.865,4
153,82,304,31620,12,1346,18231,1208632,50.93,37846605,124.027,41.8,16.763,27216.445,227.331,5.91,0.865,4
153,83,311,31931,10,1356,11041,1219673,50.93,37846605,124.027,41.8,16.763,27216.445,227.331,5.91,0.865,4
153,84,296,32227,3,1359,18077,1237750,50.93,37846605,124.027,41.8,16.763,27216.445,227.331,5.91,0.865,4
153,85,300,32527,16,1375,19251,1257001,50.93,37846605,124.027,41.8,16.763,27216.445,227.331,5.91,0.865,4
153,86,294,32821,21,1396,21453,1278454,50.93,37846605,124.027,41.8,16.763,27216.445,227.331,5.91,0.865,4
153,87,298,33119,16,1412,18336,1296790,50.93,37846605,124.027,41.8,16.763,27216.445,227.331,5.91,0.865,4
153,88,276,33395,17,1429,19143,1315933,50.93,37846605,124.027,41.8,16.763,27216.445,227.331,5.91,0.865,4
153,89,319,33714,6,1435,14818,1330751,50.93,37846605,124.027,41.8,16.763,27216.445,227.331,5.91,0.865,4
153,90,193,33907,3,1438,7752,1338503,50.93,37846605,124.027,41.8,16.763,27216.445,227.331,5.91,0.865,4
153,91,247,34154,6,1444,17807,1356310,50.93,37846605,124.027,41.8,16.763,27216.445,227.331,5.91,0.865,4
153,92,239,34393,19,1463,21064,1377374,50.93,37846605,124.027,41.8,16.763,27216.445,227.331,5.91,0.865,4
153,93,382,34775,14,1477,18803,1396177,50.93,37846605,124.027,41.8,16.763,27216.445,227.331,5.91,0.865,4
153,94,371,35146,15,1492,23257,1419434,50.93,37846605,124.027,41.8,16.763,27216.445,227.331,5.91,0.865,4
153,95,259,35405,15,1507,18415,1437849,50.93,37846605,124.027,41.8,16.763,27216.445,227.331,5.91,0.865,4
153,96,314,35719,5,1512,14938,1452787,50.93,37846605,124.027,41.8,16.763,27216.445,227.331,5.91,0.865,4
153,97,231,35950,5,1517,12125,1464912,50.93,37846605,124.027,41.8,16.763,27216.445,227.331,5.91,0.865,4
153,98,205,36155,4,1521,16307,1481219,50.93,37846605,124.027,41.8,16.763,27216.445,227.331,5.91,0.865,4
153,99,257,36412,7,1528,29354,1510573,50.93,37846605,124.027,41.8,16.763,27216.445,227.331,5.91,0.865,4
153,100,277,36689,14,1542,18781,1529354,39.81,37846605,124.027,41.8,16.763,27216.445,227.331,5.91,0.865,4
153,101,262,36951,9,1551,19352,1548706,39.81,37846605,124.027,41.8,16.763,27216.445,227.331,5.91,0.865,4
153,102,265,37216,11,1562,32734,1581440,39.81,37846605,124.027,41.8,16.763,27216.445,227.331,5.91,0.865,4
153,103,305,37521,6,1568,13195,1594635,39.81,37846605,124.027,41.8,16.763,27216.445,227.331,5.91,0.865,4
153,104,370,37891,3,1571,10709,1605344,39.81,37846605,124.027,41.8,16.763,27216.445,227.331,5.91,0.865,4
153,105,299,38190,5,1576,16628,1621972,39.81,37846605,124.027,41.8,16.763,27216.445,227.331,5.91,0.865,4
153,106,267,38457,12,1588,19918,1641890,39.81,37846605,124.027,41.8,16.763,27216.445,227.331,5.91,0.865,4
153,107,323,38780,6,1594,20016,1661906,39.81,37846605,124.027,41.8,16.763,27216.445,227.331,5.91,0.865,4
153,108,274,39054,11,1605,20567,1682473,39.81,37846605,124.027,41.8,16.763,27216.445,227.331,5.91,0.865,4
153,109,353,39407,7,1612,18927,1701400,39.81,37846605,124.027,41.8,16.763,27216.445,227.331,5.91,0.865,4
153,110,339,39746,6,1618,13956,1715356,39.81,37846605,124.027,41.8,16.763,27216.445,227.331,5.91,0.865,4
153,111,358,40104,6,1624,10091,1725447,39.81,37846605,124.027,41.8,16.763,27216.445,227.331,5.91,0.865,4
153,112,279,40383,3,1627,16162,1741609,39.81,37846605,124.027,41.8,16.763,27216.445,227.331,5.91,0.865,4
153,113,399,40782,9,1636,19656,1761265,39.81,37846605,124.027,41.8,16.763,27216.445,227.331,5.91,0.865,4
153,114,380,41162,6,1642,20985,1782250,39.81,37846605,124.027,41.8,16.763,27216.445,227.331,5.91,0.865,4
153,115,418,41580,9,1651,18098,1800348,39.81,37846605,124.027,41.8,16.763,27216.445,227.331,5.91,0.865,4
153,116,458,42038,4,1655,20010,1820358,39.81,37846605,124.027,41.8,16.763,27216.445,227.331,5.91,0.865,4
153,117,584,42622,9,1664,0,1820358,39.81,37846605,124.027,41.8,16.763,27216.445,227.331,5.91,0.865,4
153,118,443,43065,7,1671,0,1847663,39.81,37846605,124.027,41.8,16.763,27216.445,227.331,5.91,0.865,4
153,119,337,43402,5,1676,16440,1864103,39.81,37846605,124.027,41.8,16.763,27216.445,227.331,5.91,0.865,4
153,120,502,43904,6,1682,22969,1887072,39.81,37846605,124.027,41.8,16.763,27216.445,227.331,5.91,0.865,4
153,121,512,44416,12,1694,22108,1909180,39.81,37846605,124.027,41.8,16.763,27216.445,227.331,5.91,0.865,4
153,122,615,45031,15,1709,22394,1931574,39.81,37846605,124.027,41.8,16.763,27216.445,227.331,5.91,0.865,4
153,123,657,45688,7,1716,21262,1952836,39.81,37846605,124.027,41.8,16.763,27216.445,227.331,5.91,0.865,4
153,124,658,46346,5,1721,16734,1969570,39.81,37846605,124.027,41.8,16.763,27216.445,227.331,5.91,0.865,4
153,125,548,46894,10,1731,11071,1980641,39.81,37846605,124.027,41.8,16.763,27216.445,227.331,5.91,0.865,4
153,126,575,47469,1,1732,18888,1999529,39.81,37846605,124.027,41.8,16.763,27216.445,227.331,5.91,0.865,4
153,127,680,48149,6,1738,28422,2027951,39.81,37846605,124.027,41.8,16.763,27216.445,227.331,5.91,0.865,4
153,128,640,48789,18,1756,21278,2049229,39.81,37846605,124.027,41.8,16.763,27216.445,227.331,5.91,0.865,4
153,129,726,49515,18,1774,25244,2074473,39.81,37846605,124.027,41.8,16.763,27216.445,227.331,5.91,0.865,4
153,130,809,50324,13,1787,28307,2102780,39.81,37846605,124.027,41.8,16.763,27216.445,227.331,5.91,0.865,4
153,131,843,51167,13,1800,20842,2123622,39.81,37846605,124.027,41.8,16.763,27216.445,227.331,5.91,0.865,4
153,132,624,51791,7,1807,14399,2138021,39.81,37846605,124.027,41.8,16.763,27216.445,227.331,5.91,0.865,4
153,133,619,52410,2,1809,20511,2158532,39.81,37846605,124.027,41.8,16.763,27216.445,227.331,5.91,0.865,4
153,134,551,52961,12,1821,23495,2182027,39.81,37846605,124.027,41.8,16.763,27216.445,227.331,5.91,0.865,4
153,135,715,53676,9,1830,25177,2207204,39.81,37846605,124.027,41.8,16.763,27216.445,227.331,5.91,0.865,4
153,136,811,54487,14,1844,25792,2232996,39.81,37846605,124.027,41.8,16.763,27216.445,227.331,5.91,0.865,4
153,137,832,55319,14,1858,23730,2256726,39.81,37846605,124.027,41.8,16.763,27216.445,227.331,5.91,0.865,4
153,138,771,56090,11,1869,16004,2272730,39.81,37846605,124.027,41.8,16.763,27216.445,227.331,5.91,0.865,4
153,139,594,56684,8,1877,12778,2285508,39.81,37846605,124.027,41.8,16.763,27216.445,227.331,5.91,0.865,4
153,140,595,57279,8,1885,19884,2305392,39.81,37846605,124.027,41.8,16.763,27216.445,227.331,5.91,0.865,4
153,141,597,57876,11,1896,27734,2333126,39.81,37846605,124.027,41.8,16.763,27216.445,227.331,5.91,0.865,4
153,142,735,58611,17,1913,24646,2357772,39.81,37846605,124.027,41.8,16.763,27216.445,227.331,5.91,0.865,4
153,143,767,59378,12,1925,28666,2386438,39.81,37846605,124.027,41.8,16.763,27216.445,227.331,5.91,0.865,4
153,144,903,60281,13,1938,24793,2411231,39.81,37846605,124.027,41.8,16.763,27216.445,227.331,5.91,0.865,4
153,145,900,61181,13,1951,18983,2430214,39.81,37846605,124.027,41.8,16.763,27216.445,227.331,5.91,0.865,4
153,146,581,61762,4,1955,15332,2445546,39.81,37846605,124.027,41.8,16.763,27216.445,227.331,5.91,0.865,4
153,147,548,62310,5,1960,21982,2467528,39.81,37846605,124.027,41.8,16.763,27216.445,227.331,5.91,0.865,4
153,148,763,63073,17,1977,28311,2495839,39.81,37846605,124.027,41.8,16.763,27216.445,227.331,5.91,0.865,4
153,149,729,63802,17,1994,27110,2522949,39.81,37846605,124.027,41.8,16.763,27216.445,227.331,5.91,0.865,4
153,150,887,64689,16,2010,24782,2547731,39.81,37846605,124.027,41.8,16.763,27216.445,227.331,5.91,0.865,4
153,151,791,65480,8,2018,21075,2568806,39.81,37846605,124.027,41.8,16.763,27216.445,227.331,5.91,0.865,4
153,152,759,66239,14,2032,18753,2587559,39.81,37846605,124.027,41.8,16.763,27216.445,227.331,5.91,0.865,4
153,153,631,66870,1,2033,12010,2599569,39.81,37846605,124.027,41.8,16.763,27216.445,227.331,5.91,0.865,4
153,154,502,67372,6,2039,28703,2628272,37.96,37846605,124.027,41.8,16.763,27216.445,227.331,5.91,0.865,4
153,155,550,67922,19,2058,24354,2652626,37.96,37846605,124.027,41.8,16.763,27216.445,227.331,5.91,0.865,4
153,156,595,68517,20,2078,23972,2676598,37.96,37846605,124.027,41.8,16.763,27216.445,227.331,5.91,0.865,4
153,157,612,69129,14,2092,21745,2698343,37.96,37846605,124.027,41.8,16.763,27216.445,227.331,5.91,0.865,4
153,158,691,69820,8,2100,24819,2723162,37.96,37846605,124.027,41.8,16.763,27216.445,227.331,5.91,0.865,4
153,159,567,70387,13,2113,18226,2741388,37.96,37846605,124.027,41.8,16.763,27216.445,227.331,5.91,0.865,4
153,160,437,70824,7,2120,10025,2751413,37.96,37846605,124.027,41.8,16.763,27216.445,227.331,5.91,0.865,4
153,161,302,71126,4,2124,18195,2769608,37.96,37846605,124.027,41.8,16.763,27216.445,227.331,5.91,0.865,4
153,162,400,71526,12,2136,22779,2792387,37.96,37846605,124.027,41.8,16.763,27216.445,227.331,5.91,0.865,4
153,163,421,71947,11,2147,18014,2810401,37.96,37846605,124.027,41.8,16.763,27216.445,227.331,5.91,0.865,4
153,164,506,72453,12,2159,18715,2829116,37.96,37846605,124.027,41.8,16.763,27216.445,227.331,5.91,0.865,4
153,165,594,73047,10,2169,20291,2849407,37.96,37846605,124.027,41.8,16.763,27216.445,227.331,5.91,0.865,4
153,166,603,73650,13,2182,14159,2863566,37.96,37846605,124.027,41.8,16.763,27216.445,227.331,5.91,0.865,4
153,167,502,74152,6,2188,12109,2875675,37.96,37846605,124.027,41.8,16.763,27216.445,227.331,5.91,0.865,4
153,168,377,74529,15,2203,17925,2893600,37.96,37846605,124.027,41.8,16.763,27216.445,227.331,5.91,0.865,4
153,169,605,75134,24,2227,21367,2914967,37.96,37846605,124.027,41.8,16.763,27216.445,227.331,5.91,0.865,4
153,170,600,75734,10,2237,21873,2936840,37.96,37846605,124.027,41.8,16.763,27216.445,227.331,5.91,0.865,4
153,171,837,76571,16,2253,20190,2957030,19.44,37846605,124.027,41.8,16.763,27216.445,227.331,5.91,0.865,4
153,172,757,77328,17,2270,19497,2976527,19.44,37846605,124.027,41.8,16.763,27216.445,227.331,5.91,0.865,4
153,173,1002,78330,12,2282,18604,2995131,19.44,37846605,124.027,41.8,16.763,27216.445,227.331,5.91,0.865,4
153,174,910,79240,11,2293,11842,3006973,19.44,37846605,124.027,41.8,16.763,27216.445,227.331,5.91,0.865,4
153,175,748,79988,5,2298,20145,3027118,19.44,37846605,124.027,41.8,16.763,27216.445,227.331,5.91,0.865,4
153,176,711,80699,18,2316,21230,3048348,19.44,37846605,124.027,41.8,16.763,27216.445,227.331,5.91,0.865,4
153,177,974,81673,28,2344,23370,3071718,19.44,37846605,124.027,41.8,16.763,27216.445,227.331,5.91,0.865,4
153,178,1136,82809,25,2369,23655,3095373,19.44,37846605,124.027,41.8,16.763,27216.445,227.331,5.91,0.865,4
153,179,1587,84396,23,2392,22394,3117767,19.44,37846605,124.027,41.8,16.763,27216.445,227.331,5.91,0.865,4
153,180,1584,85980,32,2424,18530,3136297,19.44,37846605,124.027,41.8,16.763,27216.445,227.331,5.91,0.865,4
153,181,1350,87330,8,2432,12904,3149201,19.44,37846605,124.027,41.8,16.763,27216.445,227.331,5.91,0.865,4
153,182,1306,88636,15,2447,22361,3171562,19.44,37846605,124.027,41.8,16.763,27216.445,227.331,5.91,0.865,4
153,183,1326,89962,36,2483,26074,3197636,19.44,37846605,124.027,41.8,16.763,27216.445,227.331,5.91,0.865,4
153,184,1552,91514,30,2513,28959,3226595,19.44,37846605,124.027,41.8,16.763,27216.445,227.331,5.91,0.865,4
153,185,1967,93481,30,2543,26500,3253095,19.44,37846605,124.027,41.8,16.763,27216.445,227.331,5.91,0.865,4
153,186,2292,95773,27,2570,29446,3282541,19.44,37846605,124.027,41.8,16.763,27216.445,227.331,5.91,0.865,4
153,187,2367,98140,34,2604,25254,3307795,19.44,37846605,124.027,41.8,16.763,27216.445,227.331,5.91,0.865,4
153,188,0,98140,0,2604,17718,3325513,19.44,37846605,124.027,41.8,16.763,27216.445,227.331,5.91,0.865,4
153,189,3940,102080,55,2659,23296,3348809,19.44,37846605,124.027,41.8,16.763,27216.445,227.331,5.91,0.865,4
153,190,2236,104316,58,2717,32418,3381227,19.44,37846605,124.027,41.8,16.763,27216.445,227.331,5.91,0.865,4
153,191,3003,107319,75,2792,42748,3423975,19.44,37846605,124.027,41.8,16.763,27216.445,227.331,5.91,0.865,4
153,192,4280,111599,75,2867,31036,3455011,19.44,37846605,124.027,41.8,16.763,27216.445,227.331,5.91,0.865,4
153,193,4739,116338,52,2919,35959,3490970,33.33,37846605,124.027,41.8,16.763,27216.445,227.331,5.91,0.865,4
153,194,5300,121638,53,2972,30287,3521257,33.33,37846605,124.027,41.8,16.763,27216.445,227.331,5.91,0.865,4
153,195,4178,125816,32,3004,24229,3545486,33.33,37846605,124.027,41.8,16.763,27216.445,227.331,5.91,0.865,4
153,196,4394,130210,35,3039,32381,3577867,33.33,37846605,124.027,41.8,16.763,27216.445,227.331,5.91,0.865,4
153,197,5068,135278,62,3101,42705,3620572,33.33,37846605,124.027,41.8,16.763,27216.445,227.331,5.91,0.865,4
153,198,6526,141804,116,3217,62215,3682787,33.33,37846605,124.027,41.8,16.763,27216.445,227.331,5.91,0.865,4
153,199,8099,149903,91,3308,49400,3732187,33.33,37846605,124.027,41.8,16.763,27216.445,227.331,5.91,0.865,4
153,200,7705,157608,132,3440,47604,3779791,29.17,37846605,124.027,41.8,16.763,27216.445,227.331,5.91,0.865,4
153,201,9622,167230,84,3524,34873,3814664,29.17,37846605,124.027,41.8,16.763,27216.445,227.331,5.91,0.865,4
153,202,8536,175766,49,3573,0,3814664,34.72,37846605,124.027,41.8,16.763,27216.445,227.331,5.91,0.865,4
153,203,7482,183248,41,3614,0,3814664,34.72,37846605,124.027,41.8,16.763,27216.445,227.331,5.91,0.865,4
153,204,9291,192539,107,3721,0,3814664,34.72,37846605,124.027,41.8,16.763,27216.445,227.331,5.91,0.865,4
154,1,1035,7443,20,160,8630,88539,82.41,10196707,112.371,46.2,21.502,27936.896,127.842,9.85,0.847,0
154,2,808,8251,27,187,9257,97796,82.41,10196707,112.371,46.2,21.502,27936.896,127.842,9.85,0.847,0
154,3,783,9034,22,209,9438,107234,82.41,10196707,112.371,46.2,21.502,27936.896,127.842,9.85,0.847,0
154,4,852,9886,37,246,9055,116289,82.41,10196707,112.371,46.2,21.502,27936.896,127.842,9.85,0.847,0
154,5,638,10524,20,266,6716,123005,82.41,10196707,112.371,46.2,21.502,27936.896,127.842,9.85,0.847,0
154,6,754,11278,29,295,9186,132191,82.41,10196707,112.371,46.2,21.502,27936.896,127.842,9.85,0.847,0
154,7,452,11730,16,311,10557,142748,82.41,10196707,112.371,46.2,21.502,27936.896,127.842,9.85,0.847,0
154,8,712,12442,34,345,11402,154150,82.41,10196707,112.371,46.2,21.502,27936.896,127.842,9.85,0.847,0
154,9,699,13141,35,380,12209,166359,87.96,10196707,112.371,46.2,21.502,27936.896,127.842,9.85,0.847,0
154,10,815,13956,29,409,10187,176546,87.96,10196707,112.371,46.2,21.502,27936.896,127.842,9.85,0.847,0
154,11,1516,15472,26,435,9101,185647,87.96,10196707,112.371,46.2,21.502,27936.896,127.842,9.85,0.847,0
154,12,515,15987,35,470,5210,190857,87.96,10196707,112.371,46.2,21.502,27936.896,127.842,9.85,0.847,0
154,13,598,16585,34,504,8887,199744,87.96,10196707,112.371,46.2,21.502,27936.896,127.842,9.85,0.847,0
154,14,349,16934,31,535,11920,211664,82.41,10196707,112.371,46.2,21.502,27936.896,127.842,9.85,0.847,0
154,15,514,17448,32,567,13628,225292,82.41,10196707,112.371,46.2,21.502,27936.896,127.842,9.85,0.847,0
154,16,643,18091,32,599,13400,238692,82.41,10196707,112.371,46.2,21.502,27936.896,127.842,9.85,0.847,0
154,17,750,18841,30,629,14717,253409,82.41,10196707,112.371,46.2,21.502,27936.896,127.842,9.85,0.847,0
154,18,181,19022,28,657,12779,266188,82.41,10196707,112.371,46.2,21.502,27936.896,127.842,9.85,0.847,0
154,19,663,19685,30,687,9502,275690,82.41,10196707,112.371,46.2,21.502,27936.896,127.842,9.85,0.847,0
154,20,521,20206,27,714,11003,286693,82.41,10196707,112.371,46.2,21.502,27936.896,127.842,9.85,0.847,0
154,21,657,20863,21,735,14829,301522,82.41,10196707,112.371,46.2,21.502,27936.896,127.842,9.85,0.847,0
154,22,516,21379,27,762,15432,316954,82.41,10196707,112.371,46.2,21.502,27936.896,127.842,9.85,0.847,0
154,23,603,21982,23,785,15091,332045,82.41,10196707,112.371,46.2,21.502,27936.896,127.842,9.85,0.847,0
154,24,371,22353,35,820,14725,346770,82.41,10196707,112.371,46.2,21.502,27936.896,127.842,9.85,0.847,0
154,25,918,23271,60,880,13440,360210,82.41,10196707,112.371,46.2,21.502,27936.896,127.842,9.85,0.847,0
154,26,412,23683,23,903,8235,368445,82.41,10196707,112.371,46.2,21.502,27936.896,127.842,9.85,0.847,0
154,27,163,23846,25,928,12148,380593,82.41,10196707,112.371,46.2,21.502,27936.896,127.842,9.85,0.847,0
154,28,298,24144,20,948,15504,396097,82.41,10196707,112.371,46.2,21.502,27936.896,127.842,9.85,0.847,0
154,29,180,24324,25,973,14768,410865,82.41,10196707,112.371,46.2,21.502,27936.896,127.842,9.85,0.847,0
154,30,368,24692,16,989,16373,427238,82.41,10196707,112.371,46.2,21.502,27936.896,127.842,9.85,0.847,0
154,31,295,24987,18,1007,12652,439890,87.96,10196707,112.371,46.2,21.502,27936.896,127.842,9.85,0.847,0
154,32,364,25351,0,1007,10533,450423,87.96,10196707,112.371,46.2,21.502,27936.896,127.842,9.85,0.847,0
154,33,-161,25190,16,1023,8399,458822,87.96,10196707,112.371,46.2,21.502,27936.896,127.842,9.85,0.847,0
154,34,334,25524,40,1063,11856,470678,75,10196707,112.371,46.2,21.502,27936.896,127.842,9.85,0.847,0
154,35,0,25524,0,1063,16119,486797,75,10196707,112.371,46.2,21.502,27936.896,127.842,9.85,0.847,0
154,36,178,25702,11,1074,15698,502495,75,10196707,112.371,46.2,21.502,27936.896,127.842,9.85,0.847,0
154,37,480,26182,15,1089,15946,518441,75,10196707,112.371,46.2,21.502,27936.896,127.842,9.85,0.847,0
154,38,533,26715,16,1105,15342,533783,75,10196707,112.371,46.2,21.502,27936.896,127.842,9.85,0.847,0
154,39,553,27268,9,1114,13453,547236,75,10196707,112.371,46.2,21.502,27936.896,127.842,9.85,0.847,0
154,40,138,27406,12,1126,7482,554718,75,10196707,112.371,46.2,21.502,27936.896,127.842,9.85,0.847,0
154,41,175,27581,9,1135,12689,567407,75,10196707,112.371,46.2,21.502,27936.896,127.842,9.85,0.847,0
154,42,98,27679,9,1144,16505,583912,75,10196707,112.371,46.2,21.502,27936.896,127.842,9.85,0.847,0
154,43,234,27913,19,1163,18169,602081,75,10196707,112.371,46.2,21.502,27936.896,127.842,9.85,0.847,0
154,44,219,28132,12,1175,18282,620363,75,10196707,112.371,46.2,21.502,27936.896,127.842,9.85,0.847,0
154,45,187,28319,9,1184,20448,640811,75,10196707,112.371,46.2,21.502,27936.896,127.842,9.85,0.847,0
154,46,264,28583,6,1190,15963,656774,75,10196707,112.371,46.2,21.502,27936.896,127.842,9.85,0.847,0
154,47,227,28810,13,1203,8945,665719,75,10196707,112.371,46.2,21.502,27936.896,127.842,9.85,0.847,0
154,48,226,29036,15,1218,12048,677767,71.3,10196707,112.371,46.2,21.502,27936.896,127.842,9.85,0.847,0
154,49,173,29209,13,1231,16121,693888,71.3,10196707,112.371,46.2,21.502,27936.896,127.842,9.85,0.847,0
154,50,223,29432,16,1247,15390,709278,71.3,10196707,112.371,46.2,21.502,27936.896,127.842,9.85,0.847,0
154,51,228,29660,16,1263,15247,724525,71.3,10196707,112.371,46.2,21.502,27936.896,127.842,9.85,0.847,0
154,52,252,29912,14,1277,15154,739679,71.3,10196707,112.371,46.2,21.502,27936.896,127.842,9.85,0.847,0
154,53,288,30200,12,1289,10735,750414,71.3,10196707,112.371,46.2,21.502,27936.896,127.842,9.85,0.847,0
154,54,271,30471,13,1302,5710,756124,71.3,10196707,112.371,46.2,21.502,27936.896,127.842,9.85,0.847,0
154,55,152,30623,14,1316,11843,767967,71.3,10196707,112.371,46.2,21.502,27936.896,127.842,9.85,0.847,0
154,56,165,30788,14,1330,15013,782980,71.3,10196707,112.371,46.2,21.502,27936.896,127.842,9.85,0.847,0
154,57,219,31007,12,1342,17164,800144,71.3,10196707,112.371,46.2,21.502,27936.896,127.842,9.85,0.847,0
154,58,285,31292,14,1356,16869,817013,71.3,10196707,112.371,46.2,21.502,27936.896,127.842,9.85,0.847,0
154,59,304,31596,13,1369,16029,833042,71.3,10196707,112.371,46.2,21.502,27936.896,127.842,9.85,0.847,0
154,60,350,31946,14,1383,12605,845647,71.3,10196707,112.371,46.2,21.502,27936.896,127.842,9.85,0.847,0
154,61,257,32203,13,1396,6522,852169,71.3,10196707,112.371,46.2,21.502,27936.896,127.842,9.85,0.847,0
154,62,297,32500,14,1410,11523,863692,71.3,10196707,112.371,46.2,21.502,27936.896,127.842,9.85,0.847,0
154,63,200,32700,14,1424,15542,879234,71.3,10196707,112.371,46.2,21.502,27936.896,127.842,9.85,0.847,0
154,64,195,32895,12,1436,17079,896313,71.3,10196707,112.371,46.2,21.502,27936.896,127.842,9.85,0.847,0
154,65,366,33261,11,1447,17106,913419,69.91,10196707,112.371,46.2,21.502,27936.896,127.842,9.85,0.847,0
154,66,331,33592,8,1455,15253,928672,69.91,10196707,112.371,46.2,21.502,27936.896,127.842,9.85,0.847,0
154,67,377,33969,10,1465,11348,940020,69.91,10196707,112.371,46.2,21.502,27936.896,127.842,9.85,0.847,0
154,68,382,34351,9,1474,6570,946590,69.91,10196707,112.371,46.2,21.502,27936.896,127.842,9.85,0.847,0
154,69,142,34493,5,1479,11159,957749,69.91,10196707,112.371,46.2,21.502,27936.896,127.842,9.85,0.847,0
154,70,392,34885,6,1485,13458,971207,69.91,10196707,112.371,46.2,21.502,27936.896,127.842,9.85,0.847,0
154,71,421,35306,7,1492,7678,978885,69.91,10196707,112.371,46.2,21.502,27936.896,127.842,9.85,0.847,0
154,72,294,35600,3,1495,4761,983646,69.91,10196707,112.371,46.2,21.502,27936.896,127.842,9.85,0.847,0
154,73,310,35910,9,1504,10750,994396,69.91,10196707,112.371,46.2,21.502,27936.896,127.842,9.85,0.847,0
154,74,270,36180,1,1505,7886,1002282,69.91,10196707,112.371,46.2,21.502,27936.896,127.842,9.85,0.847,0
154,75,283,36463,7,1512,4751,1007033,69.91,10196707,112.371,46.2,21.502,27936.896,127.842,9.85,0.847,0
154,76,227,36690,5,1517,11050,1018083,69.91,10196707,112.371,46.2,21.502,27936.896,127.842,9.85,0.847,0
154,77,346,37036,3,1520,14667,1032750,69.91,10196707,112.371,46.2,21.502,27936.896,127.842,9.85,0.847,0
154,78,300,37336,2,1522,15007,1047757,69.91,10196707,112.371,46.2,21.502,27936.896,127.842,9.85,0.847,0
154,79,336,37672,1,1523,13620,1061377,69.91,10196707,112.371,46.2,21.502,27936.896,127.842,9.85,0.847,0
154,80,417,38089,1,1524,14594,1075971,69.91,10196707,112.371,46.2,21.502,27936.896,127.842,9.85,0.847,0
154,81,375,38464,3,1527,8978,1084949,69.91,10196707,112.371,46.2,21.502,27936.896,127.842,9.85,0.847,0
154,82,377,38841,1,1528,6593,1091542,69.91,10196707,112.371,46.2,21.502,27936.896,127.842,9.85,0.847,0
154,83,292,39133,2,1530,11947,1103489,69.91,10196707,112.371,46.2,21.502,27936.896,127.842,9.85,0.847,0
154,84,259,39392,4,1534,15805,1119294,69.91,10196707,112.371,46.2,21.502,27936.896,127.842,9.85,0.847,0
154,85,345,39737,6,1540,13808,1133102,69.91,10196707,112.371,46.2,21.502,27936.896,127.842,9.85,0.847,0
154,86,367,40104,3,1543,13454,1146556,72.69,10196707,112.371,46.2,21.502,27936.896,127.842,9.85,0.847,0
154,87,311,40415,6,1549,15738,1162294,72.69,10196707,112.371,46.2,21.502,27936.896,127.842,9.85,0.847,0
154,88,451,40866,6,1555,10254,1172548,72.69,10196707,112.371,46.2,21.502,27936.896,127.842,9.85,0.847,0
154,89,323,41189,6,1561,6306,1178854,72.69,10196707,112.371,46.2,21.502,27936.896,127.842,9.85,0.847,0
154,90,457,41646,3,1564,12414,1191268,72.69,10196707,112.371,46.2,21.502,27936.896,127.842,9.85,0.847,0
154,91,266,41912,4,1568,15787,1207055,72.69,10196707,112.371,46.2,21.502,27936.896,127.842,9.85,0.847,0
154,92,229,42141,8,1576,16289,1223344,72.69,10196707,112.371,46.2,21.502,27936.896,127.842,9.85,0.847,0
154,93,313,42454,3,1579,15396,1238740,72.69,10196707,112.371,46.2,21.502,27936.896,127.842,9.85,0.847,0
154,94,328,42782,8,1587,14802,1253542,72.69,10196707,112.371,46.2,21.502,27936.896,127.842,9.85,0.847,0
154,95,374,43156,11,1598,12801,1266343,72.69,10196707,112.371,46.2,21.502,27936.896,127.842,9.85,0.847,0
154,96,413,43569,7,1605,6997,1273340,72.69,10196707,112.371,46.2,21.502,27936.896,127.842,9.85,0.847,0
154,97,328,43897,9,1614,12125,1285465,71.3,10196707,112.371,46.2,21.502,27936.896,127.842,9.85,0.847,0
154,98,232,44129,6,1620,16538,1302003,71.3,10196707,112.371,46.2,21.502,27936.896,127.842,9.85,0.847,0
154,99,287,44416,9,1629,17031,1319034,71.3,10196707,112.371,46.2,21.502,27936.896,127.842,9.85,0.847,0
154,100,443,44859,2,1631,15173,1334207,71.3,10196707,112.371,46.2,21.502,27936.896,127.842,9.85,0.847,0
154,101,418,45277,13,1644,15628,1349835,71.3,10196707,112.371,46.2,21.502,27936.896,127.842,9.85,0.847,0
154,102,402,45679,2,1646,12113,1361948,71.3,10196707,112.371,46.2,21.502,27936.896,127.842,9.85,0.847,0
154,103,542,46221,8,1654,6579,1368527,71.3,10196707,112.371,46.2,21.502,27936.896,127.842,9.85,0.847,0
154,104,291,46512,6,1660,13067,1381594,71.3,10196707,112.371,46.2,21.502,27936.896,127.842,9.85,0.847,0
154,105,306,46818,2,1662,18109,1399703,71.3,10196707,112.371,46.2,21.502,27936.896,127.842,9.85,0.847,0
154,106,233,47051,6,1668,16076,1415779,71.3,10196707,112.371,46.2,21.502,27936.896,127.842,9.85,0.847,0
154,107,375,47426,8,1676,15461,1431240,71.76,10196707,112.371,46.2,21.502,27936.896,127.842,9.85,0.847,0
154,108,339,47765,3,1679,15977,1447217,71.76,10196707,112.371,46.2,21.502,27936.896,127.842,9.85,0.847,0
154,109,312,48077,3,1682,12449,1459666,71.76,10196707,112.371,46.2,21.502,27936.896,127.842,9.85,0.847,0
154,110,313,48390,2,1684,7391,1467057,71.76,10196707,112.371,46.2,21.502,27936.896,127.842,9.85,0.847,0
154,111,246,48636,5,1689,13525,1480582,71.76,10196707,112.371,46.2,21.502,27936.896,127.842,9.85,0.847,0
154,112,135,48771,2,1691,17022,1497604,71.76,10196707,112.371,46.2,21.502,27936.896,127.842,9.85,0.847,0
154,113,127,48898,6,1697,15628,1513232,71.76,10196707,112.371,46.2,21.502,27936.896,127.842,9.85,0.847,0
154,114,252,49150,5,1702,15601,1528833,71.76,10196707,112.371,46.2,21.502,27936.896,127.842,9.85,0.847,0
154,115,229,49379,3,1705,15130,1543963,71.76,10196707,112.371,46.2,21.502,27936.896,127.842,9.85,0.847,0
154,116,313,49692,7,1712,11734,1555697,71.76,10196707,112.371,46.2,21.502,27936.896,127.842,9.85,0.847,0
154,117,263,49955,4,1716,6252,1561949,71.76,10196707,112.371,46.2,21.502,27936.896,127.842,9.85,0.847,0
154,118,209,50164,1,1717,13201,1575150,71.76,10196707,112.371,46.2,21.502,27936.896,127.842,9.85,0.847,0
154,119,135,50299,2,1719,16749,1591899,65.28,10196707,112.371,46.2,21.502,27936.896,127.842,9.85,0.847,0
154,120,111,50410,3,1722,16616,1608515,65.28,10196707,112.371,46.2,21.502,27936.896,127.842,9.85,0.847,0
154,121,203,50613,3,1725,14502,1623017,65.28,10196707,112.371,46.2,21.502,27936.896,127.842,9.85,0.847,0
154,122,255,50868,2,1727,15284,1638301,65.28,10196707,112.371,46.2,21.502,27936.896,127.842,9.85,0.847,0
154,123,204,51072,8,1735,12052,1650353,65.28,10196707,112.371,46.2,21.502,27936.896,127.842,9.85,0.847,0
154,124,238,51310,2,1737,7017,1657370,65.28,10196707,112.371,46.2,21.502,27936.896,127.842,9.85,0.847,0
154,125,153,51463,1,1738,14196,1671566,65.28,10196707,112.371,46.2,21.502,27936.896,127.842,9.85,0.847,0
154,126,106,51569,0,1738,17129,1688695,65.28,10196707,112.371,46.2,21.502,27936.896,127.842,9.85,0.847,0
154,127,112,51681,1,1739,16966,1705661,65.28,10196707,112.371,46.2,21.502,27936.896,127.842,9.85,0.847,0
154,128,167,51848,1,1740,14374,1720035,65.28,10196707,112.371,46.2,21.502,27936.896,127.842,9.85,0.847,0
154,129,213,52061,3,1743,14769,1734804,65.28,10196707,112.371,46.2,21.502,27936.896,127.842,9.85,0.847,0
154,130,290,52351,3,1746,10646,1745450,65.28,10196707,112.371,46.2,21.502,27936.896,127.842,9.85,0.847,0
154,131,186,52537,4,1750,8224,1753674,65.28,10196707,112.371,46.2,21.502,27936.896,127.842,9.85,0.847,0
154,132,131,52668,6,1756,12957,1766631,66.2,10196707,112.371,46.2,21.502,27936.896,127.842,9.85,0.847,0
154,133,157,52825,3,1759,16860,1783491,66.2,10196707,112.371,46.2,21.502,27936.896,127.842,9.85,0.847,0
154,134,120,52945,2,1761,16027,1799518,66.2,10196707,112.371,46.2,21.502,27936.896,127.842,9.85,0.847,0
154,135,278,53223,3,1764,14504,1814022,66.2,10196707,112.371,46.2,21.502,27936.896,127.842,9.85,0.847,0
154,136,325,53548,6,1770,16252,1830274,66.2,10196707,112.371,46.2,21.502,27936.896,127.842,9.85,0.847,0
154,137,235,53783,2,1772,10394,1840668,66.2,10196707,112.371,46.2,21.502,27936.896,127.842,9.85,0.847,0
154,138,198,53981,3,1775,7773,1848441,66.2,10196707,112.371,46.2,21.502,27936.896,127.842,9.85,0.847,0
154,139,121,54102,3,1778,14063,1862504,66.2,10196707,112.371,46.2,21.502,27936.896,127.842,9.85,0.847,0
154,140,132,54234,1,1779,18242,1880746,66.2,10196707,112.371,46.2,21.502,27936.896,127.842,9.85,0.847,0
154,141,214,54448,5,1784,16522,1897268,66.2,10196707,112.371,46.2,21.502,27936.896,127.842,9.85,0.847,0
154,142,253,54701,2,1786,14115,1911383,66.2,10196707,112.371,46.2,21.502,27936.896,127.842,9.85,0.847,0
154,143,291,54992,2,1788,14574,1925957,66.2,10196707,112.371,46.2,21.502,27936.896,127.842,9.85,0.847,0
154,144,219,55211,4,1792,11206,1937163,66.2,10196707,112.371,46.2,21.502,27936.896,127.842,9.85,0.847,0
154,145,241,55452,2,1794,8293,1945456,66.2,10196707,112.371,46.2,21.502,27936.896,127.842,9.85,0.847,0
154,146,145,55597,2,1796,13674,1959130,66.2,10196707,112.371,46.2,21.502,27936.896,127.842,9.85,0.847,0
154,147,123,55720,5,1801,17707,1976837,55.09,10196707,112.371,46.2,21.502,27936.896,127.842,9.85,0.847,0
154,148,192,55912,4,1805,16103,1992940,55.09,10196707,112.371,46.2,21.502,27936.896,127.842,9.85,0.847,0
154,149,362,56274,2,1807,14721,2007661,55.09,10196707,112.371,46.2,21.502,27936.896,127.842,9.85,0.847,0
154,150,399,56673,2,1809,16408,2024069,55.09,10196707,112.371,46.2,21.502,27936.896,127.842,9.85,0.847,0
154,151,401,57074,6,1815,11771,2035840,55.09,10196707,112.371,46.2,21.502,27936.896,127.842,9.85,0.847,0
154,152,374,57448,3,1818,8256,2044096,55.09,10196707,112.371,46.2,21.502,27936.896,127.842,9.85,0.847,0
154,153,320,57768,1,1819,15403,2059499,55.09,10196707,112.371,46.2,21.502,27936.896,127.842,9.85,0.847,0
154,154,244,58012,3,1822,18613,2078112,55.09,10196707,112.371,46.2,21.502,27936.896,127.842,9.85,0.847,0
154,155,231,58243,2,1824,17945,2096057,55.09,10196707,112.371,46.2,21.502,27936.896,127.842,9.85,0.847,0
154,156,390,58633,3,1827,16804,2112861,55.09,10196707,112.371,46.2,21.502,27936.896,127.842,9.85,0.847,0
154,157,418,59051,2,1829,17200,2130061,56.94,10196707,112.371,46.2,21.502,27936.896,127.842,9.85,0.847,0
154,158,406,59457,4,1833,13636,2143697,56.94,10196707,112.371,46.2,21.502,27936.896,127.842,9.85,0.847,0
154,159,486,59943,5,1838,9477,2153174,56.94,10196707,112.371,46.2,21.502,27936.896,127.842,9.85,0.847,0
154,160,315,60258,2,1840,15344,2168518,56.94,10196707,112.371,46.2,21.502,27936.896,127.842,9.85,0.847,0
154,161,249,60507,3,1843,20730,2189248,56.94,10196707,112.371,46.2,21.502,27936.896,127.842,9.85,0.847,0
154,162,388,60895,3,1846,21378,2210626,56.94,10196707,112.371,46.2,21.502,27936.896,127.842,9.85,0.847,0
154,163,646,61541,3,1849,19653,2230279,56.94,10196707,112.371,46.2,21.502,27936.896,127.842,9.85,0.847,0
154,164,585,62126,3,1852,22053,2252332,56.94,10196707,112.371,46.2,21.502,27936.896,127.842,9.85,0.847,0
154,165,687,62813,3,1855,16066,2268398,56.94,10196707,112.371,46.2,21.502,27936.896,127.842,9.85,0.847,0
154,166,497,63310,5,1860,12092,2280490,56.94,10196707,112.371,46.2,21.502,27936.896,127.842,9.85,0.847,0
154,167,673,63983,7,1867,19018,2299508,56.94,10196707,112.371,46.2,21.502,27936.896,127.842,9.85,0.847,0
154,168,613,64596,4,1871,23299,2322807,58.8,10196707,112.371,46.2,21.502,27936.896,127.842,9.85,0.847,0
154,169,425,65021,4,1875,23511,2346318,58.8,10196707,112.371,46.2,21.502,27936.896,127.842,9.85,0.847,0
154,170,605,65626,3,1878,21302,2367620,58.8,10196707,112.371,46.2,21.502,27936.896,127.842,9.85,0.847,0
154,171,770,66396,10,1888,21800,2389420,58.8,10196707,112.371,46.2,21.502,27936.896,127.842,9.85,0.847,0
154,172,780,67176,6,1894,15823,2405243,58.8,10196707,112.371,46.2,21.502,27936.896,127.842,9.85,0.847,0
154,173,849,68025,5,1899,11016,2416259,58.8,10196707,112.371,46.2,21.502,27936.896,127.842,9.85,0.847,0
154,174,552,68577,13,1912,19553,2435812,58.8,10196707,112.371,46.2,21.502,27936.896,127.842,9.85,0.847,0
154,175,623,69200,8,1920,23437,2459249,58.8,10196707,112.371,46.2,21.502,27936.896,127.842,9.85,0.847,0
154,176,463,69663,5,1925,22314,2481563,58.8,10196707,112.371,46.2,21.502,27936.896,127.842,9.85,0.847,0
154,177,802,70465,3,1928,20869,2502432,58.8,10196707,112.371,46.2,21.502,27936.896,127.842,9.85,0.847,0
154,178,691,71156,3,1931,23594,2526026,58.8,10196707,112.371,46.2,21.502,27936.896,127.842,9.85,0.847,0
154,179,899,72055,5,1936,16933,2542959,58.8,10196707,112.371,46.2,21.502,27936.896,127.842,9.85,0.847,0
154,180,884,72939,8,1944,11217,2554176,58.8,10196707,112.371,46.2,21.502,27936.896,127.842,9.85,0.847,0
154,181,665,73604,9,1953,19748,2573924,58.8,10196707,112.371,46.2,21.502,27936.896,127.842,9.85,0.847,0
154,182,425,74029,4,1957,25880,2599804,58.8,10196707,112.371,46.2,21.502,27936.896,127.842,9.85,0.847,0
154,183,688,74717,6,1963,25719,2625523,58.8,10196707,112.371,46.2,21.502,27936.896,127.842,9.85,0.847,0
154,184,825,75542,8,1971,23857,2649380,58.8,10196707,112.371,46.2,21.502,27936.896,127.842,9.85,0.847,0
154,185,854,76396,6,1977,24003,2673383,58.8,10196707,112.371,46.2,21.502,27936.896,127.842,9.85,0.847,0
154,186,888,77284,6,1983,17045,2690428,58.8,10196707,112.371,46.2,21.502,27936.896,127.842,9.85,0.847,0
154,187,963,78247,12,1995,11781,2702209,58.8,10196707,112.371,46.2,21.502,27936.896,127.842,9.85,0.847,0
154,188,0,78247,0,1995,11390,2713599,58.8,10196707,112.371,46.2,21.502,27936.896,127.842,9.85,0.847,0
154,189,1638,79885,23,2018,22874,2736473,58.8,10196707,112.371,46.2,21.502,27936.896,127.842,9.85,0.847,0
154,190,427,80312,14,2032,28398,2764871,58.8,10196707,112.371,46.2,21.502,27936.896,127.842,9.85,0.847,0
154,191,944,81256,8,2040,26962,2791833,58.8,10196707,112.371,46.2,21.502,27936.896,127.842,9.85,0.847,0
154,192,1278,82534,10,2050,27879,2819712,58.8,10196707,112.371,46.2,21.502,27936.896,127.842,9.85,0.847,0
154,193,1394,83928,12,2062,20218,2839930,58.8,10196707,112.371,46.2,21.502,27936.896,127.842,9.85,0.847,0
154,194,1646,85574,5,2067,13386,2853316,58.8,10196707,112.371,46.2,21.502,27936.896,127.842,9.85,0.847,0
154,195,1090,86664,13,2080,22697,2876013,58.8,10196707,112.371,46.2,21.502,27936.896,127.842,9.85,0.847,0
154,196,1249,87913,14,2094,30170,2906183,58.8,10196707,112.371,46.2,21.502,27936.896,127.842,9.85,0.847,0
154,197,1208,89121,16,2110,0,2906183,58.8,10196707,112.371,46.2,21.502,27936.896,127.842,9.85,0.847,0
154,198,2072,91193,7,2117,0,2906183,56.94,10196707,112.371,46.2,21.502,27936.896,127.842,9.85,0.847,0
154,199,2101,93294,11,2128,0,2906183,56.94,10196707,112.371,46.2,21.502,27936.896,127.842,9.85,0.847,0
154,200,2608,95902,21,2149,0,2906183,56.94,10196707,112.371,46.2,21.502,27936.896,127.842,9.85,0.847,0
154,201,2153,98055,13,2162,0,2906183,56.94,10196707,112.371,46.2,21.502,27936.896,127.842,9.85,0.847,0
154,202,1856,99911,19,2181,0,2906183,56.94,10196707,112.371,46.2,21.502,27936.896,127.842,9.85,0.847,0
154,203,1949,101860,17,2198,0,2906183,56.94,10196707,112.371,46.2,21.502,27936.896,127.842,9.85,0.847,0
154,204,1876,103736,15,2213,0,2906183,56.94,10196707,112.371,46.2,21.502,27936.896,127.842,9.85,0.847,0
156,1,88,781,1,2,2476,24825,86.11,2881060,227.322,31.9,1.307,116935.6,176.69,16.52,0.856,0
156,2,54,835,0,2,1435,26260,86.11,2881060,227.322,31.9,1.307,116935.6,176.69,16.52,0.856,0
156,3,114,949,1,3,2153,28413,86.11,2881060,227.322,31.9,1.307,116935.6,176.69,16.52,0.856,0
156,4,0,949,0,3,3538,31951,86.11,2881060,227.322,31.9,1.307,116935.6,176.69,16.52,0.856,0
156,5,376,1325,0,3,3806,35757,86.11,2881060,227.322,31.9,1.307,116935.6,176.69,16.52,0.856,0
156,6,279,1604,1,4,2351,38108,86.11,2881060,227.322,31.9,1.307,116935.6,176.69,16.52,0.856,0
156,7,228,1832,0,4,3710,41818,86.11,2881060,227.322,31.9,1.307,116935.6,176.69,16.52,0.856,0
156,8,225,2057,2,6,0,41818,86.11,2881060,227.322,31.9,1.307,116935.6,176.69,16.52,0.856,0
156,9,153,2210,0,6,0,43144,86.11,2881060,227.322,31.9,1.307,116935.6,176.69,16.52,0.856,0
156,10,166,2376,0,6,2195,45339,86.11,2881060,227.322,31.9,1.307,116935.6,176.69,16.52,0.856,0
156,11,136,2512,0,6,2412,47751,86.11,2881060,227.322,31.9,1.307,116935.6,176.69,16.52,0.856,0
156,12,216,2728,0,6,1351,49102,86.11,2881060,227.322,31.9,1.307,116935.6,176.69,16.52,0.856,0
156,13,251,2979,1,7,1726,50828,86.11,2881060,227.322,31.9,1.307,116935.6,176.69,16.52,0.856,0
156,14,252,3231,0,7,1794,52622,86.11,2881060,227.322,31.9,1.307,116935.6,176.69,16.52,0.856,0
156,15,197,3428,0,7,1862,54484,86.11,2881060,227.322,31.9,1.307,116935.6,176.69,16.52,0.856,0
156,16,283,3711,0,7,1897,56381,86.11,2881060,227.322,31.9,1.307,116935.6,176.69,16.52,0.856,0
156,17,392,4103,0,7,1947,58328,86.11,2881060,227.322,31.9,1.307,116935.6,176.69,16.52,0.856,0
156,18,560,4663,0,7,1811,60139,86.11,2881060,227.322,31.9,1.307,116935.6,176.69,16.52,0.856,0
156,19,345,5008,1,8,2399,62538,86.11,2881060,227.322,31.9,1.307,116935.6,176.69,16.52,0.856,0
156,20,440,5448,0,8,2082,64620,86.11,2881060,227.322,31.9,1.307,116935.6,176.69,16.52,0.856,0
156,21,567,6015,1,9,2105,66725,86.11,2881060,227.322,31.9,1.307,116935.6,176.69,16.52,0.856,0
156,22,518,6533,0,9,3287,70012,83.33,2881060,227.322,31.9,1.307,116935.6,176.69,16.52,0.856,0
156,23,608,7141,1,10,3445,73457,83.33,2881060,227.322,31.9,1.307,116935.6,176.69,16.52,0.856,0
156,24,623,7764,0,10,2431,75888,83.33,2881060,227.322,31.9,1.307,116935.6,176.69,16.52,0.856,0
156,25,761,8525,0,10,3817,79705,83.33,2881060,227.322,31.9,1.307,116935.6,176.69,16.52,0.856,0
156,26,833,9358,0,10,2584,82289,83.33,2881060,227.322,31.9,1.307,116935.6,176.69,16.52,0.856,0
156,27,929,10287,0,10,3420,85709,83.33,2881060,227.322,31.9,1.307,116935.6,176.69,16.52,0.856,0
156,28,957,11244,0,10,2898,88607,83.33,2881060,227.322,31.9,1.307,116935.6,176.69,16.52,0.856,0
156,29,677,11921,0,10,2808,91415,83.33,2881060,227.322,31.9,1.307,116935.6,176.69,16.52,0.856,0
156,30,643,12564,0,10,3085,94500,83.33,2881060,227.322,31.9,1.307,116935.6,176.69,16.52,0.856,0
156,31,845,13409,0,10,3226,97726,83.33,2881060,227.322,31.9,1.307,116935.6,176.69,16.52,0.856,0
156,32,687,14096,2,12,4002,101728,83.33,2881060,227.322,31.9,1.307,116935.6,176.69,16.52,0.856,0
156,33,776,14872,0,12,2707,104435,83.33,2881060,227.322,31.9,1.307,116935.6,176.69,16.52,0.856,0
156,34,679,15551,0,12,2360,106795,83.33,2881060,227.322,31.9,1.307,116935.6,176.69,16.52,0.856,0
156,35,640,16191,0,12,2967,109762,83.33,2881060,227.322,31.9,1.307,116935.6,176.69,16.52,0.856,0
156,36,951,17142,0,12,3201,112963,83.33,2881060,227.322,31.9,1.307,116935.6,176.69,16.52,0.856,0
156,37,830,17972,0,12,3532,116495,83.33,2881060,227.322,31.9,1.307,116935.6,176.69,16.52,0.856,0
156,38,918,18890,0,12,3963,120458,83.33,2881060,227.322,31.9,1.307,116935.6,176.69,16.52,0.856,0
156,39,1311,20201,0,12,4096,124554,83.33,2881060,227.322,31.9,1.307,116935.6,176.69,16.52,0.856,0
156,40,1130,21331,1,13,3215,127769,83.33,2881060,227.322,31.9,1.307,116935.6,176.69,16.52,0.856,0
156,41,1189,22520,1,14,3275,131044,83.33,2881060,227.322,31.9,1.307,116935.6,176.69,16.52,0.856,0
156,42,1103,23623,0,14,4250,135294,83.33,2881060,227.322,31.9,1.307,116935.6,176.69,16.52,0.856,0
156,43,1526,25149,0,14,3833,139127,83.33,2881060,227.322,31.9,1.307,116935.6,176.69,16.52,0.856,0
156,44,1390,26539,0,14,4811,143938,83.33,2881060,227.322,31.9,1.307,116935.6,176.69,16.52,0.856,0
156,45,1733,28272,0,14,4235,148173,83.33,2881060,227.322,31.9,1.307,116935.6,176.69,16.52,0.856,0
156,46,1153,29425,0,14,4531,152704,83.33,2881060,227.322,31.9,1.307,116935.6,176.69,16.52,0.856,0
156,47,1547,30972,1,15,4866,157570,83.33,2881060,227.322,31.9,1.307,116935.6,176.69,16.52,0.856,0
156,48,1632,32604,0,15,4125,161695,83.33,2881060,227.322,31.9,1.307,116935.6,176.69,16.52,0.856,0
156,49,1365,33969,0,15,4487,166182,83.33,2881060,227.322,31.9,1.307,116935.6,176.69,16.52,0.856,0
156,50,1637,35606,0,15,4255,170437,83.33,2881060,227.322,31.9,1.307,116935.6,176.69,16.52,0.856,0
156,51,1491,37097,1,16,5045,175482,83.33,2881060,227.322,31.9,1.307,116935.6,176.69,16.52,0.856,0
156,52,1554,38651,1,17,5160,180642,83.33,2881060,227.322,31.9,1.307,116935.6,176.69,16.52,0.856,0
156,53,1830,40481,2,19,4152,184794,83.33,2881060,227.322,31.9,1.307,116935.6,176.69,16.52,0.856,0
156,54,1732,42213,2,21,3349,188143,83.33,2881060,227.322,31.9,1.307,116935.6,176.69,16.52,0.856,0
156,55,1501,43714,2,23,4341,192484,83.33,2881060,227.322,31.9,1.307,116935.6,176.69,16.52,0.856,0
156,56,1751,45465,3,26,3927,196411,83.33,2881060,227.322,31.9,1.307,116935.6,176.69,16.52,0.856,0
156,57,1742,47207,2,28,4769,201180,83.33,2881060,227.322,31.9,1.307,116935.6,176.69,16.52,0.856,0
156,58,1740,48947,2,30,5853,207033,83.33,2881060,227.322,31.9,1.307,116935.6,176.69,16.52,0.856,0
156,59,1967,50914,3,33,5864,212897,83.33,2881060,227.322,31.9,1.307,116935.6,176.69,16.52,0.856,0
156,60,1993,52907,3,36,5091,217988,83.33,2881060,227.322,31.9,1.307,116935.6,176.69,16.52,0.856,0
156,61,2355,55262,0,36,4081,222069,83.33,2881060,227.322,31.9,1.307,116935.6,176.69,16.52,0.856,0
156,62,1648,56910,2,38,3850,225919,83.33,2881060,227.322,31.9,1.307,116935.6,176.69,16.52,0.856,0
156,63,1523,58433,2,40,5179,231098,83.33,2881060,227.322,31.9,1.307,116935.6,176.69,16.52,0.856,0
156,64,1826,60259,3,43,5339,236437,83.33,2881060,227.322,31.9,1.307,116935.6,176.69,16.52,0.856,0
156,65,1901,62160,2,45,4649,241086,83.33,2881060,227.322,31.9,1.307,116935.6,176.69,16.52,0.856,0
156,66,1581,63741,0,45,5276,246362,83.33,2881060,227.322,31.9,1.307,116935.6,176.69,16.52,0.856,0
156,67,1754,65495,4,49,5029,251391,83.33,2881060,227.322,31.9,1.307,116935.6,176.69,16.52,0.856,0
156,68,1700,67195,2,51,4142,255533,83.33,2881060,227.322,31.9,1.307,116935.6,176.69,16.52,0.856,0
156,69,1595,68790,3,54,4113,259646,83.33,2881060,227.322,31.9,1.307,116935.6,176.69,16.52,0.856,0
156,70,1368,70158,3,57,5389,265035,83.33,2881060,227.322,31.9,1.307,116935.6,176.69,16.52,0.856,0
156,71,1721,71879,5,62,4929,269964,83.33,2881060,227.322,31.9,1.307,116935.6,176.69,16.52,0.856,0
156,72,1716,73595,4,66,4829,274793,83.33,2881060,227.322,31.9,1.307,116935.6,176.69,16.52,0.856,0
156,73,1476,75071,3,69,5862,280655,83.33,2881060,227.322,31.9,1.307,116935.6,176.69,16.52,0.856,0
156,74,1517,76588,1,70,6175,286830,83.33,2881060,227.322,31.9,1.307,116935.6,176.69,16.52,0.856,0
156,75,1828,78416,0,70,3884,290714,83.33,2881060,227.322,31.9,1.307,116935.6,176.69,16.52,0.856,0
156,76,1186,79602,3,73,4624,295338,80.56,2881060,227.322,31.9,1.307,116935.6,176.69,16.52,0.856,0
156,77,1274,80876,3,76,5161,300499,80.56,2881060,227.322,31.9,1.307,116935.6,176.69,16.52,0.856,0
156,78,1201,82077,4,80,4302,304801,80.56,2881060,227.322,31.9,1.307,116935.6,176.69,16.52,0.856,0
156,79,1097,83174,2,82,4869,309670,80.56,2881060,227.322,31.9,1.307,116935.6,176.69,16.52,0.856,0
156,80,1267,84441,4,86,3831,313501,80.56,2881060,227.322,31.9,1.307,116935.6,176.69,16.52,0.856,0
156,81,1021,85462,7,93,4193,317694,80.56,2881060,227.322,31.9,1.307,116935.6,176.69,16.52,0.856,0
156,82,1026,86488,1,94,3098,320792,80.56,2881060,227.322,31.9,1.307,116935.6,176.69,16.52,0.856,0
156,83,881,87369,4,98,3778,324570,80.56,2881060,227.322,31.9,1.307,116935.6,176.69,16.52,0.856,0
156,84,1034,88403,1,99,4371,328941,80.56,2881060,227.322,31.9,1.307,116935.6,176.69,16.52,0.856,0
156,85,1176,89579,0,99,4231,333172,80.56,2881060,227.322,31.9,1.307,116935.6,176.69,16.52,0.856,0
156,86,1199,90778,5,104,4324,337496,80.56,2881060,227.322,31.9,1.307,116935.6,176.69,16.52,0.856,0
156,87,1060,91838,2,106,4418,341914,80.56,2881060,227.322,31.9,1.307,116935.6,176.69,16.52,0.856,0
156,88,946,92784,3,109,3777,345691,80.56,2881060,227.322,31.9,1.307,116935.6,176.69,16.52,0.856,0
156,89,879,93663,1,110,3462,349153,80.56,2881060,227.322,31.9,1.307,116935.6,176.69,16.52,0.856,0
156,90,750,94413,0,110,3506,352659,80.56,2881060,227.322,31.9,1.307,116935.6,176.69,16.52,0.856,0
156,91,693,95106,3,113,4173,356832,80.56,2881060,227.322,31.9,1.307,116935.6,176.69,16.52,0.856,0
156,92,982,96088,0,113,3670,360502,80.56,2881060,227.322,31.9,1.307,116935.6,176.69,16.52,0.856,0
156,93,915,97003,2,115,5593,366095,80.56,2881060,227.322,31.9,1.307,116935.6,176.69,16.52,0.856,0
156,94,894,97897,3,118,5910,372005,80.56,2881060,227.322,31.9,1.307,116935.6,176.69,16.52,0.856,0
156,95,756,98653,3,121,4876,376881,80.56,2881060,227.322,31.9,1.307,116935.6,176.69,16.52,0.856,0
156,96,530,99183,2,123,4553,381434,80.56,2881060,227.322,31.9,1.307,116935.6,176.69,16.52,0.856,0
156,97,616,99799,5,128,4677,386111,80.56,2881060,227.322,31.9,1.307,116935.6,176.69,16.52,0.856,0
156,98,546,100345,5,133,4886,390997,80.56,2881060,227.322,31.9,1.307,116935.6,176.69,16.52,0.856,0
156,99,600,100945,1,134,5202,396199,80.56,2881060,227.322,31.9,1.307,116935.6,176.69,16.52,0.856,0
156,100,608,101553,4,138,4568,400767,80.56,2881060,227.322,31.9,1.307,116935.6,176.69,16.52,0.856,0
156,101,557,102110,4,142,4101,404868,80.56,2881060,227.322,31.9,1.307,116935.6,176.69,16.52,0.856,0
156,102,520,102630,4,146,4251,409119,80.56,2881060,227.322,31.9,1.307,116935.6,176.69,16.52,0.856,0
156,103,498,103128,0,146,3563,412682,80.56,2881060,227.322,31.9,1.307,116935.6,176.69,16.52,0.856,0
156,104,470,103598,1,147,3645,416327,80.56,2881060,227.322,31.9,1.307,116935.6,176.69,16.52,0.856,0
156,105,418,104016,2,149,4322,420649,80.56,2881060,227.322,31.9,1.307,116935.6,176.69,16.52,0.856,0
156,106,517,104533,1,150,4209,424858,80.56,2881060,227.322,31.9,1.307,116935.6,176.69,16.52,0.856,0
156,107,450,104983,1,151,5803,430661,80.56,2881060,227.322,31.9,1.307,116935.6,176.69,16.52,0.856,0
156,108,464,105447,1,152,4923,435584,80.56,2881060,227.322,31.9,1.307,116935.6,176.69,16.52,0.856,0
156,109,451,105898,1,153,3406,438990,80.56,2881060,227.322,31.9,1.307,116935.6,176.69,16.52,0.856,0
156,110,410,106308,1,154,2710,441700,80.56,2881060,227.322,31.9,1.307,116935.6,176.69,16.52,0.856,0
156,111,340,106648,3,157,4336,446036,80.56,2881060,227.322,31.9,1.307,116935.6,176.69,16.52,0.856,0
156,112,389,107037,2,159,5132,451168,80.56,2881060,227.322,31.9,1.307,116935.6,176.69,16.52,0.856,0
156,113,393,107430,1,160,4630,455798,80.56,2881060,227.322,31.9,1.307,116935.6,176.69,16.52,0.856,0
156,114,441,107871,3,163,3525,459323,80.56,2881060,227.322,31.9,1.307,116935.6,176.69,16.52,0.856,0
156,115,373,108244,1,164,5351,464674,80.56,2881060,227.322,31.9,1.307,116935.6,176.69,16.52,0.856,0
156,116,394,108638,0,164,4326,469000,80.56,2881060,227.322,31.9,1.307,116935.6,176.69,16.52,0.856,0
156,117,398,109036,0,164,3442,472442,80.56,2881060,227.322,31.9,1.307,116935.6,176.69,16.52,0.856,0
156,118,269,109305,1,165,4752,477194,80.56,2881060,227.322,31.9,1.307,116935.6,176.69,16.52,0.856,0
156,119,292,109597,0,165,4736,481930,77.78,2881060,227.322,31.9,1.307,116935.6,176.69,16.52,0.856,0
156,120,283,109880,2,167,5505,487435,77.78,2881060,227.322,31.9,1.307,116935.6,176.69,16.52,0.856,0
156,121,273,110153,2,169,5134,492569,77.78,2881060,227.322,31.9,1.307,116935.6,176.69,16.52,0.856,0
156,122,307,110460,2,171,2808,495377,77.78,2881060,227.322,31.9,1.307,116935.6,176.69,16.52,0.856,0
156,123,235,110695,3,174,3289,498666,77.78,2881060,227.322,31.9,1.307,116935.6,176.69,16.52,0.856,0
156,124,216,110911,0,174,1870,500536,77.78,2881060,227.322,31.9,1.307,116935.6,176.69,16.52,0.856,0
156,125,196,111107,3,177,2256,502792,77.78,2881060,227.322,31.9,1.307,116935.6,176.69,16.52,0.856,0
156,126,215,111322,0,177,2356,505148,77.78,2881060,227.322,31.9,1.307,116935.6,176.69,16.52,0.856,0
156,127,216,111538,0,177,2931,508079,77.78,2881060,227.322,31.9,1.307,116935.6,176.69,16.52,0.856,0
156,128,267,111805,1,178,2921,511000,77.78,2881060,227.322,31.9,1.307,116935.6,176.69,16.52,0.856,0
156,129,287,112092,0,178,2930,513930,77.78,2881060,227.322,31.9,1.307,116935.6,176.69,16.52,0.856,0
156,130,291,112383,2,180,2895,516825,77.78,2881060,227.322,31.9,1.307,116935.6,176.69,16.52,0.856,0
156,131,267,112650,2,182,3535,520360,77.78,2881060,227.322,31.9,1.307,116935.6,176.69,16.52,0.856,0
156,132,297,112947,2,184,4106,524466,77.78,2881060,227.322,31.9,1.307,116935.6,176.69,16.52,0.856,0
156,133,315,113262,4,188,4823,529289,77.78,2881060,227.322,31.9,1.307,116935.6,176.69,16.52,0.856,0
156,134,384,113646,0,188,4706,533995,77.78,2881060,227.322,31.9,1.307,116935.6,176.69,16.52,0.856,0
156,135,292,113938,2,190,4607,538602,77.78,2881060,227.322,31.9,1.307,116935.6,176.69,16.52,0.856,0
156,136,343,114281,0,190,3916,542518,77.78,2881060,227.322,31.9,1.307,116935.6,176.69,16.52,0.856,0
156,137,251,114532,0,190,3767,546285,77.78,2881060,227.322,31.9,1.307,116935.6,176.69,16.52,0.856,0
156,138,277,114809,2,192,4988,551273,77.78,2881060,227.322,31.9,1.307,116935.6,176.69,16.52,0.856,0
156,139,271,115080,1,193,4697,555970,77.78,2881060,227.322,31.9,1.307,116935.6,176.69,16.52,0.856,0
156,140,288,115368,0,193,5020,560990,77.78,2881060,227.322,31.9,1.307,116935.6,176.69,16.52,0.856,0
156,141,293,115661,0,193,5023,566013,77.78,2881060,227.322,31.9,1.307,116935.6,176.69,16.52,0.856,0
156,142,295,115956,0,193,6260,572273,77.78,2881060,227.322,31.9,1.307,116935.6,176.69,16.52,0.856,0
156,143,268,116224,0,193,4849,577122,77.78,2881060,227.322,31.9,1.307,116935.6,176.69,16.52,0.856,0
156,144,257,116481,0,193,7001,584123,77.78,2881060,227.322,31.9,1.307,116935.6,176.69,16.52,0.856,0
156,145,284,116765,0,193,5797,589920,77.78,2881060,227.322,31.9,1.307,116935.6,176.69,16.52,0.856,0
156,146,243,117008,0,193,4295,594215,77.78,2881060,227.322,31.9,1.307,116935.6,176.69,16.52,0.856,0
156,147,258,117266,1,194,5232,599447,77.78,2881060,227.322,31.9,1.307,116935.6,176.69,16.52,0.856,0
156,148,232,117498,0,194,4665,604112,77.78,2881060,227.322,31.9,1.307,116935.6,176.69,16.52,0.856,0
156,149,244,117742,0,194,5146,609258,77.78,2881060,227.322,31.9,1.307,116935.6,176.69,16.52,0.856,0
156,150,246,117988,1,195,5096,614354,77.78,2881060,227.322,31.9,1.307,116935.6,176.69,16.52,0.856,0
156,151,208,118196,1,196,5774,620128,77.78,2881060,227.322,31.9,1.307,116935.6,176.69,16.52,0.856,0
156,152,211,118407,0,196,4481,624609,77.78,2881060,227.322,31.9,1.307,116935.6,176.69,16.52,0.856,0
156,153,168,118575,1,197,5222,629831,77.78,2881060,227.322,31.9,1.307,116935.6,176.69,16.52,0.856,0
156,154,203,118778,0,197,4914,634745,64.81,2881060,227.322,31.9,1.307,116935.6,176.69,16.52,0.856,0
156,155,216,118994,1,198,4997,639742,64.81,2881060,227.322,31.9,1.307,116935.6,176.69,16.52,0.856,0
156,156,212,119206,1,199,5162,644904,64.81,2881060,227.322,31.9,1.307,116935.6,176.69,16.52,0.856,0
156,157,214,119420,2,201,5344,650248,64.81,2881060,227.322,31.9,1.307,116935.6,176.69,16.52,0.856,0
156,158,217,119637,0,201,4725,654973,64.81,2881060,227.322,31.9,1.307,116935.6,176.69,16.52,0.856,0
156,159,227,119864,1,202,5035,660008,64.81,2881060,227.322,31.9,1.307,116935.6,176.69,16.52,0.856,0
156,160,231,120095,1,203,3640,663648,64.81,2881060,227.322,31.9,1.307,116935.6,176.69,16.52,0.856,0
156,161,253,120348,2,205,4288,667936,64.81,2881060,227.322,31.9,1.307,116935.6,176.69,16.52,0.856,0
156,162,231,120579,0,205,4163,672099,64.81,2881060,227.322,31.9,1.307,116935.6,176.69,16.52,0.856,0
156,163,267,120846,0,205,4071,676170,64.81,2881060,227.322,31.9,1.307,116935.6,176.69,16.52,0.856,0
156,164,206,121052,0,205,4463,680633,64.81,2881060,227.322,31.9,1.307,116935.6,176.69,16.52,0.856,0
156,165,235,121287,0,205,5206,685839,64.81,2881060,227.322,31.9,1.307,116935.6,176.69,16.52,0.856,0
156,166,236,121523,0,205,5192,691031,64.81,2881060,227.322,31.9,1.307,116935.6,176.69,16.52,0.856,0
156,167,217,121740,0,205,4396,695427,64.81,2881060,227.322,31.9,1.307,116935.6,176.69,16.52,0.856,0
156,168,235,121975,2,207,4987,700414,64.81,2881060,227.322,31.9,1.307,116935.6,176.69,16.52,0.856,0
156,169,239,122214,1,208,4568,704982,64.81,2881060,227.322,31.9,1.307,116935.6,176.69,16.52,0.856,0
156,170,235,122449,0,208,4150,709132,64.81,2881060,227.322,31.9,1.307,116935.6,176.69,16.52,0.856,0
156,171,244,122693,0,208,5051,714183,64.81,2881060,227.322,31.9,1.307,116935.6,176.69,16.52,0.856,0
156,172,224,122917,1,209,4874,719057,64.81,2881060,227.322,31.9,1.307,116935.6,176.69,16.52,0.856,0
156,173,229,123146,0,209,5020,724077,64.81,2881060,227.322,31.9,1.307,116935.6,176.69,16.52,0.856,0
156,174,230,123376,1,210,5468,729545,64.81,2881060,227.322,31.9,1.307,116935.6,176.69,16.52,0.856,0
156,175,228,123604,1,211,4596,734141,64.81,2881060,227.322,31.9,1.307,116935.6,176.69,16.52,0.856,0
156,176,313,123917,0,211,4950,739091,64.81,2881060,227.322,31.9,1.307,116935.6,176.69,16.52,0.856,0
156,177,258,124175,1,212,6039,745130,64.81,2881060,227.322,31.9,1.307,116935.6,176.69,16.52,0.856,0
156,178,250,124425,0,212,5974,751104,64.81,2881060,227.322,31.9,1.307,116935.6,176.69,16.52,0.856,0
156,179,225,124650,0,212,4261,755365,64.81,2881060,227.322,31.9,1.307,116935.6,176.69,16.52,0.856,0
156,180,200,124850,2,214,4902,760267,64.81,2881060,227.322,31.9,1.307,116935.6,176.69,16.52,0.856,0
156,181,234,125084,0,214,4658,764925,64.81,2881060,227.322,31.9,1.307,116935.6,176.69,16.52,0.856,0
156,182,227,125311,0,214,5288,770213,64.81,2881060,227.322,31.9,1.307,116935.6,176.69,16.52,0.856,0
156,183,222,125533,0,214,5701,775914,64.81,2881060,227.322,31.9,1.307,116935.6,176.69,16.52,0.856,0
156,184,227,125760,0,214,5214,781128,64.81,2881060,227.322,31.9,1.307,116935.6,176.69,16.52,0.856,0
156,185,199,125959,0,214,5096,786224,64.81,2881060,227.322,31.9,1.307,116935.6,176.69,16.52,0.856,0
156,186,205,126164,1,215,5200,791424,64.81,2881060,227.322,31.9,1.307,116935.6,176.69,16.52,0.856,0
156,187,175,126339,1,216,4344,795768,64.81,2881060,227.322,31.9,1.307,116935.6,176.69,16.52,0.856,0
156,188,159,126498,0,216,4751,800519,64.81,2881060,227.322,31.9,1.307,116935.6,176.69,16.52,0.856,0
156,189,194,126692,0,216,4846,805365,64.81,2881060,227.322,31.9,1.307,116935.6,176.69,16.52,0.856,0
156,190,251,126943,0,216,4662,810027,64.81,2881060,227.322,31.9,1.307,116935.6,176.69,16.52,0.856,0
156,191,238,127181,2,218,4994,815021,64.81,2881060,227.322,31.9,1.307,116935.6,176.69,16.52,0.856,0
156,192,213,127394,0,218,5347,820368,64.81,2881060,227.322,31.9,1.307,116935.6,176.69,16.52,0.856,0
156,193,206,127600,1,219,5143,825511,64.81,2881060,227.322,31.9,1.307,116935.6,176.69,16.52,0.856,0
156,194,178,127778,0,219,6430,831941,64.81,2881060,227.322,31.9,1.307,116935.6,176.69,16.52,0.856,0
156,195,207,127985,1,220,5545,837486,64.81,2881060,227.322,31.9,1.307,116935.6,176.69,16.52,0.856,0
156,196,206,128191,0,220,6079,843565,64.81,2881060,227.322,31.9,1.307,116935.6,176.69,16.52,0.856,0
156,197,214,128405,0,220,6173,849738,64.81,2881060,227.322,31.9,1.307,116935.6,176.69,16.52,0.856,0
156,198,198,128603,0,220,5416,855154,64.81,2881060,227.322,31.9,1.307,116935.6,176.69,16.52,0.856,0
156,199,200,128803,2,222,6082,861236,64.81,2881060,227.322,31.9,1.307,116935.6,176.69,16.52,0.856,0
156,200,189,128992,0,222,8621,869857,64.81,2881060,227.322,31.9,1.307,116935.6,176.69,16.52,0.856,0
156,201,235,129227,1,223,7485,877342,64.81,2881060,227.322,31.9,1.307,116935.6,176.69,16.52,0.856,0
156,202,204,129431,1,224,8844,886186,64.81,2881060,227.322,31.9,1.307,116935.6,176.69,16.52,0.856,0
156,203,240,129671,0,224,0,886186,64.81,2881060,227.322,31.9,1.307,116935.6,176.69,16.52,0.856,0
156,204,273,129944,0,224,0,886186,64.81,2881060,227.322,31.9,1.307,116935.6,176.69,16.52,0.856,0
157,1,293,2245,25,69,1955,26609,87.04,19237682,85.129,43,17.85,23313.199,370.946,9.74,0.811,0
157,2,215,2460,16,85,1874,28483,87.04,19237682,85.129,43,17.85,23313.199,370.946,9.74,0.811,0
157,3,278,2738,9,94,3174,31657,87.04,19237682,85.129,43,17.85,23313.199,370.946,9.74,0.811,0
157,4,445,3183,39,133,4435,36092,87.04,19237682,85.129,43,17.85,23313.199,370.946,9.74,0.811,0
157,5,430,3613,8,141,2531,38623,87.04,19237682,85.129,43,17.85,23313.199,370.946,9.74,0.811,0
157,6,251,3864,7,148,2364,40987,87.04,19237682,85.129,43,17.85,23313.199,370.946,9.74,0.811,0
157,7,193,4057,9,157,2591,43578,87.04,19237682,85.129,43,17.85,23313.199,370.946,9.74,0.811,0
157,8,360,4417,25,182,3629,47207,87.04,19237682,85.129,43,17.85,23313.199,370.946,9.74,0.811,0
157,9,344,4761,27,209,4595,51802,87.04,19237682,85.129,43,17.85,23313.199,370.946,9.74,0.811,0
157,10,441,5202,20,229,3628,55430,87.04,19237682,85.129,43,17.85,23313.199,370.946,9.74,0.811,0
157,11,265,5467,28,257,3842,59272,87.04,19237682,85.129,43,17.85,23313.199,370.946,9.74,0.811,0
157,12,523,5990,25,282,3056,62328,87.04,19237682,85.129,43,17.85,23313.199,370.946,9.74,0.811,0
157,13,310,6300,24,306,4876,67204,87.04,19237682,85.129,43,17.85,23313.199,370.946,9.74,0.811,0
157,14,333,6633,12,318,2893,70097,87.04,19237682,85.129,43,17.85,23313.199,370.946,9.74,0.811,0
157,15,246,6879,26,344,4730,74827,87.04,19237682,85.129,43,17.85,23313.199,370.946,9.74,0.811,0
157,16,337,7216,28,372,4802,79629,87.04,19237682,85.129,43,17.85,23313.199,370.946,9.74,0.811,0
157,17,491,7707,15,387,6176,85805,87.04,19237682,85.129,43,17.85,23313.199,370.946,9.74,0.811,0
157,18,360,8067,13,400,5186,90991,87.04,19237682,85.129,43,17.85,23313.199,370.946,9.74,0.811,0
157,19,351,8418,17,417,2620,93611,87.04,19237682,85.129,43,17.85,23313.199,370.946,9.74,0.811,0
157,20,328,8746,17,434,4880,98491,87.04,19237682,85.129,43,17.85,23313.199,370.946,9.74,0.811,0
157,21,190,8936,17,451,3061,101552,87.04,19237682,85.129,43,17.85,23313.199,370.946,9.74,0.811,0
157,22,306,9242,32,483,4805,106357,87.04,19237682,85.129,43,17.85,23313.199,370.946,9.74,0.811,0
157,23,468,9710,25,508,6979,113336,87.04,19237682,85.129,43,17.85,23313.199,370.946,9.74,0.811,0
157,24,386,10096,19,527,8266,121602,87.04,19237682,85.129,43,17.85,23313.199,370.946,9.74,0.811,0
157,25,321,10417,25,552,5043,126645,87.04,19237682,85.129,43,17.85,23313.199,370.946,9.74,0.811,0
157,26,218,10635,23,575,9873,136518,87.04,19237682,85.129,43,17.85,23313.199,370.946,9.74,0.811,0
157,27,401,11036,33,608,7316,143834,87.04,19237682,85.129,43,17.85,23313.199,370.946,9.74,0.811,0
157,28,303,11339,23,631,6475,150309,87.04,19237682,85.129,43,17.85,23313.199,370.946,9.74,0.811,0
157,29,277,11616,19,650,16684,166993,87.04,19237682,85.129,43,17.85,23313.199,370.946,9.74,0.811,0
157,30,362,11978,25,675,8381,175374,87.04,19237682,85.129,43,17.85,23313.199,370.946,9.74,0.811,0
157,31,262,12240,42,717,8314,183688,87.04,19237682,85.129,43,17.85,23313.199,370.946,9.74,0.811,0
157,32,327,12567,27,744,6852,190540,87.04,19237682,85.129,43,17.85,23313.199,370.946,9.74,0.811,0
157,33,165,12732,27,771,4968,195508,87.04,19237682,85.129,43,17.85,23313.199,370.946,9.74,0.811,0
157,34,431,13163,9,780,3560,199068,87.04,19237682,85.129,43,17.85,23313.199,370.946,9.74,0.811,0
157,35,349,13512,23,803,6774,205842,87.04,19237682,85.129,43,17.85,23313.199,370.946,9.74,0.811,0
157,36,325,13837,24,827,11297,217139,87.04,19237682,85.129,43,17.85,23313.199,370.946,9.74,0.811,0
157,37,270,14107,31,858,9474,226613,87.04,19237682,85.129,43,17.85,23313.199,370.946,9.74,0.811,0
157,38,392,14499,18,876,10667,237280,87.04,19237682,85.129,43,17.85,23313.199,370.946,9.74,0.811,0
157,39,312,14811,22,898,10776,248056,87.04,19237682,85.129,43,17.85,23313.199,370.946,9.74,0.811,0
157,40,320,15131,28,926,8693,256749,87.04,19237682,85.129,43,17.85,23313.199,370.946,9.74,0.811,0
157,41,231,15362,26,952,5470,262219,78.7,19237682,85.129,43,17.85,23313.199,370.946,9.74,0.811,0
157,42,226,15588,20,972,6964,269183,78.7,19237682,85.129,43,17.85,23313.199,370.946,9.74,0.811,0
157,43,190,15778,30,1002,8621,277804,78.7,19237682,85.129,43,17.85,23313.199,370.946,9.74,0.811,0
157,44,224,16002,14,1016,8413,286217,78.7,19237682,85.129,43,17.85,23313.199,370.946,9.74,0.811,0
157,45,245,16247,30,1046,8384,294601,75,19237682,85.129,43,17.85,23313.199,370.946,9.74,0.811,0
157,46,190,16437,10,1056,9133,303734,75,19237682,85.129,43,17.85,23313.199,370.946,9.74,0.811,0
157,47,267,16704,25,1081,6673,310407,75,19237682,85.129,43,17.85,23313.199,370.946,9.74,0.811,0
157,48,167,16871,16,1097,3214,313621,75,19237682,85.129,43,17.85,23313.199,370.946,9.74,0.811,0
157,49,165,17036,10,1107,8453,322074,75,19237682,85.129,43,17.85,23313.199,370.946,9.74,0.811,0
157,50,155,17191,19,1126,10413,332487,75,19237682,85.129,43,17.85,23313.199,370.946,9.74,0.811,0
157,51,196,17387,15,1141,9979,342466,75,19237682,85.129,43,17.85,23313.199,370.946,9.74,0.811,0
157,52,198,17585,10,1151,10181,352647,75,19237682,85.129,43,17.85,23313.199,370.946,9.74,0.811,0
157,53,127,17712,8,1159,8919,361566,75,19237682,85.129,43,17.85,23313.199,370.946,9.74,0.811,0
157,54,145,17857,11,1170,6916,368482,75,19237682,85.129,43,17.85,23313.199,370.946,9.74,0.811,0
157,55,213,18070,9,1179,8709,377191,75,19237682,85.129,43,17.85,23313.199,370.946,9.74,0.811,0
157,56,213,18283,18,1197,8537,385728,75,19237682,85.129,43,17.85,23313.199,370.946,9.74,0.811,0
157,57,146,18429,13,1210,11835,397563,75,19237682,85.129,43,17.85,23313.199,370.946,9.74,0.811,0
157,58,165,18594,9,1219,12437,410000,75,19237682,85.129,43,17.85,23313.199,370.946,9.74,0.811,0
157,59,197,18791,10,1229,11451,421451,75,19237682,85.129,43,17.85,23313.199,370.946,9.74,0.811,0
157,60,191,18982,11,1240,4368,425819,75,19237682,85.129,43,17.85,23313.199,370.946,9.74,0.811,0
157,61,151,19133,13,1253,13378,439197,75,19237682,85.129,43,17.85,23313.199,370.946,9.74,0.811,0
157,62,124,19257,9,1262,4055,443252,57.41,19237682,85.129,43,17.85,23313.199,370.946,9.74,0.811,0
157,63,141,19398,17,1279,0,443252,57.41,19237682,85.129,43,17.85,23313.199,370.946,9.74,0.811,0
157,64,119,19517,0,1279,0,459405,57.41,19237682,85.129,43,17.85,23313.199,370.946,9.74,0.811,0
157,65,152,19669,9,1288,13445,472850,57.41,19237682,85.129,43,17.85,23313.199,370.946,9.74,0.811,0
157,66,238,19907,11,1299,11932,484782,57.41,19237682,85.129,43,17.85,23313.199,370.946,9.74,0.811,0
157,67,196,20103,9,1308,11626,496408,57.41,19237682,85.129,43,17.85,23313.199,370.946,9.74,0.811,0
157,68,187,20290,10,1318,6792,503200,57.41,19237682,85.129,43,17.85,23313.199,370.946,9.74,0.811,0
157,69,189,20479,8,1326,2915,506115,57.41,19237682,85.129,43,17.85,23313.199,370.946,9.74,0.811,0
157,70,125,20604,8,1334,5180,511295,57.41,19237682,85.129,43,17.85,23313.199,370.946,9.74,0.811,0
157,71,145,20749,11,1345,9269,520564,57.41,19237682,85.129,43,17.85,23313.199,370.946,9.74,0.811,0
157,72,196,20945,15,1360,11055,531619,57.41,19237682,85.129,43,17.85,23313.199,370.946,9.74,0.811,0
157,73,237,21182,9,1369,0,531619,57.41,19237682,85.129,43,17.85,23313.199,370.946,9.74,0.811,0
157,74,222,21404,11,1380,0,552670,57.41,19237682,85.129,43,17.85,23313.199,370.946,9.74,0.811,0
157,75,275,21679,11,1391,7926,560596,57.41,19237682,85.129,43,17.85,23313.199,370.946,9.74,0.811,0
157,76,320,21999,19,1410,3682,564278,50.93,19237682,85.129,43,17.85,23313.199,370.946,9.74,0.811,0
157,77,166,22165,17,1427,9360,573638,50.93,19237682,85.129,43,17.85,23313.199,370.946,9.74,0.811,0
157,78,250,22415,10,1437,11715,585353,41.67,19237682,85.129,43,17.85,23313.199,370.946,9.74,0.811,0
157,79,345,22760,14,1451,12343,597696,41.67,19237682,85.129,43,17.85,23313.199,370.946,9.74,0.811,0
157,80,320,23080,22,1473,11075,608771,41.67,19237682,85.129,43,17.85,23313.199,370.946,9.74,0.811,0
157,81,320,23400,11,1484,11226,619997,41.67,19237682,85.129,43,17.85,23313.199,370.946,9.74,0.811,0
157,82,330,23730,16,1500,6333,626330,41.67,19237682,85.129,43,17.85,23313.199,370.946,9.74,0.811,0
157,83,315,24045,12,1512,4044,630374,41.67,19237682,85.129,43,17.85,23313.199,370.946,9.74,0.811,0
157,84,246,24291,11,1523,8948,639322,41.67,19237682,85.129,43,17.85,23313.199,370.946,9.74,0.811,0
157,85,214,24505,16,1539,0,639322,41.67,19237682,85.129,43,17.85,23313.199,370.946,9.74,0.811,0
157,86,321,24826,16,1555,0,663558,41.67,19237682,85.129,43,17.85,23313.199,370.946,9.74,0.811,0
157,87,460,25286,10,1565,11824,675382,41.67,19237682,85.129,43,17.85,23313.199,370.946,9.74,0.811,0
157,88,411,25697,14,1579,1877,677259,41.67,19237682,85.129,43,17.85,23313.199,370.946,9.74,0.811,0
157,89,325,26022,10,1589,17650,694909,41.67,19237682,85.129,43,17.85,23313.199,370.946,9.74,0.811,0
157,90,291,26313,23,1612,4779,699688,41.67,19237682,85.129,43,17.85,23313.199,370.946,9.74,0.811,0
157,91,269,26582,22,1634,10424,710112,41.67,19237682,85.129,43,17.85,23313.199,370.946,9.74,0.811,0
157,92,388,26970,17,1651,12585,722697,41.67,19237682,85.129,43,17.85,23313.199,370.946,9.74,0.811,0
157,93,326,27296,16,1667,12524,735221,41.67,19237682,85.129,43,17.85,23313.199,370.946,9.74,0.811,0
157,94,450,27746,20,1687,12371,747592,41.67,19237682,85.129,43,17.85,23313.199,370.946,9.74,0.811,0
157,95,420,28166,21,1708,11445,759037,41.67,19237682,85.129,43,17.85,23313.199,370.946,9.74,0.811,0
157,96,416,28582,23,1731,0,759037,41.67,19237682,85.129,43,17.85,23313.199,370.946,9.74,0.811,0
157,97,391,28973,19,1750,0,766868,41.67,19237682,85.129,43,17.85,23313.199,370.946,9.74,0.811,0
157,98,250,29223,18,1768,16469,783337,38.89,19237682,85.129,43,17.85,23313.199,370.946,9.74,0.811,0
157,99,397,29620,31,1799,13147,796484,42.59,19237682,85.129,43,17.85,23313.199,370.946,9.74,0.811,0
157,100,555,30175,18,1817,13179,809663,42.59,19237682,85.129,43,17.85,23313.199,370.946,9.74,0.811,0
157,101,614,30789,17,1834,14680,824343,42.59,19237682,85.129,43,17.85,23313.199,370.946,9.74,0.811,0
157,102,592,31381,13,1847,14610,838953,42.59,19237682,85.129,43,17.85,23313.199,370.946,9.74,0.811,0
157,103,698,32079,24,1871,8633,847586,42.59,19237682,85.129,43,17.85,23313.199,370.946,9.74,0.811,0
157,104,456,32535,13,1884,6655,854241,42.59,19237682,85.129,43,17.85,23313.199,370.946,9.74,0.811,0
157,105,413,32948,17,1901,0,854241,42.59,19237682,85.129,43,17.85,23313.199,370.946,9.74,0.811,0
157,106,637,33585,30,1931,0,886918,42.59,19237682,85.129,43,17.85,23313.199,370.946,9.74,0.811,0
157,107,641,34226,21,1952,19097,906015,42.59,19237682,85.129,43,17.85,23313.199,370.946,9.74,0.811,0
157,108,777,35003,19,1971,18986,925001,42.59,19237682,85.129,43,17.85,23313.199,370.946,9.74,0.811,0
157,109,799,35802,17,1988,18732,943733,42.59,19237682,85.129,43,17.85,23313.199,370.946,9.74,0.811,0
157,110,889,36691,21,2009,14889,958622,42.59,19237682,85.129,43,17.85,23313.199,370.946,9.74,0.811,0
157,111,767,37458,17,2026,8570,967192,42.59,19237682,85.129,43,17.85,23313.199,370.946,9.74,0.811,0
157,112,681,38139,12,2038,17204,984396,42.59,19237682,85.129,43,17.85,23313.199,370.946,9.74,0.811,0
157,113,994,39133,36,2074,24877,1009273,42.59,19237682,85.129,43,17.85,23313.199,370.946,9.74,0.811,0
157,114,1030,40163,27,2101,21419,1030692,42.59,19237682,85.129,43,17.85,23313.199,370.946,9.74,0.811,0
157,115,1112,41275,25,2126,22964,1053656,42.59,19237682,85.129,43,17.85,23313.199,370.946,9.74,0.811,0
157,116,1119,42394,24,2150,34127,1087783,42.59,19237682,85.129,43,17.85,23313.199,370.946,9.74,0.811,0
157,117,1284,43678,15,2165,15118,1102901,42.59,19237682,85.129,43,17.85,23313.199,370.946,9.74,0.811,0
157,118,1120,44798,22,2187,28798,1131699,42.59,19237682,85.129,43,17.85,23313.199,370.946,9.74,0.811,0
157,119,1104,45902,19,2206,22529,1154228,42.59,19237682,85.129,43,17.85,23313.199,370.946,9.74,0.811,0
157,120,1151,47053,33,2239,23402,1177630,42.59,19237682,85.129,43,17.85,23313.199,370.946,9.74,0.811,0
157,121,1182,48235,30,2269,24977,1202607,42.59,19237682,85.129,43,17.85,23313.199,370.946,9.74,0.811,0
157,122,1356,49591,35,2304,23451,1226058,42.59,19237682,85.129,43,17.85,23313.199,370.946,9.74,0.811,0
157,123,1295,50886,39,2343,14215,1240273,42.59,19237682,85.129,43,17.85,23313.199,370.946,9.74,0.811,0
157,124,1225,52111,36,2379,8045,1248318,42.59,19237682,85.129,43,17.85,23313.199,370.946,9.74,0.811,0
157,125,1075,53186,34,2413,20581,1268899,42.59,19237682,85.129,43,17.85,23313.199,370.946,9.74,0.811,0
157,126,823,54009,19,2432,0,1268899,42.59,19237682,85.129,43,17.85,23313.199,370.946,9.74,0.811,0
157,127,1232,55241,48,2480,0,1295222,42.59,19237682,85.129,43,17.85,23313.199,370.946,9.74,0.811,0
157,128,1309,56550,41,2521,24147,1319369,42.59,19237682,85.129,43,17.85,23313.199,370.946,9.74,0.811,0
157,129,1345,57895,45,2566,23946,1343315,42.59,19237682,85.129,43,17.85,23313.199,370.946,9.74,0.811,0
157,130,1378,59273,50,2616,21444,1364759,42.59,19237682,85.129,43,17.85,23313.199,370.946,9.74,0.811,0
157,131,1350,60623,43,2659,13968,1378727,42.59,19237682,85.129,43,17.85,23313.199,370.946,9.74,0.811,0
157,132,1145,61768,41,2700,6607,1385334,42.59,19237682,85.129,43,17.85,23313.199,370.946,9.74,0.811,0
157,133,779,62547,29,2729,19511,1404845,42.59,19237682,85.129,43,17.85,23313.199,370.946,9.74,0.811,0
157,134,1215,63762,35,2764,22781,1427626,42.59,19237682,85.129,43,17.85,23313.199,370.946,9.74,0.811,0
157,135,1415,65177,43,2807,22643,1450269,42.59,19237682,85.129,43,17.85,23313.199,370.946,9.74,0.811,0
157,136,1454,66631,53,2860,27787,1478056,42.59,19237682,85.129,43,17.85,23313.199,370.946,9.74,0.811,0
157,137,1415,68046,44,2904,23986,1502042,42.59,19237682,85.129,43,17.85,23313.199,370.946,9.74,0.811,0
157,138,1328,69374,50,2954,11846,1513888,42.59,19237682,85.129,43,17.85,23313.199,370.946,9.74,0.811,0
157,139,1087,70461,37,2991,6862,1520750,42.59,19237682,85.129,43,17.85,23313.199,370.946,9.74,0.811,0
157,140,733,71194,38,3029,21344,1542094,42.59,19237682,85.129,43,17.85,23313.199,370.946,9.74,0.811,0
157,141,1014,72208,45,3074,24538,1566632,42.59,19237682,85.129,43,17.85,23313.199,370.946,9.74,0.811,0
157,142,1409,73617,32,3106,24383,1591015,42.59,19237682,85.129,43,17.85,23313.199,370.946,9.74,0.811,0
157,143,1346,74963,48,3154,25363,1616378,42.59,19237682,85.129,43,17.85,23313.199,370.946,9.74,0.811,0
157,144,1392,76355,42,3196,22992,1639370,42.59,19237682,85.129,43,17.85,23313.199,370.946,9.74,0.811,0
157,145,1189,77544,37,3233,13274,1652644,42.59,19237682,85.129,43,17.85,23313.199,370.946,9.74,0.811,0
157,146,981,78525,39,3272,6491,1659135,42.59,19237682,85.129,43,17.85,23313.199,370.946,9.74,0.811,0
157,147,805,79330,37,3309,20479,1679614,42.59,19237682,85.129,43,17.85,23313.199,370.946,9.74,0.811,0
157,148,1060,80390,58,3367,25754,1705368,42.59,19237682,85.129,43,17.85,23313.199,370.946,9.74,0.811,0
157,149,1256,81646,54,3421,25052,1730420,42.59,19237682,85.129,43,17.85,23313.199,370.946,9.74,0.811,0
157,150,1504,83150,38,3459,26500,1756920,42.59,19237682,85.129,43,17.85,23313.199,370.946,9.74,0.811,0
157,151,1318,84468,48,3507,24043,1780963,42.59,19237682,85.129,43,17.85,23313.199,370.946,9.74,0.811,0
157,152,1365,85833,32,3539,14670,1795633,42.59,19237682,85.129,43,17.85,23313.199,370.946,9.74,0.811,0
157,153,952,86785,39,3578,7313,1802946,42.59,19237682,85.129,43,17.85,23313.199,370.946,9.74,0.811,0
157,154,755,87540,43,3621,22326,1825272,42.59,19237682,85.129,43,17.85,23313.199,370.946,9.74,0.811,0
157,155,1053,88593,60,3681,26816,1852088,42.59,19237682,85.129,43,17.85,23313.199,370.946,9.74,0.811,0
157,156,1298,89891,40,3721,23975,1876063,45.37,19237682,85.129,43,17.85,23313.199,370.946,9.74,0.811,0
157,157,1365,91256,44,3765,0,1876063,45.37,19237682,85.129,43,17.85,23313.199,370.946,9.74,0.811,0
157,158,1339,92595,47,3812,0,1901240,45.37,19237682,85.129,43,17.85,23313.199,370.946,9.74,0.811,0
157,159,1269,93864,38,3850,37251,1938491,45.37,19237682,85.129,43,17.85,23313.199,370.946,9.74,0.811,0
157,160,1150,95014,43,3893,7247,1945738,45.37,19237682,85.129,43,17.85,23313.199,370.946,9.74,0.811,0
157,161,883,95897,33,3926,20552,1966290,45.37,19237682,85.129,43,17.85,23313.199,370.946,9.74,0.811,0
157,162,1136,97033,41,3967,24297,1990587,45.37,19237682,85.129,43,17.85,23313.199,370.946,9.74,0.811,0
157,163,1271,98304,51,4018,25185,2015772,45.37,19237682,85.129,43,17.85,23313.199,370.946,9.74,0.811,0
157,164,1380,99684,47,4065,26149,2041921,45.37,19237682,85.129,43,17.85,23313.199,370.946,9.74,0.811,0
157,165,1391,101075,35,4100,24939,2066860,45.37,19237682,85.129,43,17.85,23313.199,370.946,9.74,0.811,0
157,166,1311,102386,27,4127,14784,2081644,45.37,19237682,85.129,43,17.85,23313.199,370.946,9.74,0.811,0
157,167,1109,103495,36,4163,7331,2088975,43.52,19237682,85.129,43,17.85,23313.199,370.946,9.74,0.811,0
157,168,692,104187,22,4185,21049,2110024,43.52,19237682,85.129,43,17.85,23313.199,370.946,9.74,0.811,0
157,169,1111,105298,51,4236,26520,2136544,43.52,19237682,85.129,43,17.85,23313.199,370.946,9.74,0.811,0
157,170,1713,107011,49,4285,0,2136544,43.52,19237682,85.129,43,17.85,23313.199,370.946,9.74,0.811,0
157,171,1679,108690,27,4312,0,2185923,43.52,19237682,85.129,43,17.85,23313.199,370.946,9.74,0.811,0
157,172,1527,110217,48,4360,24148,2210071,43.52,19237682,85.129,43,17.85,23313.199,370.946,9.74,0.811,0
157,173,1333,111550,42,4402,13391,2223462,43.52,19237682,85.129,43,17.85,23313.199,370.946,9.74,0.811,0
157,174,1231,112781,33,4435,7940,2231402,43.52,19237682,85.129,43,17.85,23313.199,370.946,9.74,0.811,0
157,175,808,113589,23,4458,21978,2253380,43.52,19237682,85.129,43,17.85,23313.199,370.946,9.74,0.811,0
157,176,1059,114648,45,4503,24745,2278125,43.52,19237682,85.129,43,17.85,23313.199,370.946,9.74,0.811,0
157,177,1767,116415,47,4550,24703,2302828,43.52,19237682,85.129,43,17.85,23313.199,370.946,9.74,0.811,0
157,178,1639,118054,41,4591,25494,2328322,43.52,19237682,85.129,43,17.85,23313.199,370.946,9.74,0.811,0
157,179,1629,119683,42,4633,24328,2352650,43.52,19237682,85.129,43,17.85,23313.199,370.946,9.74,0.811,0
157,180,1552,121235,54,4687,13528,2366178,43.52,19237682,85.129,43,17.85,23313.199,370.946,9.74,0.811,0
157,181,1438,122673,31,4718,6162,2372340,43.52,19237682,85.129,43,17.85,23313.199,370.946,9.74,0.811,0
157,182,1271,123944,30,4748,21330,2393670,43.52,19237682,85.129,43,17.85,23313.199,370.946,9.74,0.811,0
157,183,1470,125414,44,4792,26021,2419691,43.52,19237682,85.129,43,17.85,23313.199,370.946,9.74,0.811,0
157,184,2158,127572,33,4825,25797,2445488,43.52,19237682,85.129,43,17.85,23313.199,370.946,9.74,0.811,0
157,185,2086,129658,37,4862,26011,2471499,43.52,19237682,85.129,43,17.85,23313.199,370.946,9.74,0.811,0
157,186,2343,132001,53,4915,0,2471499,43.52,19237682,85.129,43,17.85,23313.199,370.946,9.74,0.811,0
157,187,2064,134065,32,4947,0,2510209,43.52,19237682,85.129,43,17.85,23313.199,370.946,9.74,0.811,0
157,188,0,134065,0,4947,6537,2516746,43.52,19237682,85.129,43,17.85,23313.199,370.946,9.74,0.811,0
157,189,3426,137491,101,5048,0,2516746,43.52,19237682,85.129,43,17.85,23313.199,370.946,9.74,0.811,0
157,190,2121,139612,73,5121,0,2568071,45.37,19237682,85.129,43,17.85,23313.199,370.946,9.74,0.811,0
157,191,2958,142570,82,5203,30191,2598262,45.37,19237682,85.129,43,17.85,23313.199,370.946,9.74,0.811,0
157,192,3130,145700,44,5247,29282,2627544,44.44,19237682,85.129,43,17.85,23313.199,370.946,9.74,0.811,0
157,193,3186,148886,52,5299,29284,2656828,44.44,19237682,85.129,43,17.85,23313.199,370.946,9.74,0.811,0
157,194,3517,152403,59,5358,15709,2672537,44.44,19237682,85.129,43,17.85,23313.199,370.946,9.74,0.811,0
157,195,2880,155283,53,5411,10051,2682588,44.44,19237682,85.129,43,17.85,23313.199,370.946,9.74,0.811,0
157,196,2069,157352,56,5467,26718,2709306,44.44,19237682,85.129,43,17.85,23313.199,370.946,9.74,0.811,0
157,197,3109,160461,68,5535,31318,2740624,44.44,19237682,85.129,43,17.85,23313.199,370.946,9.74,0.811,0
157,198,4016,164477,66,5601,29857,2770481,44.44,19237682,85.129,43,17.85,23313.199,370.946,9.74,0.811,0
157,199,4013,168490,73,5674,30431,2800912,44.44,19237682,85.129,43,17.85,23313.199,370.946,9.74,0.811,0
157,200,4026,172516,75,5749,31767,2832679,44.44,19237682,85.129,43,17.85,23313.199,370.946,9.74,0.811,0
157,201,3952,176468,63,5812,19507,2852186,44.44,19237682,85.129,43,17.85,23313.199,370.946,9.74,0.811,0
157,202,3920,180388,60,5872,0,2852186,44.44,19237682,85.129,43,17.85,23313.199,370.946,9.74,0.811,0
157,203,2466,182854,59,5931,0,2852186,44.44,19237682,85.129,43,17.85,23313.199,370.946,9.74,0.811,0
157,204,3400,186254,65,5996,0,2852186,44.44,19237682,85.129,43,17.85,23313.199,370.946,9.74,0.811,0
158,1,501,2337,7,17,129500,536000,87.04,145934460,8.823,39.6,14.178,24765.954,431.297,6.18,0.816,3
158,2,440,2777,7,24,39103,575103,87.04,145934460,8.823,39.6,14.178,24765.954,431.297,6.18,0.816,3
158,3,771,3548,6,30,64503,639606,87.04,145934460,8.823,39.6,14.178,24765.954,431.297,6.18,0.816,3
158,4,601,4149,4,34,57398,697004,87.04,145934460,8.823,39.6,14.178,24765.954,431.297,6.18,0.816,3
158,5,582,4731,9,43,61397,758401,87.04,145934460,8.823,39.6,14.178,24765.954,431.297,6.18,0.816,3
158,6,658,5389,2,45,37122,795523,85.19,145934460,8.823,39.6,14.178,24765.954,431.297,6.18,0.816,3
158,7,954,6343,2,47,114698,910221,85.19,145934460,8.823,39.6,14.178,24765.954,431.297,6.18,0.816,3
158,8,1154,7497,11,58,94498,1004719,85.19,145934460,8.823,39.6,14.178,24765.954,431.297,6.18,0.816,3
158,9,1175,8672,5,63,88092,1092811,85.19,145934460,8.823,39.6,14.178,24765.954,431.297,6.18,0.816,3
158,10,1459,10131,13,76,91631,1184442,85.19,145934460,8.823,39.6,14.178,24765.954,431.297,6.18,0.816,3
158,11,1786,11917,18,94,94305,1278747,85.19,145934460,8.823,39.6,14.178,24765.954,431.297,6.18,0.816,3
158,12,1667,13584,12,106,81246,1359993,85.19,145934460,8.823,39.6,14.178,24765.954,431.297,6.18,0.816,3
158,13,2186,15770,24,130,66021,1426014,85.19,145934460,8.823,39.6,14.178,24765.954,431.297,6.18,0.816,3
158,14,2558,18328,18,148,91978,1517992,85.19,145934460,8.823,39.6,14.178,24765.954,431.297,6.18,0.816,3
158,15,2774,21102,22,170,95421,1613413,85.19,145934460,8.823,39.6,14.178,24765.954,431.297,6.18,0.816,3
158,16,3388,24490,28,198,104606,1718019,85.19,145934460,8.823,39.6,14.178,24765.954,431.297,6.18,0.816,3
158,17,3448,27938,34,232,113873,1831892,85.19,145934460,8.823,39.6,14.178,24765.954,431.297,6.18,0.816,3
158,18,4070,32008,41,273,117921,1949813,85.19,145934460,8.823,39.6,14.178,24765.954,431.297,6.18,0.816,3
158,19,4785,36793,40,313,103506,2053319,85.19,145934460,8.823,39.6,14.178,24765.954,431.297,6.18,0.816,3
158,20,6060,42853,48,361,89285,2142604,85.19,145934460,8.823,39.6,14.178,24765.954,431.297,6.18,0.816,3
158,21,4268,47121,44,405,109935,2252539,85.19,145934460,8.823,39.6,14.178,24765.954,431.297,6.18,0.816,3
158,22,5642,52763,51,456,149077,2401616,85.19,145934460,8.823,39.6,14.178,24765.954,431.297,6.18,0.816,3
158,23,5236,57999,57,513,150384,2552000,85.19,145934460,8.823,39.6,14.178,24765.954,431.297,6.18,0.816,3
158,24,4774,62773,42,555,169500,2721500,85.19,145934460,8.823,39.6,14.178,24765.954,431.297,6.18,0.816,3
158,25,5849,68622,60,615,156199,2877699,85.19,145934460,8.823,39.6,14.178,24765.954,431.297,6.18,0.816,3
158,26,5966,74588,66,681,141735,3019434,85.19,145934460,8.823,39.6,14.178,24765.954,431.297,6.18,0.816,3
158,27,6361,80949,66,747,119824,3139258,85.19,145934460,8.823,39.6,14.178,24765.954,431.297,6.18,0.816,3
158,28,6198,87147,48,795,164459,3303717,85.19,145934460,8.823,39.6,14.178,24765.954,431.297,6.18,0.816,3
158,29,6411,93558,72,867,194591,3498308,85.19,145934460,8.823,39.6,14.178,24765.954,431.297,6.18,0.816,3
158,30,5841,99399,105,972,225499,3723807,85.19,145934460,8.823,39.6,14.178,24765.954,431.297,6.18,0.816,3
158,31,7099,106498,101,1073,221711,3945518,85.19,145934460,8.823,39.6,14.178,24765.954,431.297,6.18,0.816,3
158,32,7933,114431,96,1169,154481,4099999,85.19,145934460,8.823,39.6,14.178,24765.954,431.297,6.18,0.816,3
158,33,9623,124054,53,1222,203244,4303243,85.19,145934460,8.823,39.6,14.178,24765.954,431.297,6.18,0.816,3
158,34,10633,134687,58,1280,157114,4460357,85.19,145934460,8.823,39.6,14.178,24765.954,431.297,6.18,0.816,3
158,35,10581,145268,76,1356,173374,4633731,85.19,145934460,8.823,39.6,14.178,24765.954,431.297,6.18,0.816,3
158,36,10102,155370,95,1451,169461,4803192,85.19,145934460,8.823,39.6,14.178,24765.954,431.297,6.18,0.816,3
158,37,10559,165929,86,1537,184276,4987468,85.19,145934460,8.823,39.6,14.178,24765.954,431.297,6.18,0.816,3
158,38,11231,177160,88,1625,234496,5221964,85.19,145934460,8.823,39.6,14.178,24765.954,431.297,6.18,0.816,3
158,39,10699,187859,98,1723,226499,5448463,85.19,145934460,8.823,39.6,14.178,24765.954,431.297,6.18,0.816,3
158,40,10817,198676,104,1827,188300,5636763,85.19,145934460,8.823,39.6,14.178,24765.954,431.297,6.18,0.816,3
158,41,11012,209688,88,1915,168641,5805404,85.19,145934460,8.823,39.6,14.178,24765.954,431.297,6.18,0.816,3
158,42,11656,221344,94,2009,177154,5982558,78.24,145934460,8.823,39.6,14.178,24765.954,431.297,6.18,0.816,3
158,43,10899,232243,107,2116,205544,6188102,78.24,145934460,8.823,39.6,14.178,24765.954,431.297,6.18,0.816,3
158,44,10028,242271,96,2212,225846,6413948,78.24,145934460,8.823,39.6,14.178,24765.954,431.297,6.18,0.816,3
158,45,9974,252245,93,2305,242392,6656340,78.24,145934460,8.823,39.6,14.178,24765.954,431.297,6.18,0.816,3
158,46,10598,262843,113,2418,259748,6916088,78.24,145934460,8.823,39.6,14.178,24765.954,431.297,6.18,0.816,3
158,47,9200,272043,119,2537,230926,7147014,78.24,145934460,8.823,39.6,14.178,24765.954,431.297,6.18,0.816,3
158,48,9709,281752,94,2631,205302,7352316,78.24,145934460,8.823,39.6,14.178,24765.954,431.297,6.18,0.816,3
158,49,8926,290678,91,2722,225713,7578029,78.24,145934460,8.823,39.6,14.178,24765.954,431.297,6.18,0.816,3
158,50,9263,299941,115,2837,262851,7840880,78.24,145934460,8.823,39.6,14.178,24765.954,431.297,6.18,0.816,3
158,51,8764,308705,135,2972,285746,8126626,78.24,145934460,8.823,39.6,14.178,24765.954,431.297,6.18,0.816,3
158,52,8849,317554,127,3099,276121,8402747,78.24,145934460,8.823,39.6,14.178,24765.954,431.297,6.18,0.816,3
158,53,8894,326448,150,3249,282558,8685305,78.24,145934460,8.823,39.6,14.178,24765.954,431.297,6.18,0.816,3
158,54,9434,335882,139,3388,260079,8945384,78.24,145934460,8.823,39.6,14.178,24765.954,431.297,6.18,0.816,3
158,55,8599,344481,153,3541,215206,9160590,78.24,145934460,8.823,39.6,14.178,24765.954,431.297,6.18,0.816,3
158,56,8946,353427,92,3633,255402,9415992,78.24,145934460,8.823,39.6,14.178,24765.954,431.297,6.18,0.816,3
158,57,8915,362342,174,3807,285288,9701280,78.24,145934460,8.823,39.6,14.178,24765.954,431.297,6.18,0.816,3
158,58,8338,370680,161,3968,298781,10000061,78.24,145934460,8.823,39.6,14.178,24765.954,431.297,6.18,0.816,3
158,59,8371,379051,174,4142,316139,10316200,78.24,145934460,8.823,39.6,14.178,24765.954,431.297,6.18,0.816,3
158,60,8572,387623,232,4374,326924,10643124,78.24,145934460,8.823,39.6,14.178,24765.954,431.297,6.18,0.816,3
158,61,8952,396575,181,4555,279984,10923108,78.24,145934460,8.823,39.6,14.178,24765.954,431.297,6.18,0.816,3
158,62,9268,405843,138,4693,228514,11151622,74.54,145934460,8.823,39.6,14.178,24765.954,431.297,6.18,0.816,3
158,63,9035,414878,162,4855,274423,11426045,74.54,145934460,8.823,39.6,14.178,24765.954,431.297,6.18,0.816,3
158,64,8863,423741,182,5037,307006,11733051,74.54,145934460,8.823,39.6,14.178,24765.954,431.297,6.18,0.816,3
158,65,8536,432277,178,5215,320612,12053663,74.54,145934460,8.823,39.6,14.178,24765.954,431.297,6.18,0.816,3
158,66,8831,441108,169,5384,335305,12388968,74.54,145934460,8.823,39.6,14.178,24765.954,431.297,6.18,0.816,3
158,67,8726,449834,144,5528,332581,12721549,74.54,145934460,8.823,39.6,14.178,24765.954,431.297,6.18,0.816,3
158,68,8855,458689,197,5725,294474,13016023,74.54,145934460,8.823,39.6,14.178,24765.954,431.297,6.18,0.816,3
158,69,8984,467673,134,5859,238655,13254678,74.54,145934460,8.823,39.6,14.178,24765.954,431.297,6.18,0.816,3
158,70,8985,476658,112,5971,290625,13545303,74.54,145934460,8.823,39.6,14.178,24765.954,431.297,6.18,0.816,3
158,71,8595,485253,170,6141,329794,13875097,74.54,145934460,8.823,39.6,14.178,24765.954,431.297,6.18,0.816,3
158,72,8404,493657,217,6358,343577,14218674,74.54,145934460,8.823,39.6,14.178,24765.954,431.297,6.18,0.816,3
158,73,8779,502436,174,6532,355443,14574117,74.54,145934460,8.823,39.6,14.178,24765.954,431.297,6.18,0.816,3
158,74,8987,511423,183,6715,306055,14880172,74.54,145934460,8.823,39.6,14.178,24765.954,431.297,6.18,0.816,3
158,75,8706,520129,114,6829,280980,15161152,74.54,145934460,8.823,39.6,14.178,24765.954,431.297,6.18,0.816,3
158,76,8835,528964,119,6948,234265,15395417,74.54,145934460,8.823,39.6,14.178,24765.954,431.297,6.18,0.816,3
158,77,8246,537210,143,7091,284307,15679724,74.54,145934460,8.823,39.6,14.178,24765.954,431.297,6.18,0.816,3
158,78,8248,545458,193,7284,311973,15991697,74.54,145934460,8.823,39.6,14.178,24765.954,431.297,6.18,0.816,3
158,79,7843,553301,194,7478,330267,16321964,74.54,145934460,8.823,39.6,14.178,24765.954,431.297,6.18,0.816,3
158,80,7790,561091,312,7790,339323,16661287,74.54,145934460,8.823,39.6,14.178,24765.954,431.297,6.18,0.816,3
158,81,7972,569063,182,7972,337166,16998453,74.54,145934460,8.823,39.6,14.178,24765.954,431.297,6.18,0.816,3
158,82,7889,576952,30,8002,291238,17289691,74.54,145934460,8.823,39.6,14.178,24765.954,431.297,6.18,0.816,3
158,83,7728,584680,109,8111,233061,17522752,74.54,145934460,8.823,39.6,14.178,24765.954,431.297,6.18,0.816,3
158,84,7600,592280,95,8206,281203,17803955,72.69,145934460,8.823,39.6,14.178,24765.954,431.297,6.18,0.816,3
158,85,7425,599705,153,8359,311875,18115830,72.69,145934460,8.823,39.6,14.178,24765.954,431.297,6.18,0.816,3
158,86,7176,606881,154,8513,286889,18402719,72.69,145934460,8.823,39.6,14.178,24765.954,431.297,6.18,0.816,3
158,87,7113,613994,92,8605,305227,18707946,72.69,145934460,8.823,39.6,14.178,24765.954,431.297,6.18,0.816,3
158,88,6800,620794,176,8781,337008,19044954,72.69,145934460,8.823,39.6,14.178,24765.954,431.297,6.18,0.816,3
158,89,6852,627646,188,8969,289488,19334442,72.69,145934460,8.823,39.6,14.178,24765.954,431.297,6.18,0.816,3
158,90,6791,634437,104,9073,227998,19562440,72.69,145934460,8.823,39.6,14.178,24765.954,431.297,6.18,0.816,3
158,91,6719,641156,93,9166,289727,19852167,72.69,145934460,8.823,39.6,14.178,24765.954,431.297,6.18,0.816,3
158,92,6693,647849,154,9320,316737,20168904,72.69,145934460,8.823,39.6,14.178,24765.954,431.297,6.18,0.816,3
158,93,6556,654405,216,9536,282206,20451110,72.69,145934460,8.823,39.6,14.178,24765.954,431.297,6.18,0.816,3
158,94,6760,661165,147,9683,301296,20752406,72.69,145934460,8.823,39.6,14.178,24765.954,431.297,6.18,0.816,3
158,95,6718,667883,176,9859,0,20752406,72.69,145934460,8.823,39.6,14.178,24765.954,431.297,6.18,0.816,3
158,96,6632,674515,168,10027,0,21335394,72.69,145934460,8.823,39.6,14.178,24765.954,431.297,6.18,0.816,3
158,97,6736,681251,134,10161,202377,21537771,72.69,145934460,8.823,39.6,14.178,24765.954,431.297,6.18,0.816,3
158,98,6611,687862,135,10296,252934,21790705,72.69,145934460,8.823,39.6,14.178,24765.954,431.297,6.18,0.816,3
158,99,6368,694230,198,10494,288589,22079294,72.69,145934460,8.823,39.6,14.178,24765.954,431.297,6.18,0.816,3
158,100,6562,700792,173,10667,308901,22388195,72.69,145934460,8.823,39.6,14.178,24765.954,431.297,6.18,0.816,3
158,101,6509,707301,176,10843,320221,22708416,72.69,145934460,8.823,39.6,14.178,24765.954,431.297,6.18,0.816,3
158,102,6635,713936,174,11017,322640,23031056,72.69,145934460,8.823,39.6,14.178,24765.954,431.297,6.18,0.816,3
158,103,6611,720547,188,11205,261574,23292630,72.69,145934460,8.823,39.6,14.178,24765.954,431.297,6.18,0.816,3
158,104,6615,727162,130,11335,203122,23495752,70.83,145934460,8.823,39.6,14.178,24765.954,431.297,6.18,0.816,3
158,105,6537,733699,104,11439,258893,23754645,70.83,145934460,8.823,39.6,14.178,24765.954,431.297,6.18,0.816,3
158,106,6248,739947,175,11614,298871,24053516,68.06,145934460,8.823,39.6,14.178,24765.954,431.297,6.18,0.816,3
158,107,6422,746369,156,11770,311052,24364568,68.06,145934460,8.823,39.6,14.178,24765.954,431.297,6.18,0.816,3
158,108,6428,752797,167,11937,312362,24676930,68.06,145934460,8.823,39.6,14.178,24765.954,431.297,6.18,0.816,3
158,109,6406,759203,186,12123,314810,24991740,68.06,145934460,8.823,39.6,14.178,24765.954,431.297,6.18,0.816,3
158,110,6234,765437,124,12247,259874,25251614,68.06,145934460,8.823,39.6,14.178,24765.954,431.297,6.18,0.816,3
158,111,6109,771546,95,12342,197553,25449167,68.06,145934460,8.823,39.6,14.178,24765.954,431.297,6.18,0.816,3
158,112,5940,777486,85,12427,255205,25704372,68.06,145934460,8.823,39.6,14.178,24765.954,431.297,6.18,0.816,3
158,113,5842,783328,153,12580,296536,26000908,68.06,145934460,8.823,39.6,14.178,24765.954,431.297,6.18,0.816,3
158,114,5862,789190,165,12745,299744,26300652,68.06,145934460,8.823,39.6,14.178,24765.954,431.297,6.18,0.816,3
158,115,5848,795038,147,12892,309971,26610623,68.06,145934460,8.823,39.6,14.178,24765.954,431.297,6.18,0.816,3
158,116,5811,800849,154,13046,291668,26902291,68.06,145934460,8.823,39.6,14.178,24765.954,431.297,6.18,0.816,3
158,117,5871,806720,146,13192,239675,27141966,68.06,145934460,8.823,39.6,14.178,24765.954,431.297,6.18,0.816,3
158,118,5765,812485,77,13269,185604,27327570,68.06,145934460,8.823,39.6,14.178,24765.954,431.297,6.18,0.816,3
158,119,5635,818120,85,13354,242076,27569646,68.06,145934460,8.823,39.6,14.178,24765.954,431.297,6.18,0.816,3
158,120,5395,823515,150,13504,288204,27857850,68.06,145934460,8.823,39.6,14.178,24765.954,431.297,6.18,0.816,3
158,121,5475,828990,169,13673,303611,28161461,68.06,145934460,8.823,39.6,14.178,24765.954,431.297,6.18,0.816,3
158,122,5509,834499,129,13802,316551,28478012,68.06,145934460,8.823,39.6,14.178,24765.954,431.297,6.18,0.816,3
158,123,5482,839981,161,13963,315248,28793260,68.06,145934460,8.823,39.6,14.178,24765.954,431.297,6.18,0.816,3
158,124,5462,845443,95,14058,236640,29029900,68.06,145934460,8.823,39.6,14.178,24765.954,431.297,6.18,0.816,3
158,125,5427,850870,70,14128,171962,29201862,68.06,145934460,8.823,39.6,14.178,24765.954,431.297,6.18,0.816,3
158,126,5394,856264,79,14207,232028,29433890,68.06,145934460,8.823,39.6,14.178,24765.954,431.297,6.18,0.816,3
158,127,5159,861423,144,14351,283017,29716907,68.06,145934460,8.823,39.6,14.178,24765.954,431.297,6.18,0.816,3
158,128,5920,867343,181,14532,321216,30038123,68.06,145934460,8.823,39.6,14.178,24765.954,431.297,6.18,0.816,3
158,129,4551,871894,74,14606,303221,30341344,68.06,145934460,8.823,39.6,14.178,24765.954,431.297,6.18,0.816,3
158,130,5241,877135,119,14725,298676,30640020,68.06,145934460,8.823,39.6,14.178,24765.954,431.297,6.18,0.816,3
158,131,5212,882347,129,14854,246140,30886160,68.06,145934460,8.823,39.6,14.178,24765.954,431.297,6.18,0.816,3
158,132,5189,887536,77,14931,177027,31063187,68.06,145934460,8.823,39.6,14.178,24765.954,431.297,6.18,0.816,3
158,133,5118,892654,130,15061,244577,31307764,68.06,145934460,8.823,39.6,14.178,24765.954,431.297,6.18,0.816,3
158,134,4945,897599,70,15131,290538,31598302,68.06,145934460,8.823,39.6,14.178,24765.954,431.297,6.18,0.816,3
158,135,5102,902701,129,15260,304753,31903055,68.06,145934460,8.823,39.6,14.178,24765.954,431.297,6.18,0.816,3
158,136,5057,907758,124,15384,318491,32221546,68.06,145934460,8.823,39.6,14.178,24765.954,431.297,6.18,0.816,3
158,137,5065,912823,114,15498,312272,32533818,68.06,145934460,8.823,39.6,14.178,24765.954,431.297,6.18,0.816,3
158,138,5061,917884,119,15617,250660,32784478,68.06,145934460,8.823,39.6,14.178,24765.954,431.297,6.18,0.816,3
158,139,4969,922853,68,15685,184281,32968759,68.06,145934460,8.823,39.6,14.178,24765.954,431.297,6.18,0.816,3
158,140,4892,927745,55,15740,248709,33217468,68.06,145934460,8.823,39.6,14.178,24765.954,431.297,6.18,0.816,3
158,141,4748,932493,132,15872,291805,33509273,68.06,145934460,8.823,39.6,14.178,24765.954,431.297,6.18,0.816,3
158,142,4828,937321,117,15989,304832,33814105,68.06,145934460,8.823,39.6,14.178,24765.954,431.297,6.18,0.816,3
158,143,4785,942106,110,16099,0,33814105,54.17,145934460,8.823,39.6,14.178,24765.954,431.297,6.18,0.816,3
158,144,4870,946976,90,16189,0,34447560,54.17,145934460,8.823,39.6,14.178,24765.954,431.297,6.18,0.816,3
158,145,4921,951897,121,16310,247846,34695406,54.17,145934460,8.823,39.6,14.178,24765.954,431.297,6.18,0.816,3
158,146,4852,956749,73,16383,187814,34883220,54.17,145934460,8.823,39.6,14.178,24765.954,431.297,6.18,0.816,3
158,147,4744,961493,65,16448,245441,35128661,54.17,145934460,8.823,39.6,14.178,24765.954,431.297,6.18,0.816,3
158,148,4696,966189,120,16568,295122,35423783,54.17,145934460,8.823,39.6,14.178,24765.954,431.297,6.18,0.816,3
158,149,4676,970865,115,16683,327964,35751747,54.17,145934460,8.823,39.6,14.178,24765.954,431.297,6.18,0.816,3
158,150,4711,975576,121,16804,334435,36086182,54.17,145934460,8.823,39.6,14.178,24765.954,431.297,6.18,0.816,3
158,151,4829,980405,110,16914,340668,36426850,54.17,145934460,8.823,39.6,14.178,24765.954,431.297,6.18,0.816,3
158,152,4941,985346,111,17025,269532,36696382,54.17,145934460,8.823,39.6,14.178,24765.954,431.297,6.18,0.816,3
158,153,4980,990326,68,17093,204833,36901215,54.17,145934460,8.823,39.6,14.178,24765.954,431.297,6.18,0.816,3
158,154,4993,995319,83,17176,275612,37176827,38.89,145934460,8.823,39.6,14.178,24765.954,431.297,6.18,0.816,3
158,155,4729,1000048,123,17299,307319,37484146,38.89,145934460,8.823,39.6,14.178,24765.954,431.297,6.18,0.816,3
158,156,4952,1005000,115,17414,334220,37818366,38.89,145934460,8.823,39.6,14.178,24765.954,431.297,6.18,0.816,3
158,157,4995,1009995,114,17528,336190,38154556,38.89,145934460,8.823,39.6,14.178,24765.954,431.297,6.18,0.816,3
158,158,5110,1015105,121,17649,333571,38488127,38.89,145934460,8.823,39.6,14.178,24765.954,431.297,6.18,0.816,3
158,159,5205,1020310,110,17759,270057,38758184,38.89,145934460,8.823,39.6,14.178,24765.954,431.297,6.18,0.816,3
158,160,5195,1025505,61,17820,202577,38960761,38.89,145934460,8.823,39.6,14.178,24765.954,431.297,6.18,0.816,3
158,161,5185,1030690,51,17871,328415,39289176,38.89,145934460,8.823,39.6,14.178,24765.954,431.297,6.18,0.816,3
158,162,5099,1035789,122,17993,286135,39575311,38.89,145934460,8.823,39.6,14.178,24765.954,431.297,6.18,0.816,3
158,163,5218,1041007,160,18153,337215,39912526,38.89,145934460,8.823,39.6,14.178,24765.954,431.297,6.18,0.816,3
158,164,5363,1046370,110,18263,356371,40268897,38.89,145934460,8.823,39.6,14.178,24765.954,431.297,6.18,0.816,3
158,165,5504,1051874,102,18365,355178,40624075,38.89,145934460,8.823,39.6,14.178,24765.954,431.297,6.18,0.816,3
158,166,5488,1057362,119,18484,279476,40903551,38.89,145934460,8.823,39.6,14.178,24765.954,431.297,6.18,0.816,3
158,167,5449,1062811,94,18578,218756,41122307,38.89,145934460,8.823,39.6,14.178,24765.954,431.297,6.18,0.816,3
158,168,5509,1068320,57,18635,301699,41424006,38.89,145934460,8.823,39.6,14.178,24765.954,431.297,6.18,0.816,3
158,169,5529,1073849,150,18785,324922,41748928,38.89,145934460,8.823,39.6,14.178,24765.954,431.297,6.18,0.816,3
158,170,5670,1079519,132,18917,346318,42095246,38.89,145934460,8.823,39.6,14.178,24765.954,431.297,6.18,0.816,3
158,171,5762,1085281,144,19061,361923,42457169,38.89,145934460,8.823,39.6,14.178,24765.954,431.297,6.18,0.816,3
158,172,5905,1091186,134,19195,364722,42821891,38.89,145934460,8.823,39.6,14.178,24765.954,431.297,6.18,0.816,3
158,173,6065,1097251,144,19339,282021,43103912,38.89,145934460,8.823,39.6,14.178,24765.954,431.297,6.18,0.816,3
158,174,6148,1103399,79,19418,237622,43341534,38.89,145934460,8.823,39.6,14.178,24765.954,431.297,6.18,0.816,3
158,175,6196,1109595,71,19489,291007,43632541,40.74,145934460,8.823,39.6,14.178,24765.954,431.297,6.18,0.816,3
158,176,6215,1115810,160,19649,357868,43990409,40.74,145934460,8.823,39.6,14.178,24765.954,431.297,6.18,0.816,3
158,177,6431,1122241,150,19799,374157,44364566,40.74,145934460,8.823,39.6,14.178,24765.954,431.297,6.18,0.816,3
158,178,6595,1128836,149,19948,390796,44755362,40.74,145934460,8.823,39.6,14.178,24765.954,431.297,6.18,0.816,3
158,179,7212,1136048,108,20056,379073,45134435,40.74,145934460,8.823,39.6,14.178,24765.954,431.297,6.18,0.816,3
158,180,7523,1143571,169,20225,308339,45442774,40.74,145934460,8.823,39.6,14.178,24765.954,431.297,6.18,0.816,3
158,181,7867,1151438,99,20324,255899,45698673,40.74,145934460,8.823,39.6,14.178,24765.954,431.297,6.18,0.816,3
158,182,8135,1159573,61,20385,338987,46037660,40.74,145934460,8.823,39.6,14.178,24765.954,431.297,6.18,0.816,3
158,183,8232,1167805,160,20545,384174,46421834,40.74,145934460,8.823,39.6,14.178,24765.954,431.297,6.18,0.816,3
158,184,8481,1176286,177,20722,402045,46823879,40.74,145934460,8.823,39.6,14.178,24765.954,431.297,6.18,0.816,3
158,185,8945,1185231,169,20891,0,46823879,47.69,145934460,8.823,39.6,14.178,24765.954,431.297,6.18,0.816,3
158,186,9412,1194643,186,21077,0,47683832,47.69,145934460,8.823,39.6,14.178,24765.954,431.297,6.18,0.816,3
158,187,9859,1204502,174,21251,358511,48042343,47.69,145934460,8.823,39.6,14.178,24765.954,431.297,6.18,0.816,3
158,188,10499,1215001,107,21358,295649,48337992,47.69,145934460,8.823,39.6,14.178,24765.954,431.297,6.18,0.816,3
158,189,10888,1225889,117,21475,371865,48709857,47.69,145934460,8.823,39.6,14.178,24765.954,431.297,6.18,0.816,3
158,190,11615,1237504,188,21663,439097,49148954,47.69,145934460,8.823,39.6,14.178,24765.954,431.297,6.18,0.816,3
158,191,11115,1248619,202,21865,507919,49656873,47.69,145934460,8.823,39.6,14.178,24765.954,431.297,6.18,0.816,3
158,192,11493,1260112,191,22056,648370,50305243,47.69,145934460,8.823,39.6,14.178,24765.954,431.297,6.18,0.816,3
158,193,12126,1272238,201,22257,476106,50781349,47.69,145934460,8.823,39.6,14.178,24765.954,431.297,6.18,0.816,3
158,194,12846,1285084,197,22454,409960,51191309,47.69,145934460,8.823,39.6,14.178,24765.954,431.297,6.18,0.816,3
158,195,13634,1298718,143,22597,172960,51364269,47.69,145934460,8.823,39.6,14.178,24765.954,431.297,6.18,0.816,3
158,196,13592,1312310,125,22722,436976,51801245,47.69,145934460,8.823,39.6,14.178,24765.954,431.297,6.18,0.816,3
158,197,13868,1326178,244,22966,478489,52279734,47.69,145934460,8.823,39.6,14.178,24765.954,431.297,6.18,0.816,3
158,198,14231,1340409,239,23205,502363,52782097,47.69,145934460,8.823,39.6,14.178,24765.954,431.297,6.18,0.816,3
158,199,13754,1354163,286,23491,523860,53305957,47.69,145934460,8.823,39.6,14.178,24765.954,431.297,6.18,0.816,3
158,200,15150,1369313,232,23723,544552,53850509,47.69,145934460,8.823,39.6,14.178,24765.954,431.297,6.18,0.816,3
158,201,14922,1384235,279,24002,449699,54300208,47.69,145934460,8.823,39.6,14.178,24765.954,431.297,6.18,0.816,3
158,202,15099,1399334,185,24187,374888,54675096,47.69,145934460,8.823,39.6,14.178,24765.954,431.297,6.18,0.816,3
158,203,15982,1415316,179,24366,0,54675096,47.69,145934460,8.823,39.6,14.178,24765.954,431.297,6.18,0.816,3
158,204,16319,1431635,269,24635,0,54675096,47.69,145934460,8.823,39.6,14.178,24765.954,431.297,6.18,0.816,3
159,1,5,75,0,0,0,0,90.74,12952209,494.869,20.3,2.974,1854.211,191.375,4.28,0.524,0
159,2,7,82,0,0,0,0,90.74,12952209,494.869,20.3,2.974,1854.211,191.375,4.28,0.524,0
159,3,0,82,0,0,0,0,90.74,12952209,494.869,20.3,2.974,1854.211,191.375,4.28,0.524,0
159,4,7,89,0,0,0,0,90.74,12952209,494.869,20.3,2.974,1854.211,191.375,4.28,0.524,0
159,5,13,102,0,0,0,0,90.74,12952209,494.869,20.3,2.974,1854.211,191.375,4.28,0.524,0
159,6,2,104,0,0,0,5701,90.74,12952209,494.869,20.3,2.974,1854.211,191.375,4.28,0.524,0
159,7,1,105,0,0,806,6507,90.74,12952209,494.869,20.3,2.974,1854.211,191.375,4.28,0.524,0
159,8,0,105,0,0,772,7279,90.74,12952209,494.869,20.3,2.974,1854.211,191.375,4.28,0.524,0
159,9,5,110,0,0,720,7999,90.74,12952209,494.869,20.3,2.974,1854.211,191.375,4.28,0.524,0
159,10,3,113,0,0,1036,9035,90.74,12952209,494.869,20.3,2.974,1854.211,191.375,4.28,0.524,0
159,11,5,118,0,0,842,9877,90.74,12952209,494.869,20.3,2.974,1854.211,191.375,4.28,0.524,0
159,12,2,120,0,0,1160,11037,90.74,12952209,494.869,20.3,2.974,1854.211,191.375,4.28,0.524,0
159,13,6,126,0,0,901,11938,90.74,12952209,494.869,20.3,2.974,1854.211,191.375,4.28,0.524,0
159,14,1,127,0,0,983,12921,90.74,12952209,494.869,20.3,2.974,1854.211,191.375,4.28,0.524,0
159,15,7,134,0,0,923,13844,90.74,12952209,494.869,20.3,2.974,1854.211,191.375,4.28,0.524,0
159,16,2,136,0,0,664,14508,90.74,12952209,494.869,20.3,2.974,1854.211,191.375,4.28,0.524,0
159,17,2,138,0,0,760,15268,90.74,12952209,494.869,20.3,2.974,1854.211,191.375,4.28,0.524,0
159,18,5,143,0,0,712,15980,90.74,12952209,494.869,20.3,2.974,1854.211,191.375,4.28,0.524,0
159,19,1,144,0,0,722,16702,90.74,12952209,494.869,20.3,2.974,1854.211,191.375,4.28,0.524,0
159,20,3,147,0,0,1299,18001,90.74,12952209,494.869,20.3,2.974,1854.211,191.375,4.28,0.524,0
159,21,0,147,0,0,1449,19450,90.74,12952209,494.869,20.3,2.974,1854.211,191.375,4.28,0.524,0
159,22,3,150,0,0,1038,20488,90.74,12952209,494.869,20.3,2.974,1854.211,191.375,4.28,0.524,0
159,23,3,153,0,0,1343,21831,90.74,12952209,494.869,20.3,2.974,1854.211,191.375,4.28,0.524,0
159,24,1,154,0,0,1046,22877,90.74,12952209,494.869,20.3,2.974,1854.211,191.375,4.28,0.524,0
159,25,22,176,0,0,1275,24152,90.74,12952209,494.869,20.3,2.974,1854.211,191.375,4.28,0.524,0
159,26,7,183,0,0,1025,25177,90.74,12952209,494.869,20.3,2.974,1854.211,191.375,4.28,0.524,0
159,27,8,191,0,0,1214,26391,90.74,12952209,494.869,20.3,2.974,1854.211,191.375,4.28,0.524,0
159,28,16,207,0,0,1505,27896,90.74,12952209,494.869,20.3,2.974,1854.211,191.375,4.28,0.524,0
159,29,5,212,0,0,1705,29601,90.74,12952209,494.869,20.3,2.974,1854.211,191.375,4.28,0.524,0
159,30,13,225,0,0,1140,30741,90.74,12952209,494.869,20.3,2.974,1854.211,191.375,4.28,0.524,0
159,31,18,243,0,0,1365,32106,90.74,12952209,494.869,20.3,2.974,1854.211,191.375,4.28,0.524,0
159,32,6,249,0,0,1197,33303,90.74,12952209,494.869,20.3,2.974,1854.211,191.375,4.28,0.524,0
159,33,6,255,0,0,1047,34350,90.74,12952209,494.869,20.3,2.974,1854.211,191.375,4.28,0.524,0
159,34,4,259,0,0,746,35096,69.44,12952209,494.869,20.3,2.974,1854.211,191.375,4.28,0.524,0
159,35,2,261,0,0,896,35992,69.44,12952209,494.869,20.3,2.974,1854.211,191.375,4.28,0.524,0
159,36,0,261,0,0,1323,37315,69.44,12952209,494.869,20.3,2.974,1854.211,191.375,4.28,0.524,0
159,37,7,268,0,0,1519,38834,69.44,12952209,494.869,20.3,2.974,1854.211,191.375,4.28,0.524,0
159,38,3,271,0,0,1353,40187,69.44,12952209,494.869,20.3,2.974,1854.211,191.375,4.28,0.524,0
159,39,2,273,0,0,1198,41385,69.44,12952209,494.869,20.3,2.974,1854.211,191.375,4.28,0.524,0
159,40,7,280,0,0,1040,42425,69.44,12952209,494.869,20.3,2.974,1854.211,191.375,4.28,0.524,0
159,41,4,284,0,0,380,42805,69.44,12952209,494.869,20.3,2.974,1854.211,191.375,4.28,0.524,0
159,42,1,285,0,0,574,43379,69.44,12952209,494.869,20.3,2.974,1854.211,191.375,4.28,0.524,0
159,43,1,286,0,0,866,44245,69.44,12952209,494.869,20.3,2.974,1854.211,191.375,4.28,0.524,0
159,44,1,287,0,0,895,45140,69.44,12952209,494.869,20.3,2.974,1854.211,191.375,4.28,0.524,0
159,45,0,287,0,0,1058,46198,69.44,12952209,494.869,20.3,2.974,1854.211,191.375,4.28,0.524,0
159,46,0,287,0,0,2041,48239,69.44,12952209,494.869,20.3,2.974,1854.211,191.375,4.28,0.524,0
159,47,2,289,0,0,1135,49374,69.44,12952209,494.869,20.3,2.974,1854.211,191.375,4.28,0.524,0
159,48,3,292,0,0,1744,51118,69.44,12952209,494.869,20.3,2.974,1854.211,191.375,4.28,0.524,0
159,49,5,297,0,0,1217,52335,69.44,12952209,494.869,20.3,2.974,1854.211,191.375,4.28,0.524,0
159,50,11,308,0,0,982,53317,69.44,12952209,494.869,20.3,2.974,1854.211,191.375,4.28,0.524,0
159,51,6,314,0,0,1083,54400,69.44,12952209,494.869,20.3,2.974,1854.211,191.375,4.28,0.524,0
159,52,6,320,0,0,1568,55968,69.44,12952209,494.869,20.3,2.974,1854.211,191.375,4.28,0.524,0
159,53,1,321,0,0,1109,57077,69.44,12952209,494.869,20.3,2.974,1854.211,191.375,4.28,0.524,0
159,54,4,325,0,0,1400,58477,69.44,12952209,494.869,20.3,2.974,1854.211,191.375,4.28,0.524,0
159,55,2,327,0,0,892,59369,69.44,12952209,494.869,20.3,2.974,1854.211,191.375,4.28,0.524,0
159,56,9,336,0,0,1074,60443,69.44,12952209,494.869,20.3,2.974,1854.211,191.375,4.28,0.524,0
159,57,3,339,0,0,2059,62502,69.44,12952209,494.869,20.3,2.974,1854.211,191.375,4.28,0.524,0
159,58,7,346,0,0,1766,64268,69.44,12952209,494.869,20.3,2.974,1854.211,191.375,4.28,0.524,0
159,59,3,349,0,0,1340,65608,69.44,12952209,494.869,20.3,2.974,1854.211,191.375,4.28,0.524,0
159,60,6,355,0,0,1368,66976,69.44,12952209,494.869,20.3,2.974,1854.211,191.375,4.28,0.524,0
159,61,4,359,1,1,1092,68068,69.44,12952209,494.869,20.3,2.974,1854.211,191.375,4.28,0.524,0
159,62,11,370,0,1,1083,69151,69.44,12952209,494.869,20.3,2.974,1854.211,191.375,4.28,0.524,0
159,63,7,377,0,1,957,70108,56.48,12952209,494.869,20.3,2.974,1854.211,191.375,4.28,0.524,0
159,64,7,384,1,2,1033,71141,56.48,12952209,494.869,20.3,2.974,1854.211,191.375,4.28,0.524,0
159,65,13,397,0,2,1369,72510,56.48,12952209,494.869,20.3,2.974,1854.211,191.375,4.28,0.524,0
159,66,13,410,0,2,1558,74068,56.48,12952209,494.869,20.3,2.974,1854.211,191.375,4.28,0.524,0
159,67,10,420,0,2,945,75013,56.48,12952209,494.869,20.3,2.974,1854.211,191.375,4.28,0.524,0
159,68,11,431,0,2,1318,76331,56.48,12952209,494.869,20.3,2.974,1854.211,191.375,4.28,0.524,0
159,69,8,439,0,2,1928,78259,56.48,12952209,494.869,20.3,2.974,1854.211,191.375,4.28,0.524,0
159,70,12,451,0,2,1870,80129,56.48,12952209,494.869,20.3,2.974,1854.211,191.375,4.28,0.524,0
159,71,12,463,0,2,2110,82239,56.48,12952209,494.869,20.3,2.974,1854.211,191.375,4.28,0.524,0
159,72,13,476,0,2,1790,84029,56.48,12952209,494.869,20.3,2.974,1854.211,191.375,4.28,0.524,0
159,73,18,494,0,2,1584,85613,56.48,12952209,494.869,20.3,2.974,1854.211,191.375,4.28,0.524,0
159,74,16,510,0,2,2043,87656,56.48,12952209,494.869,20.3,2.974,1854.211,191.375,4.28,0.524,0
159,75,31,541,0,2,3495,91151,56.48,12952209,494.869,20.3,2.974,1854.211,191.375,4.28,0.524,0
159,76,41,582,0,2,2908,94059,56.48,12952209,494.869,20.3,2.974,1854.211,191.375,4.28,0.524,0
159,77,30,612,0,2,2742,96801,56.48,12952209,494.869,20.3,2.974,1854.211,191.375,4.28,0.524,0
159,78,24,636,0,2,2508,99309,56.48,12952209,494.869,20.3,2.974,1854.211,191.375,4.28,0.524,0
159,79,3,639,0,2,2547,101856,56.48,12952209,494.869,20.3,2.974,1854.211,191.375,4.28,0.524,0
159,80,7,646,0,2,3033,104889,56.48,12952209,494.869,20.3,2.974,1854.211,191.375,4.28,0.524,0
159,81,15,661,0,2,3116,108005,56.48,12952209,494.869,20.3,2.974,1854.211,191.375,4.28,0.524,0
159,82,41,702,0,2,3252,111257,56.48,12952209,494.869,20.3,2.974,1854.211,191.375,4.28,0.524,0
159,83,26,728,0,2,2287,113544,56.48,12952209,494.869,20.3,2.974,1854.211,191.375,4.28,0.524,0
159,84,59,787,0,2,4568,118112,56.48,12952209,494.869,20.3,2.974,1854.211,191.375,4.28,0.524,0
159,85,11,798,0,2,3415,121527,70.37,12952209,494.869,20.3,2.974,1854.211,191.375,4.28,0.524,0
159,86,32,830,0,2,4757,126284,70.37,12952209,494.869,20.3,2.974,1854.211,191.375,4.28,0.524,0
159,87,20,850,0,2,3763,130047,70.37,12952209,494.869,20.3,2.974,1854.211,191.375,4.28,0.524,0
159,88,8,858,0,2,4702,134749,70.37,12952209,494.869,20.3,2.974,1854.211,191.375,4.28,0.524,0
159,89,20,878,0,2,3002,137751,70.37,12952209,494.869,20.3,2.974,1854.211,191.375,4.28,0.524,0
159,90,22,900,0,2,2498,140249,70.37,12952209,494.869,20.3,2.974,1854.211,191.375,4.28,0.524,0
159,91,101,1001,0,2,3694,143943,70.37,12952209,494.869,20.3,2.974,1854.211,191.375,4.28,0.524,0
159,92,24,1025,0,2,3961,147904,70.37,12952209,494.869,20.3,2.974,1854.211,191.375,4.28,0.524,0
159,93,17,1042,1,3,3737,151641,70.37,12952209,494.869,20.3,2.974,1854.211,191.375,4.28,0.524,0
159,94,21,1063,0,3,2216,153857,70.37,12952209,494.869,20.3,2.974,1854.211,191.375,4.28,0.524,0
159,95,18,1081,0,3,3414,157271,70.37,12952209,494.869,20.3,2.974,1854.211,191.375,4.28,0.524,0
159,96,11,1092,0,3,3279,160550,70.37,12952209,494.869,20.3,2.974,1854.211,191.375,4.28,0.524,0
159,97,13,1105,0,3,2834,163384,70.37,12952209,494.869,20.3,2.974,1854.211,191.375,4.28,0.524,0
159,98,8,1113,0,3,2871,166255,70.37,12952209,494.869,20.3,2.974,1854.211,191.375,4.28,0.524,0
159,99,59,1172,0,3,2644,168899,66.67,12952209,494.869,20.3,2.974,1854.211,191.375,4.28,0.524,0
159,100,22,1194,0,3,3463,172362,66.67,12952209,494.869,20.3,2.974,1854.211,191.375,4.28,0.524,0
159,101,16,1210,0,3,3898,176260,66.67,12952209,494.869,20.3,2.974,1854.211,191.375,4.28,0.524,0
159,102,42,1252,0,3,4060,180320,66.67,12952209,494.869,20.3,2.974,1854.211,191.375,4.28,0.524,0
159,103,47,1299,1,4,3021,183341,66.67,12952209,494.869,20.3,2.974,1854.211,191.375,4.28,0.524,0
159,104,38,1337,0,4,3333,186674,66.67,12952209,494.869,20.3,2.974,1854.211,191.375,4.28,0.524,0
159,105,41,1378,0,4,5705,192379,66.67,12952209,494.869,20.3,2.974,1854.211,191.375,4.28,0.524,0
159,106,38,1416,0,4,2423,194802,66.67,12952209,494.869,20.3,2.974,1854.211,191.375,4.28,0.524,0
159,107,19,1435,0,4,5556,200358,66.67,12952209,494.869,20.3,2.974,1854.211,191.375,4.28,0.524,0
159,108,38,1473,0,4,3432,203790,66.67,12952209,494.869,20.3,2.974,1854.211,191.375,4.28,0.524,0
159,109,12,1485,0,4,3232,207022,66.67,12952209,494.869,20.3,2.974,1854.211,191.375,4.28,0.524,0
159,110,54,1539,1,5,3214,210236,66.67,12952209,494.869,20.3,2.974,1854.211,191.375,4.28,0.524,0
159,111,43,1582,0,5,3764,214000,66.67,12952209,494.869,20.3,2.974,1854.211,191.375,4.28,0.524,0
159,112,47,1629,0,5,7039,221039,66.67,12952209,494.869,20.3,2.974,1854.211,191.375,4.28,0.524,0
159,113,26,1655,0,5,4613,225652,66.67,12952209,494.869,20.3,2.974,1854.211,191.375,4.28,0.524,0
159,114,34,1689,0,5,5534,231186,66.67,12952209,494.869,20.3,2.974,1854.211,191.375,4.28,0.524,0
159,115,21,1710,0,5,2491,233677,66.67,12952209,494.869,20.3,2.974,1854.211,191.375,4.28,0.524,0
159,116,19,1729,0,5,4330,238007,66.67,12952209,494.869,20.3,2.974,1854.211,191.375,4.28,0.524,0
159,117,23,1752,0,5,4122,242129,66.67,12952209,494.869,20.3,2.974,1854.211,191.375,4.28,0.524,0
159,118,69,1821,0,5,6165,248294,66.67,12952209,494.869,20.3,2.974,1854.211,191.375,4.28,0.524,0
159,119,58,1879,0,5,3521,251815,75.93,12952209,494.869,20.3,2.974,1854.211,191.375,4.28,0.524,0
159,120,47,1926,0,5,4144,255959,75.93,12952209,494.869,20.3,2.974,1854.211,191.375,4.28,0.524,0
159,121,10,1936,0,5,4066,260025,75.93,12952209,494.869,20.3,2.974,1854.211,191.375,4.28,0.524,0
159,122,58,1994,0,5,3374,263399,75.93,12952209,494.869,20.3,2.974,1854.211,191.375,4.28,0.524,0
159,123,28,2022,0,5,5862,269261,75.93,12952209,494.869,20.3,2.974,1854.211,191.375,4.28,0.524,0
159,124,20,2042,0,5,2633,271894,75.93,12952209,494.869,20.3,2.974,1854.211,191.375,4.28,0.524,0
159,125,20,2062,0,5,3491,275385,75.93,12952209,494.869,20.3,2.974,1854.211,191.375,4.28,0.524,0
159,126,30,2092,0,5,3072,278457,75.93,12952209,494.869,20.3,2.974,1854.211,191.375,4.28,0.524,0
159,127,7,2099,0,5,4598,283055,75.93,12952209,494.869,20.3,2.974,1854.211,191.375,4.28,0.524,0
159,128,5,2104,0,5,3196,286251,75.93,12952209,494.869,20.3,2.974,1854.211,191.375,4.28,0.524,0
159,129,7,2111,0,5,2902,289153,75.93,12952209,494.869,20.3,2.974,1854.211,191.375,4.28,0.524,0
159,130,17,2128,0,5,4452,293605,75.93,12952209,494.869,20.3,2.974,1854.211,191.375,4.28,0.524,0
159,131,6,2134,1,6,5175,298780,75.93,12952209,494.869,20.3,2.974,1854.211,191.375,4.28,0.524,0
159,132,6,2140,1,7,5720,304500,75.93,12952209,494.869,20.3,2.974,1854.211,191.375,4.28,0.524,0
159,133,12,2152,0,7,5153,309653,75.93,12952209,494.869,20.3,2.974,1854.211,191.375,4.28,0.524,0
159,134,19,2171,0,7,4886,314539,75.93,12952209,494.869,20.3,2.974,1854.211,191.375,4.28,0.524,0
159,135,18,2189,1,8,4756,319295,75.93,12952209,494.869,20.3,2.974,1854.211,191.375,4.28,0.524,0
159,136,11,2200,0,8,4610,323905,75.93,12952209,494.869,20.3,2.974,1854.211,191.375,4.28,0.524,0
159,137,93,2293,0,8,5569,329474,75.93,12952209,494.869,20.3,2.974,1854.211,191.375,4.28,0.524,0
159,138,59,2352,0,8,4796,334270,75.93,12952209,494.869,20.3,2.974,1854.211,191.375,4.28,0.524,0
159,139,101,2453,0,8,4018,338288,75.93,12952209,494.869,20.3,2.974,1854.211,191.375,4.28,0.524,0
159,140,87,2540,0,8,4326,342614,75.93,12952209,494.869,20.3,2.974,1854.211,191.375,4.28,0.524,0
159,141,37,2577,2,10,3306,345920,75.93,12952209,494.869,20.3,2.974,1854.211,191.375,4.28,0.524,0
159,142,67,2644,0,10,5463,351383,75.93,12952209,494.869,20.3,2.974,1854.211,191.375,4.28,0.524,0
159,143,73,2717,1,11,5700,357083,75.93,12952209,494.869,20.3,2.974,1854.211,191.375,4.28,0.524,0
159,144,63,2780,0,11,4759,361842,75.93,12952209,494.869,20.3,2.974,1854.211,191.375,4.28,0.524,0
159,145,109,2889,0,11,6402,368244,75.93,12952209,494.869,20.3,2.974,1854.211,191.375,4.28,0.524,0
159,146,200,3089,1,12,3642,371886,75.93,12952209,494.869,20.3,2.974,1854.211,191.375,4.28,0.524,0
159,147,217,3306,2,14,6128,378014,75.93,12952209,494.869,20.3,2.974,1854.211,191.375,4.28,0.524,0
159,148,231,3537,1,15,5467,383481,70.37,12952209,494.869,20.3,2.974,1854.211,191.375,4.28,0.524,0
159,149,88,3625,0,15,4597,388078,70.37,12952209,494.869,20.3,2.974,1854.211,191.375,4.28,0.524,0
159,150,47,3672,0,15,5159,393237,70.37,12952209,494.869,20.3,2.974,1854.211,191.375,4.28,0.524,0
159,151,70,3742,1,16,6163,399400,70.37,12952209,494.869,20.3,2.974,1854.211,191.375,4.28,0.524,0
159,152,101,3843,0,16,5544,404944,70.37,12952209,494.869,20.3,2.974,1854.211,191.375,4.28,0.524,0
159,153,177,4020,0,16,4763,409707,70.37,12952209,494.869,20.3,2.974,1854.211,191.375,4.28,0.524,0
159,154,43,4063,0,16,5622,415329,70.37,12952209,494.869,20.3,2.974,1854.211,191.375,4.28,0.524,0
159,155,79,4142,0,16,5792,421121,70.37,12952209,494.869,20.3,2.974,1854.211,191.375,4.28,0.524,0
159,156,76,4218,1,17,5079,426200,70.37,12952209,494.869,20.3,2.974,1854.211,191.375,4.28,0.524,0
159,157,37,4255,1,18,5792,431992,78.7,12952209,494.869,20.3,2.974,1854.211,191.375,4.28,0.524,0
159,158,49,4304,0,18,4420,436412,78.7,12952209,494.869,20.3,2.974,1854.211,191.375,4.28,0.524,0
159,159,45,4349,0,18,3481,439893,78.7,12952209,494.869,20.3,2.974,1854.211,191.375,4.28,0.524,0
159,160,25,4374,1,19,4457,444350,78.7,12952209,494.869,20.3,2.974,1854.211,191.375,4.28,0.524,0
159,161,35,4409,0,19,3253,447603,78.7,12952209,494.869,20.3,2.974,1854.211,191.375,4.28,0.524,0
159,162,30,4439,1,20,3805,451408,78.7,12952209,494.869,20.3,2.974,1854.211,191.375,4.28,0.524,0
159,163,21,4460,1,21,2838,454246,78.7,12952209,494.869,20.3,2.974,1854.211,191.375,4.28,0.524,0
159,164,19,4479,1,22,3027,457273,78.7,12952209,494.869,20.3,2.974,1854.211,191.375,4.28,0.524,0
159,165,55,4534,0,22,2901,460174,78.7,12952209,494.869,20.3,2.974,1854.211,191.375,4.28,0.524,0
159,166,31,4565,0,22,2722,462896,78.7,12952209,494.869,20.3,2.974,1854.211,191.375,4.28,0.524,0
159,167,26,4591,0,22,1687,464583,78.7,12952209,494.869,20.3,2.974,1854.211,191.375,4.28,0.524,0
159,168,11,4602,0,22,1935,466518,78.7,12952209,494.869,20.3,2.974,1854.211,191.375,4.28,0.524,0
159,169,22,4624,0,22,1603,468121,78.7,12952209,494.869,20.3,2.974,1854.211,191.375,4.28,0.524,0
159,170,10,4634,0,22,2097,470218,78.7,12952209,494.869,20.3,2.974,1854.211,191.375,4.28,0.524,0
159,171,19,4653,1,23,1549,471767,78.7,12952209,494.869,20.3,2.974,1854.211,191.375,4.28,0.524,0
159,172,18,4671,2,25,2272,474039,78.7,12952209,494.869,20.3,2.974,1854.211,191.375,4.28,0.524,0
159,173,18,4689,1,26,1892,475931,78.7,12952209,494.869,20.3,2.974,1854.211,191.375,4.28,0.524,0
159,174,22,4711,0,26,1448,477379,78.7,12952209,494.869,20.3,2.974,1854.211,191.375,4.28,0.524,0
159,175,11,4722,1,27,1631,479010,78.7,12952209,494.869,20.3,2.974,1854.211,191.375,4.28,0.524,0
159,176,16,4738,0,27,2273,481283,78.7,12952209,494.869,20.3,2.974,1854.211,191.375,4.28,0.524,0
159,177,41,4779,0,27,2158,483441,78.7,12952209,494.869,20.3,2.974,1854.211,191.375,4.28,0.524,0
159,178,10,4789,0,27,1400,484841,75.93,12952209,494.869,20.3,2.974,1854.211,191.375,4.28,0.524,0
159,179,9,4798,2,29,1894,486735,75.93,12952209,494.869,20.3,2.974,1854.211,191.375,4.28,0.524,0
159,180,13,4811,0,29,2207,488942,75.93,12952209,494.869,20.3,2.974,1854.211,191.375,4.28,0.524,0
159,181,9,4820,0,29,1283,490225,75.93,12952209,494.869,20.3,2.974,1854.211,191.375,4.28,0.524,0
159,182,12,4832,0,29,2761,492986,75.93,12952209,494.869,20.3,2.974,1854.211,191.375,4.28,0.524,0
159,183,4,4836,0,29,2807,495793,75.93,12952209,494.869,20.3,2.974,1854.211,191.375,4.28,0.524,0
159,184,4,4840,0,29,2583,498376,75.93,12952209,494.869,20.3,2.974,1854.211,191.375,4.28,0.524,0
159,185,3,4843,0,29,1873,500249,75.93,12952209,494.869,20.3,2.974,1854.211,191.375,4.28,0.524,0
159,186,4,4847,0,29,2568,502817,75.93,12952209,494.869,20.3,2.974,1854.211,191.375,4.28,0.524,0
159,187,5,4852,0,29,1853,504670,75.93,12952209,494.869,20.3,2.974,1854.211,191.375,4.28,0.524,0
159,188,14,4866,0,29,1988,506658,75.93,12952209,494.869,20.3,2.974,1854.211,191.375,4.28,0.524,0
159,189,1,4867,0,29,1306,507964,75.93,12952209,494.869,20.3,2.974,1854.211,191.375,4.28,0.524,0
159,190,6,4873,0,29,3219,511183,75.93,12952209,494.869,20.3,2.974,1854.211,191.375,4.28,0.524,0
159,191,10,4883,0,29,1935,513118,75.93,12952209,494.869,20.3,2.974,1854.211,191.375,4.28,0.524,0
159,192,2,4885,0,29,963,514081,75.93,12952209,494.869,20.3,2.974,1854.211,191.375,4.28,0.524,0
159,193,5,4890,1,30,2668,516749,75.93,12952209,494.869,20.3,2.974,1854.211,191.375,4.28,0.524,0
159,194,2,4892,0,30,2239,518988,75.93,12952209,494.869,20.3,2.974,1854.211,191.375,4.28,0.524,0
159,195,4,4896,1,31,2149,521137,72.22,12952209,494.869,20.3,2.974,1854.211,191.375,4.28,0.524,0
159,196,9,4905,1,32,1884,523021,72.22,12952209,494.869,20.3,2.974,1854.211,191.375,4.28,0.524,0
159,197,3,4908,0,32,-1884,521137,72.22,12952209,494.869,20.3,2.974,1854.211,191.375,4.28,0.524,0
159,198,32,4940,1,33,5717,526854,72.22,12952209,494.869,20.3,2.974,1854.211,191.375,4.28,0.524,0
159,199,13,4953,0,33,3450,530304,72.22,12952209,494.869,20.3,2.974,1854.211,191.375,4.28,0.524,0
159,200,12,4965,1,34,2224,532528,72.22,12952209,494.869,20.3,2.974,1854.211,191.375,4.28,0.524,0
159,201,6,4971,0,34,0,532528,72.22,12952209,494.869,20.3,2.974,1854.211,191.375,4.28,0.524,0
159,202,3,4974,0,34,0,532528,72.22,12952209,494.869,20.3,2.974,1854.211,191.375,4.28,0.524,0
159,203,18,4992,0,34,0,532528,72.22,12952209,494.869,20.3,2.974,1854.211,191.375,4.28,0.524,0
159,204,5,4997,0,34,0,532528,72.22,12952209,494.869,20.3,2.974,1854.211,191.375,4.28,0.524,0
161,1,4,13,0,0,0,0,0,183629,293.187,34.9,9.721,12951.839,204.62,11.62,0.747,0
161,2,0,13,0,0,0,0,0,183629,293.187,34.9,9.721,12951.839,204.62,11.62,0.747,0
161,3,0,13,0,0,0,0,0,183629,293.187,34.9,9.721,12951.839,204.62,11.62,0.747,0
161,4,0,13,0,0,0,0,0,183629,293.187,34.9,9.721,12951.839,204.62,11.62,0.747,0
161,5,1,14,0,0,0,0,0,183629,293.187,34.9,9.721,12951.839,204.62,11.62,0.747,0
161,6,0,14,0,0,0,0,0,183629,293.187,34.9,9.721,12951.839,204.62,11.62,0.747,0
161,7,0,14,0,0,0,0,0,183629,293.187,34.9,9.721,12951.839,204.62,11.62,0.747,0
161,8,0,14,0,0,0,0,0,183629,293.187,34.9,9.721,12951.839,204.62,11.62,0.747,0
161,9,0,14,0,0,0,0,0,183629,293.187,34.9,9.721,12951.839,204.62,11.62,0.747,0
161,10,0,14,0,0,0,0,0,183629,293.187,34.9,9.721,12951.839,204.62,11.62,0.747,0
161,11,1,15,0,0,0,0,0,183629,293.187,34.9,9.721,12951.839,204.62,11.62,0.747,0
161,12,0,15,0,0,0,0,0,183629,293.187,34.9,9.721,12951.839,204.62,11.62,0.747,0
161,13,0,15,0,0,0,0,0,183629,293.187,34.9,9.721,12951.839,204.62,11.62,0.747,0
161,14,0,15,0,0,0,0,0,183629,293.187,34.9,9.721,12951.839,204.62,11.62,0.747,0
161,15,0,15,0,0,0,0,0,183629,293.187,34.9,9.721,12951.839,204.62,11.62,0.747,0
161,16,0,15,0,0,0,0,0,183629,293.187,34.9,9.721,12951.839,204.62,11.62,0.747,0
161,17,0,15,0,0,0,0,0,183629,293.187,34.9,9.721,12951.839,204.62,11.62,0.747,0
161,18,0,15,0,0,0,0,0,183629,293.187,34.9,9.721,12951.839,204.62,11.62,0.747,0
161,19,0,15,0,0,0,0,0,183629,293.187,34.9,9.721,12951.839,204.62,11.62,0.747,0
161,20,0,15,0,0,0,0,0,183629,293.187,34.9,9.721,12951.839,204.62,11.62,0.747,0
161,21,0,15,0,0,0,0,0,183629,293.187,34.9,9.721,12951.839,204.62,11.62,0.747,0
161,22,0,15,0,0,0,0,0,183629,293.187,34.9,9.721,12951.839,204.62,11.62,0.747,0
161,23,0,15,0,0,0,0,0,183629,293.187,34.9,9.721,12951.839,204.62,11.62,0.747,0
161,24,0,15,0,0,0,0,0,183629,293.187,34.9,9.721,12951.839,204.62,11.62,0.747,0
161,25,0,15,0,0,0,0,0,183629,293.187,34.9,9.721,12951.839,204.62,11.62,0.747,0
161,26,0,15,0,0,0,0,0,183629,293.187,34.9,9.721,12951.839,204.62,11.62,0.747,0
161,27,0,15,0,0,0,0,0,183629,293.187,34.9,9.721,12951.839,204.62,11.62,0.747,0
161,28,0,15,0,0,0,0,0,183629,293.187,34.9,9.721,12951.839,204.62,11.62,0.747,0
161,29,0,15,0,0,0,0,0,183629,293.187,34.9,9.721,12951.839,204.62,11.62,0.747,0
161,30,2,17,0,0,0,0,0,183629,293.187,34.9,9.721,12951.839,204.62,11.62,0.747,0
161,31,0,17,0,0,0,0,0,183629,293.187,34.9,9.721,12951.839,204.62,11.62,0.747,0
161,32,0,17,0,0,0,0,0,183629,293.187,34.9,9.721,12951.839,204.62,11.62,0.747,0
161,33,0,17,0,0,0,0,0,183629,293.187,34.9,9.721,12951.839,204.62,11.62,0.747,0
161,34,1,18,0,0,0,0,0,183629,293.187,34.9,9.721,12951.839,204.62,11.62,0.747,0
161,35,0,18,0,0,0,0,0,183629,293.187,34.9,9.721,12951.839,204.62,11.62,0.747,0
161,36,0,18,0,0,0,0,0,183629,293.187,34.9,9.721,12951.839,204.62,11.62,0.747,0
161,37,0,18,0,0,0,0,0,183629,293.187,34.9,9.721,12951.839,204.62,11.62,0.747,0
161,38,0,18,0,0,0,0,0,183629,293.187,34.9,9.721,12951.839,204.62,11.62,0.747,0
161,39,0,18,0,0,0,0,0,183629,293.187,34.9,9.721,12951.839,204.62,11.62,0.747,0
161,40,0,18,0,0,0,0,0,183629,293.187,34.9,9.721,12951.839,204.62,11.62,0.747,0
161,41,0,18,0,0,0,0,0,183629,293.187,34.9,9.721,12951.839,204.62,11.62,0.747,0
161,42,0,18,0,0,0,0,0,183629,293.187,34.9,9.721,12951.839,204.62,11.62,0.747,0
161,43,0,18,0,0,0,0,0,183629,293.187,34.9,9.721,12951.839,204.62,11.62,0.747,0
161,44,0,18,0,0,0,0,0,183629,293.187,34.9,9.721,12951.839,204.62,11.62,0.747,0
161,45,0,18,0,0,0,0,0,183629,293.187,34.9,9.721,12951.839,204.62,11.62,0.747,0
161,46,0,18,0,0,0,0,0,183629,293.187,34.9,9.721,12951.839,204.62,11.62,0.747,0
161,47,0,18,0,0,0,0,0,183629,293.187,34.9,9.721,12951.839,204.62,11.62,0.747,0
161,48,0,18,0,0,0,0,0,183629,293.187,34.9,9.721,12951.839,204.62,11.62,0.747,0
161,49,0,18,0,0,0,0,0,183629,293.187,34.9,9.721,12951.839,204.62,11.62,0.747,0
161,50,0,18,0,0,0,0,0,183629,293.187,34.9,9.721,12951.839,204.62,11.62,0.747,0
161,51,0,18,0,0,0,0,0,183629,293.187,34.9,9.721,12951.839,204.62,11.62,0.747,0
161,52,0,18,0,0,0,0,0,183629,293.187,34.9,9.721,12951.839,204.62,11.62,0.747,0
161,53,0,18,0,0,0,0,0,183629,293.187,34.9,9.721,12951.839,204.62,11.62,0.747,0
161,54,0,18,0,0,0,0,0,183629,293.187,34.9,9.721,12951.839,204.62,11.62,0.747,0
161,55,0,18,0,0,0,0,0,183629,293.187,34.9,9.721,12951.839,204.62,11.62,0.747,0
161,56,0,18,0,0,0,0,0,183629,293.187,34.9,9.721,12951.839,204.62,11.62,0.747,0
161,57,0,18,0,0,0,0,0,183629,293.187,34.9,9.721,12951.839,204.62,11.62,0.747,0
161,58,0,18,0,0,0,0,0,183629,293.187,34.9,9.721,12951.839,204.62,11.62,0.747,0
161,59,0,18,0,0,0,0,0,183629,293.187,34.9,9.721,12951.839,204.62,11.62,0.747,0
161,60,0,18,0,0,0,0,0,183629,293.187,34.9,9.721,12951.839,204.62,11.62,0.747,0
161,61,0,18,0,0,0,0,0,183629,293.187,34.9,9.721,12951.839,204.62,11.62,0.747,0
161,62,0,18,0,0,0,0,0,183629,293.187,34.9,9.721,12951.839,204.62,11.62,0.747,0
161,63,0,18,0,0,0,0,0,183629,293.187,34.9,9.721,12951.839,204.62,11.62,0.747,0
161,64,0,18,0,0,0,0,0,183629,293.187,34.9,9.721,12951.839,204.62,11.62,0.747,0
161,65,0,18,0,0,0,0,0,183629,293.187,34.9,9.721,12951.839,204.62,11.62,0.747,0
161,66,1,19,0,0,0,0,0,183629,293.187,34.9,9.721,12951.839,204.62,11.62,0.747,0
161,67,0,19,0,0,0,0,0,183629,293.187,34.9,9.721,12951.839,204.62,11.62,0.747,0
161,68,0,19,0,0,0,0,0,183629,293.187,34.9,9.721,12951.839,204.62,11.62,0.747,0
161,69,0,19,0,0,0,0,0,183629,293.187,34.9,9.721,12951.839,204.62,11.62,0.747,0
161,70,0,19,0,0,0,0,0,183629,293.187,34.9,9.721,12951.839,204.62,11.62,0.747,0
161,71,0,19,0,0,0,0,0,183629,293.187,34.9,9.721,12951.839,204.62,11.62,0.747,0
161,72,0,19,0,0,0,0,0,183629,293.187,34.9,9.721,12951.839,204.62,11.62,0.747,0
161,73,0,19,0,0,0,0,0,183629,293.187,34.9,9.721,12951.839,204.62,11.62,0.747,0
161,74,0,19,0,0,0,0,0,183629,293.187,34.9,9.721,12951.839,204.62,11.62,0.747,0
161,75,0,19,0,0,0,0,0,183629,293.187,34.9,9.721,12951.839,204.62,11.62,0.747,0
161,76,0,19,0,0,0,0,0,183629,293.187,34.9,9.721,12951.839,204.62,11.62,0.747,0
161,77,0,19,0,0,0,0,0,183629,293.187,34.9,9.721,12951.839,204.62,11.62,0.747,0
161,78,0,19,0,0,0,0,0,183629,293.187,34.9,9.721,12951.839,204.62,11.62,0.747,0
161,79,0,19,0,0,0,0,0,183629,293.187,34.9,9.721,12951.839,204.62,11.62,0.747,0
161,80,0,19,0,0,0,0,0,183629,293.187,34.9,9.721,12951.839,204.62,11.62,0.747,0
161,81,0,19,0,0,0,0,0,183629,293.187,34.9,9.721,12951.839,204.62,11.62,0.747,0
161,82,0,19,0,0,0,0,0,183629,293.187,34.9,9.721,12951.839,204.62,11.62,0.747,0
161,83,0,19,0,0,0,0,0,183629,293.187,34.9,9.721,12951.839,204.62,11.62,0.747,0
161,84,0,19,0,0,0,0,0,183629,293.187,34.9,9.721,12951.839,204.62,11.62,0.747,0
161,85,0,19,0,0,0,0,0,183629,293.187,34.9,9.721,12951.839,204.62,11.62,0.747,0
161,86,0,19,0,0,0,0,0,183629,293.187,34.9,9.721,12951.839,204.62,11.62,0.747,0
161,87,0,19,0,0,0,0,0,183629,293.187,34.9,9.721,12951.839,204.62,11.62,0.747,0
161,88,0,19,0,0,0,0,0,183629,293.187,34.9,9.721,12951.839,204.62,11.62,0.747,0
161,89,0,19,0,0,0,0,0,183629,293.187,34.9,9.721,12951.839,204.62,11.62,0.747,0
161,90,0,19,0,0,0,0,0,183629,293.187,34.9,9.721,12951.839,204.62,11.62,0.747,0
161,91,0,19,0,0,0,0,0,183629,293.187,34.9,9.721,12951.839,204.62,11.62,0.747,0
161,92,0,19,0,0,0,0,0,183629,293.187,34.9,9.721,12951.839,204.62,11.62,0.747,0
161,93,0,19,0,0,0,0,0,183629,293.187,34.9,9.721,12951.839,204.62,11.62,0.747,0
161,94,3,22,0,0,0,0,0,183629,293.187,34.9,9.721,12951.839,204.62,11.62,0.747,0
161,95,0,22,0,0,0,0,0,183629,293.187,34.9,9.721,12951.839,204.62,11.62,0.747,0
161,96,0,22,0,0,0,0,0,183629,293.187,34.9,9.721,12951.839,204.62,11.62,0.747,0
161,97,0,22,0,0,0,0,0,183629,293.187,34.9,9.721,12951.839,204.62,11.62,0.747,0
161,98,0,22,0,0,0,0,0,183629,293.187,34.9,9.721,12951.839,204.62,11.62,0.747,0
161,99,0,22,0,0,0,0,0,183629,293.187,34.9,9.721,12951.839,204.62,11.62,0.747,0
161,100,0,22,0,0,0,0,0,183629,293.187,34.9,9.721,12951.839,204.62,11.62,0.747,0
161,101,0,22,0,0,0,0,0,183629,293.187,34.9,9.721,12951.839,204.62,11.62,0.747,0
161,102,0,22,0,0,0,0,0,183629,293.187,34.9,9.721,12951.839,204.62,11.62,0.747,0
161,103,0,22,0,0,0,0,0,183629,293.187,34.9,9.721,12951.839,204.62,11.62,0.747,0
161,104,0,22,0,0,0,0,0,183629,293.187,34.9,9.721,12951.839,204.62,11.62,0.747,0
161,105,0,22,0,0,0,0,0,183629,293.187,34.9,9.721,12951.839,204.62,11.62,0.747,0
161,106,0,22,0,0,0,0,0,183629,293.187,34.9,9.721,12951.839,204.62,11.62,0.747,0
161,107,0,22,0,0,0,0,0,183629,293.187,34.9,9.721,12951.839,204.62,11.62,0.747,0
161,108,1,23,0,0,0,0,0,183629,293.187,34.9,9.721,12951.839,204.62,11.62,0.747,0
161,109,0,23,0,0,0,0,0,183629,293.187,34.9,9.721,12951.839,204.62,11.62,0.747,0
161,110,0,23,0,0,0,0,0,183629,293.187,34.9,9.721,12951.839,204.62,11.62,0.747,0
161,111,0,23,0,0,0,0,0,183629,293.187,34.9,9.721,12951.839,204.62,11.62,0.747,0
161,112,0,23,0,0,0,0,0,183629,293.187,34.9,9.721,12951.839,204.62,11.62,0.747,0
161,113,0,23,0,0,0,0,0,183629,293.187,34.9,9.721,12951.839,204.62,11.62,0.747,0
161,114,0,23,0,0,0,0,0,183629,293.187,34.9,9.721,12951.839,204.62,11.62,0.747,0
161,115,1,24,0,0,0,0,0,183629,293.187,34.9,9.721,12951.839,204.62,11.62,0.747,0
161,116,0,24,0,0,0,0,0,183629,293.187,34.9,9.721,12951.839,204.62,11.62,0.747,0
161,117,0,24,0,0,0,0,0,183629,293.187,34.9,9.721,12951.839,204.62,11.62,0.747,0
161,118,0,24,0,0,0,0,0,183629,293.187,34.9,9.721,12951.839,204.62,11.62,0.747,0
161,119,0,24,0,0,0,0,0,183629,293.187,34.9,9.721,12951.839,204.62,11.62,0.747,0
161,120,0,24,0,0,0,0,0,183629,293.187,34.9,9.721,12951.839,204.62,11.62,0.747,0
161,121,0,24,0,0,0,0,0,183629,293.187,34.9,9.721,12951.839,204.62,11.62,0.747,0
161,122,1,25,0,0,0,0,0,183629,293.187,34.9,9.721,12951.839,204.62,11.62,0.747,0
161,123,0,25,0,0,0,0,0,183629,293.187,34.9,9.721,12951.839,204.62,11.62,0.747,0
161,124,0,25,0,0,0,0,0,183629,293.187,34.9,9.721,12951.839,204.62,11.62,0.747,0
161,125,0,25,0,0,0,0,0,183629,293.187,34.9,9.721,12951.839,204.62,11.62,0.747,0
161,126,0,25,0,0,0,0,0,183629,293.187,34.9,9.721,12951.839,204.62,11.62,0.747,0
161,127,0,25,0,0,0,0,0,183629,293.187,34.9,9.721,12951.839,204.62,11.62,0.747,0
161,128,0,25,0,0,0,0,0,183629,293.187,34.9,9.721,12951.839,204.62,11.62,0.747,0
161,129,0,25,0,0,0,0,0,183629,293.187,34.9,9.721,12951.839,204.62,11.62,0.747,0
161,130,0,25,0,0,0,0,0,183629,293.187,34.9,9.721,12951.839,204.62,11.62,0.747,0
161,131,0,25,0,0,0,0,0,183629,293.187,34.9,9.721,12951.839,204.62,11.62,0.747,0
161,132,0,25,0,0,0,0,0,183629,293.187,34.9,9.721,12951.839,204.62,11.62,0.747,0
161,133,0,25,0,0,0,0,0,183629,293.187,34.9,9.721,12951.839,204.62,11.62,0.747,0
161,134,0,25,0,0,0,0,0,183629,293.187,34.9,9.721,12951.839,204.62,11.62,0.747,0
161,135,0,25,0,0,0,0,0,183629,293.187,34.9,9.721,12951.839,204.62,11.62,0.747,0
161,136,0,25,0,0,0,0,0,183629,293.187,34.9,9.721,12951.839,204.62,11.62,0.747,0
161,137,0,25,0,0,0,0,0,183629,293.187,34.9,9.721,12951.839,204.62,11.62,0.747,0
161,138,0,25,0,0,0,0,0,183629,293.187,34.9,9.721,12951.839,204.62,11.62,0.747,0
161,139,0,25,0,0,0,0,0,183629,293.187,34.9,9.721,12951.839,204.62,11.62,0.747,0
161,140,0,25,0,0,0,0,0,183629,293.187,34.9,9.721,12951.839,204.62,11.62,0.747,0
161,141,1,26,0,0,0,0,0,183629,293.187,34.9,9.721,12951.839,204.62,11.62,0.747,0
161,142,0,26,0,0,0,0,0,183629,293.187,34.9,9.721,12951.839,204.62,11.62,0.747,0
161,143,0,26,0,0,0,0,0,183629,293.187,34.9,9.721,12951.839,204.62,11.62,0.747,0
161,144,0,26,0,0,0,0,0,183629,293.187,34.9,9.721,12951.839,204.62,11.62,0.747,0
161,145,0,26,0,0,0,0,0,183629,293.187,34.9,9.721,12951.839,204.62,11.62,0.747,0
161,146,0,26,0,0,0,0,0,183629,293.187,34.9,9.721,12951.839,204.62,11.62,0.747,0
161,147,0,26,0,0,0,0,0,183629,293.187,34.9,9.721,12951.839,204.62,11.62,0.747,0
161,148,0,26,0,0,0,0,0,183629,293.187,34.9,9.721,12951.839,204.62,11.62,0.747,0
161,149,0,26,0,0,0,0,0,183629,293.187,34.9,9.721,12951.839,204.62,11.62,0.747,0
161,150,0,26,0,0,0,0,0,183629,293.187,34.9,9.721,12951.839,204.62,11.62,0.747,0
161,151,0,26,0,0,0,0,0,183629,293.187,34.9,9.721,12951.839,204.62,11.62,0.747,0
161,152,0,26,0,0,0,0,0,183629,293.187,34.9,9.721,12951.839,204.62,11.62,0.747,0
161,153,0,26,0,0,0,0,0,183629,293.187,34.9,9.721,12951.839,204.62,11.62,0.747,0
161,154,0,26,0,0,0,0,0,183629,293.187,34.9,9.721,12951.839,204.62,11.62,0.747,0
161,155,0,26,0,0,0,0,0,183629,293.187,34.9,9.721,12951.839,204.62,11.62,0.747,0
161,156,0,26,0,0,0,0,0,183629,293.187,34.9,9.721,12951.839,204.62,11.62,0.747,0
161,157,0,26,0,0,0,0,0,183629,293.187,34.9,9.721,12951.839,204.62,11.62,0.747,0
161,158,0,26,0,0,0,0,0,183629,293.187,34.9,9.721,12951.839,204.62,11.62,0.747,0
161,159,0,26,0,0,0,0,0,183629,293.187,34.9,9.721,12951.839,204.62,11.62,0.747,0
161,160,0,26,0,0,0,0,0,183629,293.187,34.9,9.721,12951.839,204.62,11.62,0.747,0
161,161,0,26,0,0,0,0,0,183629,293.187,34.9,9.721,12951.839,204.62,11.62,0.747,0
161,162,0,26,0,0,0,0,0,183629,293.187,34.9,9.721,12951.839,204.62,11.62,0.747,0
161,163,1,27,0,0,0,0,0,183629,293.187,34.9,9.721,12951.839,204.62,11.62,0.747,0
161,164,0,27,0,0,0,0,0,183629,293.187,34.9,9.721,12951.839,204.62,11.62,0.747,0
161,165,0,27,0,0,0,0,0,183629,293.187,34.9,9.721,12951.839,204.62,11.62,0.747,0
161,166,0,27,0,0,0,0,0,183629,293.187,34.9,9.721,12951.839,204.62,11.62,0.747,0
161,167,0,27,0,0,0,0,0,183629,293.187,34.9,9.721,12951.839,204.62,11.62,0.747,0
161,168,0,27,0,0,0,0,0,183629,293.187,34.9,9.721,12951.839,204.62,11.62,0.747,0
161,169,0,27,0,0,0,0,0,183629,293.187,34.9,9.721,12951.839,204.62,11.62,0.747,0
161,170,0,27,0,0,0,0,0,183629,293.187,34.9,9.721,12951.839,204.62,11.62,0.747,0
161,171,0,27,0,0,0,0,0,183629,293.187,34.9,9.721,12951.839,204.62,11.62,0.747,0
161,172,0,27,0,0,0,0,0,183629,293.187,34.9,9.721,12951.839,204.62,11.62,0.747,0
161,173,0,27,0,0,0,0,0,183629,293.187,34.9,9.721,12951.839,204.62,11.62,0.747,0
161,174,0,27,0,0,0,0,0,183629,293.187,34.9,9.721,12951.839,204.62,11.62,0.747,0
161,175,0,27,0,0,0,0,0,183629,293.187,34.9,9.721,12951.839,204.62,11.62,0.747,0
161,176,0,27,0,0,0,0,0,183629,293.187,34.9,9.721,12951.839,204.62,11.62,0.747,0
161,177,0,27,0,0,0,0,0,183629,293.187,34.9,9.721,12951.839,204.62,11.62,0.747,0
161,178,0,27,0,0,0,0,0,183629,293.187,34.9,9.721,12951.839,204.62,11.62,0.747,0
161,179,0,27,0,0,0,0,0,183629,293.187,34.9,9.721,12951.839,204.62,11.62,0.747,0
161,180,0,27,0,0,0,0,0,183629,293.187,34.9,9.721,12951.839,204.62,11.62,0.747,0
161,181,0,27,0,0,0,0,0,183629,293.187,34.9,9.721,12951.839,204.62,11.62,0.747,0
161,182,0,27,0,0,0,0,0,183629,293.187,34.9,9.721,12951.839,204.62,11.62,0.747,0
161,183,0,27,0,0,0,0,0,183629,293.187,34.9,9.721,12951.839,204.62,11.62,0.747,0
161,184,0,27,0,0,0,0,0,183629,293.187,34.9,9.721,12951.839,204.62,11.62,0.747,0
161,185,0,27,0,0,0,0,0,183629,293.187,34.9,9.721,12951.839,204.62,11.62,0.747,0
161,186,0,27,0,0,0,0,0,183629,293.187,34.9,9.721,12951.839,204.62,11.62,0.747,0
161,187,0,27,0,0,0,0,0,183629,293.187,34.9,9.721,12951.839,204.62,11.62,0.747,0
161,188,0,27,0,0,0,0,0,183629,293.187,34.9,9.721,12951.839,204.62,11.62,0.747,0
161,189,0,27,0,0,0,0,0,183629,293.187,34.9,9.721,12951.839,204.62,11.62,0.747,0
161,190,0,27,0,0,0,0,0,183629,293.187,34.9,9.721,12951.839,204.62,11.62,0.747,0
161,191,1,28,0,0,0,0,0,183629,293.187,34.9,9.721,12951.839,204.62,11.62,0.747,0
161,192,0,28,0,0,0,0,0,183629,293.187,34.9,9.721,12951.839,204.62,11.62,0.747,0
161,193,0,28,0,0,0,0,0,183629,293.187,34.9,9.721,12951.839,204.62,11.62,0.747,0
161,194,1,29,0,0,0,0,0,183629,293.187,34.9,9.721,12951.839,204.62,11.62,0.747,0
161,195,0,29,0,0,0,0,0,183629,293.187,34.9,9.721,12951.839,204.62,11.62,0.747,0
161,196,0,29,0,0,0,0,0,183629,293.187,34.9,9.721,12951.839,204.62,11.62,0.747,0
161,197,0,29,0,0,0,0,0,183629,293.187,34.9,9.721,12951.839,204.62,11.62,0.747,0
161,198,2,31,0,0,0,0,0,183629,293.187,34.9,9.721,12951.839,204.62,11.62,0.747,0
161,199,0,31,0,0,0,0,0,183629,293.187,34.9,9.721,12951.839,204.62,11.62,0.747,0
161,200,1,32,0,0,0,0,0,183629,293.187,34.9,9.721,12951.839,204.62,11.62,0.747,0
161,201,1,33,0,0,0,0,0,183629,293.187,34.9,9.721,12951.839,204.62,11.62,0.747,0
161,202,0,33,0,0,0,0,0,183629,293.187,34.9,9.721,12951.839,204.62,11.62,0.747,0
161,203,3,36,0,0,0,0,0,183629,293.187,34.9,9.721,12951.839,204.62,11.62,0.747,0
161,204,0,36,0,0,0,0,0,183629,293.187,34.9,9.721,12951.839,204.62,11.62,0.747,0
162,1,0,1,0,0,0,0,0,110947,281.787,31.8,7.724,10727.146,252.675,11.62,0.723,0
162,2,1,2,0,0,0,0,0,110947,281.787,31.8,7.724,10727.146,252.675,11.62,0.723,0
162,3,0,2,0,0,0,0,0,110947,281.787,31.8,7.724,10727.146,252.675,11.62,0.723,0
162,4,5,7,0,0,0,0,0,110947,281.787,31.8,7.724,10727.146,252.675,11.62,0.723,0
162,5,0,7,0,0,0,0,0,110947,281.787,31.8,7.724,10727.146,252.675,11.62,0.723,0
162,6,0,7,0,0,0,0,0,110947,281.787,31.8,7.724,10727.146,252.675,11.62,0.723,0
162,7,0,7,0,0,0,0,0,110947,281.787,31.8,7.724,10727.146,252.675,11.62,0.723,0
162,8,1,8,0,0,0,0,0,110947,281.787,31.8,7.724,10727.146,252.675,11.62,0.723,0
162,9,0,8,0,0,0,0,0,110947,281.787,31.8,7.724,10727.146,252.675,11.62,0.723,0
162,10,4,12,0,0,0,0,0,110947,281.787,31.8,7.724,10727.146,252.675,11.62,0.723,0
162,11,0,12,0,0,0,0,0,110947,281.787,31.8,7.724,10727.146,252.675,11.62,0.723,0
162,12,0,12,0,0,0,0,0,110947,281.787,31.8,7.724,10727.146,252.675,11.62,0.723,0
162,13,0,12,0,0,0,0,0,110947,281.787,31.8,7.724,10727.146,252.675,11.62,0.723,0
162,14,0,12,0,0,0,0,0,110947,281.787,31.8,7.724,10727.146,252.675,11.62,0.723,0
162,15,0,12,0,0,0,0,0,110947,281.787,31.8,7.724,10727.146,252.675,11.62,0.723,0
162,16,0,12,0,0,0,0,0,110947,281.787,31.8,7.724,10727.146,252.675,11.62,0.723,0
162,17,0,12,0,0,0,0,0,110947,281.787,31.8,7.724,10727.146,252.675,11.62,0.723,0
162,18,0,12,0,0,0,0,0,110947,281.787,31.8,7.724,10727.146,252.675,11.62,0.723,0
162,19,0,12,0,0,0,0,0,110947,281.787,31.8,7.724,10727.146,252.675,11.62,0.723,0
162,20,0,12,0,0,0,0,0,110947,281.787,31.8,7.724,10727.146,252.675,11.62,0.723,0
162,21,0,12,0,0,0,0,0,110947,281.787,31.8,7.724,10727.146,252.675,11.62,0.723,0
162,22,0,12,0,0,0,0,0,110947,281.787,31.8,7.724,10727.146,252.675,11.62,0.723,0
162,23,1,13,0,0,0,0,0,110947,281.787,31.8,7.724,10727.146,252.675,11.62,0.723,0
162,24,0,13,0,0,0,0,0,110947,281.787,31.8,7.724,10727.146,252.675,11.62,0.723,0
162,25,1,14,0,0,0,0,0,110947,281.787,31.8,7.724,10727.146,252.675,11.62,0.723,0
162,26,0,14,0,0,0,0,0,110947,281.787,31.8,7.724,10727.146,252.675,11.62,0.723,0
162,27,0,14,0,0,0,0,0,110947,281.787,31.8,7.724,10727.146,252.675,11.62,0.723,0
162,28,1,15,0,0,0,0,0,110947,281.787,31.8,7.724,10727.146,252.675,11.62,0.723,0
162,29,1,16,0,0,0,0,0,110947,281.787,31.8,7.724,10727.146,252.675,11.62,0.723,0
162,30,0,16,0,0,0,0,0,110947,281.787,31.8,7.724,10727.146,252.675,11.62,0.723,0
162,31,0,16,0,0,0,0,0,110947,281.787,31.8,7.724,10727.146,252.675,11.62,0.723,0
162,32,0,16,0,0,0,0,0,110947,281.787,31.8,7.724,10727.146,252.675,11.62,0.723,0
162,33,0,16,0,0,0,0,0,110947,281.787,31.8,7.724,10727.146,252.675,11.62,0.723,0
162,34,1,17,0,0,0,0,0,110947,281.787,31.8,7.724,10727.146,252.675,11.62,0.723,0
162,35,0,17,0,0,0,0,0,110947,281.787,31.8,7.724,10727.146,252.675,11.62,0.723,0
162,36,0,17,0,0,0,0,0,110947,281.787,31.8,7.724,10727.146,252.675,11.62,0.723,0
162,37,0,17,0,0,0,0,0,110947,281.787,31.8,7.724,10727.146,252.675,11.62,0.723,0
162,38,0,17,0,0,0,0,0,110947,281.787,31.8,7.724,10727.146,252.675,11.62,0.723,0
162,39,0,17,0,0,0,0,0,110947,281.787,31.8,7.724,10727.146,252.675,11.62,0.723,0
162,40,0,17,0,0,0,0,0,110947,281.787,31.8,7.724,10727.146,252.675,11.62,0.723,0
162,41,0,17,0,0,0,0,0,110947,281.787,31.8,7.724,10727.146,252.675,11.62,0.723,0
162,42,0,17,0,0,0,0,0,110947,281.787,31.8,7.724,10727.146,252.675,11.62,0.723,0
162,43,0,17,0,0,0,0,0,110947,281.787,31.8,7.724,10727.146,252.675,11.62,0.723,0
162,44,0,17,0,0,0,0,0,110947,281.787,31.8,7.724,10727.146,252.675,11.62,0.723,0
162,45,0,17,0,0,0,0,0,110947,281.787,31.8,7.724,10727.146,252.675,11.62,0.723,0
162,46,0,17,0,0,0,0,0,110947,281.787,31.8,7.724,10727.146,252.675,11.62,0.723,0
162,47,0,17,0,0,0,0,0,110947,281.787,31.8,7.724,10727.146,252.675,11.62,0.723,0
162,48,0,17,0,0,0,0,0,110947,281.787,31.8,7.724,10727.146,252.675,11.62,0.723,0
162,49,0,17,0,0,0,0,0,110947,281.787,31.8,7.724,10727.146,252.675,11.62,0.723,0
162,50,0,17,0,0,0,0,0,110947,281.787,31.8,7.724,10727.146,252.675,11.62,0.723,0
162,51,1,18,0,0,0,0,0,110947,281.787,31.8,7.724,10727.146,252.675,11.62,0.723,0
162,52,0,18,0,0,0,0,0,110947,281.787,31.8,7.724,10727.146,252.675,11.62,0.723,0
162,53,0,18,0,0,0,0,0,110947,281.787,31.8,7.724,10727.146,252.675,11.62,0.723,0
162,54,0,18,0,0,0,0,0,110947,281.787,31.8,7.724,10727.146,252.675,11.62,0.723,0
162,55,0,18,0,0,0,0,0,110947,281.787,31.8,7.724,10727.146,252.675,11.62,0.723,0
162,56,0,18,0,0,0,0,0,110947,281.787,31.8,7.724,10727.146,252.675,11.62,0.723,0
162,57,0,18,0,0,0,0,0,110947,281.787,31.8,7.724,10727.146,252.675,11.62,0.723,0
162,58,0,18,0,0,0,0,0,110947,281.787,31.8,7.724,10727.146,252.675,11.62,0.723,0
162,59,7,25,0,0,0,0,0,110947,281.787,31.8,7.724,10727.146,252.675,11.62,0.723,0
162,60,1,26,0,0,0,0,0,110947,281.787,31.8,7.724,10727.146,252.675,11.62,0.723,0
162,61,0,26,0,0,0,0,0,110947,281.787,31.8,7.724,10727.146,252.675,11.62,0.723,0
162,62,0,26,0,0,0,0,0,110947,281.787,31.8,7.724,10727.146,252.675,11.62,0.723,0
162,63,0,26,0,0,0,0,0,110947,281.787,31.8,7.724,10727.146,252.675,11.62,0.723,0
162,64,0,26,0,0,0,0,0,110947,281.787,31.8,7.724,10727.146,252.675,11.62,0.723,0
162,65,0,26,0,0,0,0,0,110947,281.787,31.8,7.724,10727.146,252.675,11.62,0.723,0
162,66,0,26,0,0,0,0,0,110947,281.787,31.8,7.724,10727.146,252.675,11.62,0.723,0
162,67,0,26,0,0,0,0,0,110947,281.787,31.8,7.724,10727.146,252.675,11.62,0.723,0
162,68,0,26,0,0,0,0,0,110947,281.787,31.8,7.724,10727.146,252.675,11.62,0.723,0
162,69,0,26,0,0,0,0,0,110947,281.787,31.8,7.724,10727.146,252.675,11.62,0.723,0
162,70,1,27,0,0,0,0,0,110947,281.787,31.8,7.724,10727.146,252.675,11.62,0.723,0
162,71,0,27,0,0,0,0,0,110947,281.787,31.8,7.724,10727.146,252.675,11.62,0.723,0
162,72,0,27,0,0,0,0,0,110947,281.787,31.8,7.724,10727.146,252.675,11.62,0.723,0
162,73,0,27,0,0,0,0,0,110947,281.787,31.8,7.724,10727.146,252.675,11.62,0.723,0
162,74,0,27,0,0,0,0,0,110947,281.787,31.8,7.724,10727.146,252.675,11.62,0.723,0
162,75,0,27,0,0,0,0,0,110947,281.787,31.8,7.724,10727.146,252.675,11.62,0.723,0
162,76,0,27,0,0,0,0,0,110947,281.787,31.8,7.724,10727.146,252.675,11.62,0.723,0
162,77,0,27,0,0,0,0,0,110947,281.787,31.8,7.724,10727.146,252.675,11.62,0.723,0
162,78,2,29,0,0,0,0,0,110947,281.787,31.8,7.724,10727.146,252.675,11.62,0.723,0
162,79,0,29,0,0,0,0,0,110947,281.787,31.8,7.724,10727.146,252.675,11.62,0.723,0
162,80,0,29,0,0,0,0,0,110947,281.787,31.8,7.724,10727.146,252.675,11.62,0.723,0
162,81,0,29,0,0,0,0,0,110947,281.787,31.8,7.724,10727.146,252.675,11.62,0.723,0
162,82,0,29,0,0,0,0,0,110947,281.787,31.8,7.724,10727.146,252.675,11.62,0.723,0
162,83,0,29,0,0,0,0,0,110947,281.787,31.8,7.724,10727.146,252.675,11.62,0.723,0
162,84,0,29,0,0,0,0,0,110947,281.787,31.8,7.724,10727.146,252.675,11.62,0.723,0
162,85,0,29,0,0,0,0,0,110947,281.787,31.8,7.724,10727.146,252.675,11.62,0.723,0
162,86,0,29,0,0,0,0,0,110947,281.787,31.8,7.724,10727.146,252.675,11.62,0.723,0
162,87,0,29,0,0,0,0,0,110947,281.787,31.8,7.724,10727.146,252.675,11.62,0.723,0
162,88,0,29,0,0,0,0,0,110947,281.787,31.8,7.724,10727.146,252.675,11.62,0.723,0
162,89,0,29,0,0,0,0,0,110947,281.787,31.8,7.724,10727.146,252.675,11.62,0.723,0
162,90,0,29,0,0,0,0,0,110947,281.787,31.8,7.724,10727.146,252.675,11.62,0.723,0
162,91,0,29,0,0,0,0,0,110947,281.787,31.8,7.724,10727.146,252.675,11.62,0.723,0
162,92,0,29,0,0,0,0,0,110947,281.787,31.8,7.724,10727.146,252.675,11.62,0.723,0
162,93,0,29,0,0,0,0,0,110947,281.787,31.8,7.724,10727.146,252.675,11.62,0.723,0
162,94,0,29,0,0,0,0,0,110947,281.787,31.8,7.724,10727.146,252.675,11.62,0.723,0
162,95,0,29,0,0,0,0,0,110947,281.787,31.8,7.724,10727.146,252.675,11.62,0.723,0
162,96,0,29,0,0,0,0,0,110947,281.787,31.8,7.724,10727.146,252.675,11.62,0.723,0
162,97,0,29,0,0,0,0,0,110947,281.787,31.8,7.724,10727.146,252.675,11.62,0.723,0
162,98,0,29,0,0,0,0,0,110947,281.787,31.8,7.724,10727.146,252.675,11.62,0.723,0
162,99,0,29,0,0,0,0,0,110947,281.787,31.8,7.724,10727.146,252.675,11.62,0.723,0
162,100,0,29,0,0,0,0,0,110947,281.787,31.8,7.724,10727.146,252.675,11.62,0.723,0
162,101,0,29,0,0,0,0,0,110947,281.787,31.8,7.724,10727.146,252.675,11.62,0.723,0
162,102,0,29,0,0,0,0,0,110947,281.787,31.8,7.724,10727.146,252.675,11.62,0.723,0
162,103,0,29,0,0,0,0,0,110947,281.787,31.8,7.724,10727.146,252.675,11.62,0.723,0
162,104,6,35,0,0,0,0,0,110947,281.787,31.8,7.724,10727.146,252.675,11.62,0.723,0
162,105,0,35,0,0,0,0,0,110947,281.787,31.8,7.724,10727.146,252.675,11.62,0.723,0
162,106,0,35,0,0,0,0,0,110947,281.787,31.8,7.724,10727.146,252.675,11.62,0.723,0
162,107,0,35,0,0,0,0,0,110947,281.787,31.8,7.724,10727.146,252.675,11.62,0.723,0
162,108,0,35,0,0,0,0,0,110947,281.787,31.8,7.724,10727.146,252.675,11.62,0.723,0
162,109,3,38,0,0,0,0,0,110947,281.787,31.8,7.724,10727.146,252.675,11.62,0.723,0
162,110,6,44,0,0,0,0,0,110947,281.787,31.8,7.724,10727.146,252.675,11.62,0.723,0
162,111,6,50,0,0,0,0,0,110947,281.787,31.8,7.724,10727.146,252.675,11.62,0.723,0
162,112,0,50,0,0,0,0,0,110947,281.787,31.8,7.724,10727.146,252.675,11.62,0.723,0
162,113,0,50,0,0,0,0,0,110947,281.787,31.8,7.724,10727.146,252.675,11.62,0.723,0
162,114,0,50,0,0,0,0,0,110947,281.787,31.8,7.724,10727.146,252.675,11.62,0.723,0
162,115,2,52,0,0,0,0,0,110947,281.787,31.8,7.724,10727.146,252.675,11.62,0.723,0
162,116,0,52,0,0,0,0,0,110947,281.787,31.8,7.724,10727.146,252.675,11.62,0.723,0
162,117,0,52,0,0,0,0,0,110947,281.787,31.8,7.724,10727.146,252.675,11.62,0.723,0
162,118,0,52,0,0,0,0,0,110947,281.787,31.8,7.724,10727.146,252.675,11.62,0.723,0
162,119,0,52,0,0,0,0,0,110947,281.787,31.8,7.724,10727.146,252.675,11.62,0.723,0
162,120,0,52,0,0,0,0,0,110947,281.787,31.8,7.724,10727.146,252.675,11.62,0.723,0
162,121,0,52,0,0,0,0,0,110947,281.787,31.8,7.724,10727.146,252.675,11.62,0.723,0
162,122,0,52,0,0,0,0,0,110947,281.787,31.8,7.724,10727.146,252.675,11.62,0.723,0
162,123,2,54,0,0,0,0,0,110947,281.787,31.8,7.724,10727.146,252.675,11.62,0.723,0
162,124,1,55,0,0,0,0,0,110947,281.787,31.8,7.724,10727.146,252.675,11.62,0.723,0
162,125,0,55,0,0,0,0,0,110947,281.787,31.8,7.724,10727.146,252.675,11.62,0.723,0
162,126,0,55,0,0,0,0,0,110947,281.787,31.8,7.724,10727.146,252.675,11.62,0.723,0
162,127,0,55,0,0,0,0,0,110947,281.787,31.8,7.724,10727.146,252.675,11.62,0.723,0
162,128,1,56,0,0,0,0,0,110947,281.787,31.8,7.724,10727.146,252.675,11.62,0.723,0
162,129,0,56,0,0,0,0,0,110947,281.787,31.8,7.724,10727.146,252.675,11.62,0.723,0
162,130,0,56,0,0,0,0,0,110947,281.787,31.8,7.724,10727.146,252.675,11.62,0.723,0
162,131,0,56,0,0,0,0,0,110947,281.787,31.8,7.724,10727.146,252.675,11.62,0.723,0
162,132,1,57,0,0,0,0,0,110947,281.787,31.8,7.724,10727.146,252.675,11.62,0.723,0
162,133,0,57,0,0,0,0,0,110947,281.787,31.8,7.724,10727.146,252.675,11.62,0.723,0
162,134,0,57,0,0,0,0,0,110947,281.787,31.8,7.724,10727.146,252.675,11.62,0.723,0
162,135,0,57,0,0,0,0,0,110947,281.787,31.8,7.724,10727.146,252.675,11.62,0.723,0
162,136,0,57,0,0,0,0,0,110947,281.787,31.8,7.724,10727.146,252.675,11.62,0.723,0
162,137,0,57,0,0,0,0,0,110947,281.787,31.8,7.724,10727.146,252.675,11.62,0.723,0
162,138,0,57,0,0,0,0,0,110947,281.787,31.8,7.724,10727.146,252.675,11.62,0.723,0
162,139,0,57,0,0,0,0,0,110947,281.787,31.8,7.724,10727.146,252.675,11.62,0.723,0
162,140,1,58,0,0,0,0,0,110947,281.787,31.8,7.724,10727.146,252.675,11.62,0.723,0
162,141,0,58,0,0,0,0,0,110947,281.787,31.8,7.724,10727.146,252.675,11.62,0.723,0
162,142,0,58,0,0,0,0,0,110947,281.787,31.8,7.724,10727.146,252.675,11.62,0.723,0
162,143,0,58,0,0,0,0,0,110947,281.787,31.8,7.724,10727.146,252.675,11.62,0.723,0
162,144,0,58,0,0,0,0,0,110947,281.787,31.8,7.724,10727.146,252.675,11.62,0.723,0
162,145,0,58,0,0,0,0,0,110947,281.787,31.8,7.724,10727.146,252.675,11.62,0.723,0
162,146,0,58,0,0,0,0,0,110947,281.787,31.8,7.724,10727.146,252.675,11.62,0.723,0
162,147,0,58,0,0,0,0,0,110947,281.787,31.8,7.724,10727.146,252.675,11.62,0.723,0
162,148,0,58,0,0,0,0,0,110947,281.787,31.8,7.724,10727.146,252.675,11.62,0.723,0
162,149,0,58,0,0,0,0,0,110947,281.787,31.8,7.724,10727.146,252.675,11.62,0.723,0
162,150,2,60,0,0,0,0,0,110947,281.787,31.8,7.724,10727.146,252.675,11.62,0.723,0
162,151,0,60,0,0,0,0,0,110947,281.787,31.8,7.724,10727.146,252.675,11.62,0.723,0
162,152,0,60,0,0,0,0,0,110947,281.787,31.8,7.724,10727.146,252.675,11.62,0.723,0
162,153,0,60,0,0,0,0,0,110947,281.787,31.8,7.724,10727.146,252.675,11.62,0.723,0
162,154,0,60,0,0,0,0,0,110947,281.787,31.8,7.724,10727.146,252.675,11.62,0.723,0
162,155,1,61,0,0,0,0,0,110947,281.787,31.8,7.724,10727.146,252.675,11.62,0.723,0
162,156,0,61,0,0,0,0,0,110947,281.787,31.8,7.724,10727.146,252.675,11.62,0.723,0
162,157,0,61,0,0,0,0,0,110947,281.787,31.8,7.724,10727.146,252.675,11.62,0.723,0
162,158,0,61,0,0,0,0,0,110947,281.787,31.8,7.724,10727.146,252.675,11.62,0.723,0
162,159,0,61,0,0,0,0,0,110947,281.787,31.8,7.724,10727.146,252.675,11.62,0.723,0
162,160,0,61,0,0,0,0,0,110947,281.787,31.8,7.724,10727.146,252.675,11.62,0.723,0
162,161,1,62,0,0,0,0,0,110947,281.787,31.8,7.724,10727.146,252.675,11.62,0.723,0
162,162,0,62,0,0,0,0,0,110947,281.787,31.8,7.724,10727.146,252.675,11.62,0.723,0
162,163,0,62,0,0,0,0,0,110947,281.787,31.8,7.724,10727.146,252.675,11.62,0.723,0
162,164,0,62,0,0,0,0,0,110947,281.787,31.8,7.724,10727.146,252.675,11.62,0.723,0
162,165,2,64,0,0,0,0,0,110947,281.787,31.8,7.724,10727.146,252.675,11.62,0.723,0
162,166,0,64,0,0,0,0,0,110947,281.787,31.8,7.724,10727.146,252.675,11.62,0.723,0
162,167,0,64,0,0,0,0,0,110947,281.787,31.8,7.724,10727.146,252.675,11.62,0.723,0
162,168,0,64,0,0,0,0,0,110947,281.787,31.8,7.724,10727.146,252.675,11.62,0.723,0
162,169,0,64,0,0,0,0,0,110947,281.787,31.8,7.724,10727.146,252.675,11.62,0.723,0
162,170,0,64,0,0,0,0,0,110947,281.787,31.8,7.724,10727.146,252.675,11.62,0.723,0
162,171,0,64,0,0,0,0,0,110947,281.787,31.8,7.724,10727.146,252.675,11.62,0.723,0
162,172,0,64,0,0,0,0,0,110947,281.787,31.8,7.724,10727.146,252.675,11.62,0.723,0
162,173,0,64,0,0,0,0,0,110947,281.787,31.8,7.724,10727.146,252.675,11.62,0.723,0
162,174,0,64,0,0,0,0,0,110947,281.787,31.8,7.724,10727.146,252.675,11.62,0.723,0
162,175,0,64,0,0,0,0,0,110947,281.787,31.8,7.724,10727.146,252.675,11.62,0.723,0
162,176,0,64,0,0,0,0,0,110947,281.787,31.8,7.724,10727.146,252.675,11.62,0.723,0
162,177,0,64,0,0,0,0,0,110947,281.787,31.8,7.724,10727.146,252.675,11.62,0.723,0
162,178,0,64,0,0,0,0,0,110947,281.787,31.8,7.724,10727.146,252.675,11.62,0.723,0
162,179,0,64,0,0,0,0,0,110947,281.787,31.8,7.724,10727.146,252.675,11.62,0.723,0
162,180,0,64,0,0,0,0,0,110947,281.787,31.8,7.724,10727.146,252.675,11.62,0.723,0
162,181,0,64,0,0,0,0,0,110947,281.787,31.8,7.724,10727.146,252.675,11.62,0.723,0
162,182,0,64,0,0,0,0,0,110947,281.787,31.8,7.724,10727.146,252.675,11.62,0.723,0
162,183,0,64,0,0,0,0,0,110947,281.787,31.8,7.724,10727.146,252.675,11.62,0.723,0
162,184,0,64,0,0,0,0,0,110947,281.787,31.8,7.724,10727.146,252.675,11.62,0.723,0
162,185,0,64,0,0,0,0,0,110947,281.787,31.8,7.724,10727.146,252.675,11.62,0.723,0
162,186,0,64,0,0,0,0,0,110947,281.787,31.8,7.724,10727.146,252.675,11.62,0.723,0
162,187,0,64,0,0,0,0,0,110947,281.787,31.8,7.724,10727.146,252.675,11.62,0.723,0
162,188,0,64,0,0,0,0,0,110947,281.787,31.8,7.724,10727.146,252.675,11.62,0.723,0
162,189,0,64,0,0,0,0,0,110947,281.787,31.8,7.724,10727.146,252.675,11.62,0.723,0
162,190,0,64,0,0,0,0,0,110947,281.787,31.8,7.724,10727.146,252.675,11.62,0.723,0
162,191,0,64,0,0,0,0,0,110947,281.787,31.8,7.724,10727.146,252.675,11.62,0.723,0
162,192,0,64,0,0,0,0,0,110947,281.787,31.8,7.724,10727.146,252.675,11.62,0.723,0
162,193,0,64,0,0,0,0,0,110947,281.787,31.8,7.724,10727.146,252.675,11.62,0.723,0
162,194,0,64,0,0,0,0,0,110947,281.787,31.8,7.724,10727.146,252.675,11.62,0.723,0
162,195,0,64,0,0,0,0,0,110947,281.787,31.8,7.724,10727.146,252.675,11.62,0.723,0
162,196,0,64,0,0,0,0,0,110947,281.787,31.8,7.724,10727.146,252.675,11.62,0.723,0
162,197,0,64,0,0,0,0,0,110947,281.787,31.8,7.724,10727.146,252.675,11.62,0.723,0
162,198,0,64,0,0,0,0,0,110947,281.787,31.8,7.724,10727.146,252.675,11.62,0.723,0
162,199,0,64,0,0,0,0,0,110947,281.787,31.8,7.724,10727.146,252.675,11.62,0.723,0
162,200,1,65,0,0,0,0,0,110947,281.787,31.8,7.724,10727.146,252.675,11.62,0.723,0
162,201,2,67,0,0,0,0,0,110947,281.787,31.8,7.724,10727.146,252.675,11.62,0.723,0
162,202,0,67,0,0,0,0,0,110947,281.787,31.8,7.724,10727.146,252.675,11.62,0.723,0
162,203,0,67,0,0,0,0,0,110947,281.787,31.8,7.724,10727.146,252.675,11.62,0.723,0
162,204,1,68,0,0,0,0,0,110947,281.787,31.8,7.724,10727.146,252.675,11.62,0.723,0
165,1,110,1563,2,10,7381,123706,89.81,34813867,15.322,31.9,3.295,49045.411,259.538,17.72,0.853,4
165,2,157,1720,6,16,7688,131394,89.81,34813867,15.322,31.9,3.295,49045.411,259.538,17.72,0.853,4
165,3,165,1885,5,21,8012,139406,89.81,34813867,15.322,31.9,3.295,49045.411,259.538,17.72,0.853,4
165,4,0,1885,0,21,7779,147185,89.81,34813867,15.322,31.9,3.295,49045.411,259.538,17.72,0.853,4
165,5,294,2179,8,29,6778,153963,89.81,34813867,15.322,31.9,3.295,49045.411,259.538,17.72,0.853,4
165,6,206,2385,5,34,6832,160795,91.67,34813867,15.322,31.9,3.295,49045.411,259.538,17.72,0.853,4
165,7,138,2523,4,38,6384,167179,91.67,34813867,15.322,31.9,3.295,49045.411,259.538,17.72,0.853,4
165,8,272,2795,3,41,6387,173566,91.67,34813867,15.322,31.9,3.295,49045.411,259.538,17.72,0.853,4
165,9,137,2932,0,41,6819,180385,91.67,34813867,15.322,31.9,3.295,49045.411,259.538,17.72,0.853,4
165,10,355,3287,3,44,7441,187826,91.67,34813867,15.322,31.9,3.295,49045.411,259.538,17.72,0.853,4
165,11,364,3651,3,47,8993,196819,91.67,34813867,15.322,31.9,3.295,49045.411,259.538,17.72,0.853,4
165,12,382,4033,5,52,7365,204184,91.67,34813867,15.322,31.9,3.295,49045.411,259.538,17.72,0.853,4
165,13,429,4462,7,59,8219,212403,91.67,34813867,15.322,31.9,3.295,49045.411,259.538,17.72,0.853,4
165,14,472,4934,6,65,8388,220791,91.67,34813867,15.322,31.9,3.295,49045.411,259.538,17.72,0.853,4
165,15,435,5369,8,73,7669,228460,91.67,34813867,15.322,31.9,3.295,49045.411,259.538,17.72,0.853,4
165,16,493,5862,6,79,8256,236716,91.67,34813867,15.322,31.9,3.295,49045.411,259.538,17.72,0.853,4
165,17,518,6380,4,83,9006,245722,91.67,34813867,15.322,31.9,3.295,49045.411,259.538,17.72,0.853,4
165,18,762,7142,4,87,8733,254455,91.67,34813867,15.322,31.9,3.295,49045.411,259.538,17.72,0.853,4
165,19,1132,8274,5,92,9578,264033,91.67,34813867,15.322,31.9,3.295,49045.411,259.538,17.72,0.853,4
165,20,1088,9362,5,97,9260,273293,91.67,34813867,15.322,31.9,3.295,49045.411,259.538,17.72,0.853,4
165,21,1122,10484,6,103,9222,282515,91.67,34813867,15.322,31.9,3.295,49045.411,259.538,17.72,0.853,4
165,22,1147,11631,6,109,10340,292855,91.67,34813867,15.322,31.9,3.295,49045.411,259.538,17.72,0.853,4
165,23,1141,12772,5,114,8547,301402,91.67,34813867,15.322,31.9,3.295,49045.411,259.538,17.72,0.853,4
165,24,1158,13930,7,121,10203,311605,91.67,34813867,15.322,31.9,3.295,49045.411,259.538,17.72,0.853,4
165,25,1172,15102,6,127,9055,320660,91.67,34813867,15.322,31.9,3.295,49045.411,259.538,17.72,0.853,4
165,26,1197,16299,9,136,8967,329627,94.44,34813867,15.322,31.9,3.295,49045.411,259.538,17.72,0.853,4
165,27,1223,17522,3,139,9325,338952,94.44,34813867,15.322,31.9,3.295,49045.411,259.538,17.72,0.853,4
165,28,1289,18811,5,144,10887,349839,94.44,34813867,15.322,31.9,3.295,49045.411,259.538,17.72,0.853,4
165,29,1266,20077,8,152,9658,359497,94.44,34813867,15.322,31.9,3.295,49045.411,259.538,17.72,0.853,4
165,30,1325,21402,5,157,9288,368785,91.67,34813867,15.322,31.9,3.295,49045.411,259.538,17.72,0.853,4
165,31,1351,22753,5,162,12820,381605,91.67,34813867,15.322,31.9,3.295,49045.411,259.538,17.72,0.853,4
165,32,1344,24097,7,169,12780,394385,91.67,34813867,15.322,31.9,3.295,49045.411,259.538,17.72,0.853,4
165,33,1362,25459,7,176,12006,406391,91.67,34813867,15.322,31.9,3.295,49045.411,259.538,17.72,0.853,4
165,34,1552,27011,8,184,11514,417905,91.67,34813867,15.322,31.9,3.295,49045.411,259.538,17.72,0.853,4
165,35,1645,28656,7,191,13052,430957,91.67,34813867,15.322,31.9,3.295,49045.411,259.538,17.72,0.853,4
165,36,1595,30251,9,200,16026,446983,91.67,34813867,15.322,31.9,3.295,49045.411,259.538,17.72,0.853,4
165,37,1687,31938,9,209,13037,460020,89.81,34813867,15.322,31.9,3.295,49045.411,259.538,17.72,0.853,4
165,38,1793,33731,10,219,14778,474798,89.81,34813867,15.322,31.9,3.295,49045.411,259.538,17.72,0.853,4
165,39,1701,35432,10,229,16144,490942,89.81,34813867,15.322,31.9,3.295,49045.411,259.538,17.72,0.853,4
165,40,1704,37136,10,239,17725,508667,89.81,34813867,15.322,31.9,3.295,49045.411,259.538,17.72,0.853,4
165,41,1912,39048,7,246,15005,523672,89.81,34813867,15.322,31.9,3.295,49045.411,259.538,17.72,0.853,4
165,42,1966,41014,9,255,14574,538246,89.81,34813867,15.322,31.9,3.295,49045.411,259.538,17.72,0.853,4
165,43,1911,42925,9,264,16639,554885,89.81,34813867,15.322,31.9,3.295,49045.411,259.538,17.72,0.853,4
165,44,1905,44830,9,273,16678,571563,89.81,34813867,15.322,31.9,3.295,49045.411,259.538,17.72,0.853,4
165,45,2039,46869,10,283,17758,589321,89.81,34813867,15.322,31.9,3.295,49045.411,259.538,17.72,0.853,4
165,46,2307,49176,9,292,38382,627703,89.81,34813867,15.322,31.9,3.295,49045.411,259.538,17.72,0.853,4
165,47,2840,52016,10,302,15549,643252,89.81,34813867,15.322,31.9,3.295,49045.411,259.538,17.72,0.853,4
165,48,2736,54752,10,312,16130,659382,89.81,34813867,15.322,31.9,3.295,49045.411,259.538,17.72,0.853,4
165,49,2593,57345,8,320,18094,677476,89.81,34813867,15.322,31.9,3.295,49045.411,259.538,17.72,0.853,4
165,50,2509,59854,9,329,14980,692456,89.81,34813867,15.322,31.9,3.295,49045.411,259.538,17.72,0.853,4
165,51,2691,62545,10,339,15899,708355,89.81,34813867,15.322,31.9,3.295,49045.411,259.538,17.72,0.853,4
165,52,2532,65077,12,351,17558,725913,89.81,34813867,15.322,31.9,3.295,49045.411,259.538,17.72,0.853,4
165,53,2642,67719,13,364,18919,744832,91.67,34813867,15.322,31.9,3.295,49045.411,259.538,17.72,0.853,4
165,54,2442,70161,15,379,18545,763377,91.67,34813867,15.322,31.9,3.295,49045.411,259.538,17.72,0.853,4
165,55,2399,72560,11,390,16664,780041,91.67,34813867,15.322,31.9,3.295,49045.411,259.538,17.72,0.853,4
165,56,2235,74795,9,399,15525,795566,91.67,34813867,15.322,31.9,3.295,49045.411,259.538,17.72,0.853,4
165,57,1931,76726,12,411,16428,811994,91.67,34813867,15.322,31.9,3.295,49045.411,259.538,17.72,0.853,4
165,58,1815,78541,14,425,16769,828763,91.67,34813867,15.322,31.9,3.295,49045.411,259.538,17.72,0.853,4
165,59,1644,80185,16,441,19104,847867,91.67,34813867,15.322,31.9,3.295,49045.411,259.538,17.72,0.853,4
165,60,1581,81766,17,458,16200,864067,91.67,34813867,15.322,31.9,3.295,49045.411,259.538,17.72,0.853,4
165,61,1618,83384,22,480,15854,879921,75.46,34813867,15.322,31.9,3.295,49045.411,259.538,17.72,0.853,4
165,62,1877,85261,23,503,15364,895285,75.46,34813867,15.322,31.9,3.295,49045.411,259.538,17.72,0.853,4
165,63,1881,87142,22,525,16976,912261,75.46,34813867,15.322,31.9,3.295,49045.411,259.538,17.72,0.853,4
165,64,1869,89011,24,549,16246,928507,75.46,34813867,15.322,31.9,3.295,49045.411,259.538,17.72,0.853,4
165,65,2171,91182,30,579,21763,950270,75.46,34813867,15.322,31.9,3.295,49045.411,259.538,17.72,0.853,4
165,66,1975,93157,32,611,24229,974499,75.46,34813867,15.322,31.9,3.295,49045.411,259.538,17.72,0.853,4
165,67,2591,95748,31,642,25036,999535,72.69,34813867,15.322,31.9,3.295,49045.411,259.538,17.72,0.853,4
165,68,3121,98869,34,676,18578,1018113,72.69,34813867,15.322,31.9,3.295,49045.411,259.538,17.72,0.853,4
165,69,3045,101914,36,712,20858,1038971,69.91,34813867,15.322,31.9,3.295,49045.411,259.538,17.72,0.853,4
165,70,3369,105283,34,746,22139,1061110,69.91,34813867,15.322,31.9,3.295,49045.411,259.538,17.72,0.853,4
165,71,3288,108571,37,783,22500,1083610,69.91,34813867,15.322,31.9,3.295,49045.411,259.538,17.72,0.853,4
165,72,3717,112288,36,819,27324,1110934,69.91,34813867,15.322,31.9,3.295,49045.411,259.538,17.72,0.853,4
165,73,3733,116021,38,857,17385,1128319,69.91,34813867,15.322,31.9,3.295,49045.411,259.538,17.72,0.853,4
165,74,3921,119942,36,893,19377,1147696,69.91,34813867,15.322,31.9,3.295,49045.411,259.538,17.72,0.853,4
165,75,3366,123308,39,932,20255,1167951,69.91,34813867,15.322,31.9,3.295,49045.411,259.538,17.72,0.853,4
165,76,4233,127541,40,972,17629,1185580,69.91,34813867,15.322,31.9,3.295,49045.411,259.538,17.72,0.853,4
165,77,4507,132048,39,1011,23484,1209064,69.91,34813867,15.322,31.9,3.295,49045.411,259.538,17.72,0.853,4
165,78,4267,136315,41,1052,30507,1239571,69.91,34813867,15.322,31.9,3.295,49045.411,259.538,17.72,0.853,4
165,79,4919,141234,39,1091,26016,1265587,69.91,34813867,15.322,31.9,3.295,49045.411,259.538,17.72,0.853,4
165,80,4757,145991,48,1139,24708,1290295,69.91,34813867,15.322,31.9,3.295,49045.411,259.538,17.72,0.853,4
165,81,4301,150292,45,1184,35656,1325951,69.91,34813867,15.322,31.9,3.295,49045.411,259.538,17.72,0.853,4
165,82,3941,154233,46,1230,33614,1359565,71.3,34813867,15.322,31.9,3.295,49045.411,259.538,17.72,0.853,4
165,83,3379,157612,37,1267,27253,1386818,71.3,34813867,15.322,31.9,3.295,49045.411,259.538,17.72,0.853,4
165,84,3393,161005,40,1307,34511,1421329,71.3,34813867,15.322,31.9,3.295,49045.411,259.538,17.72,0.853,4
165,85,3139,164144,39,1346,37740,1459069,71.3,34813867,15.322,31.9,3.295,49045.411,259.538,17.72,0.853,4
165,86,3123,167267,41,1387,38470,1497539,71.3,34813867,15.322,31.9,3.295,49045.411,259.538,17.72,0.853,4
165,87,3372,170639,41,1428,44275,1541814,71.3,34813867,15.322,31.9,3.295,49045.411,259.538,17.72,0.853,4
165,88,3938,174577,46,1474,45521,1587335,71.3,34813867,15.322,31.9,3.295,49045.411,259.538,17.72,0.853,4
165,89,3927,178504,37,1511,45104,1632439,71.3,34813867,15.322,31.9,3.295,49045.411,259.538,17.72,0.853,4
165,90,3989,182493,40,1551,48173,1680612,71.3,34813867,15.322,31.9,3.295,49045.411,259.538,17.72,0.853,4
165,91,3943,186436,48,1599,35173,1715785,71.3,34813867,15.322,31.9,3.295,49045.411,259.538,17.72,0.853,4
165,92,4387,190823,50,1649,53214,1768999,71.3,34813867,15.322,31.9,3.295,49045.411,259.538,17.72,0.853,4
165,93,3402,194225,49,1698,43927,1812926,71.3,34813867,15.322,31.9,3.295,49045.411,259.538,17.72,0.853,4
165,94,3383,197608,54,1752,52135,1865061,71.3,34813867,15.322,31.9,3.295,49045.411,259.538,17.72,0.853,4
165,95,4193,201801,50,1802,50564,1915625,71.3,34813867,15.322,31.9,3.295,49045.411,259.538,17.72,0.853,4
165,96,4128,205929,56,1858,60064,1975689,71.3,34813867,15.322,31.9,3.295,49045.411,259.538,17.72,0.853,4
165,97,3580,209509,58,1916,42968,2018657,71.3,34813867,15.322,31.9,3.295,49045.411,259.538,17.72,0.853,4
165,98,4207,213716,52,1968,53166,2071823,71.3,34813867,15.322,31.9,3.295,49045.411,259.538,17.72,0.853,4
165,99,3392,217108,49,2017,53153,2124976,71.3,34813867,15.322,31.9,3.295,49045.411,259.538,17.72,0.853,4
165,100,3036,220144,42,2059,54472,2179448,71.3,34813867,15.322,31.9,3.295,49045.411,259.538,17.72,0.853,4
165,101,3183,223327,41,2100,46842,2226290,71.3,34813867,15.322,31.9,3.295,49045.411,259.538,17.72,0.853,4
165,102,3159,226486,51,2151,44429,2270719,71.3,34813867,15.322,31.9,3.295,49045.411,259.538,17.72,0.853,4
165,103,2994,229480,30,2181,66155,2336874,71.3,34813867,15.322,31.9,3.295,49045.411,259.538,17.72,0.853,4
165,104,2779,232259,42,2223,40799,2377673,71.3,34813867,15.322,31.9,3.295,49045.411,259.538,17.72,0.853,4
165,105,2852,235111,20,2243,59010,2436683,71.3,34813867,15.322,31.9,3.295,49045.411,259.538,17.72,0.853,4
165,106,2692,237803,40,2283,58190,2494873,71.3,34813867,15.322,31.9,3.295,49045.411,259.538,17.72,0.853,4
165,107,2671,240474,42,2325,65549,2560422,71.3,34813867,15.322,31.9,3.295,49045.411,259.538,17.72,0.853,4
165,108,2764,243238,45,2370,62364,2622786,71.3,34813867,15.322,31.9,3.295,49045.411,259.538,17.72,0.853,4
165,109,2613,245851,37,2407,48140,2670926,71.3,34813867,15.322,31.9,3.295,49045.411,259.538,17.72,0.853,4
165,110,2565,248416,40,2447,57498,2728424,71.3,34813867,15.322,31.9,3.295,49045.411,259.538,17.72,0.853,4
165,111,2504,250920,39,2486,56450,2784874,71.3,34813867,15.322,31.9,3.295,49045.411,259.538,17.72,0.853,4
165,112,2429,253349,37,2523,52180,2837054,71.3,34813867,15.322,31.9,3.295,49045.411,259.538,17.72,0.853,4
165,113,2476,255825,34,2557,57372,2894426,71.3,34813867,15.322,31.9,3.295,49045.411,259.538,17.72,0.853,4
165,114,2331,258156,44,2601,52502,2946928,71.3,34813867,15.322,31.9,3.295,49045.411,259.538,17.72,0.853,4
165,115,2238,260394,34,2635,52812,2999740,71.3,34813867,15.322,31.9,3.295,49045.411,259.538,17.72,0.853,4
165,116,2378,262772,37,2672,57216,3056956,71.3,34813867,15.322,31.9,3.295,49045.411,259.538,17.72,0.853,4
165,117,2201,264973,31,2703,53793,3110749,71.3,34813867,15.322,31.9,3.295,49045.411,259.538,17.72,0.853,4
165,118,1968,266941,30,2733,64137,3174886,71.3,34813867,15.322,31.9,3.295,49045.411,259.538,17.72,0.853,4
165,119,1993,268934,27,2760,62845,3237731,65.74,34813867,15.322,31.9,3.295,49045.411,259.538,17.72,0.853,4
165,120,1897,270831,29,2789,51961,3289692,65.74,34813867,15.322,31.9,3.295,49045.411,259.538,17.72,0.853,4
165,121,1759,272590,27,2816,60849,3350541,65.74,34813867,15.322,31.9,3.295,49045.411,259.538,17.72,0.853,4
165,122,1629,274219,50,2866,45147,3395688,65.74,34813867,15.322,31.9,3.295,49045.411,259.538,17.72,0.853,4
165,123,1686,275905,0,2866,36666,3432354,65.74,34813867,15.322,31.9,3.295,49045.411,259.538,17.72,0.853,4
165,124,1573,277478,1,2867,41361,3473715,65.74,34813867,15.322,31.9,3.295,49045.411,259.538,17.72,0.853,4
165,125,1357,278835,50,2917,54325,3528040,71.3,34813867,15.322,31.9,3.295,49045.411,259.538,17.72,0.853,4
165,126,1258,280093,32,2949,52099,3580139,71.3,34813867,15.322,31.9,3.295,49045.411,259.538,17.72,0.853,4
165,127,1342,281435,35,2984,55566,3635705,71.3,34813867,15.322,31.9,3.295,49045.411,259.538,17.72,0.853,4
165,128,1389,282824,36,3020,58299,3694004,71.3,34813867,15.322,31.9,3.295,49045.411,259.538,17.72,0.853,4
165,129,1402,284226,35,3055,60846,3754850,71.3,34813867,15.322,31.9,3.295,49045.411,259.538,17.72,0.853,4
165,130,1567,285793,38,3093,58424,3813274,71.3,34813867,15.322,31.9,3.295,49045.411,259.538,17.72,0.853,4
165,131,1469,287262,37,3130,59325,3872599,71.3,34813867,15.322,31.9,3.295,49045.411,259.538,17.72,0.853,4
165,132,1428,288690,37,3167,60828,3933427,71.3,34813867,15.322,31.9,3.295,49045.411,259.538,17.72,0.853,4
165,133,1257,289947,32,3199,67676,4001103,60.19,34813867,15.322,31.9,3.295,49045.411,259.538,17.72,0.853,4
165,134,1521,291468,34,3233,70754,4071857,60.19,34813867,15.322,31.9,3.295,49045.411,259.538,17.72,0.853,4
165,135,1569,293037,36,3269,66347,4138204,60.19,34813867,15.322,31.9,3.295,49045.411,259.538,17.72,0.853,4
165,136,1482,294519,34,3303,63872,4202076,60.19,34813867,15.322,31.9,3.295,49045.411,259.538,17.72,0.853,4
165,137,1383,295902,35,3338,60016,4262092,60.19,34813867,15.322,31.9,3.295,49045.411,259.538,17.72,0.853,4
165,138,1413,297315,31,3369,55613,4317705,60.19,34813867,15.322,31.9,3.295,49045.411,259.538,17.72,0.853,4
165,139,1227,298542,39,3408,60712,4378417,60.19,34813867,15.322,31.9,3.295,49045.411,259.538,17.72,0.853,4
165,140,1372,299914,28,3436,61067,4439484,60.19,34813867,15.322,31.9,3.295,49045.411,259.538,17.72,0.853,4
165,141,1419,301333,34,3470,61620,4501104,60.19,34813867,15.322,31.9,3.295,49045.411,259.538,17.72,0.853,4
165,142,1353,302686,36,3506,62413,4563517,60.19,34813867,15.322,31.9,3.295,49045.411,259.538,17.72,0.853,4
165,143,1287,303973,42,3548,59120,4622637,60.19,34813867,15.322,31.9,3.295,49045.411,259.538,17.72,0.853,4
165,144,1213,305186,32,3580,52313,4674950,60.19,34813867,15.322,31.9,3.295,49045.411,259.538,17.72,0.853,4
165,145,1184,306370,39,3619,58535,4733485,60.19,34813867,15.322,31.9,3.295,49045.411,259.538,17.72,0.853,4
165,146,1109,307479,30,3649,58707,4792192,60.19,34813867,15.322,31.9,3.295,49045.411,259.538,17.72,0.853,4
165,147,1175,308654,42,3691,58467,4850659,60.19,34813867,15.322,31.9,3.295,49045.411,259.538,17.72,0.853,4
165,148,1114,309768,31,3722,63265,4913924,60.19,34813867,15.322,31.9,3.295,49045.411,259.538,17.72,0.853,4
165,149,1068,310836,33,3755,60195,4974119,60.19,34813867,15.322,31.9,3.295,49045.411,259.538,17.72,0.853,4
165,150,1019,311855,30,3785,52008,5026127,60.19,34813867,15.322,31.9,3.295,49045.411,259.538,17.72,0.853,4
165,151,1069,312924,28,3813,37466,5063593,60.19,34813867,15.322,31.9,3.295,49045.411,259.538,17.72,0.853,4
165,152,987,313911,27,3840,46936,5110529,60.19,34813867,15.322,31.9,3.295,49045.411,259.538,17.72,0.853,4
165,153,910,314821,30,3870,49989,5160518,60.19,34813867,15.322,31.9,3.295,49045.411,259.538,17.72,0.853,4
165,154,951,315772,27,3897,52643,5213161,60.19,34813867,15.322,31.9,3.295,49045.411,259.538,17.72,0.853,4
165,155,898,316670,32,3929,48653,5261814,60.19,34813867,15.322,31.9,3.295,49045.411,259.538,17.72,0.853,4
165,156,816,317486,27,3956,52647,5314461,60.19,34813867,15.322,31.9,3.295,49045.411,259.538,17.72,0.853,4
165,157,833,318319,26,3982,50010,5364471,60.19,34813867,15.322,31.9,3.295,49045.411,259.538,17.72,0.853,4
165,158,822,319141,33,4015,41665,5406136,60.19,34813867,15.322,31.9,3.295,49045.411,259.538,17.72,0.853,4
165,159,791,319932,34,4049,44171,5450307,60.19,34813867,15.322,31.9,3.295,49045.411,259.538,17.72,0.853,4
165,160,895,320827,32,4081,48690,5498997,60.19,34813867,15.322,31.9,3.295,49045.411,259.538,17.72,0.853,4
165,161,768,321595,26,4107,49205,5548202,60.19,34813867,15.322,31.9,3.295,49045.411,259.538,17.72,0.853,4
165,162,642,322237,30,4137,41291,5589493,60.19,34813867,15.322,31.9,3.295,49045.411,259.538,17.72,0.853,4
165,163,775,323012,28,4165,55584,5645077,60.19,34813867,15.322,31.9,3.295,49045.411,259.538,17.72,0.853,4
165,164,708,323720,24,4189,41178,5686255,60.19,34813867,15.322,31.9,3.295,49045.411,259.538,17.72,0.853,4
165,165,687,324407,24,4213,36222,5722477,60.19,34813867,15.322,31.9,3.295,49045.411,259.538,17.72,0.853,4
165,166,643,325050,27,4240,44025,5766502,60.19,34813867,15.322,31.9,3.295,49045.411,259.538,17.72,0.853,4
165,167,601,325651,28,4268,51453,5817955,60.19,34813867,15.322,31.9,3.295,49045.411,259.538,17.72,0.853,4
165,168,607,326258,37,4305,50194,5868149,57.41,34813867,15.322,31.9,3.295,49045.411,259.538,17.72,0.853,4
165,169,672,326930,33,4338,49035,5917184,57.41,34813867,15.322,31.9,3.295,49045.411,259.538,17.72,0.853,4
165,170,621,327551,31,4369,49700,5966884,57.41,34813867,15.322,31.9,3.295,49045.411,259.538,17.72,0.853,4
165,171,593,328144,30,4399,43032,6009916,57.41,34813867,15.322,31.9,3.295,49045.411,259.538,17.72,0.853,4
165,172,576,328720,31,4430,40033,6049949,57.41,34813867,15.322,31.9,3.295,49045.411,259.538,17.72,0.853,4
165,173,551,329271,28,4458,43652,6093601,57.41,34813867,15.322,31.9,3.295,49045.411,259.538,17.72,0.853,4
165,174,483,329754,27,4485,48367,6141968,57.41,34813867,15.322,31.9,3.295,49045.411,259.538,17.72,0.853,4
165,175,492,330246,27,4512,48854,6190822,57.41,34813867,15.322,31.9,3.295,49045.411,259.538,17.72,0.853,4
165,176,552,330798,30,4542,46037,6236859,57.41,34813867,15.322,31.9,3.295,49045.411,259.538,17.72,0.853,4
165,177,561,331359,27,4569,38698,6275557,57.41,34813867,15.322,31.9,3.295,49045.411,259.538,17.72,0.853,4
165,178,498,331857,30,4599,38528,6314085,57.41,34813867,15.322,31.9,3.295,49045.411,259.538,17.72,0.853,4
165,179,472,332329,26,4625,34300,6348385,57.41,34813867,15.322,31.9,3.295,49045.411,259.538,17.72,0.853,4
165,180,461,332790,30,4655,44112,6392497,57.41,34813867,15.322,31.9,3.295,49045.411,259.538,17.72,0.853,4
165,181,403,333193,28,4683,51676,6444173,57.41,34813867,15.322,31.9,3.295,49045.411,259.538,17.72,0.853,4
165,182,455,333648,29,4712,47320,6491493,57.41,34813867,15.322,31.9,3.295,49045.411,259.538,17.72,0.853,4
165,183,539,334187,27,4739,49535,6541028,57.41,34813867,15.322,31.9,3.295,49045.411,259.538,17.72,0.853,4
165,184,418,334605,29,4768,51632,6592660,57.41,34813867,15.322,31.9,3.295,49045.411,259.538,17.72,0.853,4
165,185,492,335097,26,4794,46019,6638679,57.41,34813867,15.322,31.9,3.295,49045.411,259.538,17.72,0.853,4
165,186,481,335578,29,4823,39340,6678019,57.41,34813867,15.322,31.9,3.295,49045.411,259.538,17.72,0.853,4
165,187,419,335997,27,4850,47129,6725148,57.41,34813867,15.322,31.9,3.295,49045.411,259.538,17.72,0.853,4
165,188,390,336387,25,4875,50785,6775933,57.41,34813867,15.322,31.9,3.295,49045.411,259.538,17.72,0.853,4
165,189,379,336766,23,4898,52184,6828117,57.41,34813867,15.322,31.9,3.295,49045.411,259.538,17.72,0.853,4
165,190,477,337243,25,4923,48341,6876458,57.41,34813867,15.322,31.9,3.295,49045.411,259.538,17.72,0.853,4
165,191,468,337711,24,4947,53894,6930352,57.41,34813867,15.322,31.9,3.295,49045.411,259.538,17.72,0.853,4
165,192,421,338132,25,4972,46189,6976541,57.41,34813867,15.322,31.9,3.295,49045.411,259.538,17.72,0.853,4
165,193,407,338539,24,4996,38239,7014780,57.41,34813867,15.322,31.9,3.295,49045.411,259.538,17.72,0.853,4
165,194,405,338944,22,5018,45703,7060483,57.41,34813867,15.322,31.9,3.295,49045.411,259.538,17.72,0.853,4
165,195,323,339267,25,5043,49495,7109978,57.41,34813867,15.322,31.9,3.295,49045.411,259.538,17.72,0.853,4
165,196,348,339615,25,5068,51849,7161827,57.41,34813867,15.322,31.9,3.295,49045.411,259.538,17.72,0.853,4
165,197,474,340089,19,5087,52966,7214793,57.41,34813867,15.322,31.9,3.295,49045.411,259.538,17.72,0.853,4
165,198,501,340590,21,5108,53032,7267825,57.41,34813867,15.322,31.9,3.295,49045.411,259.538,17.72,0.853,4
165,199,472,341062,19,5127,47926,7315751,57.41,34813867,15.322,31.9,3.295,49045.411,259.538,17.72,0.853,4
165,200,433,341495,17,5144,38385,7354136,57.41,34813867,15.322,31.9,3.295,49045.411,259.538,17.72,0.853,4
165,201,359,341854,21,5165,48884,7403020,57.41,34813867,15.322,31.9,3.295,49045.411,259.538,17.72,0.853,4
165,202,348,342202,20,5185,0,7403020,57.41,34813867,15.322,31.9,3.295,49045.411,259.538,17.72,0.853,4
165,203,381,342583,16,5201,0,7403020,57.41,34813867,15.322,31.9,3.295,49045.411,259.538,17.72,0.853,4
165,204,385,342968,16,5217,0,7403020,57.41,34813867,15.322,31.9,3.295,49045.411,259.538,17.72,0.853,4
166,1,13,175,0,0,195,1495,77.78,16743930,82.328,18.7,3.008,2470.58,241.219,2.42,0.505,0
166,2,15,190,1,1,127,1622,77.78,16743930,82.328,18.7,3.008,2470.58,241.219,2.42,0.505,0
166,3,5,195,0,1,153,1775,77.78,16743930,82.328,18.7,3.008,2470.58,241.219,2.42,0.505,0
166,4,12,207,0,1,177,1952,77.78,16743930,82.328,18.7,3.008,2470.58,241.219,2.42,0.505,0
166,5,12,219,1,2,92,2044,77.78,16743930,82.328,18.7,3.008,2470.58,241.219,2.42,0.505,0
166,6,3,222,0,2,95,2139,77.78,16743930,82.328,18.7,3.008,2470.58,241.219,2.42,0.505,0
166,7,4,226,0,2,110,2249,77.78,16743930,82.328,18.7,3.008,2470.58,241.219,2.42,0.505,0
166,8,11,237,0,2,108,2357,77.78,16743930,82.328,18.7,3.008,2470.58,241.219,2.42,0.505,0
166,9,7,244,0,2,199,2556,77.78,16743930,82.328,18.7,3.008,2470.58,241.219,2.42,0.505,0
166,10,6,250,0,2,195,2751,77.78,16743930,82.328,18.7,3.008,2470.58,241.219,2.42,0.505,0
166,11,15,265,0,2,173,2924,77.78,16743930,82.328,18.7,3.008,2470.58,241.219,2.42,0.505,0
166,12,13,278,0,2,104,3028,77.78,16743930,82.328,18.7,3.008,2470.58,241.219,2.42,0.505,0
166,13,2,280,0,2,144,3172,77.78,16743930,82.328,18.7,3.008,2470.58,241.219,2.42,0.505,0
166,14,11,291,0,2,272,3444,77.78,16743930,82.328,18.7,3.008,2470.58,241.219,2.42,0.505,0
166,15,8,299,0,2,227,3671,77.78,16743930,82.328,18.7,3.008,2470.58,241.219,2.42,0.505,0
166,16,15,314,0,2,435,4106,77.78,16743930,82.328,18.7,3.008,2470.58,241.219,2.42,0.505,0
166,17,21,335,0,2,287,4393,77.78,16743930,82.328,18.7,3.008,2470.58,241.219,2.42,0.505,0
166,18,7,342,1,3,226,4619,77.78,16743930,82.328,18.7,3.008,2470.58,241.219,2.42,0.505,0
166,19,8,350,0,3,313,4932,77.78,16743930,82.328,18.7,3.008,2470.58,241.219,2.42,0.505,0
166,20,17,367,1,4,281,5213,77.78,16743930,82.328,18.7,3.008,2470.58,241.219,2.42,0.505,0
166,21,10,377,1,5,466,5679,77.78,16743930,82.328,18.7,3.008,2470.58,241.219,2.42,0.505,0
166,22,35,412,0,5,482,6161,77.78,16743930,82.328,18.7,3.008,2470.58,241.219,2.42,0.505,0
166,23,30,442,1,6,387,6548,77.78,16743930,82.328,18.7,3.008,2470.58,241.219,2.42,0.505,0
166,24,37,479,0,6,528,7076,77.78,16743930,82.328,18.7,3.008,2470.58,241.219,2.42,0.505,0
166,25,66,545,1,7,703,7779,77.78,16743930,82.328,18.7,3.008,2470.58,241.219,2.42,0.505,0
166,26,69,614,0,7,579,8358,77.78,16743930,82.328,18.7,3.008,2470.58,241.219,2.42,0.505,0
166,27,57,671,2,9,677,9035,77.78,16743930,82.328,18.7,3.008,2470.58,241.219,2.42,0.505,0
166,28,64,735,0,9,873,9908,77.78,16743930,82.328,18.7,3.008,2470.58,241.219,2.42,0.505,0
166,29,88,823,0,9,800,10708,77.78,16743930,82.328,18.7,3.008,2470.58,241.219,2.42,0.505,0
166,30,59,882,0,9,1161,11869,77.78,16743930,82.328,18.7,3.008,2470.58,241.219,2.42,0.505,0
166,31,51,933,0,9,901,12770,77.78,16743930,82.328,18.7,3.008,2470.58,241.219,2.42,0.505,0
166,32,91,1024,0,9,1190,13960,77.78,16743930,82.328,18.7,3.008,2470.58,241.219,2.42,0.505,0
166,33,91,1115,0,9,810,14770,77.78,16743930,82.328,18.7,3.008,2470.58,241.219,2.42,0.505,0
166,34,67,1182,0,9,807,15577,77.78,16743930,82.328,18.7,3.008,2470.58,241.219,2.42,0.505,0
166,35,89,1271,1,10,702,16279,77.78,16743930,82.328,18.7,3.008,2470.58,241.219,2.42,0.505,0
166,36,58,1329,1,11,1182,17461,77.78,16743930,82.328,18.7,3.008,2470.58,241.219,2.42,0.505,0
166,37,104,1433,1,12,1027,18488,77.78,16743930,82.328,18.7,3.008,2470.58,241.219,2.42,0.505,0
166,38,59,1492,1,13,872,19360,77.78,16743930,82.328,18.7,3.008,2470.58,241.219,2.42,0.505,0
166,39,59,1551,1,14,848,20208,77.78,16743930,82.328,18.7,3.008,2470.58,241.219,2.42,0.505,0
166,40,83,1634,3,17,1356,21564,77.78,16743930,82.328,18.7,3.008,2470.58,241.219,2.42,0.505,0
166,41,75,1709,2,19,917,22481,72.22,16743930,82.328,18.7,3.008,2470.58,241.219,2.42,0.505,0
166,42,177,1886,0,19,1099,23580,72.22,16743930,82.328,18.7,3.008,2470.58,241.219,2.42,0.505,0
166,43,109,1995,0,19,920,24500,72.22,16743930,82.328,18.7,3.008,2470.58,241.219,2.42,0.505,0
166,44,110,2105,3,22,992,25492,72.22,16743930,82.328,18.7,3.008,2470.58,241.219,2.42,0.505,0
166,45,84,2189,1,23,1128,26620,72.22,16743930,82.328,18.7,3.008,2470.58,241.219,2.42,0.505,0
166,46,121,2310,2,25,989,27609,72.22,16743930,82.328,18.7,3.008,2470.58,241.219,2.42,0.505,0
166,47,119,2429,0,25,816,28425,72.22,16743930,82.328,18.7,3.008,2470.58,241.219,2.42,0.505,0
166,48,51,2480,1,26,1172,29597,72.22,16743930,82.328,18.7,3.008,2470.58,241.219,2.42,0.505,0
166,49,64,2544,0,26,930,30527,72.22,16743930,82.328,18.7,3.008,2470.58,241.219,2.42,0.505,0
166,50,73,2617,4,30,1042,31569,72.22,16743930,82.328,18.7,3.008,2470.58,241.219,2.42,0.505,0
166,51,97,2714,0,30,1215,32784,72.22,16743930,82.328,18.7,3.008,2470.58,241.219,2.42,0.505,0
166,52,98,2812,3,33,1199,33983,72.22,16743930,82.328,18.7,3.008,2470.58,241.219,2.42,0.505,0
166,53,97,2909,0,33,934,34917,72.22,16743930,82.328,18.7,3.008,2470.58,241.219,2.42,0.505,0
166,54,67,2976,2,35,889,35806,72.22,16743930,82.328,18.7,3.008,2470.58,241.219,2.42,0.505,0
166,55,71,3047,0,35,1091,36897,72.22,16743930,82.328,18.7,3.008,2470.58,241.219,2.42,0.505,0
166,56,83,3130,1,36,551,37448,72.22,16743930,82.328,18.7,3.008,2470.58,241.219,2.42,0.505,0
166,57,31,3161,1,37,961,38409,72.22,16743930,82.328,18.7,3.008,2470.58,241.219,2.42,0.505,0
166,58,92,3253,2,39,991,39400,72.22,16743930,82.328,18.7,3.008,2470.58,241.219,2.42,0.505,0
166,59,95,3348,2,41,1236,40636,72.22,16743930,82.328,18.7,3.008,2470.58,241.219,2.42,0.505,0
166,60,81,3429,0,41,1370,42006,72.22,16743930,82.328,18.7,3.008,2470.58,241.219,2.42,0.505,0
166,61,106,3535,1,42,1024,43030,72.22,16743930,82.328,18.7,3.008,2470.58,241.219,2.42,0.505,0
166,62,110,3645,0,42,1820,44850,72.22,16743930,82.328,18.7,3.008,2470.58,241.219,2.42,0.505,0
166,63,94,3739,0,42,1339,46189,72.22,16743930,82.328,18.7,3.008,2470.58,241.219,2.42,0.505,0
166,64,97,3836,1,43,1549,47738,72.22,16743930,82.328,18.7,3.008,2470.58,241.219,2.42,0.505,0
166,65,96,3932,2,45,1348,49086,72.22,16743930,82.328,18.7,3.008,2470.58,241.219,2.42,0.505,0
166,66,89,4021,0,45,1700,50786,72.22,16743930,82.328,18.7,3.008,2470.58,241.219,2.42,0.505,0
166,67,134,4155,0,45,1166,51952,72.22,16743930,82.328,18.7,3.008,2470.58,241.219,2.42,0.505,0
166,68,94,4249,2,47,1266,53218,61.11,16743930,82.328,18.7,3.008,2470.58,241.219,2.42,0.505,0
166,69,79,4328,2,49,1010,54228,61.11,16743930,82.328,18.7,3.008,2470.58,241.219,2.42,0.505,0
166,70,99,4427,3,52,1402,55630,61.11,16743930,82.328,18.7,3.008,2470.58,241.219,2.42,0.505,0
166,71,89,4516,0,52,1205,56835,61.11,16743930,82.328,18.7,3.008,2470.58,241.219,2.42,0.505,0
166,72,124,4640,2,54,1164,57999,61.11,16743930,82.328,18.7,3.008,2470.58,241.219,2.42,0.505,0
166,73,119,4759,2,56,1005,59004,61.11,16743930,82.328,18.7,3.008,2470.58,241.219,2.42,0.505,0
166,74,92,4851,0,56,1378,60382,61.11,16743930,82.328,18.7,3.008,2470.58,241.219,2.42,0.505,0
166,75,145,4996,4,60,1223,61605,61.11,16743930,82.328,18.7,3.008,2470.58,241.219,2.42,0.505,0
166,76,94,5090,0,60,1254,62859,61.11,16743930,82.328,18.7,3.008,2470.58,241.219,2.42,0.505,0
166,77,83,5173,4,64,999,63858,61.11,16743930,82.328,18.7,3.008,2470.58,241.219,2.42,0.505,0
166,78,74,5247,6,70,970,64828,61.11,16743930,82.328,18.7,3.008,2470.58,241.219,2.42,0.505,0
166,79,122,5369,3,73,1406,66234,61.11,16743930,82.328,18.7,3.008,2470.58,241.219,2.42,0.505,0
166,80,106,5475,3,76,1617,67851,61.11,16743930,82.328,18.7,3.008,2470.58,241.219,2.42,0.505,0
166,81,164,5639,3,79,1247,69098,61.11,16743930,82.328,18.7,3.008,2470.58,241.219,2.42,0.505,0
166,82,99,5738,3,82,978,70076,61.11,16743930,82.328,18.7,3.008,2470.58,241.219,2.42,0.505,0
166,83,150,5888,2,84,1040,71116,61.11,16743930,82.328,18.7,3.008,2470.58,241.219,2.42,0.505,0
166,84,82,5970,2,86,1045,72161,61.11,16743930,82.328,18.7,3.008,2470.58,241.219,2.42,0.505,0
166,85,64,6034,3,89,987,73148,61.11,16743930,82.328,18.7,3.008,2470.58,241.219,2.42,0.505,0
166,86,95,6129,4,93,985,74133,57.41,16743930,82.328,18.7,3.008,2470.58,241.219,2.42,0.505,0
166,87,104,6233,1,94,1057,75190,57.41,16743930,82.328,18.7,3.008,2470.58,241.219,2.42,0.505,0
166,88,121,6354,4,98,1009,76199,57.41,16743930,82.328,18.7,3.008,2470.58,241.219,2.42,0.505,0
166,89,105,6459,4,102,1179,77378,57.41,16743930,82.328,18.7,3.008,2470.58,241.219,2.42,0.505,0
166,90,127,6586,3,105,956,78334,57.41,16743930,82.328,18.7,3.008,2470.58,241.219,2.42,0.505,0
166,91,112,6698,3,108,1274,79608,46.3,16743930,82.328,18.7,3.008,2470.58,241.219,2.42,0.505,0
166,92,95,6793,4,112,907,80515,46.3,16743930,82.328,18.7,3.008,2470.58,241.219,2.42,0.505,0
166,93,132,6925,4,116,1160,81675,46.3,16743930,82.328,18.7,3.008,2470.58,241.219,2.42,0.505,0
166,94,129,7054,5,121,1078,82753,46.3,16743930,82.328,18.7,3.008,2470.58,241.219,2.42,0.505,0
166,95,110,7164,4,125,959,83712,46.3,16743930,82.328,18.7,3.008,2470.58,241.219,2.42,0.505,0
166,96,108,7272,4,129,756,84468,46.3,16743930,82.328,18.7,3.008,2470.58,241.219,2.42,0.505,0
166,97,128,7400,4,133,838,85306,46.3,16743930,82.328,18.7,3.008,2470.58,241.219,2.42,0.505,0
166,98,78,7478,3,136,693,85999,46.3,16743930,82.328,18.7,3.008,2470.58,241.219,2.42,0.505,0
166,99,69,7547,1,137,788,86787,46.3,16743930,82.328,18.7,3.008,2470.58,241.219,2.42,0.505,0
166,100,110,7657,4,141,970,87757,46.3,16743930,82.328,18.7,3.008,2470.58,241.219,2.42,0.505,0
166,101,127,7784,2,143,868,88625,46.3,16743930,82.328,18.7,3.008,2470.58,241.219,2.42,0.505,0
166,102,98,7882,2,145,790,89415,46.3,16743930,82.328,18.7,3.008,2470.58,241.219,2.42,0.505,0
166,103,132,8014,0,145,1108,90523,46.3,16743930,82.328,18.7,3.008,2470.58,241.219,2.42,0.505,0
166,104,121,8135,3,148,710,91233,46.3,16743930,82.328,18.7,3.008,2470.58,241.219,2.42,0.505,0
166,105,63,8198,2,150,764,91997,46.3,16743930,82.328,18.7,3.008,2470.58,241.219,2.42,0.505,0
166,106,45,8243,0,150,804,92801,46.3,16743930,82.328,18.7,3.008,2470.58,241.219,2.42,0.505,0
166,107,126,8369,3,153,1173,93974,46.3,16743930,82.328,18.7,3.008,2470.58,241.219,2.42,0.505,0
166,108,112,8481,3,156,1074,95048,32.41,16743930,82.328,18.7,3.008,2470.58,241.219,2.42,0.505,0
166,109,63,8544,4,160,790,95838,32.41,16743930,82.328,18.7,3.008,2470.58,241.219,2.42,0.505,0
166,110,125,8669,3,163,712,96550,32.41,16743930,82.328,18.7,3.008,2470.58,241.219,2.42,0.505,0
166,111,141,8810,4,167,639,97189,32.41,16743930,82.328,18.7,3.008,2470.58,241.219,2.42,0.505,0
166,112,138,8948,3,170,369,97558,32.41,16743930,82.328,18.7,3.008,2470.58,241.219,2.42,0.505,0
166,113,37,8985,4,174,1244,98802,32.41,16743930,82.328,18.7,3.008,2470.58,241.219,2.42,0.505,0
166,114,136,9121,3,177,1170,99972,32.41,16743930,82.328,18.7,3.008,2470.58,241.219,2.42,0.505,0
166,115,145,9266,1,178,1602,101574,32.41,16743930,82.328,18.7,3.008,2470.58,241.219,2.42,0.505,0
166,116,156,9422,4,182,1315,102889,32.41,16743930,82.328,18.7,3.008,2470.58,241.219,2.42,0.505,0
166,117,130,9552,5,187,1367,104256,32.41,16743930,82.328,18.7,3.008,2470.58,241.219,2.42,0.505,0
166,118,129,9681,4,191,1083,105339,32.41,16743930,82.328,18.7,3.008,2470.58,241.219,2.42,0.505,0
166,119,83,9764,3,194,824,106163,32.41,16743930,82.328,18.7,3.008,2470.58,241.219,2.42,0.505,0
166,120,41,9805,4,198,1963,108126,32.41,16743930,82.328,18.7,3.008,2470.58,241.219,2.42,0.505,0
166,121,156,9961,2,200,1547,109673,32.41,16743930,82.328,18.7,3.008,2470.58,241.219,2.42,0.505,0
166,122,145,10106,4,204,1374,111047,32.41,16743930,82.328,18.7,3.008,2470.58,241.219,2.42,0.505,0
166,123,126,10232,1,205,850,111897,32.41,16743930,82.328,18.7,3.008,2470.58,241.219,2.42,0.505,0
166,124,52,10284,4,209,915,112812,32.41,16743930,82.328,18.7,3.008,2470.58,241.219,2.42,0.505,0
166,125,60,10344,0,209,946,113758,32.41,16743930,82.328,18.7,3.008,2470.58,241.219,2.42,0.505,0
166,126,42,10386,2,211,1078,114836,32.41,16743930,82.328,18.7,3.008,2470.58,241.219,2.42,0.505,0
166,127,46,10432,3,214,1241,116077,32.41,16743930,82.328,18.7,3.008,2470.58,241.219,2.42,0.505,0
166,128,106,10538,0,214,1917,117994,32.41,16743930,82.328,18.7,3.008,2470.58,241.219,2.42,0.505,0
166,129,177,10715,9,223,1711,119705,32.41,16743930,82.328,18.7,3.008,2470.58,241.219,2.42,0.505,0
166,130,172,10887,2,225,1576,121281,32.41,16743930,82.328,18.7,3.008,2470.58,241.219,2.42,0.505,0
166,131,146,11033,4,229,1656,122937,32.41,16743930,82.328,18.7,3.008,2470.58,241.219,2.42,0.505,0
166,132,142,11175,3,232,1402,124339,32.41,16743930,82.328,18.7,3.008,2470.58,241.219,2.42,0.505,0
166,133,137,11312,4,236,876,125215,32.41,16743930,82.328,18.7,3.008,2470.58,241.219,2.42,0.505,0
166,134,68,11380,2,238,1842,127057,32.41,16743930,82.328,18.7,3.008,2470.58,241.219,2.42,0.505,0
166,135,207,11587,4,242,1730,128787,32.41,16743930,82.328,18.7,3.008,2470.58,241.219,2.42,0.505,0
166,136,153,11740,2,244,1952,130739,32.41,16743930,82.328,18.7,3.008,2470.58,241.219,2.42,0.505,0
166,137,132,11872,5,249,1886,132625,32.41,16743930,82.328,18.7,3.008,2470.58,241.219,2.42,0.505,0
166,138,160,12032,2,251,1317,133942,37.96,16743930,82.328,18.7,3.008,2470.58,241.219,2.42,0.505,0
166,139,130,12162,2,253,1049,134991,37.96,16743930,82.328,18.7,3.008,2470.58,241.219,2.42,0.505,0
166,140,75,12237,3,256,926,135917,37.96,16743930,82.328,18.7,3.008,2470.58,241.219,2.42,0.505,0
166,141,68,12305,0,256,1463,137380,37.96,16743930,82.328,18.7,3.008,2470.58,241.219,2.42,0.505,0
166,142,141,12446,2,258,1519,138899,37.96,16743930,82.328,18.7,3.008,2470.58,241.219,2.42,0.505,0
166,143,113,12559,3,261,1421,140320,37.96,16743930,82.328,18.7,3.008,2470.58,241.219,2.42,0.505,0
166,144,130,12689,1,262,1552,141872,37.96,16743930,82.328,18.7,3.008,2470.58,241.219,2.42,0.505,0
166,145,161,12850,4,266,1250,143122,37.96,16743930,82.328,18.7,3.008,2470.58,241.219,2.42,0.505,0
166,146,99,12949,3,269,812,143934,37.96,16743930,82.328,18.7,3.008,2470.58,241.219,2.42,0.505,0
166,147,64,13013,3,272,816,144750,37.96,16743930,82.328,18.7,3.008,2470.58,241.219,2.42,0.505,0
166,148,43,13056,2,274,1384,146134,37.96,16743930,82.328,18.7,3.008,2470.58,241.219,2.42,0.505,0
166,149,130,13186,1,275,1242,147376,37.96,16743930,82.328,18.7,3.008,2470.58,241.219,2.42,0.505,0
166,150,108,13294,2,277,1250,148626,37.96,16743930,82.328,18.7,3.008,2470.58,241.219,2.42,0.505,0
166,151,90,13384,2,279,1338,149964,37.96,16743930,82.328,18.7,3.008,2470.58,241.219,2.42,0.505,0
166,152,72,13456,3,282,1276,151240,37.96,16743930,82.328,18.7,3.008,2470.58,241.219,2.42,0.505,0
166,153,100,13556,2,284,1090,152330,37.96,16743930,82.328,18.7,3.008,2470.58,241.219,2.42,0.505,0
166,154,55,13611,0,284,944,153274,37.96,16743930,82.328,18.7,3.008,2470.58,241.219,2.42,0.505,0
166,155,57,13668,0,284,1187,154461,37.96,16743930,82.328,18.7,3.008,2470.58,241.219,2.42,0.505,0
166,156,75,13743,3,287,1032,155493,37.96,16743930,82.328,18.7,3.008,2470.58,241.219,2.42,0.505,0
166,157,83,13826,0,287,1346,156839,37.96,16743930,82.328,18.7,3.008,2470.58,241.219,2.42,0.505,0
166,158,55,13881,0,287,1313,158152,37.96,16743930,82.328,18.7,3.008,2470.58,241.219,2.42,0.505,0
166,159,67,13948,0,287,1166,159318,37.96,16743930,82.328,18.7,3.008,2470.58,241.219,2.42,0.505,0
166,160,39,13987,3,290,1082,160400,37.96,16743930,82.328,18.7,3.008,2470.58,241.219,2.42,0.505,0
166,161,27,14014,1,291,788,161188,37.96,16743930,82.328,18.7,3.008,2470.58,241.219,2.42,0.505,0
166,162,30,14044,1,292,1317,162505,37.96,16743930,82.328,18.7,3.008,2470.58,241.219,2.42,0.505,0
166,163,58,14102,1,293,933,163438,37.96,16743930,82.328,18.7,3.008,2470.58,241.219,2.42,0.505,0
166,164,48,14150,0,293,1261,164699,37.96,16743930,82.328,18.7,3.008,2470.58,241.219,2.42,0.505,0
166,165,43,14193,0,293,1093,165792,37.96,16743930,82.328,18.7,3.008,2470.58,241.219,2.42,0.505,0
166,166,44,14237,2,295,1206,166998,37.96,16743930,82.328,18.7,3.008,2470.58,241.219,2.42,0.505,0
166,167,43,14280,2,297,852,167850,37.96,16743930,82.328,18.7,3.008,2470.58,241.219,2.42,0.505,0
166,168,26,14306,0,297,727,168577,37.96,16743930,82.328,18.7,3.008,2470.58,241.219,2.42,0.505,0
166,169,223,14529,1,298,1169,169746,37.96,16743930,82.328,18.7,3.008,2470.58,241.219,2.42,0.505,0
166,170,39,14568,1,299,1312,171058,37.96,16743930,82.328,18.7,3.008,2470.58,241.219,2.42,0.505,0
166,171,50,14618,1,300,1154,172212,43.52,16743930,82.328,18.7,3.008,2470.58,241.219,2.42,0.505,0
166,172,27,14645,1,301,1334,173546,43.52,16743930,82.328,18.7,3.008,2470.58,241.219,2.42,0.505,0
166,173,43,14688,1,302,1224,174770,43.52,16743930,82.328,18.7,3.008,2470.58,241.219,2.42,0.505,0
166,174,26,14714,0,302,997,175767,43.52,16743930,82.328,18.7,3.008,2470.58,241.219,2.42,0.505,0
166,175,24,14738,0,302,857,176624,43.52,16743930,82.328,18.7,3.008,2470.58,241.219,2.42,0.505,0
166,176,21,14759,0,302,1005,177629,43.52,16743930,82.328,18.7,3.008,2470.58,241.219,2.42,0.505,0
166,177,36,14795,1,303,1005,178634,43.52,16743930,82.328,18.7,3.008,2470.58,241.219,2.42,0.505,0
166,178,21,14816,1,304,1170,179804,43.52,16743930,82.328,18.7,3.008,2470.58,241.219,2.42,0.505,0
166,179,0,14816,0,304,1141,180945,43.52,16743930,82.328,18.7,3.008,2470.58,241.219,2.42,0.505,0
166,180,53,14869,2,306,1295,182240,43.52,16743930,82.328,18.7,3.008,2470.58,241.219,2.42,0.505,0
166,181,40,14909,2,308,929,183169,40.74,16743930,82.328,18.7,3.008,2470.58,241.219,2.42,0.505,0
166,182,10,14919,1,309,920,184089,40.74,16743930,82.328,18.7,3.008,2470.58,241.219,2.42,0.505,0
166,183,26,14945,1,310,1266,185355,40.74,16743930,82.328,18.7,3.008,2470.58,241.219,2.42,0.505,0
166,184,37,14982,1,311,1351,186706,40.74,16743930,82.328,18.7,3.008,2470.58,241.219,2.42,0.505,0
166,185,37,15019,0,311,1213,187919,40.74,16743930,82.328,18.7,3.008,2470.58,241.219,2.42,0.505,0
166,186,32,15051,1,312,1337,189256,40.74,16743930,82.328,18.7,3.008,2470.58,241.219,2.42,0.505,0
166,187,17,15068,0,312,1131,190387,40.74,16743930,82.328,18.7,3.008,2470.58,241.219,2.42,0.505,0
166,188,26,15094,0,312,929,191316,40.74,16743930,82.328,18.7,3.008,2470.58,241.219,2.42,0.505,0
166,189,28,15122,0,312,777,192093,40.74,16743930,82.328,18.7,3.008,2470.58,241.219,2.42,0.505,0
166,190,19,15141,0,312,1042,193135,40.74,16743930,82.328,18.7,3.008,2470.58,241.219,2.42,0.505,0
166,191,33,15174,1,313,987,194122,40.74,16743930,82.328,18.7,3.008,2470.58,241.219,2.42,0.505,0
166,192,16,15190,0,313,1059,195181,40.74,16743930,82.328,18.7,3.008,2470.58,241.219,2.42,0.505,0
166,193,23,15213,0,313,1177,196358,40.74,16743930,82.328,18.7,3.008,2470.58,241.219,2.42,0.505,0
166,194,31,15244,1,314,1091,197449,40.74,16743930,82.328,18.7,3.008,2470.58,241.219,2.42,0.505,0
166,195,24,15268,0,314,639,198088,40.74,16743930,82.328,18.7,3.008,2470.58,241.219,2.42,0.505,0
166,196,24,15292,1,315,924,199012,40.74,16743930,82.328,18.7,3.008,2470.58,241.219,2.42,0.505,0
166,197,15,15307,0,315,1293,200305,40.74,16743930,82.328,18.7,3.008,2470.58,241.219,2.42,0.505,0
166,198,24,15331,1,316,1105,201410,40.74,16743930,82.328,18.7,3.008,2470.58,241.219,2.42,0.505,0
166,199,17,15348,0,316,1084,202494,40.74,16743930,82.328,18.7,3.008,2470.58,241.219,2.42,0.505,0
166,200,20,15368,1,317,982,203476,40.74,16743930,82.328,18.7,3.008,2470.58,241.219,2.42,0.505,0
166,201,24,15392,0,317,1156,204632,40.74,16743930,82.328,18.7,3.008,2470.58,241.219,2.42,0.505,0
166,202,26,15418,0,317,829,205461,40.74,16743930,82.328,18.7,3.008,2470.58,241.219,2.42,0.505,0
166,203,14,15432,2,319,0,205461,40.74,16743930,82.328,18.7,3.008,2470.58,241.219,2.42,0.505,0
166,204,27,15459,1,320,0,205461,40.74,16743930,82.328,18.7,3.008,2470.58,241.219,2.42,0.505,0
167,1,115,900,7,23,810,4371,100,6804596,80.291,41.2,17.366,14048.881,439.415,10.08,0.787,0
167,2,160,1060,0,23,637,5008,100,6804596,80.291,41.2,17.366,14048.881,439.415,10.08,0.787,0
167,3,111,1171,8,31,748,5756,100,6804596,80.291,41.2,17.366,14048.881,439.415,10.08,0.787,0
167,4,305,1476,8,39,645,6401,100,6804596,80.291,41.2,17.366,14048.881,439.415,10.08,0.787,0
167,5,148,1624,5,44,959,7360,100,6804596,80.291,41.2,17.366,14048.881,439.415,10.08,0.787,0
167,6,284,1908,7,51,1192,8552,100,6804596,80.291,41.2,17.366,14048.881,439.415,10.08,0.787,0
167,7,292,2200,7,58,1074,9626,100,6804596,80.291,41.2,17.366,14048.881,439.415,10.08,0.787,0
167,8,247,2447,3,61,1135,10761,100,6804596,80.291,41.2,17.366,14048.881,439.415,10.08,0.787,0
167,9,219,2666,4,65,1586,12347,100,6804596,80.291,41.2,17.366,14048.881,439.415,10.08,0.787,0
167,10,201,2867,1,66,1893,14240,100,6804596,80.291,41.2,17.366,14048.881,439.415,10.08,0.787,0
167,11,238,3105,5,71,2159,16399,100,6804596,80.291,41.2,17.366,14048.881,439.415,10.08,0.787,0
167,12,275,3380,3,74,1913,18312,100,6804596,80.291,41.2,17.366,14048.881,439.415,10.08,0.787,0
167,13,250,3630,6,80,2646,20958,100,6804596,80.291,41.2,17.366,14048.881,439.415,10.08,0.787,0
167,14,424,4054,5,85,2440,23398,100,6804596,80.291,41.2,17.366,14048.881,439.415,10.08,0.787,0
167,15,411,4465,9,94,2880,26278,100,6804596,80.291,41.2,17.366,14048.881,439.415,10.08,0.787,0
167,16,408,4873,5,99,3194,29472,100,6804596,80.291,41.2,17.366,14048.881,439.415,10.08,0.787,0
167,17,445,5318,4,103,3094,32566,100,6804596,80.291,41.2,17.366,14048.881,439.415,10.08,0.787,0
167,18,372,5690,7,110,3462,36028,100,6804596,80.291,41.2,17.366,14048.881,439.415,10.08,0.787,0
167,19,304,5994,7,117,2673,38701,100,6804596,80.291,41.2,17.366,14048.881,439.415,10.08,0.787,0
167,20,324,6318,5,122,3111,41812,100,6804596,80.291,41.2,17.366,14048.881,439.415,10.08,0.787,0
167,21,312,6630,3,125,3543,45355,96.3,6804596,80.291,41.2,17.366,14048.881,439.415,10.08,0.787,0
167,22,260,6890,0,125,3281,48636,96.3,6804596,80.291,41.2,17.366,14048.881,439.415,10.08,0.787,0
167,23,224,7114,9,134,2688,51324,96.3,6804596,80.291,41.2,17.366,14048.881,439.415,10.08,0.787,0
167,24,162,7276,5,139,3563,54887,96.3,6804596,80.291,41.2,17.366,14048.881,439.415,10.08,0.787,0
167,25,207,7483,5,144,5051,59938,96.3,6804596,80.291,41.2,17.366,14048.881,439.415,10.08,0.787,0
167,26,296,7779,7,151,4365,64303,96.3,6804596,80.291,41.2,17.366,14048.881,439.415,10.08,0.787,0
167,27,263,8042,5,156,3614,67917,93.52,6804596,80.291,41.2,17.366,14048.881,439.415,10.08,0.787,0
167,28,233,8275,6,162,5446,73363,93.52,6804596,80.291,41.2,17.366,14048.881,439.415,10.08,0.787,0
167,29,222,8497,6,168,5579,78942,93.52,6804596,80.291,41.2,17.366,14048.881,439.415,10.08,0.787,0
167,30,227,8724,5,173,6703,85645,96.3,6804596,80.291,41.2,17.366,14048.881,439.415,10.08,0.787,0
167,31,285,9009,6,179,5906,91551,96.3,6804596,80.291,41.2,17.366,14048.881,439.415,10.08,0.787,0
167,32,196,9205,6,185,5086,96637,96.3,6804596,80.291,41.2,17.366,14048.881,439.415,10.08,0.787,0
167,33,157,9362,4,189,5274,101911,96.3,6804596,80.291,41.2,17.366,14048.881,439.415,10.08,0.787,0
167,34,102,9464,4,193,4550,106461,96.3,6804596,80.291,41.2,17.366,14048.881,439.415,10.08,0.787,0
167,35,93,9557,4,197,4817,111278,93.52,6804596,80.291,41.2,17.366,14048.881,439.415,10.08,0.787,0
167,36,120,9677,3,200,6196,117474,93.52,6804596,80.291,41.2,17.366,14048.881,439.415,10.08,0.787,0
167,37,114,9791,3,203,5521,122995,93.52,6804596,80.291,41.2,17.366,14048.881,439.415,10.08,0.787,0
167,38,57,9848,3,206,5810,128805,93.52,6804596,80.291,41.2,17.366,14048.881,439.415,10.08,0.787,0
167,39,95,9943,3,209,5728,134533,93.52,6804596,80.291,41.2,17.366,14048.881,439.415,10.08,0.787,0
167,40,89,10032,4,213,6059,140592,93.52,6804596,80.291,41.2,17.366,14048.881,439.415,10.08,0.787,0
167,41,82,10114,2,215,5012,145604,93.52,6804596,80.291,41.2,17.366,14048.881,439.415,10.08,0.787,0
167,42,62,10176,3,218,5700,151304,93.52,6804596,80.291,41.2,17.366,14048.881,439.415,10.08,0.787,0
167,43,67,10243,2,220,5299,156603,93.52,6804596,80.291,41.2,17.366,14048.881,439.415,10.08,0.787,0
167,44,52,10295,2,222,6194,162797,93.52,6804596,80.291,41.2,17.366,14048.881,439.415,10.08,0.787,0
167,45,79,10374,2,224,5873,168670,93.52,6804596,80.291,41.2,17.366,14048.881,439.415,10.08,0.787,0
167,46,64,10438,1,225,6076,174746,93.52,6804596,80.291,41.2,17.366,14048.881,439.415,10.08,0.787,0
167,47,58,10496,3,228,6526,181272,51.85,6804596,80.291,41.2,17.366,14048.881,439.415,10.08,0.787,0
167,48,114,10610,2,230,4113,185385,51.85,6804596,80.291,41.2,17.366,14048.881,439.415,10.08,0.787,0
167,49,89,10699,1,231,5298,190683,51.85,6804596,80.291,41.2,17.366,14048.881,439.415,10.08,0.787,0
167,50,34,10733,3,234,6198,196881,51.85,6804596,80.291,41.2,17.366,14048.881,439.415,10.08,0.787,0
167,51,100,10833,1,235,6918,203799,51.85,6804596,80.291,41.2,17.366,14048.881,439.415,10.08,0.787,0
167,52,86,10919,2,237,5998,209797,49.07,6804596,80.291,41.2,17.366,14048.881,439.415,10.08,0.787,0
167,53,105,11024,0,237,4415,214212,49.07,6804596,80.291,41.2,17.366,14048.881,439.415,10.08,0.787,0
167,54,68,11092,1,238,3644,217856,49.07,6804596,80.291,41.2,17.366,14048.881,439.415,10.08,0.787,0
167,55,67,11159,0,238,2488,220344,49.07,6804596,80.291,41.2,17.366,14048.881,439.415,10.08,0.787,0
167,56,34,11193,1,239,3427,223771,49.07,6804596,80.291,41.2,17.366,14048.881,439.415,10.08,0.787,0
167,57,34,11227,0,239,5714,229485,49.07,6804596,80.291,41.2,17.366,14048.881,439.415,10.08,0.787,0
167,58,48,11275,1,240,4534,234019,49.07,6804596,80.291,41.2,17.366,14048.881,439.415,10.08,0.787,0
167,59,25,11300,1,241,5215,239234,49.07,6804596,80.291,41.2,17.366,14048.881,439.415,10.08,0.787,0
167,60,54,11354,1,242,3548,242782,49.07,6804596,80.291,41.2,17.366,14048.881,439.415,10.08,0.787,0
167,61,27,11381,0,242,2663,245445,49.07,6804596,80.291,41.2,17.366,14048.881,439.415,10.08,0.787,0
167,62,31,11412,1,243,2315,247760,43.52,6804596,80.291,41.2,17.366,14048.881,439.415,10.08,0.787,0
167,63,18,11430,1,244,4372,252132,43.52,6804596,80.291,41.2,17.366,14048.881,439.415,10.08,0.787,0
167,64,24,11454,1,245,5110,257242,43.52,6804596,80.291,41.2,17.366,14048.881,439.415,10.08,0.787,0
167,65,69,11523,0,245,4024,261266,43.52,6804596,80.291,41.2,17.366,14048.881,439.415,10.08,0.787,0
167,66,48,11571,1,246,4795,266061,43.52,6804596,80.291,41.2,17.366,14048.881,439.415,10.08,0.787,0
167,67,96,11667,1,247,3124,269185,24.07,6804596,80.291,41.2,17.366,14048.881,439.415,10.08,0.787,0
167,68,74,11741,1,248,3317,272502,24.07,6804596,80.291,41.2,17.366,14048.881,439.415,10.08,0.787,0
167,69,82,11823,1,249,4308,276810,24.07,6804596,80.291,41.2,17.366,14048.881,439.415,10.08,0.787,0
167,70,73,11896,1,250,5239,282049,24.07,6804596,80.291,41.2,17.366,14048.881,439.415,10.08,0.787,0
167,71,69,11965,0,250,5015,287064,24.07,6804596,80.291,41.2,17.366,14048.881,439.415,10.08,0.787,0
167,72,66,12031,1,251,4932,291996,24.07,6804596,80.291,41.2,17.366,14048.881,439.415,10.08,0.787,0
167,73,71,12102,1,252,5793,297789,24.07,6804596,80.291,41.2,17.366,14048.881,439.415,10.08,0.787,0
167,74,73,12175,0,252,3337,301126,24.07,6804596,80.291,41.2,17.366,14048.881,439.415,10.08,0.787,0
167,75,76,12251,1,253,1802,302928,24.07,6804596,80.291,41.2,17.366,14048.881,439.415,10.08,0.787,0
167,76,59,12310,1,254,5085,308013,24.07,6804596,80.291,41.2,17.366,14048.881,439.415,10.08,0.787,0
167,77,57,12367,1,255,5470,313483,24.07,6804596,80.291,41.2,17.366,14048.881,439.415,10.08,0.787,0
167,78,59,12426,1,256,6098,319581,24.07,6804596,80.291,41.2,17.366,14048.881,439.415,10.08,0.787,0
167,79,96,12522,1,257,6032,325613,24.07,6804596,80.291,41.2,17.366,14048.881,439.415,10.08,0.787,0
167,80,94,12616,1,258,6729,332342,24.07,6804596,80.291,41.2,17.366,14048.881,439.415,10.08,0.787,0
167,81,93,12709,1,259,4211,336553,24.07,6804596,80.291,41.2,17.366,14048.881,439.415,10.08,0.787,0
167,82,94,12803,1,260,3269,339822,24.07,6804596,80.291,41.2,17.366,14048.881,439.415,10.08,0.787,0
167,83,91,12894,1,261,5438,345260,24.07,6804596,80.291,41.2,17.366,14048.881,439.415,10.08,0.787,0
167,84,96,12990,1,262,6025,351285,24.07,6804596,80.291,41.2,17.366,14048.881,439.415,10.08,0.787,0
167,85,102,13092,1,263,7784,359069,24.07,6804596,80.291,41.2,17.366,14048.881,439.415,10.08,0.787,0
167,86,143,13235,0,263,7311,366380,24.07,6804596,80.291,41.2,17.366,14048.881,439.415,10.08,0.787,0
167,87,137,13372,1,264,8495,374875,24.07,6804596,80.291,41.2,17.366,14048.881,439.415,10.08,0.787,0
167,88,193,13565,1,265,5933,380808,24.07,6804596,80.291,41.2,17.366,14048.881,439.415,10.08,0.787,0
167,89,227,13792,2,267,4905,385713,24.07,6804596,80.291,41.2,17.366,14048.881,439.415,10.08,0.787,0
167,90,254,14046,3,270,7150,392863,25.93,6804596,80.291,41.2,17.366,14048.881,439.415,10.08,0.787,0
167,91,242,14288,4,274,8377,401240,25.93,6804596,80.291,41.2,17.366,14048.881,439.415,10.08,0.787,0
167,92,276,14564,3,277,8626,409866,38.89,6804596,80.291,41.2,17.366,14048.881,439.415,10.08,0.787,0
167,93,272,14836,4,281,9013,418879,38.89,6804596,80.291,41.2,17.366,14048.881,439.415,10.08,0.787,0
167,94,359,15195,6,287,8102,426981,38.89,6804596,80.291,41.2,17.366,14048.881,439.415,10.08,0.787,0
167,95,309,15504,11,298,7434,434415,38.89,6804596,80.291,41.2,17.366,14048.881,439.415,10.08,0.787,0
167,96,325,15829,8,306,5030,439445,38.89,6804596,80.291,41.2,17.366,14048.881,439.415,10.08,0.787,0
167,97,302,16131,5,311,7872,447317,38.89,6804596,80.291,41.2,17.366,14048.881,439.415,10.08,0.787,0
167,98,289,16420,6,317,8287,455604,38.89,6804596,80.291,41.2,17.366,14048.881,439.415,10.08,0.787,0
167,99,299,16719,13,330,8567,464171,38.89,6804596,80.291,41.2,17.366,14048.881,439.415,10.08,0.787,0
167,100,357,17076,11,341,7529,471700,38.89,6804596,80.291,41.2,17.366,14048.881,439.415,10.08,0.787,0
167,101,266,17342,11,352,8646,480346,44.44,6804596,80.291,41.2,17.366,14048.881,439.415,10.08,0.787,0
167,102,386,17728,18,370,7032,487378,44.44,6804596,80.291,41.2,17.366,14048.881,439.415,10.08,0.787,0
167,103,345,18073,12,382,4050,491428,44.44,6804596,80.291,41.2,17.366,14048.881,439.415,10.08,0.787,0
167,104,287,18360,11,393,6915,498343,44.44,6804596,80.291,41.2,17.366,14048.881,439.415,10.08,0.787,0
167,105,279,18639,12,405,8659,507002,44.44,6804596,80.291,41.2,17.366,14048.881,439.415,10.08,0.787,0
167,106,344,18983,13,418,8393,515395,44.44,6804596,80.291,41.2,17.366,14048.881,439.415,10.08,0.787,0
167,107,351,19334,11,429,9183,524578,44.44,6804596,80.291,41.2,17.366,14048.881,439.415,10.08,0.787,0
167,108,383,19717,13,442,9910,534488,55.56,6804596,80.291,41.2,17.366,14048.881,439.415,10.08,0.787,0
167,109,392,20109,10,452,7648,542136,55.56,6804596,80.291,41.2,17.366,14048.881,439.415,10.08,0.787,0
167,110,389,20498,9,461,7955,550091,55.56,6804596,80.291,41.2,17.366,14048.881,439.415,10.08,0.787,0
167,111,396,20894,11,472,8349,558440,55.56,6804596,80.291,41.2,17.366,14048.881,439.415,10.08,0.787,0
167,112,359,21253,10,482,10310,568750,55.56,6804596,80.291,41.2,17.366,14048.881,439.415,10.08,0.787,0
167,113,352,21605,9,491,11521,580271,55.56,6804596,80.291,41.2,17.366,14048.881,439.415,10.08,0.787,0
167,114,426,22031,8,499,11079,591350,55.56,6804596,80.291,41.2,17.366,14048.881,439.415,10.08,0.787,0
167,115,412,22443,9,508,10634,601984,55.56,6804596,80.291,41.2,17.366,14048.881,439.415,10.08,0.787,0
167,116,409,22852,10,518,9349,611333,55.56,6804596,80.291,41.2,17.366,14048.881,439.415,10.08,0.787,0
167,117,411,23263,8,526,10381,621714,55.56,6804596,80.291,41.2,17.366,14048.881,439.415,10.08,0.787,0
167,118,467,23730,8,534,9560,631274,55.56,6804596,80.291,41.2,17.366,14048.881,439.415,10.08,0.787,0
167,119,411,24141,9,543,9817,641091,55.56,6804596,80.291,41.2,17.366,14048.881,439.415,10.08,0.787,0
167,120,379,24520,8,551,9653,650744,55.56,6804596,80.291,41.2,17.366,14048.881,439.415,10.08,0.787,0
167,121,372,24892,7,558,8804,659548,55.56,6804596,80.291,41.2,17.366,14048.881,439.415,10.08,0.787,0
167,122,321,25213,7,565,9436,668984,55.56,6804596,80.291,41.2,17.366,14048.881,439.415,10.08,0.787,0
167,123,339,25552,8,573,9109,678093,55.56,6804596,80.291,41.2,17.366,14048.881,439.415,10.08,0.787,0
167,124,330,25882,9,582,8395,686488,55.56,6804596,80.291,41.2,17.366,14048.881,439.415,10.08,0.787,0
167,125,311,26193,8,590,7168,693656,55.56,6804596,80.291,41.2,17.366,14048.881,439.415,10.08,0.787,0
167,126,258,26451,8,598,9590,703246,55.56,6804596,80.291,41.2,17.366,14048.881,439.415,10.08,0.787,0
167,127,287,26738,7,605,9858,713104,55.56,6804596,80.291,41.2,17.366,14048.881,439.415,10.08,0.787,0
167,128,295,27033,9,614,10033,723137,55.56,6804596,80.291,41.2,17.366,14048.881,439.415,10.08,0.787,0
167,129,299,27332,7,621,9922,733059,55.56,6804596,80.291,41.2,17.366,14048.881,439.415,10.08,0.787,0
167,130,276,27608,5,626,8014,741073,55.56,6804596,80.291,41.2,17.366,14048.881,439.415,10.08,0.787,0
167,131,255,27863,6,632,6251,747324,55.56,6804596,80.291,41.2,17.366,14048.881,439.415,10.08,0.787,0
167,132,236,28099,9,641,6819,754143,55.56,6804596,80.291,41.2,17.366,14048.881,439.415,10.08,0.787,0
167,133,163,28262,5,646,8086,762229,55.56,6804596,80.291,41.2,17.366,14048.881,439.415,10.08,0.787,0
167,134,235,28497,6,652,8768,770997,55.56,6804596,80.291,41.2,17.366,14048.881,439.415,10.08,0.787,0
167,135,254,28751,6,658,9100,780097,55.56,6804596,80.291,41.2,17.366,14048.881,439.415,10.08,0.787,0
167,136,247,28998,3,661,9383,789480,55.56,6804596,80.291,41.2,17.366,14048.881,439.415,10.08,0.787,0
167,137,235,29233,4,665,8529,798009,58.33,6804596,80.291,41.2,17.366,14048.881,439.415,10.08,0.787,0
167,138,238,29471,5,670,6559,804568,58.33,6804596,80.291,41.2,17.366,14048.881,439.415,10.08,0.787,0
167,139,211,29682,4,674,7352,811920,58.33,6804596,80.291,41.2,17.366,14048.881,439.415,10.08,0.787,0
167,140,100,29782,3,677,9186,821106,58.33,6804596,80.291,41.2,17.366,14048.881,439.415,10.08,0.787,0
167,141,108,29890,4,681,10571,831677,58.33,6804596,80.291,41.2,17.366,14048.881,439.415,10.08,0.787,0
167,142,158,30048,3,684,10764,842441,58.33,6804596,80.291,41.2,17.366,14048.881,439.415,10.08,0.787,0
167,143,161,30209,5,689,11618,854059,58.33,6804596,80.291,41.2,17.366,14048.881,439.415,10.08,0.787,0
167,144,169,30378,3,692,8670,862729,58.33,6804596,80.291,41.2,17.366,14048.881,439.415,10.08,0.787,0
167,145,170,30548,3,695,6939,869668,58.33,6804596,80.291,41.2,17.366,14048.881,439.415,10.08,0.787,0
167,146,109,30657,3,698,7261,876929,58.33,6804596,80.291,41.2,17.366,14048.881,439.415,10.08,0.787,0
167,147,57,30714,3,701,8646,885575,58.33,6804596,80.291,41.2,17.366,14048.881,439.415,10.08,0.787,0
167,148,106,30820,4,705,9932,895507,58.33,6804596,80.291,41.2,17.366,14048.881,439.415,10.08,0.787,0
167,149,154,30974,2,707,8836,904343,58.33,6804596,80.291,41.2,17.366,14048.881,439.415,10.08,0.787,0
167,150,125,31099,0,707,9513,913856,58.33,6804596,80.291,41.2,17.366,14048.881,439.415,10.08,0.787,0
167,151,108,31207,2,709,6996,920852,58.33,6804596,80.291,41.2,17.366,14048.881,439.415,10.08,0.787,0
167,152,75,31282,1,710,4356,925208,58.33,6804596,80.291,41.2,17.366,14048.881,439.415,10.08,0.787,0
167,153,83,31365,1,711,5829,931037,58.33,6804596,80.291,41.2,17.366,14048.881,439.415,10.08,0.787,0
167,154,41,31406,2,713,7509,938546,50.93,6804596,80.291,41.2,17.366,14048.881,439.415,10.08,0.787,0
167,155,76,31482,2,715,8752,947298,50.93,6804596,80.291,41.2,17.366,14048.881,439.415,10.08,0.787,0
167,156,99,31581,1,716,8432,955730,50.93,6804596,80.291,41.2,17.366,14048.881,439.415,10.08,0.787,0
167,157,95,31676,2,718,10833,966563,50.93,6804596,80.291,41.2,17.366,14048.881,439.415,10.08,0.787,0
167,158,96,31772,3,721,7848,974411,50.93,6804596,80.291,41.2,17.366,14048.881,439.415,10.08,0.787,0
167,159,77,31849,2,723,4189,978600,50.93,6804596,80.291,41.2,17.366,14048.881,439.415,10.08,0.787,0
167,160,56,31905,1,724,6198,984798,50.93,6804596,80.291,41.2,17.366,14048.881,439.415,10.08,0.787,0
167,161,36,31941,1,725,8342,993140,50.93,6804596,80.291,41.2,17.366,14048.881,439.415,10.08,0.787,0
167,162,53,31994,2,727,8285,1001425,50.93,6804596,80.291,41.2,17.366,14048.881,439.415,10.08,0.787,0
167,163,84,32078,1,728,7976,1009401,50.93,6804596,80.291,41.2,17.366,14048.881,439.415,10.08,0.787,0
167,164,58,32136,1,729,9507,1018908,50.93,6804596,80.291,41.2,17.366,14048.881,439.415,10.08,0.787,0
167,165,92,32228,1,730,6068,1024976,50.93,6804596,80.291,41.2,17.366,14048.881,439.415,10.08,0.787,0
167,166,72,32300,1,731,3082,1028058,50.93,6804596,80.291,41.2,17.366,14048.881,439.415,10.08,0.787,0
167,167,108,32408,2,733,5930,1033988,50.93,6804596,80.291,41.2,17.366,14048.881,439.415,10.08,0.787,0
167,168,29,32437,0,733,7709,1041697,50.93,6804596,80.291,41.2,17.366,14048.881,439.415,10.08,0.787,0
167,169,74,32511,2,735,7682,1049379,50.93,6804596,80.291,41.2,17.366,14048.881,439.415,10.08,0.787,0
167,170,102,32613,1,736,6877,1056256,50.93,6804596,80.291,41.2,17.366,14048.881,439.415,10.08,0.787,0
167,171,82,32695,2,738,7411,1063667,50.93,6804596,80.291,41.2,17.366,14048.881,439.415,10.08,0.787,0
167,172,62,32757,1,739,5959,1069626,50.93,6804596,80.291,41.2,17.366,14048.881,439.415,10.08,0.787,0
167,173,83,32840,1,740,3175,1072801,50.93,6804596,80.291,41.2,17.366,14048.881,439.415,10.08,0.787,0
167,174,68,32908,1,741,5278,1078079,50.93,6804596,80.291,41.2,17.366,14048.881,439.415,10.08,0.787,0
167,175,30,32938,2,743,6814,1084893,50.93,6804596,80.291,41.2,17.366,14048.881,439.415,10.08,0.787,0
167,176,61,32999,0,743,7466,1092359,50.93,6804596,80.291,41.2,17.366,14048.881,439.415,10.08,0.787,0
167,177,81,33080,1,744,6663,1099022,50.93,6804596,80.291,41.2,17.366,14048.881,439.415,10.08,0.787,0
167,178,83,33163,1,745,7422,1106444,50.93,6804596,80.291,41.2,17.366,14048.881,439.415,10.08,0.787,0
167,179,75,33238,1,746,5513,1111957,50.93,6804596,80.291,41.2,17.366,14048.881,439.415,10.08,0.787,0
167,180,74,33312,0,746,3138,1115095,50.93,6804596,80.291,41.2,17.366,14048.881,439.415,10.08,0.787,0
167,181,72,33384,1,747,5268,1120363,50.93,6804596,80.291,41.2,17.366,14048.881,439.415,10.08,0.787,0
167,182,30,33414,1,748,7315,1127678,50.93,6804596,80.291,41.2,17.366,14048.881,439.415,10.08,0.787,0
167,183,65,33479,1,749,6561,1134239,50.93,6804596,80.291,41.2,17.366,14048.881,439.415,10.08,0.787,0
167,184,72,33551,0,749,6139,1140378,50.93,6804596,80.291,41.2,17.366,14048.881,439.415,10.08,0.787,0
167,185,111,33662,1,750,6661,1147039,50.93,6804596,80.291,41.2,17.366,14048.881,439.415,10.08,0.787,0
167,186,73,33735,1,751,4751,1151790,50.93,6804596,80.291,41.2,17.366,14048.881,439.415,10.08,0.787,0
167,187,107,33842,2,753,2667,1154457,50.93,6804596,80.291,41.2,17.366,14048.881,439.415,10.08,0.787,0
167,188,59,33901,1,754,5349,1159806,50.93,6804596,80.291,41.2,17.366,14048.881,439.415,10.08,0.787,0
167,189,0,33901,0,754,7076,1166882,50.93,6804596,80.291,41.2,17.366,14048.881,439.415,10.08,0.787,0
167,190,171,34072,3,757,6700,1173582,50.93,6804596,80.291,41.2,17.366,14048.881,439.415,10.08,0.787,0
167,191,121,34193,1,758,6139,1179721,50.93,6804596,80.291,41.2,17.366,14048.881,439.415,10.08,0.787,0
167,192,151,34344,2,760,6933,1186654,50.93,6804596,80.291,41.2,17.366,14048.881,439.415,10.08,0.787,0
167,193,173,34517,1,761,4976,1191630,50.93,6804596,80.291,41.2,17.366,14048.881,439.415,10.08,0.787,0
167,194,168,34685,1,762,2906,1194536,50.93,6804596,80.291,41.2,17.366,14048.881,439.415,10.08,0.787,0
167,195,102,34787,1,763,5263,1199799,50.93,6804596,80.291,41.2,17.366,14048.881,439.415,10.08,0.787,0
167,196,67,34854,2,765,7177,1206976,50.93,6804596,80.291,41.2,17.366,14048.881,439.415,10.08,0.787,0
167,197,152,35006,2,767,6428,1213404,50.93,6804596,80.291,41.2,17.366,14048.881,439.415,10.08,0.787,0
167,198,245,35251,1,768,6504,1219908,50.93,6804596,80.291,41.2,17.366,14048.881,439.415,10.08,0.787,0
167,199,203,35454,2,770,7429,1227337,50.93,6804596,80.291,41.2,17.366,14048.881,439.415,10.08,0.787,0
167,200,265,35719,2,772,5456,1232793,50.93,6804596,80.291,41.2,17.366,14048.881,439.415,10.08,0.787,0
167,201,227,35946,2,774,3325,1236118,50.93,6804596,80.291,41.2,17.366,14048.881,439.415,10.08,0.787,0
167,202,214,36160,2,776,5746,1241864,50.93,6804596,80.291,41.2,17.366,14048.881,439.415,10.08,0.787,0
167,203,122,36282,2,778,0,1241864,50.93,6804596,80.291,41.2,17.366,14048.881,439.415,10.08,0.787,0
167,204,326,36608,2,780,0,1241864,50.93,6804596,80.291,41.2,17.366,14048.881,439.415,10.08,0.787,0
168,1,0,10,0,0,0,0,52.78,98340,208.354,36.2,8.606,26382.287,242.648,10.55,0.797,0
168,2,0,10,0,0,0,0,52.78,98340,208.354,36.2,8.606,26382.287,242.648,10.55,0.797,0
168,3,0,10,0,0,0,0,52.78,98340,208.354,36.2,8.606,26382.287,242.648,10.55,0.797,0
168,4,0,10,0,0,0,0,52.78,98340,208.354,36.2,8.606,26382.287,242.648,10.55,0.797,0
168,5,0,10,0,0,0,0,52.78,98340,208.354,36.2,8.606,26382.287,242.648,10.55,0.797,0
168,6,0,10,0,0,0,0,52.78,98340,208.354,36.2,8.606,26382.287,242.648,10.55,0.797,0
168,7,0,10,0,0,0,0,52.78,98340,208.354,36.2,8.606,26382.287,242.648,10.55,0.797,0
168,8,0,10,0,0,0,0,82.41,98340,208.354,36.2,8.606,26382.287,242.648,10.55,0.797,0
168,9,0,10,0,0,0,0,93.52,98340,208.354,36.2,8.606,26382.287,242.648,10.55,0.797,0
168,10,0,10,0,0,0,0,93.52,98340,208.354,36.2,8.606,26382.287,242.648,10.55,0.797,0
168,11,0,10,0,0,0,0,93.52,98340,208.354,36.2,8.606,26382.287,242.648,10.55,0.797,0
168,12,0,10,0,0,0,0,93.52,98340,208.354,36.2,8.606,26382.287,242.648,10.55,0.797,0
168,13,0,10,0,0,0,0,93.52,98340,208.354,36.2,8.606,26382.287,242.648,10.55,0.797,0
168,14,0,10,0,0,0,0,93.52,98340,208.354,36.2,8.606,26382.287,242.648,10.55,0.797,0
168,15,1,11,0,0,0,0,93.52,98340,208.354,36.2,8.606,26382.287,242.648,10.55,0.797,0
168,16,0,11,0,0,0,0,93.52,98340,208.354,36.2,8.606,26382.287,242.648,10.55,0.797,0
168,17,0,11,0,0,0,0,93.52,98340,208.354,36.2,8.606,26382.287,242.648,10.55,0.797,0
168,18,0,11,0,0,0,0,93.52,98340,208.354,36.2,8.606,26382.287,242.648,10.55,0.797,0
168,19,0,11,0,0,0,0,93.52,98340,208.354,36.2,8.606,26382.287,242.648,10.55,0.797,0
168,20,0,11,0,0,0,0,93.52,98340,208.354,36.2,8.606,26382.287,242.648,10.55,0.797,0
168,21,0,11,0,0,0,0,93.52,98340,208.354,36.2,8.606,26382.287,242.648,10.55,0.797,0
168,22,0,11,0,0,0,0,93.52,98340,208.354,36.2,8.606,26382.287,242.648,10.55,0.797,0
168,23,0,11,0,0,0,0,93.52,98340,208.354,36.2,8.606,26382.287,242.648,10.55,0.797,0
168,24,0,11,0,0,0,0,93.52,98340,208.354,36.2,8.606,26382.287,242.648,10.55,0.797,0
168,25,0,11,0,0,0,0,93.52,98340,208.354,36.2,8.606,26382.287,242.648,10.55,0.797,0
168,26,0,11,0,0,0,0,93.52,98340,208.354,36.2,8.606,26382.287,242.648,10.55,0.797,0
168,27,0,11,0,0,0,0,93.52,98340,208.354,36.2,8.606,26382.287,242.648,10.55,0.797,0
168,28,0,11,0,0,0,0,93.52,98340,208.354,36.2,8.606,26382.287,242.648,10.55,0.797,0
168,29,0,11,0,0,0,0,93.52,98340,208.354,36.2,8.606,26382.287,242.648,10.55,0.797,0
168,30,0,11,0,0,0,0,93.52,98340,208.354,36.2,8.606,26382.287,242.648,10.55,0.797,0
168,31,0,11,0,0,0,0,93.52,98340,208.354,36.2,8.606,26382.287,242.648,10.55,0.797,0
168,32,0,11,0,0,0,0,93.52,98340,208.354,36.2,8.606,26382.287,242.648,10.55,0.797,0
168,33,0,11,0,0,0,0,93.52,98340,208.354,36.2,8.606,26382.287,242.648,10.55,0.797,0
168,34,0,11,0,0,0,0,66.67,98340,208.354,36.2,8.606,26382.287,242.648,10.55,0.797,0
168,35,0,11,0,0,0,0,66.67,98340,208.354,36.2,8.606,26382.287,242.648,10.55,0.797,0
168,36,0,11,0,0,0,0,66.67,98340,208.354,36.2,8.606,26382.287,242.648,10.55,0.797,0
168,37,0,11,0,0,0,0,66.67,98340,208.354,36.2,8.606,26382.287,242.648,10.55,0.797,0
168,38,0,11,0,0,0,0,66.67,98340,208.354,36.2,8.606,26382.287,242.648,10.55,0.797,0
168,39,0,11,0,0,0,0,66.67,98340,208.354,36.2,8.606,26382.287,242.648,10.55,0.797,0
168,40,0,11,0,0,0,0,66.67,98340,208.354,36.2,8.606,26382.287,242.648,10.55,0.797,0
168,41,0,11,0,0,0,0,66.67,98340,208.354,36.2,8.606,26382.287,242.648,10.55,0.797,0
168,42,0,11,0,0,0,0,66.67,98340,208.354,36.2,8.606,26382.287,242.648,10.55,0.797,0
168,43,0,11,0,0,0,0,66.67,98340,208.354,36.2,8.606,26382.287,242.648,10.55,0.797,0
168,44,0,11,0,0,0,0,66.67,98340,208.354,36.2,8.606,26382.287,242.648,10.55,0.797,0
168,45,0,11,0,0,0,0,66.67,98340,208.354,36.2,8.606,26382.287,242.648,10.55,0.797,0
168,46,0,11,0,0,0,0,66.67,98340,208.354,36.2,8.606,26382.287,242.648,10.55,0.797,0
168,47,0,11,0,0,0,0,66.67,98340,208.354,36.2,8.606,26382.287,242.648,10.55,0.797,0
168,48,0,11,0,0,0,0,55.56,98340,208.354,36.2,8.606,26382.287,242.648,10.55,0.797,0
168,49,0,11,0,0,0,0,55.56,98340,208.354,36.2,8.606,26382.287,242.648,10.55,0.797,0
168,50,0,11,0,0,0,0,55.56,98340,208.354,36.2,8.606,26382.287,242.648,10.55,0.797,0
168,51,0,11,0,0,0,0,55.56,98340,208.354,36.2,8.606,26382.287,242.648,10.55,0.797,0
168,52,0,11,0,0,0,0,55.56,98340,208.354,36.2,8.606,26382.287,242.648,10.55,0.797,0
168,53,0,11,0,0,0,0,55.56,98340,208.354,36.2,8.606,26382.287,242.648,10.55,0.797,0
168,54,0,11,0,0,0,0,55.56,98340,208.354,36.2,8.606,26382.287,242.648,10.55,0.797,0
168,55,0,11,0,0,0,0,55.56,98340,208.354,36.2,8.606,26382.287,242.648,10.55,0.797,0
168,56,0,11,0,0,0,0,55.56,98340,208.354,36.2,8.606,26382.287,242.648,10.55,0.797,0
168,57,0,11,0,0,0,0,55.56,98340,208.354,36.2,8.606,26382.287,242.648,10.55,0.797,0
168,58,0,11,0,0,0,0,55.56,98340,208.354,36.2,8.606,26382.287,242.648,10.55,0.797,0
168,59,0,11,0,0,0,0,55.56,98340,208.354,36.2,8.606,26382.287,242.648,10.55,0.797,0
168,60,0,11,0,0,0,0,55.56,98340,208.354,36.2,8.606,26382.287,242.648,10.55,0.797,0
168,61,0,11,0,0,0,0,55.56,98340,208.354,36.2,8.606,26382.287,242.648,10.55,0.797,0
168,62,0,11,0,0,0,0,19.44,98340,208.354,36.2,8.606,26382.287,242.648,10.55,0.797,0
168,63,0,11,0,0,0,0,19.44,98340,208.354,36.2,8.606,26382.287,242.648,10.55,0.797,0
168,64,0,11,0,0,0,0,19.44,98340,208.354,36.2,8.606,26382.287,242.648,10.55,0.797,0
168,65,0,11,0,0,0,0,19.44,98340,208.354,36.2,8.606,26382.287,242.648,10.55,0.797,0
168,66,0,11,0,0,0,0,19.44,98340,208.354,36.2,8.606,26382.287,242.648,10.55,0.797,0
168,67,0,11,0,0,0,0,19.44,98340,208.354,36.2,8.606,26382.287,242.648,10.55,0.797,0
168,68,0,11,0,0,0,0,19.44,98340,208.354,36.2,8.606,26382.287,242.648,10.55,0.797,0
168,69,0,11,0,0,0,0,19.44,98340,208.354,36.2,8.606,26382.287,242.648,10.55,0.797,0
168,70,0,11,0,0,0,0,19.44,98340,208.354,36.2,8.606,26382.287,242.648,10.55,0.797,0
168,71,0,11,0,0,0,0,19.44,98340,208.354,36.2,8.606,26382.287,242.648,10.55,0.797,0
168,72,0,11,0,0,0,0,19.44,98340,208.354,36.2,8.606,26382.287,242.648,10.55,0.797,0
168,73,0,11,0,0,0,0,19.44,98340,208.354,36.2,8.606,26382.287,242.648,10.55,0.797,0
168,74,0,11,0,0,0,0,19.44,98340,208.354,36.2,8.606,26382.287,242.648,10.55,0.797,0
168,75,0,11,0,0,0,0,19.44,98340,208.354,36.2,8.606,26382.287,242.648,10.55,0.797,0
168,76,0,11,0,0,0,0,19.44,98340,208.354,36.2,8.606,26382.287,242.648,10.55,0.797,0
168,77,0,11,0,0,0,0,19.44,98340,208.354,36.2,8.606,26382.287,242.648,10.55,0.797,0
168,78,0,11,0,0,0,0,19.44,98340,208.354,36.2,8.606,26382.287,242.648,10.55,0.797,0
168,79,0,11,0,0,0,0,19.44,98340,208.354,36.2,8.606,26382.287,242.648,10.55,0.797,0
168,80,0,11,0,0,0,0,19.44,98340,208.354,36.2,8.606,26382.287,242.648,10.55,0.797,0
168,81,0,11,0,0,0,0,19.44,98340,208.354,36.2,8.606,26382.287,242.648,10.55,0.797,0
168,82,0,11,0,0,0,0,19.44,98340,208.354,36.2,8.606,26382.287,242.648,10.55,0.797,0
168,83,0,11,0,0,0,0,19.44,98340,208.354,36.2,8.606,26382.287,242.648,10.55,0.797,0
168,84,0,11,0,0,0,0,19.44,98340,208.354,36.2,8.606,26382.287,242.648,10.55,0.797,0
168,85,0,11,0,0,0,0,19.44,98340,208.354,36.2,8.606,26382.287,242.648,10.55,0.797,0
168,86,0,11,0,0,0,0,19.44,98340,208.354,36.2,8.606,26382.287,242.648,10.55,0.797,0
168,87,0,11,0,0,0,0,19.44,98340,208.354,36.2,8.606,26382.287,242.648,10.55,0.797,0
168,88,0,11,0,0,0,0,19.44,98340,208.354,36.2,8.606,26382.287,242.648,10.55,0.797,0
168,89,0,11,0,0,0,0,19.44,98340,208.354,36.2,8.606,26382.287,242.648,10.55,0.797,0
168,90,0,11,0,0,0,0,19.44,98340,208.354,36.2,8.606,26382.287,242.648,10.55,0.797,0
168,91,0,11,0,0,0,0,19.44,98340,208.354,36.2,8.606,26382.287,242.648,10.55,0.797,0
168,92,0,11,0,0,0,0,19.44,98340,208.354,36.2,8.606,26382.287,242.648,10.55,0.797,0
168,93,0,11,0,0,0,0,19.44,98340,208.354,36.2,8.606,26382.287,242.648,10.55,0.797,0
168,94,0,11,0,0,0,0,19.44,98340,208.354,36.2,8.606,26382.287,242.648,10.55,0.797,0
168,95,0,11,0,0,0,0,19.44,98340,208.354,36.2,8.606,26382.287,242.648,10.55,0.797,0
168,96,0,11,0,0,0,0,19.44,98340,208.354,36.2,8.606,26382.287,242.648,10.55,0.797,0
168,97,0,11,0,0,0,0,19.44,98340,208.354,36.2,8.606,26382.287,242.648,10.55,0.797,0
168,98,70,81,0,0,0,0,19.44,98340,208.354,36.2,8.606,26382.287,242.648,10.55,0.797,0
168,99,0,81,0,0,0,0,19.44,98340,208.354,36.2,8.606,26382.287,242.648,10.55,0.797,0
168,100,10,91,0,0,0,0,19.44,98340,208.354,36.2,8.606,26382.287,242.648,10.55,0.797,0
168,101,3,94,0,0,0,0,19.44,98340,208.354,36.2,8.606,26382.287,242.648,10.55,0.797,0
168,102,6,100,0,0,0,0,19.44,98340,208.354,36.2,8.606,26382.287,242.648,10.55,0.797,0
168,103,0,100,0,0,0,0,19.44,98340,208.354,36.2,8.606,26382.287,242.648,10.55,0.797,0
168,104,0,100,0,0,0,0,19.44,98340,208.354,36.2,8.606,26382.287,242.648,10.55,0.797,0
168,105,0,100,0,0,0,0,19.44,98340,208.354,36.2,8.606,26382.287,242.648,10.55,0.797,0
168,106,0,100,0,0,0,0,19.44,98340,208.354,36.2,8.606,26382.287,242.648,10.55,0.797,0
168,107,0,100,0,0,0,0,19.44,98340,208.354,36.2,8.606,26382.287,242.648,10.55,0.797,0
168,108,0,100,0,0,0,0,19.44,98340,208.354,36.2,8.606,26382.287,242.648,10.55,0.797,0
168,109,0,100,0,0,0,0,19.44,98340,208.354,36.2,8.606,26382.287,242.648,10.55,0.797,0
168,110,0,100,0,0,0,0,19.44,98340,208.354,36.2,8.606,26382.287,242.648,10.55,0.797,0
168,111,0,100,0,0,0,0,19.44,98340,208.354,36.2,8.606,26382.287,242.648,10.55,0.797,0
168,112,8,108,0,0,0,0,19.44,98340,208.354,36.2,8.606,26382.287,242.648,10.55,0.797,0
168,113,6,114,0,0,0,0,19.44,98340,208.354,36.2,8.606,26382.287,242.648,10.55,0.797,0
168,114,0,114,0,0,0,0,19.44,98340,208.354,36.2,8.606,26382.287,242.648,10.55,0.797,0
168,115,0,114,0,0,0,0,19.44,98340,208.354,36.2,8.606,26382.287,242.648,10.55,0.797,0
168,116,0,114,0,0,0,0,19.44,98340,208.354,36.2,8.606,26382.287,242.648,10.55,0.797,0
168,117,0,114,0,0,0,0,19.44,98340,208.354,36.2,8.606,26382.287,242.648,10.55,0.797,0
168,118,0,114,0,0,0,0,19.44,98340,208.354,36.2,8.606,26382.287,242.648,10.55,0.797,0
168,119,0,114,0,0,0,0,19.44,98340,208.354,36.2,8.606,26382.287,242.648,10.55,0.797,0
168,120,0,114,0,0,0,0,19.44,98340,208.354,36.2,8.606,26382.287,242.648,10.55,0.797,0
168,121,0,114,0,0,0,0,19.44,98340,208.354,36.2,8.606,26382.287,242.648,10.55,0.797,0
168,122,0,114,0,0,0,0,19.44,98340,208.354,36.2,8.606,26382.287,242.648,10.55,0.797,0
168,123,0,114,0,0,0,0,19.44,98340,208.354,36.2,8.606,26382.287,242.648,10.55,0.797,0
168,124,0,114,0,0,0,0,19.44,98340,208.354,36.2,8.606,26382.287,242.648,10.55,0.797,0
168,125,0,114,0,0,0,0,19.44,98340,208.354,36.2,8.606,26382.287,242.648,10.55,0.797,0
168,126,0,114,0,0,0,0,19.44,98340,208.354,36.2,8.606,26382.287,242.648,10.55,0.797,0
168,127,12,126,0,0,0,0,19.44,98340,208.354,36.2,8.606,26382.287,242.648,10.55,0.797,0
168,128,0,126,0,0,0,0,19.44,98340,208.354,36.2,8.606,26382.287,242.648,10.55,0.797,0
168,129,0,126,0,0,0,0,19.44,98340,208.354,36.2,8.606,26382.287,242.648,10.55,0.797,0
168,130,0,126,0,0,0,0,19.44,98340,208.354,36.2,8.606,26382.287,242.648,10.55,0.797,0
168,131,0,126,0,0,0,0,19.44,98340,208.354,36.2,8.606,26382.287,242.648,10.55,0.797,0
168,132,0,126,0,0,0,0,30.56,98340,208.354,36.2,8.606,26382.287,242.648,10.55,0.797,0
168,133,0,126,0,0,0,0,30.56,98340,208.354,36.2,8.606,26382.287,242.648,10.55,0.797,0
168,134,1,127,0,0,0,0,30.56,98340,208.354,36.2,8.606,26382.287,242.648,10.55,0.797,0
168,135,0,127,0,0,0,0,30.56,98340,208.354,36.2,8.606,26382.287,242.648,10.55,0.797,0
168,136,0,127,0,0,0,0,30.56,98340,208.354,36.2,8.606,26382.287,242.648,10.55,0.797,0
168,137,0,127,0,0,0,0,30.56,98340,208.354,36.2,8.606,26382.287,242.648,10.55,0.797,0
168,138,0,127,0,0,0,0,30.56,98340,208.354,36.2,8.606,26382.287,242.648,10.55,0.797,0
168,139,0,127,0,0,0,0,30.56,98340,208.354,36.2,8.606,26382.287,242.648,10.55,0.797,0
168,140,0,127,0,0,0,0,30.56,98340,208.354,36.2,8.606,26382.287,242.648,10.55,0.797,0
168,141,0,127,0,0,0,0,30.56,98340,208.354,36.2,8.606,26382.287,242.648,10.55,0.797,0
168,142,5,132,0,0,0,0,30.56,98340,208.354,36.2,8.606,26382.287,242.648,10.55,0.797,0
168,143,0,132,0,0,0,0,30.56,98340,208.354,36.2,8.606,26382.287,242.648,10.55,0.797,0
168,144,0,132,0,0,0,0,30.56,98340,208.354,36.2,8.606,26382.287,242.648,10.55,0.797,0
168,145,0,132,0,0,0,0,30.56,98340,208.354,36.2,8.606,26382.287,242.648,10.55,0.797,0
168,146,0,132,0,0,0,0,30.56,98340,208.354,36.2,8.606,26382.287,242.648,10.55,0.797,0
168,147,0,132,0,0,0,0,30.56,98340,208.354,36.2,8.606,26382.287,242.648,10.55,0.797,0
168,148,4,136,0,0,0,0,30.56,98340,208.354,36.2,8.606,26382.287,242.648,10.55,0.797,0
168,149,0,136,0,0,0,0,30.56,98340,208.354,36.2,8.606,26382.287,242.648,10.55,0.797,0
168,150,0,136,0,0,0,0,30.56,98340,208.354,36.2,8.606,26382.287,242.648,10.55,0.797,0
168,151,0,136,0,0,0,0,30.56,98340,208.354,36.2,8.606,26382.287,242.648,10.55,0.797,0
168,152,0,136,0,0,0,0,30.56,98340,208.354,36.2,8.606,26382.287,242.648,10.55,0.797,0
168,153,0,136,0,0,0,0,30.56,98340,208.354,36.2,8.606,26382.287,242.648,10.55,0.797,0
168,154,0,136,0,0,0,0,30.56,98340,208.354,36.2,8.606,26382.287,242.648,10.55,0.797,0
168,155,0,136,0,0,0,0,30.56,98340,208.354,36.2,8.606,26382.287,242.648,10.55,0.797,0
168,156,0,136,0,0,0,0,30.56,98340,208.354,36.2,8.606,26382.287,242.648,10.55,0.797,0
168,157,0,136,0,0,0,0,30.56,98340,208.354,36.2,8.606,26382.287,242.648,10.55,0.797,0
168,158,0,136,0,0,0,0,30.56,98340,208.354,36.2,8.606,26382.287,242.648,10.55,0.797,0
168,159,0,136,0,0,0,0,30.56,98340,208.354,36.2,8.606,26382.287,242.648,10.55,0.797,0
168,160,1,137,0,0,0,0,30.56,98340,208.354,36.2,8.606,26382.287,242.648,10.55,0.797,0
168,161,0,137,0,0,0,0,30.56,98340,208.354,36.2,8.606,26382.287,242.648,10.55,0.797,0
168,162,0,137,0,0,0,0,30.56,98340,208.354,36.2,8.606,26382.287,242.648,10.55,0.797,0
168,163,0,137,0,0,0,0,30.56,98340,208.354,36.2,8.606,26382.287,242.648,10.55,0.797,0
168,164,0,137,0,0,0,0,30.56,98340,208.354,36.2,8.606,26382.287,242.648,10.55,0.797,0
168,165,0,137,0,0,0,0,30.56,98340,208.354,36.2,8.606,26382.287,242.648,10.55,0.797,0
168,166,2,139,0,0,0,0,30.56,98340,208.354,36.2,8.606,26382.287,242.648,10.55,0.797,0
168,167,0,139,0,0,0,0,30.56,98340,208.354,36.2,8.606,26382.287,242.648,10.55,0.797,0
168,168,1,140,0,0,0,0,30.56,98340,208.354,36.2,8.606,26382.287,242.648,10.55,0.797,0
168,169,0,140,0,0,0,0,30.56,98340,208.354,36.2,8.606,26382.287,242.648,10.55,0.797,0
168,170,0,140,0,0,0,0,30.56,98340,208.354,36.2,8.606,26382.287,242.648,10.55,0.797,0
168,171,1,141,0,0,0,0,30.56,98340,208.354,36.2,8.606,26382.287,242.648,10.55,0.797,0
168,172,0,141,0,0,0,0,30.56,98340,208.354,36.2,8.606,26382.287,242.648,10.55,0.797,0
168,173,0,141,0,0,0,0,30.56,98340,208.354,36.2,8.606,26382.287,242.648,10.55,0.797,0
168,174,0,141,0,0,0,0,30.56,98340,208.354,36.2,8.606,26382.287,242.648,10.55,0.797,0
168,175,2,143,0,0,0,0,36.11,98340,208.354,36.2,8.606,26382.287,242.648,10.55,0.797,0
168,176,0,143,0,0,0,0,36.11,98340,208.354,36.2,8.606,26382.287,242.648,10.55,0.797,0
168,177,0,143,0,0,0,0,36.11,98340,208.354,36.2,8.606,26382.287,242.648,10.55,0.797,0
168,178,0,143,0,0,0,0,36.11,98340,208.354,36.2,8.606,26382.287,242.648,10.55,0.797,0
168,179,0,143,0,0,0,0,36.11,98340,208.354,36.2,8.606,26382.287,242.648,10.55,0.797,0
168,180,0,143,0,0,0,0,36.11,98340,208.354,36.2,8.606,26382.287,242.648,10.55,0.797,0
168,181,0,143,0,0,0,0,36.11,98340,208.354,36.2,8.606,26382.287,242.648,10.55,0.797,0
168,182,0,143,0,0,0,0,36.11,98340,208.354,36.2,8.606,26382.287,242.648,10.55,0.797,0
168,183,0,143,0,0,0,0,36.11,98340,208.354,36.2,8.606,26382.287,242.648,10.55,0.797,0
168,184,1,144,0,0,0,0,36.11,98340,208.354,36.2,8.606,26382.287,242.648,10.55,0.797,0
168,185,0,144,0,0,0,0,36.11,98340,208.354,36.2,8.606,26382.287,242.648,10.55,0.797,0
168,186,0,144,0,0,0,0,36.11,98340,208.354,36.2,8.606,26382.287,242.648,10.55,0.797,0
168,187,1,145,0,0,0,0,36.11,98340,208.354,36.2,8.606,26382.287,242.648,10.55,0.797,0
168,188,0,145,0,0,0,0,36.11,98340,208.354,36.2,8.606,26382.287,242.648,10.55,0.797,0
168,189,3,148,0,0,0,0,36.11,98340,208.354,36.2,8.606,26382.287,242.648,10.55,0.797,0
168,190,0,148,0,0,0,0,36.11,98340,208.354,36.2,8.606,26382.287,242.648,10.55,0.797,0
168,191,0,148,0,0,0,0,36.11,98340,208.354,36.2,8.606,26382.287,242.648,10.55,0.797,0
168,192,0,148,0,0,0,0,36.11,98340,208.354,36.2,8.606,26382.287,242.648,10.55,0.797,0
168,193,0,148,0,0,0,0,36.11,98340,208.354,36.2,8.606,26382.287,242.648,10.55,0.797,0
168,194,0,148,0,0,0,0,36.11,98340,208.354,36.2,8.606,26382.287,242.648,10.55,0.797,0
168,195,0,148,0,0,0,0,36.11,98340,208.354,36.2,8.606,26382.287,242.648,10.55,0.797,0
168,196,0,148,0,0,0,0,36.11,98340,208.354,36.2,8.606,26382.287,242.648,10.55,0.797,0
168,197,0,148,0,0,0,0,36.11,98340,208.354,36.2,8.606,26382.287,242.648,10.55,0.797,0
168,198,0,148,0,0,0,0,36.11,98340,208.354,36.2,8.606,26382.287,242.648,10.55,0.797,0
168,199,1,149,0,0,0,0,36.11,98340,208.354,36.2,8.606,26382.287,242.648,10.55,0.797,0
168,200,0,149,0,0,0,0,36.11,98340,208.354,36.2,8.606,26382.287,242.648,10.55,0.797,0
168,201,0,149,0,0,0,0,36.11,98340,208.354,36.2,8.606,26382.287,242.648,10.55,0.797,0
168,202,0,149,0,0,0,0,36.11,98340,208.354,36.2,8.606,26382.287,242.648,10.55,0.797,0
168,203,0,149,0,0,0,0,36.11,98340,208.354,36.2,8.606,26382.287,242.648,10.55,0.797,0
168,204,0,149,0,0,0,0,36.11,98340,208.354,36.2,8.606,26382.287,242.648,10.55,0.797,0
170,1,35,879,0,3,0,0,38.89,5850343,7915.731,42.4,12.922,85535.383,92.243,10.99,0.932,0
170,2,121,1000,1,4,0,0,38.89,5850343,7915.731,42.4,12.922,85535.383,92.243,10.99,0.932,0
170,3,49,1049,1,5,0,0,48.15,5850343,7915.731,42.4,12.922,85535.383,92.243,10.99,0.932,0
170,4,65,1114,0,5,0,0,48.15,5850343,7915.731,42.4,12.922,85535.383,92.243,10.99,0.932,0
170,5,75,1189,1,6,0,0,48.15,5850343,7915.731,42.4,12.922,85535.383,92.243,10.99,0.932,0
170,6,120,1309,0,6,0,0,48.15,5850343,7915.731,42.4,12.922,85535.383,92.243,10.99,0.932,0
170,7,66,1375,0,6,0,72680,59.26,5850343,7915.731,42.4,12.922,85535.383,92.243,10.99,0.932,0
170,8,106,1481,0,6,0,72680,82.41,5850343,7915.731,42.4,12.922,85535.383,92.243,10.99,0.932,0
170,9,142,1623,0,6,0,72680,82.41,5850343,7915.731,42.4,12.922,85535.383,92.243,10.99,0.932,0
170,10,286,1909,0,6,0,72680,79.63,5850343,7915.731,42.4,12.922,85535.383,92.243,10.99,0.932,0
170,11,0,1909,0,6,0,72680,79.63,5850343,7915.731,42.4,12.922,85535.383,92.243,10.99,0.932,0
170,12,390,2299,2,8,0,72680,79.63,5850343,7915.731,42.4,12.922,85535.383,92.243,10.99,0.932,0
170,13,233,2532,0,8,0,72680,79.63,5850343,7915.731,42.4,12.922,85535.383,92.243,10.99,0.932,0
170,14,386,2918,1,9,0,94796,85.19,5850343,7915.731,42.4,12.922,85535.383,92.243,10.99,0.932,0
170,15,334,3252,1,10,0,94796,85.19,5850343,7915.731,42.4,12.922,85535.383,92.243,10.99,0.932,0
170,16,447,3699,0,10,0,94796,85.19,5850343,7915.731,42.4,12.922,85535.383,92.243,10.99,0.932,0
170,17,728,4427,0,10,0,94796,85.19,5850343,7915.731,42.4,12.922,85535.383,92.243,10.99,0.932,0
170,18,623,5050,1,11,0,94796,85.19,5850343,7915.731,42.4,12.922,85535.383,92.243,10.99,0.932,0
170,19,942,5992,0,11,0,94796,85.19,5850343,7915.731,42.4,12.922,85535.383,92.243,10.99,0.932,0
170,20,596,6588,0,11,0,121774,85.19,5850343,7915.731,42.4,12.922,85535.383,92.243,10.99,0.932,0
170,21,1426,8014,0,11,0,121774,85.19,5850343,7915.731,42.4,12.922,85535.383,92.243,10.99,0.932,0
170,22,1111,9125,0,11,0,121774,85.19,5850343,7915.731,42.4,12.922,85535.383,92.243,10.99,0.932,0
170,23,1016,10141,1,12,0,121774,85.19,5850343,7915.731,42.4,12.922,85535.383,92.243,10.99,0.932,0
170,24,1037,11178,0,12,0,121774,85.19,5850343,7915.731,42.4,12.922,85535.383,92.243,10.99,0.932,0
170,25,897,12075,0,12,0,121774,85.19,5850343,7915.731,42.4,12.922,85535.383,92.243,10.99,0.932,0
170,26,618,12693,0,12,0,121774,85.19,5850343,7915.731,42.4,12.922,85535.383,92.243,10.99,0.932,0
170,27,931,13624,0,12,0,143919,85.19,5850343,7915.731,42.4,12.922,85535.383,92.243,10.99,0.932,0
170,28,799,14423,2,14,0,143919,85.19,5850343,7915.731,42.4,12.922,85535.383,92.243,10.99,0.932,0
170,29,528,14951,0,14,0,143919,85.19,5850343,7915.731,42.4,12.922,85535.383,92.243,10.99,0.932,0
170,30,690,15641,0,14,0,143919,85.19,5850343,7915.731,42.4,12.922,85535.383,92.243,10.99,0.932,0
170,31,528,16169,1,15,0,143919,85.19,5850343,7915.731,42.4,12.922,85535.383,92.243,10.99,0.932,0
170,32,932,17101,1,16,0,143919,85.19,5850343,7915.731,42.4,12.922,85535.383,92.243,10.99,0.932,0
170,33,447,17548,1,17,0,143919,85.19,5850343,7915.731,42.4,12.922,85535.383,92.243,10.99,0.932,0
170,34,657,18205,1,18,0,175604,85.19,5850343,7915.731,42.4,12.922,85535.383,92.243,10.99,0.932,0
170,35,573,18778,0,18,0,175604,85.19,5850343,7915.731,42.4,12.922,85535.383,92.243,10.99,0.932,0
170,36,632,19410,0,18,0,175604,85.19,5850343,7915.731,42.4,12.922,85535.383,92.243,10.99,0.932,0
170,37,788,20198,2,20,0,175604,85.19,5850343,7915.731,42.4,12.922,85535.383,92.243,10.99,0.932,0
170,38,741,20939,0,20,0,175604,85.19,5850343,7915.731,42.4,12.922,85535.383,92.243,10.99,0.932,0
170,39,768,21707,0,20,0,175604,85.19,5850343,7915.731,42.4,12.922,85535.383,92.243,10.99,0.932,0
170,40,753,22460,0,20,0,246254,85.19,5850343,7915.731,42.4,12.922,85535.383,92.243,10.99,0.932,0
170,41,876,23336,0,20,0,246254,85.19,5850343,7915.731,42.4,12.922,85535.383,92.243,10.99,0.932,0
170,42,451,23787,1,21,0,246254,81.48,5850343,7915.731,42.4,12.922,85535.383,92.243,10.99,0.932,0
170,43,884,24671,0,21,0,246254,81.48,5850343,7915.731,42.4,12.922,85535.383,92.243,10.99,0.932,0
170,44,675,25346,0,21,0,246254,81.48,5850343,7915.731,42.4,12.922,85535.383,92.243,10.99,0.932,0
170,45,752,26098,0,21,0,246254,81.48,5850343,7915.731,42.4,12.922,85535.383,92.243,10.99,0.932,0
170,46,793,26891,0,21,0,246254,81.48,5850343,7915.731,42.4,12.922,85535.383,92.243,10.99,0.932,0
170,47,465,27356,1,22,0,246254,81.48,5850343,7915.731,42.4,12.922,85535.383,92.243,10.99,0.932,0
170,48,682,28038,0,22,0,294414,81.48,5850343,7915.731,42.4,12.922,85535.383,92.243,10.99,0.932,0
170,49,305,28343,0,22,0,294414,81.48,5850343,7915.731,42.4,12.922,85535.383,92.243,10.99,0.932,0
170,50,451,28794,0,22,0,294414,81.48,5850343,7915.731,42.4,12.922,85535.383,92.243,10.99,0.932,0
170,51,570,29364,0,22,0,294414,81.48,5850343,7915.731,42.4,12.922,85535.383,92.243,10.99,0.932,0
170,52,448,29812,1,23,0,294414,81.48,5850343,7915.731,42.4,12.922,85535.383,92.243,10.99,0.932,0
170,53,614,30426,0,23,0,294414,81.48,5850343,7915.731,42.4,12.922,85535.383,92.243,10.99,0.932,0
170,54,642,31068,0,23,0,294414,81.48,5850343,7915.731,42.4,12.922,85535.383,92.243,10.99,0.932,0
170,55,548,31616,0,23,0,334691,81.48,5850343,7915.731,42.4,12.922,85535.383,92.243,10.99,0.932,0
170,56,344,31960,0,23,0,334691,81.48,5850343,7915.731,42.4,12.922,85535.383,92.243,10.99,0.932,0
170,57,383,32343,0,23,0,334691,81.48,5850343,7915.731,42.4,12.922,85535.383,92.243,10.99,0.932,0
170,58,533,32876,0,23,0,334691,81.48,5850343,7915.731,42.4,12.922,85535.383,92.243,10.99,0.932,0
170,59,373,33249,0,23,0,334691,81.48,5850343,7915.731,42.4,12.922,85535.383,92.243,10.99,0.932,0
170,60,611,33860,0,23,0,334691,81.48,5850343,7915.731,42.4,12.922,85535.383,92.243,10.99,0.932,0
170,61,506,34366,0,23,0,334691,81.48,5850343,7915.731,42.4,12.922,85535.383,92.243,10.99,0.932,0
170,62,518,34884,0,23,0,408495,81.48,5850343,7915.731,42.4,12.922,85535.383,92.243,10.99,0.932,0
170,63,408,35292,1,24,0,408495,77.78,5850343,7915.731,42.4,12.922,85535.383,92.243,10.99,0.932,0
170,64,544,35836,0,24,0,408495,77.78,5850343,7915.731,42.4,12.922,85535.383,92.243,10.99,0.932,0
170,65,569,36405,0,24,0,408495,77.78,5850343,7915.731,42.4,12.922,85535.383,92.243,10.99,0.932,0
170,66,517,36922,0,24,0,408495,77.78,5850343,7915.731,42.4,12.922,85535.383,92.243,10.99,0.932,0
170,67,261,37183,0,24,0,408495,77.78,5850343,7915.731,42.4,12.922,85535.383,92.243,10.99,0.932,0
170,68,344,37527,1,25,0,408495,77.78,5850343,7915.731,42.4,12.922,85535.383,92.243,10.99,0.932,0
170,69,383,37910,0,25,0,488695,77.78,5850343,7915.731,42.4,12.922,85535.383,92.243,10.99,0.932,0
170,70,386,38296,0,25,0,488695,77.78,5850343,7915.731,42.4,12.922,85535.383,92.243,10.99,0.932,0
170,71,218,38514,0,25,0,488695,77.78,5850343,7915.731,42.4,12.922,85535.383,92.243,10.99,0.932,0
170,72,451,38965,0,25,0,488695,77.78,5850343,7915.731,42.4,12.922,85535.383,92.243,10.99,0.932,0
170,73,422,39387,0,25,0,488695,77.78,5850343,7915.731,42.4,12.922,85535.383,92.243,10.99,0.932,0
170,74,463,39850,0,25,0,488695,77.78,5850343,7915.731,42.4,12.922,85535.383,92.243,10.99,0.932,0
170,75,347,40197,1,26,0,488695,77.78,5850343,7915.731,42.4,12.922,85535.383,92.243,10.99,0.932,0
170,76,407,40604,0,26,0,576189,77.78,5850343,7915.731,42.4,12.922,85535.383,92.243,10.99,0.932,0
170,77,214,40818,0,26,0,576189,77.78,5850343,7915.731,42.4,12.922,85535.383,92.243,10.99,0.932,0
170,78,151,40969,0,26,0,576189,77.78,5850343,7915.731,42.4,12.922,85535.383,92.243,10.99,0.932,0
170,79,247,41216,0,26,0,576189,77.78,5850343,7915.731,42.4,12.922,85535.383,92.243,10.99,0.932,0
170,80,257,41473,0,26,0,576189,53.7,5850343,7915.731,42.4,12.922,85535.383,92.243,10.99,0.932,0
170,81,142,41615,0,26,0,576189,53.7,5850343,7915.731,42.4,12.922,85535.383,92.243,10.99,0.932,0
170,82,218,41833,0,26,0,576189,53.7,5850343,7915.731,42.4,12.922,85535.383,92.243,10.99,0.932,0
170,83,262,42095,0,26,0,684359,53.7,5850343,7915.731,42.4,12.922,85535.383,92.243,10.99,0.932,0
170,84,218,42313,0,26,0,684359,53.7,5850343,7915.731,42.4,12.922,85535.383,92.243,10.99,0.932,0
170,85,119,42432,0,26,0,684359,53.7,5850343,7915.731,42.4,12.922,85535.383,92.243,10.99,0.932,0
170,86,191,42623,0,26,0,684359,53.7,5850343,7915.731,42.4,12.922,85535.383,92.243,10.99,0.932,0
170,87,113,42736,0,26,0,684359,53.7,5850343,7915.731,42.4,12.922,85535.383,92.243,10.99,0.932,0
170,88,219,42955,0,26,0,684359,53.7,5850343,7915.731,42.4,12.922,85535.383,92.243,10.99,0.932,0
170,89,291,43246,0,26,0,684359,53.7,5850343,7915.731,42.4,12.922,85535.383,92.243,10.99,0.932,0
170,90,213,43459,0,26,0,757746,53.7,5850343,7915.731,42.4,12.922,85535.383,92.243,10.99,0.932,0
170,91,202,43661,0,26,0,757746,53.7,5850343,7915.731,42.4,12.922,85535.383,92.243,10.99,0.932,0
170,92,246,43907,0,26,0,757746,53.7,5850343,7915.731,42.4,12.922,85535.383,92.243,10.99,0.932,0
170,93,215,44122,0,26,0,757746,53.7,5850343,7915.731,42.4,12.922,85535.383,92.243,10.99,0.932,0
170,94,188,44310,0,26,0,757746,53.7,5850343,7915.731,42.4,12.922,85535.383,92.243,10.99,0.932,0
170,95,169,44479,0,26,0,757746,53.7,5850343,7915.731,42.4,12.922,85535.383,92.243,10.99,0.932,0
170,96,185,44664,0,26,0,757746,53.7,5850343,7915.731,42.4,12.922,85535.383,92.243,10.99,0.932,0
170,97,0,44664,0,26,0,866414,53.7,5850343,7915.731,42.4,12.922,85535.383,92.243,10.99,0.932,0
170,98,319,44983,0,26,0,866414,53.7,5850343,7915.731,42.4,12.922,85535.383,92.243,10.99,0.932,0
170,99,157,45140,0,26,0,866414,53.7,5850343,7915.731,42.4,12.922,85535.383,92.243,10.99,0.932,0
170,100,158,45298,0,26,0,866414,53.7,5850343,7915.731,42.4,12.922,85535.383,92.243,10.99,0.932,0
170,101,124,45422,0,26,0,866414,53.7,5850343,7915.731,42.4,12.922,85535.383,92.243,10.99,0.932,0
170,102,191,45613,0,26,0,866414,53.7,5850343,7915.731,42.4,12.922,85535.383,92.243,10.99,0.932,0
170,103,170,45783,0,26,0,866414,53.7,5850343,7915.731,42.4,12.922,85535.383,92.243,10.99,0.932,0
170,104,178,45961,0,26,0,1009532,53.7,5850343,7915.731,42.4,12.922,85535.383,92.243,10.99,0.932,0
170,105,322,46283,0,26,0,1009532,53.7,5850343,7915.731,42.4,12.922,85535.383,92.243,10.99,0.932,0
170,106,346,46629,1,27,0,1009532,53.7,5850343,7915.731,42.4,12.922,85535.383,92.243,10.99,0.932,0
170,107,249,46878,0,27,0,1009532,53.7,5850343,7915.731,42.4,12.922,85535.383,92.243,10.99,0.932,0
170,108,248,47126,0,27,0,1009532,53.7,5850343,7915.731,42.4,12.922,85535.383,92.243,10.99,0.932,0
170,109,327,47453,0,27,0,1009532,53.7,5850343,7915.731,42.4,12.922,85535.383,92.243,10.99,0.932,0
170,110,202,47655,0,27,0,1009532,53.7,5850343,7915.731,42.4,12.922,85535.383,92.243,10.99,0.932,0
170,111,257,47912,0,27,0,1170049,53.7,5850343,7915.731,42.4,12.922,85535.383,92.243,10.99,0.932,0
170,112,123,48035,0,27,0,1170049,53.7,5850343,7915.731,42.4,12.922,85535.383,92.243,10.99,0.932,0
170,113,399,48434,0,27,0,1170049,53.7,5850343,7915.731,42.4,12.922,85535.383,92.243,10.99,0.932,0
170,114,310,48744,0,27,0,1170049,51.85,5850343,7915.731,42.4,12.922,85535.383,92.243,10.99,0.932,0
170,115,354,49098,0,27,0,1170049,51.85,5850343,7915.731,42.4,12.922,85535.383,92.243,10.99,0.932,0
170,116,277,49375,0,27,0,1170049,51.85,5850343,7915.731,42.4,12.922,85535.383,92.243,10.99,0.932,0
170,117,513,49888,0,27,0,1170049,51.85,5850343,7915.731,42.4,12.922,85535.383,92.243,10.99,0.932,0
170,118,481,50369,0,27,0,1321094,51.85,5850343,7915.731,42.4,12.922,85535.383,92.243,10.99,0.932,0
170,119,469,50838,0,27,0,1321094,51.85,5850343,7915.731,42.4,12.922,85535.383,92.243,10.99,0.932,0
170,120,359,51197,0,27,0,1321094,51.85,5850343,7915.731,42.4,12.922,85535.383,92.243,10.99,0.932,0
170,121,334,51531,0,27,0,1321094,51.85,5850343,7915.731,42.4,12.922,85535.383,92.243,10.99,0.932,0
170,122,278,51809,0,27,0,1321094,51.85,5850343,7915.731,42.4,12.922,85535.383,92.243,10.99,0.932,0
170,123,396,52205,0,27,0,1321094,51.85,5850343,7915.731,42.4,12.922,85535.383,92.243,10.99,0.932,0
170,124,307,52512,0,27,0,1321094,51.85,5850343,7915.731,42.4,12.922,85535.383,92.243,10.99,0.932,0
170,125,313,52825,0,27,0,1474372,51.85,5850343,7915.731,42.4,12.922,85535.383,92.243,10.99,0.932,0
170,126,226,53051,0,27,0,1474372,51.85,5850343,7915.731,42.4,12.922,85535.383,92.243,10.99,0.932,0
170,127,295,53346,0,27,0,1474372,51.85,5850343,7915.731,42.4,12.922,85535.383,92.243,10.99,0.932,0
170,128,908,54254,0,27,0,1474372,51.85,5850343,7915.731,42.4,12.922,85535.383,92.243,10.99,0.932,0
170,129,301,54555,0,27,0,1474372,51.85,5850343,7915.731,42.4,12.922,85535.383,92.243,10.99,0.932,0
170,130,242,54797,0,27,0,1474372,51.85,5850343,7915.731,42.4,12.922,85535.383,92.243,10.99,0.932,0
170,131,132,54929,0,27,0,1474372,51.85,5850343,7915.731,42.4,12.922,85535.383,92.243,10.99,0.932,0
170,132,175,55104,0,27,0,1474372,51.85,5850343,7915.731,42.4,12.922,85535.383,92.243,10.99,0.932,0
170,133,188,55292,0,27,0,1610906,51.85,5850343,7915.731,42.4,12.922,85535.383,92.243,10.99,0.932,0
170,134,61,55353,0,27,0,1610906,51.85,5850343,7915.731,42.4,12.922,85535.383,92.243,10.99,0.932,0
170,135,42,55395,0,27,0,1610906,51.85,5850343,7915.731,42.4,12.922,85535.383,92.243,10.99,0.932,0
170,136,102,55497,0,27,0,1610906,51.85,5850343,7915.731,42.4,12.922,85535.383,92.243,10.99,0.932,0
170,137,83,55580,0,27,0,1610906,51.85,5850343,7915.731,42.4,12.922,85535.383,92.243,10.99,0.932,0
170,138,81,55661,0,27,0,1610906,51.85,5850343,7915.731,42.4,12.922,85535.383,92.243,10.99,0.932,0
170,139,86,55747,0,27,0,1610906,51.85,5850343,7915.731,42.4,12.922,85535.383,92.243,10.99,0.932,0
170,140,91,55838,0,27,0,1745928,51.85,5850343,7915.731,42.4,12.922,85535.383,92.243,10.99,0.932,0
170,141,100,55938,0,27,0,1745928,51.85,5850343,7915.731,42.4,12.922,85535.383,92.243,10.99,0.932,0
170,142,93,56031,0,27,0,1745928,51.85,5850343,7915.731,42.4,12.922,85535.383,92.243,10.99,0.932,0
170,143,68,56099,0,27,0,1745928,51.85,5850343,7915.731,42.4,12.922,85535.383,92.243,10.99,0.932,0
170,144,117,56216,0,27,0,1745928,51.85,5850343,7915.731,42.4,12.922,85535.383,92.243,10.99,0.932,0
170,145,50,56266,0,27,0,1745928,51.85,5850343,7915.731,42.4,12.922,85535.383,92.243,10.99,0.932,0
170,146,87,56353,0,27,0,1832813,51.85,5850343,7915.731,42.4,12.922,85535.383,92.243,10.99,0.932,0
170,147,51,56404,0,27,0,1832813,51.85,5850343,7915.731,42.4,12.922,85535.383,92.243,10.99,0.932,0
170,148,31,56435,0,27,0,1832813,51.85,5850343,7915.731,42.4,12.922,85535.383,92.243,10.99,0.932,0
170,149,60,56495,0,27,0,1832813,51.85,5850343,7915.731,42.4,12.922,85535.383,92.243,10.99,0.932,0
170,150,77,56572,0,27,0,1832813,51.85,5850343,7915.731,42.4,12.922,85535.383,92.243,10.99,0.932,0
170,151,94,56666,0,27,0,1832813,51.85,5850343,7915.731,42.4,12.922,85535.383,92.243,10.99,0.932,0
170,152,51,56717,0,27,0,1832813,51.85,5850343,7915.731,42.4,12.922,85535.383,92.243,10.99,0.932,0
170,153,54,56771,0,27,0,2068284,51.85,5850343,7915.731,42.4,12.922,85535.383,92.243,10.99,0.932,0
170,154,41,56812,0,27,0,2068284,51.85,5850343,7915.731,42.4,12.922,85535.383,92.243,10.99,0.932,0
170,155,40,56852,0,27,0,2068284,51.85,5850343,7915.731,42.4,12.922,85535.383,92.243,10.99,0.932,0
170,156,8,56860,0,27,0,2068284,51.85,5850343,7915.731,42.4,12.922,85535.383,92.243,10.99,0.932,0
170,157,48,56908,0,27,0,2068284,51.85,5850343,7915.731,42.4,12.922,85535.383,92.243,10.99,0.932,0
170,158,0,56908,0,27,0,2068284,51.85,5850343,7915.731,42.4,12.922,85535.383,92.243,10.99,0.932,0
170,159,74,56982,0,27,0,2068284,51.85,5850343,7915.731,42.4,12.922,85535.383,92.243,10.99,0.932,0
170,160,40,57022,0,27,0,2281104,51.85,5850343,7915.731,42.4,12.922,85535.383,92.243,10.99,0.932,0
170,161,22,57044,0,27,0,2281104,51.85,5850343,7915.731,42.4,12.922,85535.383,92.243,10.99,0.932,0
170,162,47,57091,0,27,0,2281104,51.85,5850343,7915.731,42.4,12.922,85535.383,92.243,10.99,0.932,0
170,163,75,57166,0,27,0,2281104,51.85,5850343,7915.731,42.4,12.922,85535.383,92.243,10.99,0.932,0
170,164,63,57229,0,27,0,2281104,51.85,5850343,7915.731,42.4,12.922,85535.383,92.243,10.99,0.932,0
170,165,86,57315,0,27,0,2281104,51.85,5850343,7915.731,42.4,12.922,85535.383,92.243,10.99,0.932,0
170,166,42,57357,0,27,0,2281104,51.85,5850343,7915.731,42.4,12.922,85535.383,92.243,10.99,0.932,0
170,167,49,57406,0,27,0,2281104,51.85,5850343,7915.731,42.4,12.922,85535.383,92.243,10.99,0.932,0
170,168,48,57454,0,27,0,2498073,51.85,5850343,7915.731,42.4,12.922,85535.383,92.243,10.99,0.932,0
170,169,34,57488,0,27,0,2498073,51.85,5850343,7915.731,42.4,12.922,85535.383,92.243,10.99,0.932,0
170,170,26,57514,0,27,0,2498073,51.85,5850343,7915.731,42.4,12.922,85535.383,92.243,10.99,0.932,0
170,171,18,57532,0,27,0,2498073,51.85,5850343,7915.731,42.4,12.922,85535.383,92.243,10.99,0.932,0
170,172,11,57543,0,27,0,2498073,51.85,5850343,7915.731,42.4,12.922,85535.383,92.243,10.99,0.932,0
170,173,15,57558,0,27,0,2498073,51.85,5850343,7915.731,42.4,12.922,85535.383,92.243,10.99,0.932,0
170,174,18,57576,0,27,0,2692047,51.85,5850343,7915.731,42.4,12.922,85535.383,92.243,10.99,0.932,0
170,175,30,57606,0,27,0,2692047,51.85,5850343,7915.731,42.4,12.922,85535.383,92.243,10.99,0.932,0
170,176,21,57627,0,27,0,2692047,51.85,5850343,7915.731,42.4,12.922,85535.383,92.243,10.99,0.932,0
170,177,12,57639,0,27,0,2692047,54.63,5850343,7915.731,42.4,12.922,85535.383,92.243,10.99,0.932,0
170,178,15,57654,0,27,0,2692047,54.63,5850343,7915.731,42.4,12.922,85535.383,92.243,10.99,0.932,0
170,179,11,57665,0,27,0,2692047,54.63,5850343,7915.731,42.4,12.922,85535.383,92.243,10.99,0.932,0
170,180,20,57685,0,27,0,2692047,54.63,5850343,7915.731,42.4,12.922,85535.383,92.243,10.99,0.932,0
170,181,15,57700,0,27,0,2885545,54.63,5850343,7915.731,42.4,12.922,85535.383,92.243,10.99,0.932,0
170,182,15,57715,0,27,0,2885545,54.63,5850343,7915.731,42.4,12.922,85535.383,92.243,10.99,0.932,0
170,183,27,57742,0,27,0,2885545,54.63,5850343,7915.731,42.4,12.922,85535.383,92.243,10.99,0.932,0
170,184,0,57742,0,27,0,2885545,54.63,5850343,7915.731,42.4,12.922,85535.383,92.243,10.99,0.932,0
170,185,42,57784,0,27,0,2885545,54.63,5850343,7915.731,42.4,12.922,85535.383,92.243,10.99,0.932,0
170,186,10,57794,0,27,0,2885545,54.63,5850343,7915.731,42.4,12.922,85535.383,92.243,10.99,0.932,0
170,187,6,57800,0,27,0,2885545,52.78,5850343,7915.731,42.4,12.922,85535.383,92.243,10.99,0.932,0
170,188,12,57812,0,27,0,3072368,52.78,5850343,7915.731,42.4,12.922,85535.383,92.243,10.99,0.932,0
170,189,7,57819,0,27,0,3072368,52.78,5850343,7915.731,42.4,12.922,85535.383,92.243,10.99,0.932,0
170,190,11,57830,0,27,0,3072368,52.78,5850343,7915.731,42.4,12.922,85535.383,92.243,10.99,0.932,0
170,191,10,57840,0,27,0,3072368,52.78,5850343,7915.731,42.4,12.922,85535.383,92.243,10.99,0.932,0
170,192,9,57849,0,27,0,3072368,52.78,5850343,7915.731,42.4,12.922,85535.383,92.243,10.99,0.932,0
170,193,10,57859,0,27,0,3072368,52.78,5850343,7915.731,42.4,12.922,85535.383,92.243,10.99,0.932,0
170,194,7,57866,0,27,0,3072368,52.78,5850343,7915.731,42.4,12.922,85535.383,92.243,10.99,0.932,0
170,195,10,57876,0,27,0,3290291,52.78,5850343,7915.731,42.4,12.922,85535.383,92.243,10.99,0.932,0
170,196,4,57880,1,28,0,3290291,52.78,5850343,7915.731,42.4,12.922,85535.383,92.243,10.99,0.932,0
170,197,4,57884,0,28,0,3290291,52.78,5850343,7915.731,42.4,12.922,85535.383,92.243,10.99,0.932,0
170,198,5,57889,0,28,0,3290291,52.78,5850343,7915.731,42.4,12.922,85535.383,92.243,10.99,0.932,0
170,199,3,57892,0,28,0,3290291,52.78,5850343,7915.731,42.4,12.922,85535.383,92.243,10.99,0.932,0
170,200,9,57901,0,28,0,3290291,52.78,5850343,7915.731,42.4,12.922,85535.383,92.243,10.99,0.932,0
170,201,3,57904,0,28,0,3290291,52.78,5850343,7915.731,42.4,12.922,85535.383,92.243,10.99,0.932,0
170,202,7,57911,0,28,0,3486260,52.78,5850343,7915.731,42.4,12.922,85535.383,92.243,10.99,0.932,0
170,203,4,57915,0,28,0,3486260,52.78,5850343,7915.731,42.4,12.922,85535.383,92.243,10.99,0.932,0
170,204,6,57921,0,28,0,3486260,52.78,5850343,7915.731,42.4,12.922,85535.383,92.243,10.99,0.932,0
172,1,27,363,0,0,1191,10288,75,5459643,113.128,41.2,15.07,30155.152,287.959,7.29,0.855,0
172,2,37,400,0,0,1454,11742,75,5459643,113.128,41.2,15.07,30155.152,287.959,7.29,0.855,0
172,3,26,426,0,0,1889,13631,75,5459643,113.128,41.2,15.07,30155.152,287.959,7.29,0.855,0
172,4,24,450,0,0,1524,15155,75,5459643,113.128,41.2,15.07,30155.152,287.959,7.29,0.855,0
172,5,21,471,0,0,1036,16191,75,5459643,113.128,41.2,15.07,30155.152,287.959,7.29,0.855,0
172,6,14,485,0,0,1448,17639,75,5459643,113.128,41.2,15.07,30155.152,287.959,7.29,0.855,0
172,7,49,534,2,2,2042,19681,75,5459643,113.128,41.2,15.07,30155.152,287.959,7.29,0.855,0
172,8,47,581,0,2,1690,21371,87.04,5459643,113.128,41.2,15.07,30155.152,287.959,7.29,0.855,0
172,9,101,682,0,2,2301,23672,87.04,5459643,113.128,41.2,15.07,30155.152,287.959,7.29,0.855,0
172,10,19,701,0,2,2174,25846,87.04,5459643,113.128,41.2,15.07,30155.152,287.959,7.29,0.855,0
172,11,14,715,0,2,1580,27426,87.04,5459643,113.128,41.2,15.07,30155.152,287.959,7.29,0.855,0
172,12,13,728,0,2,1324,28750,87.04,5459643,113.128,41.2,15.07,30155.152,287.959,7.29,0.855,0
172,13,14,742,0,2,1302,30052,87.04,5459643,113.128,41.2,15.07,30155.152,287.959,7.29,0.855,0
172,14,27,769,0,2,1439,31491,75,5459643,113.128,41.2,15.07,30155.152,287.959,7.29,0.855,0
172,15,66,835,0,2,2967,34458,75,5459643,113.128,41.2,15.07,30155.152,287.959,7.29,0.855,0
172,16,28,863,4,6,3351,37809,75,5459643,113.128,41.2,15.07,30155.152,287.959,7.29,0.855,0
172,17,114,977,2,8,3144,40953,75,5459643,113.128,41.2,15.07,30155.152,287.959,7.29,0.855,0
172,18,72,1049,1,9,3323,44276,75,5459643,113.128,41.2,15.07,30155.152,287.959,7.29,0.855,0
172,19,40,1089,2,11,2458,46734,75,5459643,113.128,41.2,15.07,30155.152,287.959,7.29,0.855,0
172,20,72,1161,1,12,2694,49428,75,5459643,113.128,41.2,15.07,30155.152,287.959,7.29,0.855,0
172,21,12,1173,1,13,3468,52896,75,5459643,113.128,41.2,15.07,30155.152,287.959,7.29,0.855,0
172,22,26,1199,1,14,4525,57421,73.15,5459643,113.128,41.2,15.07,30155.152,287.959,7.29,0.855,0
172,23,45,1244,0,14,3840,61261,73.15,5459643,113.128,41.2,15.07,30155.152,287.959,7.29,0.855,0
172,24,81,1325,1,15,4828,66089,73.15,5459643,113.128,41.2,15.07,30155.152,287.959,7.29,0.855,0
172,25,35,1360,2,17,4839,70928,73.15,5459643,113.128,41.2,15.07,30155.152,287.959,7.29,0.855,0
172,26,13,1373,0,17,3171,74099,73.15,5459643,113.128,41.2,15.07,30155.152,287.959,7.29,0.855,0
172,27,6,1379,1,18,1767,75866,73.15,5459643,113.128,41.2,15.07,30155.152,287.959,7.29,0.855,0
172,28,2,1381,0,18,5472,81338,73.15,5459643,113.128,41.2,15.07,30155.152,287.959,7.29,0.855,0
172,29,3,1384,2,20,4584,85922,73.15,5459643,113.128,41.2,15.07,30155.152,287.959,7.29,0.855,0
172,30,7,1391,2,22,5150,91072,73.15,5459643,113.128,41.2,15.07,30155.152,287.959,7.29,0.855,0
172,31,5,1396,1,23,3698,94770,73.15,5459643,113.128,41.2,15.07,30155.152,287.959,7.29,0.855,0
172,32,7,1403,0,23,1450,96220,73.15,5459643,113.128,41.2,15.07,30155.152,287.959,7.29,0.855,0
172,33,4,1407,1,24,1584,97804,73.15,5459643,113.128,41.2,15.07,30155.152,287.959,7.29,0.855,0
172,34,1,1408,0,24,2060,99864,73.15,5459643,113.128,41.2,15.07,30155.152,287.959,7.29,0.855,0
172,35,5,1413,1,25,4742,104606,73.15,5459643,113.128,41.2,15.07,30155.152,287.959,7.29,0.855,0
172,36,8,1421,0,25,5161,109767,73.15,5459643,113.128,41.2,15.07,30155.152,287.959,7.29,0.855,0
172,37,8,1429,0,25,4694,114461,73.15,5459643,113.128,41.2,15.07,30155.152,287.959,7.29,0.855,0
172,38,16,1445,1,26,3910,118371,73.15,5459643,113.128,41.2,15.07,30155.152,287.959,7.29,0.855,0
172,39,10,1455,0,26,1488,119859,73.15,5459643,113.128,41.2,15.07,30155.152,287.959,7.29,0.855,0
172,40,0,1455,0,26,786,120645,73.15,5459643,113.128,41.2,15.07,30155.152,287.959,7.29,0.855,0
172,41,2,1457,0,26,2063,122708,73.15,5459643,113.128,41.2,15.07,30155.152,287.959,7.29,0.855,0
172,42,0,1457,0,26,4326,127034,73.15,5459643,113.128,41.2,15.07,30155.152,287.959,7.29,0.855,0
172,43,8,1465,1,27,4876,131910,73.15,5459643,113.128,41.2,15.07,30155.152,287.959,7.29,0.855,0
172,44,4,1469,0,27,3992,135902,73.15,5459643,113.128,41.2,15.07,30155.152,287.959,7.29,0.855,0
172,45,8,1477,0,27,4084,139986,73.15,5459643,113.128,41.2,15.07,30155.152,287.959,7.29,0.855,0
172,46,3,1480,0,27,2476,142462,73.15,5459643,113.128,41.2,15.07,30155.152,287.959,7.29,0.855,0
172,47,13,1493,1,28,971,143433,73.15,5459643,113.128,41.2,15.07,30155.152,287.959,7.29,0.855,0
172,48,1,1494,0,28,2041,145474,73.15,5459643,113.128,41.2,15.07,30155.152,287.959,7.29,0.855,0
172,49,1,1495,0,28,3371,148845,73.15,5459643,113.128,41.2,15.07,30155.152,287.959,7.29,0.855,0
172,50,0,1495,0,28,2933,151778,73.15,5459643,113.128,41.2,15.07,30155.152,287.959,7.29,0.855,0
172,51,1,1496,0,28,2751,154529,73.15,5459643,113.128,41.2,15.07,30155.152,287.959,7.29,0.855,0
172,52,6,1502,0,28,2236,156765,73.15,5459643,113.128,41.2,15.07,30155.152,287.959,7.29,0.855,0
172,53,1,1503,0,28,1649,158414,73.15,5459643,113.128,41.2,15.07,30155.152,287.959,7.29,0.855,0
172,54,1,1504,0,28,645,159059,73.15,5459643,113.128,41.2,15.07,30155.152,287.959,7.29,0.855,0
172,55,5,1509,0,28,1464,160523,73.15,5459643,113.128,41.2,15.07,30155.152,287.959,7.29,0.855,0
172,56,2,1511,0,28,2839,163362,73.15,5459643,113.128,41.2,15.07,30155.152,287.959,7.29,0.855,0
172,57,2,1513,0,28,2352,165714,73.15,5459643,113.128,41.2,15.07,30155.152,287.959,7.29,0.855,0
172,58,2,1515,0,28,1848,167562,73.15,5459643,113.128,41.2,15.07,30155.152,287.959,7.29,0.855,0
172,59,5,1520,0,28,3433,170995,73.15,5459643,113.128,41.2,15.07,30155.152,287.959,7.29,0.855,0
172,60,0,1520,0,28,1606,172601,73.15,5459643,113.128,41.2,15.07,30155.152,287.959,7.29,0.855,0
172,61,1,1521,0,28,274,172875,73.15,5459643,113.128,41.2,15.07,30155.152,287.959,7.29,0.855,0
172,62,1,1522,0,28,6418,179293,69.44,5459643,113.128,41.2,15.07,30155.152,287.959,7.29,0.855,0
172,63,0,1522,0,28,2336,181629,69.44,5459643,113.128,41.2,15.07,30155.152,287.959,7.29,0.855,0
172,64,0,1522,0,28,2135,183764,52.78,5459643,113.128,41.2,15.07,30155.152,287.959,7.29,0.855,0
172,65,3,1525,0,28,1832,185596,52.78,5459643,113.128,41.2,15.07,30155.152,287.959,7.29,0.855,0
172,66,1,1526,0,28,2639,188235,50,5459643,113.128,41.2,15.07,30155.152,287.959,7.29,0.855,0
172,67,0,1526,0,28,1180,189415,50,5459643,113.128,41.2,15.07,30155.152,287.959,7.29,0.855,0
172,68,2,1528,0,28,160,189575,50,5459643,113.128,41.2,15.07,30155.152,287.959,7.29,0.855,0
172,69,0,1528,0,28,851,190426,50,5459643,113.128,41.2,15.07,30155.152,287.959,7.29,0.855,0
172,70,2,1530,0,28,1545,191971,47.22,5459643,113.128,41.2,15.07,30155.152,287.959,7.29,0.855,0
172,71,1,1531,0,28,1500,193471,44.44,5459643,113.128,41.2,15.07,30155.152,287.959,7.29,0.855,0
172,72,2,1533,0,28,1262,194733,44.44,5459643,113.128,41.2,15.07,30155.152,287.959,7.29,0.855,0
172,73,8,1541,0,28,1511,196244,44.44,5459643,113.128,41.2,15.07,30155.152,287.959,7.29,0.855,0
172,74,1,1542,0,28,479,196723,44.44,5459643,113.128,41.2,15.07,30155.152,287.959,7.29,0.855,0
172,75,3,1545,0,28,47,196770,40.74,5459643,113.128,41.2,15.07,30155.152,287.959,7.29,0.855,0
172,76,3,1548,0,28,847,197617,40.74,5459643,113.128,41.2,15.07,30155.152,287.959,7.29,0.855,0
172,77,4,1552,0,28,1163,198780,40.74,5459643,113.128,41.2,15.07,30155.152,287.959,7.29,0.855,0
172,78,0,1552,0,28,787,199567,40.74,5459643,113.128,41.2,15.07,30155.152,287.959,7.29,0.855,0
172,79,9,1561,0,28,806,200373,40.74,5459643,113.128,41.2,15.07,30155.152,287.959,7.29,0.855,0
172,80,1,1562,0,28,1278,201651,40.74,5459643,113.128,41.2,15.07,30155.152,287.959,7.29,0.855,0
172,81,14,1576,0,28,301,201952,37.96,5459643,113.128,41.2,15.07,30155.152,287.959,7.29,0.855,0
172,82,10,1586,0,28,41,201993,37.96,5459643,113.128,41.2,15.07,30155.152,287.959,7.29,0.855,0
172,83,1,1587,0,28,661,202654,37.96,5459643,113.128,41.2,15.07,30155.152,287.959,7.29,0.855,0
172,84,1,1588,0,28,1257,203911,37.96,5459643,113.128,41.2,15.07,30155.152,287.959,7.29,0.855,0
172,85,1,1589,0,28,936,204847,37.96,5459643,113.128,41.2,15.07,30155.152,287.959,7.29,0.855,0
172,86,18,1607,0,28,1515,206362,37.96,5459643,113.128,41.2,15.07,30155.152,287.959,7.29,0.855,0
172,87,23,1630,0,28,1611,207973,37.96,5459643,113.128,41.2,15.07,30155.152,287.959,7.29,0.855,0
172,88,13,1643,0,28,931,208904,37.96,5459643,113.128,41.2,15.07,30155.152,287.959,7.29,0.855,0
172,89,14,1657,0,28,62,208966,37.96,5459643,113.128,41.2,15.07,30155.152,287.959,7.29,0.855,0
172,90,7,1664,0,28,784,209750,37.96,5459643,113.128,41.2,15.07,30155.152,287.959,7.29,0.855,0
172,91,1,1665,0,28,2063,211813,37.96,5459643,113.128,41.2,15.07,30155.152,287.959,7.29,0.855,0
172,92,2,1667,0,28,1708,213521,37.96,5459643,113.128,41.2,15.07,30155.152,287.959,7.29,0.855,0
172,93,20,1687,0,28,1801,215322,37.96,5459643,113.128,41.2,15.07,30155.152,287.959,7.29,0.855,0
172,94,13,1700,0,28,2216,217538,37.96,5459643,113.128,41.2,15.07,30155.152,287.959,7.29,0.855,0
172,95,20,1720,0,28,808,218346,37.96,5459643,113.128,41.2,15.07,30155.152,287.959,7.29,0.855,0
172,96,29,1749,0,28,50,218396,37.96,5459643,113.128,41.2,15.07,30155.152,287.959,7.29,0.855,0
172,97,15,1764,0,28,873,219269,37.96,5459643,113.128,41.2,15.07,30155.152,287.959,7.29,0.855,0
172,98,1,1765,0,28,2225,221494,37.96,5459643,113.128,41.2,15.07,30155.152,287.959,7.29,0.855,0
172,99,2,1767,0,28,2284,223778,37.96,5459643,113.128,41.2,15.07,30155.152,287.959,7.29,0.855,0
172,100,31,1798,0,28,2172,225950,37.96,5459643,113.128,41.2,15.07,30155.152,287.959,7.29,0.855,0
172,101,53,1851,0,28,2879,228829,37.96,5459643,113.128,41.2,15.07,30155.152,287.959,7.29,0.855,0
172,102,19,1870,0,28,960,229789,37.96,5459643,113.128,41.2,15.07,30155.152,287.959,7.29,0.855,0
172,103,23,1893,0,28,279,230068,37.96,5459643,113.128,41.2,15.07,30155.152,287.959,7.29,0.855,0
172,104,8,1901,0,28,1163,231231,37.96,5459643,113.128,41.2,15.07,30155.152,287.959,7.29,0.855,0
172,105,1,1902,0,28,2205,233436,37.96,5459643,113.128,41.2,15.07,30155.152,287.959,7.29,0.855,0
172,106,6,1908,0,28,2336,235772,37.96,5459643,113.128,41.2,15.07,30155.152,287.959,7.29,0.855,0
172,107,19,1927,0,28,1862,237634,37.96,5459643,113.128,41.2,15.07,30155.152,287.959,7.29,0.855,0
172,108,24,1951,0,28,2161,239795,37.96,5459643,113.128,41.2,15.07,30155.152,287.959,7.29,0.855,0
172,109,14,1965,0,28,410,240205,37.96,5459643,113.128,41.2,15.07,30155.152,287.959,7.29,0.855,0
172,110,11,1976,0,28,24,240229,37.96,5459643,113.128,41.2,15.07,30155.152,287.959,7.29,0.855,0
172,111,3,1979,0,28,3333,243562,37.96,5459643,113.128,41.2,15.07,30155.152,287.959,7.29,0.855,0
172,112,1,1980,0,28,2571,246133,37.96,5459643,113.128,41.2,15.07,30155.152,287.959,7.29,0.855,0
172,113,41,2021,0,28,2251,248384,37.96,5459643,113.128,41.2,15.07,30155.152,287.959,7.29,0.855,0
172,114,37,2058,0,28,2049,250433,37.96,5459643,113.128,41.2,15.07,30155.152,287.959,7.29,0.855,0
172,115,31,2089,0,28,2275,252708,37.96,5459643,113.128,41.2,15.07,30155.152,287.959,7.29,0.855,0
172,116,29,2118,0,28,767,253475,37.96,5459643,113.128,41.2,15.07,30155.152,287.959,7.29,0.855,0
172,117,23,2141,0,28,216,253691,37.96,5459643,113.128,41.2,15.07,30155.152,287.959,7.29,0.855,0
172,118,38,2179,0,28,1548,255239,35.19,5459643,113.128,41.2,15.07,30155.152,287.959,7.29,0.855,0
172,119,2,2181,0,28,2296,257535,35.19,5459643,113.128,41.2,15.07,30155.152,287.959,7.29,0.855,0
172,120,23,2204,0,28,1851,259386,35.19,5459643,113.128,41.2,15.07,30155.152,287.959,7.29,0.855,0
172,121,41,2245,0,28,2176,261562,35.19,5459643,113.128,41.2,15.07,30155.152,287.959,7.29,0.855,0
172,122,20,2265,0,28,2884,264446,35.19,5459643,113.128,41.2,15.07,30155.152,287.959,7.29,0.855,0
172,123,27,2292,1,29,585,265031,35.19,5459643,113.128,41.2,15.07,30155.152,287.959,7.29,0.855,0
172,124,45,2337,0,29,766,265797,35.19,5459643,113.128,41.2,15.07,30155.152,287.959,7.29,0.855,0
172,125,7,2344,0,29,1320,267117,35.19,5459643,113.128,41.2,15.07,30155.152,287.959,7.29,0.855,0
172,126,10,2354,0,29,2538,269655,35.19,5459643,113.128,41.2,15.07,30155.152,287.959,7.29,0.855,0
172,127,14,2368,0,29,2667,272322,35.19,5459643,113.128,41.2,15.07,30155.152,287.959,7.29,0.855,0
172,128,49,2417,0,29,2473,274795,35.19,5459643,113.128,41.2,15.07,30155.152,287.959,7.29,0.855,0
172,129,63,2480,0,29,3099,277894,35.19,5459643,113.128,41.2,15.07,30155.152,287.959,7.29,0.855,0
172,130,43,2523,2,31,1068,278962,35.19,5459643,113.128,41.2,15.07,30155.152,287.959,7.29,0.855,0
172,131,43,2566,0,31,564,279526,35.19,5459643,113.128,41.2,15.07,30155.152,287.959,7.29,0.855,0
172,132,30,2596,0,31,1454,280980,35.19,5459643,113.128,41.2,15.07,30155.152,287.959,7.29,0.855,0
172,133,3,2599,0,31,3131,284111,35.19,5459643,113.128,41.2,15.07,30155.152,287.959,7.29,0.855,0
172,134,16,2615,0,31,2741,286852,35.19,5459643,113.128,41.2,15.07,30155.152,287.959,7.29,0.855,0
172,135,75,2690,0,31,2738,289590,35.19,5459643,113.128,41.2,15.07,30155.152,287.959,7.29,0.855,0
172,136,49,2739,0,31,3235,292825,35.19,5459643,113.128,41.2,15.07,30155.152,287.959,7.29,0.855,0
172,137,62,2801,0,31,2013,294838,35.19,5459643,113.128,41.2,15.07,30155.152,287.959,7.29,0.855,0
172,138,54,2855,0,31,481,295319,32.41,5459643,113.128,41.2,15.07,30155.152,287.959,7.29,0.855,0
172,139,47,2902,0,31,1583,296902,32.41,5459643,113.128,41.2,15.07,30155.152,287.959,7.29,0.855,0
172,140,5,2907,0,31,3684,300586,32.41,5459643,113.128,41.2,15.07,30155.152,287.959,7.29,0.855,0
172,141,15,2922,0,31,3435,304021,32.41,5459643,113.128,41.2,15.07,30155.152,287.959,7.29,0.855,0
172,142,100,3022,2,33,3245,307266,32.41,5459643,113.128,41.2,15.07,30155.152,287.959,7.29,0.855,0
172,143,80,3102,0,33,3833,311099,32.41,5459643,113.128,41.2,15.07,30155.152,287.959,7.29,0.855,0
172,144,123,3225,0,33,1723,312822,32.41,5459643,113.128,41.2,15.07,30155.152,287.959,7.29,0.855,0
172,145,91,3316,0,33,929,313751,32.41,5459643,113.128,41.2,15.07,30155.152,287.959,7.29,0.855,0
172,146,40,3356,0,33,2103,315854,32.41,5459643,113.128,41.2,15.07,30155.152,287.959,7.29,0.855,0
172,147,68,3424,0,33,4090,319944,28.7,5459643,113.128,41.2,15.07,30155.152,287.959,7.29,0.855,0
172,148,28,3452,0,33,3636,323580,28.7,5459643,113.128,41.2,15.07,30155.152,287.959,7.29,0.855,0
172,149,84,3536,0,33,4360,327940,28.7,5459643,113.128,41.2,15.07,30155.152,287.959,7.29,0.855,0
172,150,90,3626,0,33,4453,332393,28.7,5459643,113.128,41.2,15.07,30155.152,287.959,7.29,0.855,0
172,151,102,3728,0,33,1951,334344,28.7,5459643,113.128,41.2,15.07,30155.152,287.959,7.29,0.855,0
172,152,114,3842,0,33,588,334932,28.7,5459643,113.128,41.2,15.07,30155.152,287.959,7.29,0.855,0
172,153,34,3876,0,33,2763,337695,28.7,5459643,113.128,41.2,15.07,30155.152,287.959,7.29,0.855,0
172,154,41,3917,0,33,2428,340123,25.93,5459643,113.128,41.2,15.07,30155.152,287.959,7.29,0.855,0
172,155,72,3989,0,33,3519,343642,25.93,5459643,113.128,41.2,15.07,30155.152,287.959,7.29,0.855,0
172,156,53,4042,0,33,4772,348414,27.31,5459643,113.128,41.2,15.07,30155.152,287.959,7.29,0.855,0
172,157,121,4163,4,37,5947,354361,28.7,5459643,113.128,41.2,15.07,30155.152,287.959,7.29,0.855,0
172,158,137,4300,0,37,2462,356823,28.7,5459643,113.128,41.2,15.07,30155.152,287.959,7.29,0.855,0
172,159,226,4526,0,37,922,357745,28.7,5459643,113.128,41.2,15.07,30155.152,287.959,7.29,0.855,0
172,160,88,4614,0,37,2891,360636,28.7,5459643,113.128,41.2,15.07,30155.152,287.959,7.29,0.855,0
172,161,22,4636,0,37,5309,365945,28.7,5459643,113.128,41.2,15.07,30155.152,287.959,7.29,0.855,0
172,162,91,4727,0,37,5021,370966,28.7,5459643,113.128,41.2,15.07,30155.152,287.959,7.29,0.855,0
172,163,161,4888,0,37,4266,375232,28.7,5459643,113.128,41.2,15.07,30155.152,287.959,7.29,0.855,0
172,164,133,5021,0,37,6191,381423,31.48,5459643,113.128,41.2,15.07,30155.152,287.959,7.29,0.855,0
172,165,231,5252,0,37,3080,384503,31.48,5459643,113.128,41.2,15.07,30155.152,287.959,7.29,0.855,0
172,166,201,5453,1,38,1425,385928,31.48,5459643,113.128,41.2,15.07,30155.152,287.959,7.29,0.855,0
172,167,79,5532,0,38,4323,390251,31.48,5459643,113.128,41.2,15.07,30155.152,287.959,7.29,0.855,0
172,168,48,5580,0,38,3235,393486,31.48,5459643,113.128,41.2,15.07,30155.152,287.959,7.29,0.855,0
172,169,188,5768,0,38,4027,397513,31.48,5459643,113.128,41.2,15.07,30155.152,287.959,7.29,0.855,0
172,170,92,5860,0,38,5542,403055,31.48,5459643,113.128,41.2,15.07,30155.152,287.959,7.29,0.855,0
172,171,161,6021,1,39,5750,408805,31.48,5459643,113.128,41.2,15.07,30155.152,287.959,7.29,0.855,0
172,172,235,6256,0,39,3443,412248,31.48,5459643,113.128,41.2,15.07,30155.152,287.959,7.29,0.855,0
172,173,290,6546,0,39,1952,414200,31.48,5459643,113.128,41.2,15.07,30155.152,287.959,7.29,0.855,0
172,174,131,6677,0,39,2664,416864,31.48,5459643,113.128,41.2,15.07,30155.152,287.959,7.29,0.855,0
172,175,79,6756,0,39,6231,423095,31.48,5459643,113.128,41.2,15.07,30155.152,287.959,7.29,0.855,0
172,176,175,6931,1,40,5213,428308,31.48,5459643,113.128,41.2,15.07,30155.152,287.959,7.29,0.855,0
172,177,338,7269,1,41,5540,433848,31.48,5459643,113.128,41.2,15.07,30155.152,287.959,7.29,0.855,0
172,178,360,7629,0,41,6483,440331,28.7,5459643,113.128,41.2,15.07,30155.152,287.959,7.29,0.855,0
172,179,419,8048,0,41,5655,445986,28.7,5459643,113.128,41.2,15.07,30155.152,287.959,7.29,0.855,0
172,180,552,8600,3,44,1954,447940,28.7,5459643,113.128,41.2,15.07,30155.152,287.959,7.29,0.855,0
172,181,478,9078,0,44,2561,450501,28.7,5459643,113.128,41.2,15.07,30155.152,287.959,7.29,0.855,0
172,182,265,9343,0,44,7350,457851,28.7,5459643,113.128,41.2,15.07,30155.152,287.959,7.29,0.855,0
172,183,231,9574,1,45,9170,467021,28.7,5459643,113.128,41.2,15.07,30155.152,287.959,7.29,0.855,0
172,184,567,10141,3,48,7824,474845,34.72,5459643,113.128,41.2,15.07,30155.152,287.959,7.29,0.855,0
172,185,797,10938,0,48,9492,484337,34.72,5459643,113.128,41.2,15.07,30155.152,287.959,7.29,0.855,0
172,186,679,11617,6,54,8565,492902,34.72,5459643,113.128,41.2,15.07,30155.152,287.959,7.29,0.855,0
172,187,704,12321,0,54,3382,496284,34.72,5459643,113.128,41.2,15.07,30155.152,287.959,7.29,0.855,0
172,188,818,13139,1,55,3750,500034,43.52,5459643,113.128,41.2,15.07,30155.152,287.959,7.29,0.855,0
172,189,353,13492,0,55,8679,508713,43.52,5459643,113.128,41.2,15.07,30155.152,287.959,7.29,0.855,0
172,190,320,13812,0,55,9518,518231,43.52,5459643,113.128,41.2,15.07,30155.152,287.959,7.29,0.855,0
172,191,877,14689,0,55,10136,528367,43.52,5459643,113.128,41.2,15.07,30155.152,287.959,7.29,0.855,0
172,192,1037,15726,2,57,11123,539490,43.52,5459643,113.128,41.2,15.07,30155.152,287.959,7.29,0.855,0
172,193,1184,16910,0,57,8959,548449,43.52,5459643,113.128,41.2,15.07,30155.152,287.959,7.29,0.855,0
172,194,1887,18797,4,61,3998,552447,43.52,5459643,113.128,41.2,15.07,30155.152,287.959,7.29,0.855,0
172,195,1054,19851,0,61,5058,557505,47.22,5459643,113.128,41.2,15.07,30155.152,287.959,7.29,0.855,0
172,196,504,20355,0,61,10228,567733,50,5459643,113.128,41.2,15.07,30155.152,287.959,7.29,0.855,0
172,197,531,20886,0,61,12502,580235,50,5459643,113.128,41.2,15.07,30155.152,287.959,7.29,0.855,0
172,198,1410,22296,5,66,14010,594245,50,5459643,113.128,41.2,15.07,30155.152,287.959,7.29,0.855,0
172,199,1929,24225,5,71,11904,606149,50,5459643,113.128,41.2,15.07,30155.152,287.959,7.29,0.855,0
172,200,2075,26300,0,71,10858,617007,50,5459643,113.128,41.2,15.07,30155.152,287.959,7.29,0.855,0
172,201,1968,28268,11,82,5025,622032,50,5459643,113.128,41.2,15.07,30155.152,287.959,7.29,0.855,0
172,202,1567,29835,6,88,5946,627978,50,5459643,113.128,41.2,15.07,30155.152,287.959,7.29,0.855,0
172,203,860,30695,4,92,0,627978,50,5459643,113.128,41.2,15.07,30155.152,287.959,7.29,0.855,0
172,204,705,31400,6,98,0,627978,50,5459643,113.128,41.2,15.07,30155.152,287.959,7.29,0.855,0
173,1,51,814,2,13,1095,24857,89.81,2078932,102.619,44.5,19.062,31400.84,153.493,7.25,0.896,0
173,2,27,841,2,15,1064,25921,89.81,2078932,102.619,44.5,19.062,31400.84,153.493,7.25,0.896,0
173,3,56,897,1,16,1188,27109,89.81,2078932,102.619,44.5,19.062,31400.84,153.493,7.25,0.896,0
173,4,37,934,4,20,655,27764,89.81,2078932,102.619,44.5,19.062,31400.84,153.493,7.25,0.896,0
173,5,43,977,2,22,489,28253,89.81,2078932,102.619,44.5,19.062,31400.84,153.493,7.25,0.896,0
173,6,20,997,6,28,1202,29455,89.81,2078932,102.619,44.5,19.062,31400.84,153.493,7.25,0.896,0
173,7,24,1021,2,30,1214,30669,89.81,2078932,102.619,44.5,19.062,31400.84,153.493,7.25,0.896,0
173,8,34,1055,6,36,1144,31813,89.81,2078932,102.619,44.5,19.062,31400.84,153.493,7.25,0.896,0
173,9,36,1091,4,40,1234,33047,89.81,2078932,102.619,44.5,19.062,31400.84,153.493,7.25,0.896,0
173,10,33,1124,3,43,1232,34279,89.81,2078932,102.619,44.5,19.062,31400.84,153.493,7.25,0.896,0
173,11,36,1160,2,45,572,34851,89.81,2078932,102.619,44.5,19.062,31400.84,153.493,7.25,0.896,0
173,12,28,1188,5,50,554,35405,89.81,2078932,102.619,44.5,19.062,31400.84,153.493,7.25,0.896,0
173,13,17,1205,3,53,541,35946,89.81,2078932,102.619,44.5,19.062,31400.84,153.493,7.25,0.896,0
173,14,7,1212,2,55,1168,37114,89.81,2078932,102.619,44.5,19.062,31400.84,153.493,7.25,0.896,0
173,15,8,1220,1,56,1023,38137,89.81,2078932,102.619,44.5,19.062,31400.84,153.493,7.25,0.896,0
173,16,28,1248,5,61,1193,39330,89.81,2078932,102.619,44.5,19.062,31400.84,153.493,7.25,0.896,0
173,17,20,1268,0,61,1250,40580,89.81,2078932,102.619,44.5,19.062,31400.84,153.493,7.25,0.896,0
173,18,36,1304,5,66,685,41265,89.81,2078932,102.619,44.5,19.062,31400.84,153.493,7.25,0.896,0
173,19,13,1317,4,70,537,41802,89.81,2078932,102.619,44.5,19.062,31400.84,153.493,7.25,0.896,0
173,20,13,1330,4,74,1174,42976,86.11,2078932,102.619,44.5,19.062,31400.84,153.493,7.25,0.896,0
173,21,5,1335,0,74,1459,44435,86.11,2078932,102.619,44.5,19.062,31400.84,153.493,7.25,0.896,0
173,22,5,1340,3,77,1268,45703,86.11,2078932,102.619,44.5,19.062,31400.84,153.493,7.25,0.896,0
173,23,13,1353,2,79,1315,47018,86.11,2078932,102.619,44.5,19.062,31400.84,153.493,7.25,0.896,0
173,24,13,1366,0,79,1161,48179,86.11,2078932,102.619,44.5,19.062,31400.84,153.493,7.25,0.896,0
173,25,7,1373,1,80,794,48973,86.11,2078932,102.619,44.5,19.062,31400.84,153.493,7.25,0.896,0
173,26,15,1388,1,81,634,49607,86.11,2078932,102.619,44.5,19.062,31400.84,153.493,7.25,0.896,0
173,27,19,1407,1,82,683,50290,86.11,2078932,102.619,44.5,19.062,31400.84,153.493,7.25,0.896,0
173,28,0,1407,1,83,1317,51607,86.11,2078932,102.619,44.5,19.062,31400.84,153.493,7.25,0.896,0
173,29,1,1408,3,86,1341,52948,86.11,2078932,102.619,44.5,19.062,31400.84,153.493,7.25,0.896,0
173,30,10,1418,3,89,1352,54300,75,2078932,102.619,44.5,19.062,31400.84,153.493,7.25,0.896,0
173,31,11,1429,2,91,720,55020,75,2078932,102.619,44.5,19.062,31400.84,153.493,7.25,0.896,0
173,32,5,1434,2,93,500,55520,75,2078932,102.619,44.5,19.062,31400.84,153.493,7.25,0.896,0
173,33,5,1439,1,94,616,56136,75,2078932,102.619,44.5,19.062,31400.84,153.493,7.25,0.896,0
173,34,0,1439,2,96,1338,57474,75,2078932,102.619,44.5,19.062,31400.84,153.493,7.25,0.896,0
173,35,6,1445,1,97,1449,58923,75,2078932,102.619,44.5,19.062,31400.84,153.493,7.25,0.896,0
173,36,3,1448,1,98,1055,59978,75,2078932,102.619,44.5,19.062,31400.84,153.493,7.25,0.896,0
173,37,1,1449,1,99,1049,61027,75,2078932,102.619,44.5,19.062,31400.84,153.493,7.25,0.896,0
173,38,1,1450,0,99,1176,62203,75,2078932,102.619,44.5,19.062,31400.84,153.493,7.25,0.896,0
173,39,4,1454,1,100,625,62828,75,2078932,102.619,44.5,19.062,31400.84,153.493,7.25,0.896,0
173,40,3,1457,1,101,537,63365,75,2078932,102.619,44.5,19.062,31400.84,153.493,7.25,0.896,0
173,41,3,1460,1,102,1182,64547,63.89,2078932,102.619,44.5,19.062,31400.84,153.493,7.25,0.896,0
173,42,1,1461,0,102,1147,65694,63.89,2078932,102.619,44.5,19.062,31400.84,153.493,7.25,0.896,0
173,43,2,1463,0,102,984,66678,63.89,2078932,102.619,44.5,19.062,31400.84,153.493,7.25,0.896,0
173,44,1,1464,1,103,1023,67701,56.02,2078932,102.619,44.5,19.062,31400.84,153.493,7.25,0.896,0
173,45,1,1465,0,103,1151,68852,56.02,2078932,102.619,44.5,19.062,31400.84,153.493,7.25,0.896,0
173,46,0,1465,0,103,511,69363,56.02,2078932,102.619,44.5,19.062,31400.84,153.493,7.25,0.896,0
173,47,1,1466,0,103,479,69842,56.02,2078932,102.619,44.5,19.062,31400.84,153.493,7.25,0.896,0
173,48,0,1466,1,104,1128,70970,44.91,2078932,102.619,44.5,19.062,31400.84,153.493,7.25,0.896,0
173,49,1,1467,0,104,981,71951,44.91,2078932,102.619,44.5,19.062,31400.84,153.493,7.25,0.896,0
173,50,1,1468,0,104,909,72860,44.91,2078932,102.619,44.5,19.062,31400.84,153.493,7.25,0.896,0
173,51,0,1468,2,106,882,73742,44.91,2078932,102.619,44.5,19.062,31400.84,153.493,7.25,0.896,0
173,52,0,1468,0,106,677,74419,44.91,2078932,102.619,44.5,19.062,31400.84,153.493,7.25,0.896,0
173,53,0,1468,0,106,341,74760,44.91,2078932,102.619,44.5,19.062,31400.84,153.493,7.25,0.896,0
173,54,0,1468,0,106,256,75016,44.91,2078932,102.619,44.5,19.062,31400.84,153.493,7.25,0.896,0
173,55,1,1469,0,106,754,75770,44.91,2078932,102.619,44.5,19.062,31400.84,153.493,7.25,0.896,0
173,56,0,1469,0,106,809,76579,44.91,2078932,102.619,44.5,19.062,31400.84,153.493,7.25,0.896,0
173,57,0,1469,0,106,631,77210,44.91,2078932,102.619,44.5,19.062,31400.84,153.493,7.25,0.896,0
173,58,2,1471,1,107,706,77916,44.91,2078932,102.619,44.5,19.062,31400.84,153.493,7.25,0.896,0
173,59,2,1473,1,108,613,78529,44.91,2078932,102.619,44.5,19.062,31400.84,153.493,7.25,0.896,0
173,60,0,1473,0,108,264,78793,44.91,2078932,102.619,44.5,19.062,31400.84,153.493,7.25,0.896,0
173,61,0,1473,0,108,246,79039,44.91,2078932,102.619,44.5,19.062,31400.84,153.493,7.25,0.896,0
173,62,0,1473,0,108,659,79698,44.91,2078932,102.619,44.5,19.062,31400.84,153.493,7.25,0.896,0
173,63,2,1475,0,108,807,80505,43.52,2078932,102.619,44.5,19.062,31400.84,153.493,7.25,0.896,0
173,64,0,1475,0,108,828,81333,36.11,2078932,102.619,44.5,19.062,31400.84,153.493,7.25,0.896,0
173,65,2,1477,0,108,828,82161,36.11,2078932,102.619,44.5,19.062,31400.84,153.493,7.25,0.896,0
173,66,2,1479,0,108,715,82876,36.11,2078932,102.619,44.5,19.062,31400.84,153.493,7.25,0.896,0
173,67,5,1484,0,108,229,83105,36.11,2078932,102.619,44.5,19.062,31400.84,153.493,7.25,0.896,0
173,68,1,1485,0,108,211,83316,36.11,2078932,102.619,44.5,19.062,31400.84,153.493,7.25,0.896,0
173,69,0,1485,0,108,814,84130,36.11,2078932,102.619,44.5,19.062,31400.84,153.493,7.25,0.896,0
173,70,0,1485,0,108,738,84868,36.11,2078932,102.619,44.5,19.062,31400.84,153.493,7.25,0.896,0
173,71,1,1486,0,108,758,85626,36.11,2078932,102.619,44.5,19.062,31400.84,153.493,7.25,0.896,0
173,72,2,1488,1,109,702,86328,36.11,2078932,102.619,44.5,19.062,31400.84,153.493,7.25,0.896,0
173,73,0,1488,0,109,767,87095,36.11,2078932,102.619,44.5,19.062,31400.84,153.493,7.25,0.896,0
173,74,2,1490,0,109,291,87386,36.11,2078932,102.619,44.5,19.062,31400.84,153.493,7.25,0.896,0
173,75,2,1492,0,109,212,87598,36.11,2078932,102.619,44.5,19.062,31400.84,153.493,7.25,0.896,0
173,76,3,1495,0,109,567,88165,36.11,2078932,102.619,44.5,19.062,31400.84,153.493,7.25,0.896,0
173,77,1,1496,0,109,986,89151,36.11,2078932,102.619,44.5,19.062,31400.84,153.493,7.25,0.896,0
173,78,3,1499,0,109,952,90103,36.11,2078932,102.619,44.5,19.062,31400.84,153.493,7.25,0.896,0
173,79,4,1503,0,109,902,91005,36.11,2078932,102.619,44.5,19.062,31400.84,153.493,7.25,0.896,0
173,80,8,1511,0,109,1147,92152,36.11,2078932,102.619,44.5,19.062,31400.84,153.493,7.25,0.896,0
173,81,2,1513,0,109,767,92919,36.11,2078932,102.619,44.5,19.062,31400.84,153.493,7.25,0.896,0
173,82,6,1519,0,109,262,93181,36.11,2078932,102.619,44.5,19.062,31400.84,153.493,7.25,0.896,0
173,83,1,1520,0,109,984,94165,36.11,2078932,102.619,44.5,19.062,31400.84,153.493,7.25,0.896,0
173,84,1,1521,0,109,1222,95387,36.11,2078932,102.619,44.5,19.062,31400.84,153.493,7.25,0.896,0
173,85,13,1534,2,111,1212,96599,36.11,2078932,102.619,44.5,19.062,31400.84,153.493,7.25,0.896,0
173,86,7,1541,0,111,843,97442,36.11,2078932,102.619,44.5,19.062,31400.84,153.493,7.25,0.896,0
173,87,6,1547,0,111,878,98320,36.11,2078932,102.619,44.5,19.062,31400.84,153.493,7.25,0.896,0
173,88,11,1558,0,111,625,98945,36.11,2078932,102.619,44.5,19.062,31400.84,153.493,7.25,0.896,0
173,89,14,1572,0,111,300,99245,36.11,2078932,102.619,44.5,19.062,31400.84,153.493,7.25,0.896,0
173,90,9,1581,0,111,1085,100330,36.11,2078932,102.619,44.5,19.062,31400.84,153.493,7.25,0.896,0
173,91,4,1585,0,111,1399,101729,36.11,2078932,102.619,44.5,19.062,31400.84,153.493,7.25,0.896,0
173,92,15,1600,0,111,1198,102927,36.11,2078932,102.619,44.5,19.062,31400.84,153.493,7.25,0.896,0
173,93,13,1613,0,111,1274,104201,36.11,2078932,102.619,44.5,19.062,31400.84,153.493,7.25,0.896,0
173,94,20,1633,0,111,1451,105652,36.11,2078932,102.619,44.5,19.062,31400.84,153.493,7.25,0.896,0
173,95,16,1649,0,111,716,106368,36.11,2078932,102.619,44.5,19.062,31400.84,153.493,7.25,0.896,0
173,96,30,1679,0,111,530,106898,36.11,2078932,102.619,44.5,19.062,31400.84,153.493,7.25,0.896,0
173,97,21,1700,0,111,1330,108228,36.11,2078932,102.619,44.5,19.062,31400.84,153.493,7.25,0.896,0
173,98,16,1716,0,111,1607,109835,36.11,2078932,102.619,44.5,19.062,31400.84,153.493,7.25,0.896,0
173,99,23,1739,0,111,1271,111106,36.11,2078932,102.619,44.5,19.062,31400.84,153.493,7.25,0.896,0
173,100,24,1763,0,111,1390,112496,36.11,2078932,102.619,44.5,19.062,31400.84,153.493,7.25,0.896,0
173,101,13,1776,0,111,1169,113665,36.11,2078932,102.619,44.5,19.062,31400.84,153.493,7.25,0.896,0
173,102,17,1793,0,111,550,114215,36.11,2078932,102.619,44.5,19.062,31400.84,153.493,7.25,0.896,0
173,103,34,1827,0,111,450,114665,36.11,2078932,102.619,44.5,19.062,31400.84,153.493,7.25,0.896,0
173,104,14,1841,0,111,1208,115873,36.11,2078932,102.619,44.5,19.062,31400.84,153.493,7.25,0.896,0
173,105,8,1849,0,111,1112,116985,36.11,2078932,102.619,44.5,19.062,31400.84,153.493,7.25,0.896,0
173,106,10,1859,0,111,1032,118017,36.11,2078932,102.619,44.5,19.062,31400.84,153.493,7.25,0.896,0
173,107,19,1878,0,111,1012,119029,36.11,2078932,102.619,44.5,19.062,31400.84,153.493,7.25,0.896,0
173,108,19,1897,0,111,1027,120056,36.11,2078932,102.619,44.5,19.062,31400.84,153.493,7.25,0.896,0
173,109,19,1916,0,111,480,120536,36.11,2078932,102.619,44.5,19.062,31400.84,153.493,7.25,0.896,0
173,110,24,1940,0,111,371,120907,36.11,2078932,102.619,44.5,19.062,31400.84,153.493,7.25,0.896,0
173,111,6,1946,0,111,914,121821,46.3,2078932,102.619,44.5,19.062,31400.84,153.493,7.25,0.896,0
173,112,7,1953,0,111,1150,122971,46.3,2078932,102.619,44.5,19.062,31400.84,153.493,7.25,0.896,0
173,113,24,1977,0,111,935,123906,46.3,2078932,102.619,44.5,19.062,31400.84,153.493,7.25,0.896,0
173,114,38,2015,4,115,848,124754,46.3,2078932,102.619,44.5,19.062,31400.84,153.493,7.25,0.896,0
173,115,18,2033,0,115,918,125672,46.3,2078932,102.619,44.5,19.062,31400.84,153.493,7.25,0.896,0
173,116,19,2052,0,115,565,126237,46.3,2078932,102.619,44.5,19.062,31400.84,153.493,7.25,0.896,0
173,117,14,2066,0,115,335,126572,46.3,2078932,102.619,44.5,19.062,31400.84,153.493,7.25,0.896,0
173,118,16,2082,0,115,874,127446,46.3,2078932,102.619,44.5,19.062,31400.84,153.493,7.25,0.896,0
173,119,5,2087,2,117,919,128365,46.3,2078932,102.619,44.5,19.062,31400.84,153.493,7.25,0.896,0
173,120,14,2101,0,117,879,129244,46.3,2078932,102.619,44.5,19.062,31400.84,153.493,7.25,0.896,0
173,121,14,2115,0,117,917,130161,46.3,2078932,102.619,44.5,19.062,31400.84,153.493,7.25,0.896,0
173,122,24,2139,0,117,892,131053,46.3,2078932,102.619,44.5,19.062,31400.84,153.493,7.25,0.896,0
173,123,26,2165,0,117,374,131427,46.3,2078932,102.619,44.5,19.062,31400.84,153.493,7.25,0.896,0
173,124,6,2171,0,117,272,131699,46.3,2078932,102.619,44.5,19.062,31400.84,153.493,7.25,0.896,0
173,125,9,2180,0,117,890,132589,46.3,2078932,102.619,44.5,19.062,31400.84,153.493,7.25,0.896,0
173,126,1,2181,0,117,974,133563,46.3,2078932,102.619,44.5,19.062,31400.84,153.493,7.25,0.896,0
173,127,9,2190,1,118,771,134334,46.3,2078932,102.619,44.5,19.062,31400.84,153.493,7.25,0.896,0
173,128,18,2208,0,118,753,135087,46.3,2078932,102.619,44.5,19.062,31400.84,153.493,7.25,0.896,0
173,129,15,2223,0,118,829,135916,46.3,2078932,102.619,44.5,19.062,31400.84,153.493,7.25,0.896,0
173,130,10,2233,1,119,304,136220,46.3,2078932,102.619,44.5,19.062,31400.84,153.493,7.25,0.896,0
173,131,14,2247,1,120,322,136542,46.3,2078932,102.619,44.5,19.062,31400.84,153.493,7.25,0.896,0
173,132,2,2249,0,120,1058,137600,46.3,2078932,102.619,44.5,19.062,31400.84,153.493,7.25,0.896,0
173,133,6,2255,0,120,1118,138718,46.3,2078932,102.619,44.5,19.062,31400.84,153.493,7.25,0.896,0
173,134,17,2272,0,120,856,139574,46.3,2078932,102.619,44.5,19.062,31400.84,153.493,7.25,0.896,0
173,135,31,2303,3,123,937,140511,46.3,2078932,102.619,44.5,19.062,31400.84,153.493,7.25,0.896,0
173,136,29,2332,1,124,1034,141545,46.3,2078932,102.619,44.5,19.062,31400.84,153.493,7.25,0.896,0
173,137,37,2369,0,124,382,141927,46.3,2078932,102.619,44.5,19.062,31400.84,153.493,7.25,0.896,0
173,138,32,2401,0,124,393,142320,46.3,2078932,102.619,44.5,19.062,31400.84,153.493,7.25,0.896,0
173,139,15,2416,0,124,1143,143463,46.3,2078932,102.619,44.5,19.062,31400.84,153.493,7.25,0.896,0
173,140,22,2438,0,124,1092,144555,46.3,2078932,102.619,44.5,19.062,31400.84,153.493,7.25,0.896,0
173,141,18,2456,0,124,1168,145723,46.3,2078932,102.619,44.5,19.062,31400.84,153.493,7.25,0.896,0
173,142,37,2493,1,125,1096,146819,46.3,2078932,102.619,44.5,19.062,31400.84,153.493,7.25,0.896,0
173,143,43,2536,0,125,1203,148022,46.3,2078932,102.619,44.5,19.062,31400.84,153.493,7.25,0.896,0
173,144,38,2574,2,127,760,148782,46.3,2078932,102.619,44.5,19.062,31400.84,153.493,7.25,0.896,0
173,145,43,2617,0,127,453,149235,46.3,2078932,102.619,44.5,19.062,31400.84,153.493,7.25,0.896,0
173,146,34,2651,0,127,1460,150695,46.3,2078932,102.619,44.5,19.062,31400.84,153.493,7.25,0.896,0
173,147,14,2665,1,128,1439,152134,46.3,2078932,102.619,44.5,19.062,31400.84,153.493,7.25,0.896,0
173,148,21,2686,0,128,1299,153433,46.3,2078932,102.619,44.5,19.062,31400.84,153.493,7.25,0.896,0
173,149,36,2722,0,128,1338,154771,46.3,2078932,102.619,44.5,19.062,31400.84,153.493,7.25,0.896,0
173,150,33,2755,0,128,1328,156099,46.3,2078932,102.619,44.5,19.062,31400.84,153.493,7.25,0.896,0
173,151,42,2797,0,128,769,156868,46.3,2078932,102.619,44.5,19.062,31400.84,153.493,7.25,0.896,0
173,152,37,2834,0,128,588,157456,46.3,2078932,102.619,44.5,19.062,31400.84,153.493,7.25,0.896,0
173,153,31,2865,0,128,1415,158871,46.3,2078932,102.619,44.5,19.062,31400.84,153.493,7.25,0.896,0
173,154,27,2892,0,128,1608,160479,46.3,2078932,102.619,44.5,19.062,31400.84,153.493,7.25,0.896,0
173,155,41,2933,0,128,1653,162132,46.3,2078932,102.619,44.5,19.062,31400.84,153.493,7.25,0.896,0
173,156,55,2988,0,128,1733,163865,46.3,2078932,102.619,44.5,19.062,31400.84,153.493,7.25,0.896,0
173,157,53,3041,1,129,1708,165573,46.3,2078932,102.619,44.5,19.062,31400.84,153.493,7.25,0.896,0
173,158,47,3088,0,129,1212,166785,46.3,2078932,102.619,44.5,19.062,31400.84,153.493,7.25,0.896,0
173,159,43,3131,1,130,706,167491,46.3,2078932,102.619,44.5,19.062,31400.84,153.493,7.25,0.896,0
173,160,43,3174,0,130,1581,169072,46.3,2078932,102.619,44.5,19.062,31400.84,153.493,7.25,0.896,0
173,161,16,3190,0,130,2560,171632,46.3,2078932,102.619,44.5,19.062,31400.84,153.493,7.25,0.896,0
173,162,42,3232,0,130,2489,174121,46.3,2078932,102.619,44.5,19.062,31400.84,153.493,7.25,0.896,0
173,163,80,3312,1,131,2758,176879,46.3,2078932,102.619,44.5,19.062,31400.84,153.493,7.25,0.896,0
173,164,76,3388,0,131,3191,180070,46.3,2078932,102.619,44.5,19.062,31400.84,153.493,7.25,0.896,0
173,165,110,3498,0,131,1793,181863,46.3,2078932,102.619,44.5,19.062,31400.84,153.493,7.25,0.896,0
173,166,105,3603,0,131,1110,182973,46.3,2078932,102.619,44.5,19.062,31400.84,153.493,7.25,0.896,0
173,167,99,3702,0,131,2247,185220,46.3,2078932,102.619,44.5,19.062,31400.84,153.493,7.25,0.896,0
173,168,53,3755,0,131,3123,188343,46.3,2078932,102.619,44.5,19.062,31400.84,153.493,7.25,0.896,0
173,169,82,3837,0,131,3070,191413,46.3,2078932,102.619,44.5,19.062,31400.84,153.493,7.25,0.896,0
173,170,123,3960,0,131,3557,194970,46.3,2078932,102.619,44.5,19.062,31400.84,153.493,7.25,0.896,0
173,171,98,4058,0,131,3070,198040,46.3,2078932,102.619,44.5,19.062,31400.84,153.493,7.25,0.896,0
173,172,137,4195,2,133,2288,200328,46.3,2078932,102.619,44.5,19.062,31400.84,153.493,7.25,0.896,0
173,173,114,4309,0,133,984,201312,46.3,2078932,102.619,44.5,19.062,31400.84,153.493,7.25,0.896,0
173,174,111,4420,0,133,2335,203647,46.3,2078932,102.619,44.5,19.062,31400.84,153.493,7.25,0.896,0
173,175,50,4470,0,133,2616,206263,46.3,2078932,102.619,44.5,19.062,31400.84,153.493,7.25,0.896,0
173,176,88,4558,0,133,2848,209111,46.3,2078932,102.619,44.5,19.062,31400.84,153.493,7.25,0.896,0
173,177,136,4694,0,133,3645,212756,46.3,2078932,102.619,44.5,19.062,31400.84,153.493,7.25,0.896,0
173,178,122,4816,2,135,2775,215531,46.3,2078932,102.619,44.5,19.062,31400.84,153.493,7.25,0.896,0
173,179,191,5007,0,135,1917,217448,46.3,2078932,102.619,44.5,19.062,31400.84,153.493,7.25,0.896,0
173,180,184,5191,1,136,909,218357,46.3,2078932,102.619,44.5,19.062,31400.84,153.493,7.25,0.896,0
173,181,159,5350,0,136,2382,220739,46.3,2078932,102.619,44.5,19.062,31400.84,153.493,7.25,0.896,0
173,182,44,5394,0,136,3391,224130,46.3,2078932,102.619,44.5,19.062,31400.84,153.493,7.25,0.896,0
173,183,93,5487,2,138,2899,227029,46.3,2078932,102.619,44.5,19.062,31400.84,153.493,7.25,0.896,0
173,184,203,5690,0,138,3281,230310,46.3,2078932,102.619,44.5,19.062,31400.84,153.493,7.25,0.896,0
173,185,175,5865,0,138,2893,233203,43.52,2078932,102.619,44.5,19.062,31400.84,153.493,7.25,0.896,0
173,186,238,6103,2,140,1940,235143,43.52,2078932,102.619,44.5,19.062,31400.84,153.493,7.25,0.896,0
173,187,227,6330,0,140,1034,236177,43.52,2078932,102.619,44.5,19.062,31400.84,153.493,7.25,0.896,0
173,188,168,6498,0,140,2509,238686,43.52,2078932,102.619,44.5,19.062,31400.84,153.493,7.25,0.896,0
173,189,76,6574,0,140,4001,242687,43.52,2078932,102.619,44.5,19.062,31400.84,153.493,7.25,0.896,0
173,190,194,6768,1,141,3652,246339,43.52,2078932,102.619,44.5,19.062,31400.84,153.493,7.25,0.896,0
173,191,356,7124,0,141,3682,250021,43.52,2078932,102.619,44.5,19.062,31400.84,153.493,7.25,0.896,0
173,192,387,7511,0,141,4362,254383,47.22,2078932,102.619,44.5,19.062,31400.84,153.493,7.25,0.896,0
173,193,363,7874,0,141,0,254383,47.22,2078932,102.619,44.5,19.062,31400.84,153.493,7.25,0.896,0
173,194,380,8254,0,141,0,258743,47.22,2078932,102.619,44.5,19.062,31400.84,153.493,7.25,0.896,0
173,195,411,8665,1,142,3308,262051,47.22,2078932,102.619,44.5,19.062,31400.84,153.493,7.25,0.896,0
173,196,167,8832,2,144,4902,266953,47.22,2078932,102.619,44.5,19.062,31400.84,153.493,7.25,0.896,0
173,197,399,9231,3,147,5287,272240,47.22,2078932,102.619,44.5,19.062,31400.84,153.493,7.25,0.896,0
173,198,707,9938,1,148,5196,277436,50.93,2078932,102.619,44.5,19.062,31400.84,153.493,7.25,0.896,0
173,199,746,10684,5,153,5605,283041,50.93,2078932,102.619,44.5,19.062,31400.84,153.493,7.25,0.896,0
173,200,836,11520,0,153,3765,286806,50.93,2078932,102.619,44.5,19.062,31400.84,153.493,7.25,0.896,0
173,201,1624,13144,0,153,2637,289443,50.93,2078932,102.619,44.5,19.062,31400.84,153.493,7.25,0.896,0
173,202,539,13683,8,161,4326,293769,50.93,2078932,102.619,44.5,19.062,31400.84,153.493,7.25,0.896,0
173,203,794,14477,3,164,0,293769,50.93,2078932,102.619,44.5,19.062,31400.84,153.493,7.25,0.896,0
173,204,2,14479,2,166,0,293769,50.93,2078932,102.619,44.5,19.062,31400.84,153.493,7.25,0.896,0
175,1,27,1353,2,5,3220,44292,87.96,59308690,46.754,27.3,5.344,12294.876,200.38,5.52,0.699,4
175,2,27,1380,0,5,3673,47965,87.96,59308690,46.754,27.3,5.344,12294.876,200.38,5.52,0.699,4
175,3,82,1462,0,5,2396,50361,87.96,59308690,46.754,27.3,5.344,12294.876,200.38,5.52,0.699,4
175,4,43,1505,2,7,3576,53937,87.96,59308690,46.754,27.3,5.344,12294.876,200.38,5.52,0.699,4
175,5,80,1585,2,9,2936,56873,87.96,59308690,46.754,27.3,5.344,12294.876,200.38,5.52,0.699,4
175,6,70,1655,2,11,1225,58098,87.96,59308690,46.754,27.3,5.344,12294.876,200.38,5.52,0.699,4
175,7,31,1686,1,12,0,58098,87.96,59308690,46.754,27.3,5.344,12294.876,200.38,5.52,0.699,4
175,8,63,1749,1,13,0,63776,87.96,59308690,46.754,27.3,5.344,12294.876,200.38,5.52,0.699,4
175,9,96,1845,5,18,5098,68874,87.96,59308690,46.754,27.3,5.344,12294.876,200.38,5.52,0.699,4
175,10,89,1934,0,18,4154,73028,87.96,59308690,46.754,27.3,5.344,12294.876,200.38,5.52,0.699,4
175,11,69,2003,6,24,2025,75053,87.96,59308690,46.754,27.3,5.344,12294.876,200.38,5.52,0.699,4
175,12,25,2028,1,25,5032,80085,87.96,59308690,46.754,27.3,5.344,12294.876,200.38,5.52,0.699,4
175,13,145,2173,0,25,3578,83663,87.96,59308690,46.754,27.3,5.344,12294.876,200.38,5.52,0.699,4
175,14,99,2272,2,27,3359,87022,87.96,59308690,46.754,27.3,5.344,12294.876,200.38,5.52,0.699,4
175,15,143,2415,0,27,3493,90515,87.96,59308690,46.754,27.3,5.344,12294.876,200.38,5.52,0.699,4
175,16,91,2506,7,34,4545,95060,87.96,59308690,46.754,27.3,5.344,12294.876,200.38,5.52,0.699,4
175,17,99,2605,14,48,5767,100827,87.96,59308690,46.754,27.3,5.344,12294.876,200.38,5.52,0.699,4
175,18,178,2783,2,50,7374,108201,87.96,59308690,46.754,27.3,5.344,12294.876,200.38,5.52,0.699,4
175,19,251,3034,2,52,6510,114711,87.96,59308690,46.754,27.3,5.344,12294.876,200.38,5.52,0.699,4
175,20,124,3158,2,54,6799,121510,87.96,59308690,46.754,27.3,5.344,12294.876,200.38,5.52,0.699,4
175,21,142,3300,4,58,5427,126937,87.96,59308690,46.754,27.3,5.344,12294.876,200.38,5.52,0.699,4
175,22,165,3465,0,58,6837,133774,87.96,59308690,46.754,27.3,5.344,12294.876,200.38,5.52,0.699,4
175,23,170,3635,7,65,9796,143570,87.96,59308690,46.754,27.3,5.344,12294.876,200.38,5.52,0.699,4
175,24,318,3953,10,75,8820,152390,87.96,59308690,46.754,27.3,5.344,12294.876,200.38,5.52,0.699,4
175,25,267,4220,4,79,8614,161004,87.96,59308690,46.754,27.3,5.344,12294.876,200.38,5.52,0.699,4
175,26,141,4361,7,86,7639,168643,87.96,59308690,46.754,27.3,5.344,12294.876,200.38,5.52,0.699,4
175,27,185,4546,1,87,9827,178470,87.96,59308690,46.754,27.3,5.344,12294.876,200.38,5.52,0.699,4
175,28,247,4793,3,90,7027,185497,87.96,59308690,46.754,27.3,5.344,12294.876,200.38,5.52,0.699,4
175,29,203,4996,3,93,11630,197127,87.96,59308690,46.754,27.3,5.344,12294.876,200.38,5.52,0.699,4
175,30,354,5350,10,103,10403,207530,87.96,59308690,46.754,27.3,5.344,12294.876,200.38,5.52,0.699,4
175,31,297,5647,0,103,9992,217522,84.26,59308690,46.754,27.3,5.344,12294.876,200.38,5.52,0.699,4
175,32,304,5951,13,116,13164,230686,84.26,59308690,46.754,27.3,5.344,12294.876,200.38,5.52,0.699,4
175,33,385,6336,7,123,15061,245747,84.26,59308690,46.754,27.3,5.344,12294.876,200.38,5.52,0.699,4
175,34,447,6783,8,131,11794,257541,84.26,59308690,46.754,27.3,5.344,12294.876,200.38,5.52,0.699,4
175,35,437,7220,7,138,10523,268064,84.26,59308690,46.754,27.3,5.344,12294.876,200.38,5.52,0.699,4
175,36,352,7572,10,148,11315,279379,84.26,59308690,46.754,27.3,5.344,12294.876,200.38,5.52,0.699,4
175,37,236,7808,5,153,12774,292153,84.26,59308690,46.754,27.3,5.344,12294.876,200.38,5.52,0.699,4
175,38,424,8232,8,161,15599,307752,84.26,59308690,46.754,27.3,5.344,12294.876,200.38,5.52,0.699,4
175,39,663,8895,17,178,16327,324079,84.26,59308690,46.754,27.3,5.344,12294.876,200.38,5.52,0.699,4
175,40,525,9420,8,186,17257,341336,84.26,59308690,46.754,27.3,5.344,12294.876,200.38,5.52,0.699,4
175,41,595,10015,8,194,14731,356067,84.26,59308690,46.754,27.3,5.344,12294.876,200.38,5.52,0.699,4
175,42,637,10652,12,206,13630,369697,84.26,59308690,46.754,27.3,5.344,12294.876,200.38,5.52,0.699,4
175,43,698,11350,0,206,16655,386352,84.26,59308690,46.754,27.3,5.344,12294.876,200.38,5.52,0.699,4
175,44,724,12074,13,219,16666,403018,84.26,59308690,46.754,27.3,5.344,12294.876,200.38,5.52,0.699,4
175,45,665,12739,19,238,18537,421555,84.26,59308690,46.754,27.3,5.344,12294.876,200.38,5.52,0.699,4
175,46,785,13524,9,247,18004,439559,84.26,59308690,46.754,27.3,5.344,12294.876,200.38,5.52,0.699,4
175,47,831,14355,14,261,21314,460873,84.26,59308690,46.754,27.3,5.344,12294.876,200.38,5.52,0.699,4
175,48,1160,15515,3,264,14198,475071,84.26,59308690,46.754,27.3,5.344,12294.876,200.38,5.52,0.699,4
175,49,918,16433,22,286,13538,488609,84.26,59308690,46.754,27.3,5.344,12294.876,200.38,5.52,0.699,4
175,50,767,17200,26,312,17252,505861,84.26,59308690,46.754,27.3,5.344,12294.876,200.38,5.52,0.699,4
175,51,803,18003,27,339,19572,525433,84.26,59308690,46.754,27.3,5.344,12294.876,200.38,5.52,0.699,4
175,52,1134,19137,30,369,17599,543032,84.26,59308690,46.754,27.3,5.344,12294.876,200.38,5.52,0.699,4
175,53,988,20125,28,397,21338,564370,84.26,59308690,46.754,27.3,5.344,12294.876,200.38,5.52,0.699,4
175,54,1218,21343,10,407,19485,583855,84.26,59308690,46.754,27.3,5.344,12294.876,200.38,5.52,0.699,4
175,55,1240,22583,22,429,12922,596777,84.26,59308690,46.754,27.3,5.344,12294.876,200.38,5.52,0.699,4
175,56,1032,23615,52,481,9214,605991,84.26,59308690,46.754,27.3,5.344,12294.876,200.38,5.52,0.699,4
175,57,649,24264,43,524,29005,634996,84.26,59308690,46.754,27.3,5.344,12294.876,200.38,5.52,0.699,4
175,58,1673,25937,28,552,20727,655723,84.26,59308690,46.754,27.3,5.344,12294.876,200.38,5.52,0.699,4
175,59,1466,27403,25,577,24452,680175,84.26,59308690,46.754,27.3,5.344,12294.876,200.38,5.52,0.699,4
175,60,1837,29240,34,611,21708,701883,84.26,59308690,46.754,27.3,5.344,12294.876,200.38,5.52,0.699,4
175,61,1727,30967,32,643,23242,725125,84.26,59308690,46.754,27.3,5.344,12294.876,200.38,5.52,0.699,4
175,62,1716,32683,40,683,17617,742742,80.56,59308690,46.754,27.3,5.344,12294.876,200.38,5.52,0.699,4
175,63,1674,34357,22,705,18792,761534,80.56,59308690,46.754,27.3,5.344,12294.876,200.38,5.52,0.699,4
175,64,1455,35812,50,755,24445,785979,80.56,59308690,46.754,27.3,5.344,12294.876,200.38,5.52,0.699,4
175,65,1713,37525,37,792,34696,820675,80.56,59308690,46.754,27.3,5.344,12294.876,200.38,5.52,0.699,4
175,66,3267,40792,56,848,30196,850871,80.56,59308690,46.754,27.3,5.344,12294.876,200.38,5.52,0.699,4
175,67,2642,43434,60,908,40797,891668,80.56,59308690,46.754,27.3,5.344,12294.876,200.38,5.52,0.699,4
175,68,2539,45973,44,952,28396,920064,80.56,59308690,46.754,27.3,5.344,12294.876,200.38,5.52,0.699,4
175,69,2312,48285,46,998,22995,943059,76.85,59308690,46.754,27.3,5.344,12294.876,200.38,5.52,0.699,4
175,70,2594,50879,82,1080,25011,968070,76.85,59308690,46.754,27.3,5.344,12294.876,200.38,5.52,0.699,4
175,71,2112,52991,82,1162,30330,998400,76.85,59308690,46.754,27.3,5.344,12294.876,200.38,5.52,0.699,4
175,72,2430,55421,48,1210,29999,1028399,76.85,59308690,46.754,27.3,5.344,12294.876,200.38,5.52,0.699,4
175,73,3147,58568,79,1289,32026,1060425,76.85,59308690,46.754,27.3,5.344,12294.876,200.38,5.52,0.699,4
175,74,3359,61927,65,1354,27462,1087887,76.85,59308690,46.754,27.3,5.344,12294.876,200.38,5.52,0.699,4
175,75,3809,65736,69,1423,34071,1121958,76.85,59308690,46.754,27.3,5.344,12294.876,200.38,5.52,0.699,4
175,76,4302,70038,57,1480,26975,1148933,76.85,59308690,46.754,27.3,5.344,12294.876,200.38,5.52,0.699,4
175,77,3495,73533,88,1568,23580,1172513,76.85,59308690,46.754,27.3,5.344,12294.876,200.38,5.52,0.699,4
175,78,2801,76334,57,1625,34847,1207360,76.85,59308690,46.754,27.3,5.344,12294.876,200.38,5.52,0.699,4
175,79,4078,80412,49,1674,20738,1228098,76.85,59308690,46.754,27.3,5.344,12294.876,200.38,5.52,0.699,4
175,80,3478,83890,63,1737,32336,1260434,76.85,59308690,46.754,27.3,5.344,12294.876,200.38,5.52,0.699,4
175,81,3825,87715,94,1831,33174,1293608,76.85,59308690,46.754,27.3,5.344,12294.876,200.38,5.52,0.699,4
175,82,4966,92681,46,1877,34452,1328060,76.85,59308690,46.754,27.3,5.344,12294.876,200.38,5.52,0.699,4
175,83,4621,97302,53,1930,25116,1353176,76.85,59308690,46.754,27.3,5.344,12294.876,200.38,5.52,0.699,4
175,84,4288,101590,61,1991,29596,1382772,76.85,59308690,46.754,27.3,5.344,12294.876,200.38,5.52,0.699,4
175,85,4518,106108,111,2102,34122,1416894,76.85,59308690,46.754,27.3,5.344,12294.876,200.38,5.52,0.699,4
175,86,5688,111796,103,2205,43118,1460012,76.85,59308690,46.754,27.3,5.344,12294.876,200.38,5.52,0.699,4
175,87,6579,118375,87,2292,33092,1493104,76.85,59308690,46.754,27.3,5.344,12294.876,200.38,5.52,0.699,4
175,88,6215,124590,48,2340,35905,1529009,76.85,59308690,46.754,27.3,5.344,12294.876,200.38,5.52,0.699,4
175,89,7210,131800,73,2413,38075,1567084,76.85,59308690,46.754,27.3,5.344,12294.876,200.38,5.52,0.699,4
175,90,6334,138134,43,2456,29911,1596995,76.85,59308690,46.754,27.3,5.344,12294.876,200.38,5.52,0.699,4
175,91,6130,144264,73,2529,33013,1630008,76.85,59308690,46.754,27.3,5.344,12294.876,200.38,5.52,0.699,4
175,92,6945,151209,128,2657,36931,1666939,76.85,59308690,46.754,27.3,5.344,12294.876,200.38,5.52,0.699,4
175,93,8124,159333,92,2749,39188,1706127,76.85,59308690,46.754,27.3,5.344,12294.876,200.38,5.52,0.699,4
175,94,8728,168061,95,2844,39026,1745153,76.85,59308690,46.754,27.3,5.344,12294.876,200.38,5.52,0.699,4
175,95,9063,177124,108,2952,46925,1792078,76.85,59308690,46.754,27.3,5.344,12294.876,200.38,5.52,0.699,4
175,96,10853,187977,74,3026,38083,1830161,76.85,59308690,46.754,27.3,5.344,12294.876,200.38,5.52,0.699,4
175,97,8773,196750,173,3199,33950,1864111,76.85,59308690,46.754,27.3,5.344,12294.876,200.38,5.52,0.699,4
175,98,8971,205721,111,3310,43421,1907532,76.85,59308690,46.754,27.3,5.344,12294.876,200.38,5.52,0.699,4
175,99,10134,215855,192,3502,36867,1944399,76.85,59308690,46.754,27.3,5.344,12294.876,200.38,5.52,0.699,4
175,100,8810,224665,100,3602,56170,2000569,76.85,59308690,46.754,27.3,5.344,12294.876,200.38,5.52,0.699,4
175,101,13674,238339,118,3720,56663,2057232,76.85,59308690,46.754,27.3,5.344,12294.876,200.38,5.52,0.699,4
175,102,12348,250687,140,3860,51338,2108570,76.85,59308690,46.754,27.3,5.344,12294.876,200.38,5.52,0.699,4
175,103,13497,264184,111,3971,45821,2154391,80.56,59308690,46.754,27.3,5.344,12294.876,200.38,5.52,0.699,4
175,104,12058,276242,108,4079,40233,2194624,80.56,59308690,46.754,27.3,5.344,12294.876,200.38,5.52,0.699,4
175,105,11554,287796,93,4172,38114,2232738,80.56,59308690,46.754,27.3,5.344,12294.876,200.38,5.52,0.699,4
175,106,10496,298292,174,4346,45389,2278127,80.56,59308690,46.754,27.3,5.344,12294.876,200.38,5.52,0.699,4
175,107,12757,311049,107,4453,46796,2324923,80.56,59308690,46.754,27.3,5.344,12294.876,200.38,5.52,0.699,4
175,108,13172,324221,216,4669,48130,2373053,80.56,59308690,46.754,27.3,5.344,12294.876,200.38,5.52,0.699,4
175,109,13373,337594,135,4804,49688,2422741,80.56,59308690,46.754,27.3,5.344,12294.876,200.38,5.52,0.699,4
175,110,13285,350879,144,4948,49006,2471747,80.56,59308690,46.754,27.3,5.344,12294.876,200.38,5.52,0.699,4
175,111,13449,364328,85,5033,33899,2505646,80.56,59308690,46.754,27.3,5.344,12294.876,200.38,5.52,0.699,4
175,112,9300,373628,140,5173,31275,2536921,80.56,59308690,46.754,27.3,5.344,12294.876,200.38,5.52,0.699,4
175,113,8170,381798,195,5368,48553,2585474,80.56,59308690,46.754,27.3,5.344,12294.876,200.38,5.52,0.699,4
175,114,13150,394948,572,5940,46632,2632106,80.56,59308690,46.754,27.3,5.344,12294.876,200.38,5.52,0.699,4
175,115,13104,408052,153,6093,52382,2684488,80.56,59308690,46.754,27.3,5.344,12294.876,200.38,5.52,0.699,4
175,116,13944,421996,250,6343,46324,2730812,80.56,59308690,46.754,27.3,5.344,12294.876,200.38,5.52,0.699,4
175,117,12204,434200,312,6655,42966,2773778,80.56,59308690,46.754,27.3,5.344,12294.876,200.38,5.52,0.699,4
175,118,11233,445433,114,6769,28433,2802211,80.56,59308690,46.754,27.3,5.344,12294.876,200.38,5.52,0.699,4
175,119,7096,452529,298,7067,28424,2830635,80.56,59308690,46.754,27.3,5.344,12294.876,200.38,5.52,0.699,4
175,120,7232,459761,190,7257,42528,2873163,80.56,59308690,46.754,27.3,5.344,12294.876,200.38,5.52,0.699,4
175,121,11362,471123,240,7497,44886,2918049,80.56,59308690,46.754,27.3,5.344,12294.876,200.38,5.52,0.699,4
175,122,11046,482169,315,7812,41486,2959535,80.56,59308690,46.754,27.3,5.344,12294.876,200.38,5.52,0.699,4
175,123,11014,493183,193,8005,42450,3001985,80.56,59308690,46.754,27.3,5.344,12294.876,200.38,5.52,0.699,4
175,124,10107,503290,148,8153,34794,3036779,80.56,59308690,46.754,27.3,5.344,12294.876,200.38,5.52,0.699,4
175,125,8195,511485,213,8366,21916,3058695,80.56,59308690,46.754,27.3,5.344,12294.876,200.38,5.52,0.699,4
175,126,5377,516862,173,8539,19507,3078202,80.56,59308690,46.754,27.3,5.344,12294.876,200.38,5.52,0.699,4
175,127,4456,521318,345,8884,34989,3113191,80.56,59308690,46.754,27.3,5.344,12294.876,200.38,5.52,0.699,4
175,128,8559,529877,414,9298,36616,3149807,80.56,59308690,46.754,27.3,5.344,12294.876,200.38,5.52,0.699,4
175,129,8307,538184,306,9604,33851,3183658,80.56,59308690,46.754,27.3,5.344,12294.876,200.38,5.52,0.699,4
175,130,7292,545476,305,9909,36607,3220265,80.56,59308690,46.754,27.3,5.344,12294.876,200.38,5.52,0.699,4
175,131,7712,553188,301,10210,30318,3250583,80.56,59308690,46.754,27.3,5.344,12294.876,200.38,5.52,0.699,4
175,132,6670,559858,198,10408,16911,3267494,80.56,59308690,46.754,27.3,5.344,12294.876,200.38,5.52,0.699,4
175,133,3740,563598,213,10621,11483,3278977,80.56,59308690,46.754,27.3,5.344,12294.876,200.38,5.52,0.699,4
175,134,2511,566109,130,10751,16457,3295434,80.56,59308690,46.754,27.3,5.344,12294.876,200.38,5.52,0.699,4
175,135,2810,568919,259,11010,20063,3315497,80.56,59308690,46.754,27.3,5.344,12294.876,200.38,5.52,0.699,4
175,136,3946,572865,260,11270,35614,3351111,80.56,59308690,46.754,27.3,5.344,12294.876,200.38,5.52,0.699,4
175,137,6275,579140,286,11556,26918,3378029,80.56,59308690,46.754,27.3,5.344,12294.876,200.38,5.52,0.699,4
175,138,4513,583653,121,11677,22609,3400638,80.56,59308690,46.754,27.3,5.344,12294.876,200.38,5.52,0.699,4
175,139,3692,587345,162,11839,15032,3415670,80.56,59308690,46.754,27.3,5.344,12294.876,200.38,5.52,0.699,4
175,140,2541,589886,143,11982,14677,3430347,77.78,59308690,46.754,27.3,5.344,12294.876,200.38,5.52,0.699,4
175,141,2258,592144,282,12264,25324,3455671,77.78,59308690,46.754,27.3,5.344,12294.876,200.38,5.52,0.699,4
175,142,3916,596060,159,12423,24612,3480283,77.78,59308690,46.754,27.3,5.344,12294.876,200.38,5.52,0.699,4
175,143,3880,599940,195,12618,24224,3504507,77.78,59308690,46.754,27.3,5.344,12294.876,200.38,5.52,0.699,4
175,144,3398,603338,225,12843,30560,3535067,77.78,59308690,46.754,27.3,5.344,12294.876,200.38,5.52,0.699,4
175,145,3707,607045,144,12987,18358,3553425,77.78,59308690,46.754,27.3,5.344,12294.876,200.38,5.52,0.699,4
175,146,2728,609773,72,13059,10640,3564065,72.22,59308690,46.754,27.3,5.344,12294.876,200.38,5.52,0.699,4
175,147,1677,611450,100,13159,14771,3578836,72.22,59308690,46.754,27.3,5.344,12294.876,200.38,5.52,0.699,4
175,148,1567,613017,149,13308,20137,3598973,72.22,59308690,46.754,27.3,5.344,12294.876,200.38,5.52,0.699,4
175,149,2684,615701,194,13502,19009,3617982,72.22,59308690,46.754,27.3,5.344,12294.876,200.38,5.52,0.699,4
175,150,2585,618286,126,13628,14329,3632311,72.22,59308690,46.754,27.3,5.344,12294.876,200.38,5.52,0.699,4
175,151,1837,620123,115,13743,20659,3652970,72.22,59308690,46.754,27.3,5.344,12294.876,200.38,5.52,0.699,4
175,152,2428,622551,238,13981,21902,3674872,72.22,59308690,46.754,27.3,5.344,12294.876,200.38,5.52,0.699,4
175,153,2505,625056,47,14028,18849,3693721,72.22,59308690,46.754,27.3,5.344,12294.876,200.38,5.52,0.699,4
175,154,1985,627041,121,14149,11687,3705408,72.22,59308690,46.754,27.3,5.344,12294.876,200.38,5.52,0.699,4
175,155,1218,628259,114,14263,21313,3726721,72.22,59308690,46.754,27.3,5.344,12294.876,200.38,5.52,0.699,4
175,156,2336,630595,126,14389,20380,3747101,72.22,59308690,46.754,27.3,5.344,12294.876,200.38,5.52,0.699,4
175,157,2420,633015,174,14563,18599,3765700,72.22,59308690,46.754,27.3,5.344,12294.876,200.38,5.52,0.699,4
175,158,2063,635078,115,14678,18123,3783823,72.22,59308690,46.754,27.3,5.344,12294.876,200.38,5.52,0.699,4
175,159,1806,636884,101,14779,16367,3800190,72.22,59308690,46.754,27.3,5.344,12294.876,200.38,5.52,0.699,4
175,160,1633,638517,110,14889,8759,3808949,72.22,59308690,46.754,27.3,5.344,12294.876,200.38,5.52,0.699,4
175,161,845,639362,115,15004,12213,3821162,72.22,59308690,46.754,27.3,5.344,12294.876,200.38,5.52,0.699,4
175,162,1079,640441,82,15086,21736,3842898,72.22,59308690,46.754,27.3,5.344,12294.876,200.38,5.52,0.699,4
175,163,1990,642431,82,15168,20555,3863453,72.22,59308690,46.754,27.3,5.344,12294.876,200.38,5.52,0.699,4
175,164,2007,644438,97,15265,20713,3884166,72.22,59308690,46.754,27.3,5.344,12294.876,200.38,5.52,0.699,4
175,165,1960,646398,113,15378,18620,3902786,72.22,59308690,46.754,27.3,5.344,12294.876,200.38,5.52,0.699,4
175,166,1816,648214,49,15427,15692,3918478,72.22,59308690,46.754,27.3,5.344,12294.876,200.38,5.52,0.699,4
175,167,1579,649793,20,15447,10136,3928614,72.22,59308690,46.754,27.3,5.344,12294.876,200.38,5.52,0.699,4
175,168,956,650749,52,15499,11603,3940217,72.22,59308690,46.754,27.3,5.344,12294.876,200.38,5.52,0.699,4
175,169,772,651521,142,15641,20962,3961179,72.22,59308690,46.754,27.3,5.344,12294.876,200.38,5.52,0.699,4
175,170,1923,653444,64,15705,22354,3983533,72.22,59308690,46.754,27.3,5.344,12294.876,200.38,5.52,0.699,4
175,171,2128,655572,67,15772,20057,4003590,72.22,59308690,46.754,27.3,5.344,12294.876,200.38,5.52,0.699,4
175,172,2055,657627,85,15857,21069,4024659,72.22,59308690,46.754,27.3,5.344,12294.876,200.38,5.52,0.699,4
175,173,2029,659656,83,15940,16884,4041543,44.44,59308690,46.754,27.3,5.344,12294.876,200.38,5.52,0.699,4
175,174,1555,661211,13,15953,6180,4047723,44.44,59308690,46.754,27.3,5.344,12294.876,200.38,5.52,0.699,4
175,175,725,661936,39,15992,16394,4064117,44.44,59308690,46.754,27.3,5.344,12294.876,200.38,5.52,0.699,4
175,176,1346,663282,126,16118,19640,4083757,44.44,59308690,46.754,27.3,5.344,12294.876,200.38,5.52,0.699,4
175,177,1906,665188,88,16206,18405,4102162,44.44,59308690,46.754,27.3,5.344,12294.876,200.38,5.52,0.699,4
175,178,1861,667049,77,16283,14917,4117079,44.44,59308690,46.754,27.3,5.344,12294.876,200.38,5.52,0.699,4
175,179,1480,668529,29,16312,11359,4128438,44.44,59308690,46.754,27.3,5.344,12294.876,200.38,5.52,0.699,4
175,180,969,669498,64,16376,15028,4143466,44.44,59308690,46.754,27.3,5.344,12294.876,200.38,5.52,0.699,4
175,181,1268,670766,22,16398,9014,4152480,44.44,59308690,46.754,27.3,5.344,12294.876,200.38,5.52,0.699,4
175,182,903,671669,188,16586,12011,4164491,44.44,59308690,46.754,27.3,5.344,12294.876,200.38,5.52,0.699,4
175,183,903,672572,81,16667,23426,4187917,44.44,59308690,46.754,27.3,5.344,12294.876,200.38,5.52,0.699,4
175,184,1767,674339,67,16734,21132,4209049,39.81,59308690,46.754,27.3,5.344,12294.876,200.38,5.52,0.699,4
175,185,1745,676084,132,16866,20660,4229709,39.81,59308690,46.754,27.3,5.344,12294.876,200.38,5.52,0.699,4
175,186,1749,677833,43,16909,21804,4251513,39.81,59308690,46.754,27.3,5.344,12294.876,200.38,5.52,0.699,4
175,187,1883,679716,29,16938,18113,4269626,39.81,59308690,46.754,27.3,5.344,12294.876,200.38,5.52,0.699,4
175,188,1573,681289,38,16976,10714,4280340,39.81,59308690,46.754,27.3,5.344,12294.876,200.38,5.52,0.699,4
175,189,926,682215,40,17016,14591,4294931,39.81,59308690,46.754,27.3,5.344,12294.876,200.38,5.52,0.699,4
175,190,1027,683242,87,17103,23583,4318514,39.81,59308690,46.754,27.3,5.344,12294.876,200.38,5.52,0.699,4
175,191,1913,685155,145,17248,21172,4339686,39.81,59308690,46.754,27.3,5.344,12294.876,200.38,5.52,0.699,4
175,192,1736,686891,160,17408,20419,4360105,39.81,59308690,46.754,27.3,5.344,12294.876,200.38,5.52,0.699,4
175,193,1641,688532,139,17547,28066,4388171,39.81,59308690,46.754,27.3,5.344,12294.876,200.38,5.52,0.699,4
175,194,2364,690896,126,17673,19270,4407441,39.81,59308690,46.754,27.3,5.344,12294.876,200.38,5.52,0.699,4
175,195,1575,692471,107,17780,10977,4418418,39.81,59308690,46.754,27.3,5.344,12294.876,200.38,5.52,0.699,4
175,196,0,692471,0,17780,15534,4433952,39.81,59308690,46.754,27.3,5.344,12294.876,200.38,5.52,0.699,4
175,197,2066,694537,248,18028,24793,4458745,39.81,59308690,46.754,27.3,5.344,12294.876,200.38,5.52,0.699,4
175,198,1877,696414,123,18151,0,4458745,39.81,59308690,46.754,27.3,5.344,12294.876,200.38,5.52,0.699,4
175,199,1770,698184,158,18309,0,4505533,39.81,59308690,46.754,27.3,5.344,12294.876,200.38,5.52,0.699,4
175,200,2019,700203,61,18370,22608,4528141,39.81,59308690,46.754,27.3,5.344,12294.876,200.38,5.52,0.699,4
175,201,1928,702131,38,18408,21337,4549478,39.81,59308690,46.754,27.3,5.344,12294.876,200.38,5.52,0.699,4
175,202,1662,703793,63,18471,0,4549478,39.81,59308690,46.754,27.3,5.344,12294.876,200.38,5.52,0.699,4
175,203,1461,705254,21,18492,0,4549478,39.81,59308690,46.754,27.3,5.344,12294.876,200.38,5.52,0.699,4
175,204,1050,706304,164,18656,0,4549478,39.81,59308690,46.754,27.3,5.344,12294.876,200.38,5.52,0.699,4
176,1,0,9786,0,163,11290,404962,75.93,51269183,527.967,43.4,13.914,35938.374,85.998,6.8,0.903,4
176,2,190,9976,6,169,8896,413858,75.93,51269183,527.967,43.4,13.914,35938.374,85.998,6.8,0.903,4
176,3,86,10062,5,174,10507,424365,75.93,51269183,527.967,43.4,13.914,35938.374,85.998,6.8,0.903,4
176,4,94,10156,3,177,0,424365,78.7,51269183,527.967,43.4,13.914,35938.374,85.998,6.8,0.903,4
176,5,81,10237,6,183,0,441662,78.7,51269183,527.967,43.4,13.914,35938.374,85.998,6.8,0.903,4
176,6,47,10284,3,186,5847,447509,82.41,51269183,527.967,43.4,13.914,35938.374,85.998,6.8,0.903,4
176,7,47,10331,6,192,9145,456654,82.41,51269183,527.967,43.4,13.914,35938.374,85.998,6.8,0.903,4
176,8,53,10384,8,200,11491,468145,82.41,51269183,527.967,43.4,13.914,35938.374,85.998,6.8,0.903,4
176,9,39,10423,4,204,11057,479202,82.41,51269183,527.967,43.4,13.914,35938.374,85.998,6.8,0.903,4
176,10,27,10450,4,208,8551,487753,82.41,51269183,527.967,43.4,13.914,35938.374,85.998,6.8,0.903,4
176,11,0,10450,0,208,8656,496409,82.41,51269183,527.967,43.4,13.914,35938.374,85.998,6.8,0.903,4
176,12,62,10512,6,214,4424,500833,82.41,51269183,527.967,43.4,13.914,35938.374,85.998,6.8,0.903,4
176,13,25,10537,3,217,4519,505352,82.41,51269183,527.967,43.4,13.914,35938.374,85.998,6.8,0.903,4
176,14,27,10564,5,222,7435,512787,82.41,51269183,527.967,43.4,13.914,35938.374,85.998,6.8,0.903,4
176,15,27,10591,3,225,6739,519526,82.41,51269183,527.967,43.4,13.914,35938.374,85.998,6.8,0.903,4
176,16,22,10613,4,229,4981,524507,82.41,51269183,527.967,43.4,13.914,35938.374,85.998,6.8,0.903,4
176,17,22,10635,1,230,7770,532277,82.41,51269183,527.967,43.4,13.914,35938.374,85.998,6.8,0.903,4
176,18,18,10653,2,232,0,532277,73.15,51269183,527.967,43.4,13.914,35938.374,85.998,6.8,0.903,4
176,19,8,10661,2,234,0,546866,73.15,51269183,527.967,43.4,13.914,35938.374,85.998,6.8,0.903,4
176,20,13,10674,2,236,4188,551054,43.52,51269183,527.967,43.4,13.914,35938.374,85.998,6.8,0.903,4
176,21,9,10683,1,237,7239,558293,43.52,51269183,527.967,43.4,13.914,35938.374,85.998,6.8,0.903,4
176,22,11,10694,1,238,7545,565838,43.52,51269183,527.967,43.4,13.914,35938.374,85.998,6.8,0.903,4
176,23,8,10702,2,240,7994,573832,43.52,51269183,527.967,43.4,13.914,35938.374,85.998,6.8,0.903,4
176,24,6,10708,0,240,6088,579920,43.52,51269183,527.967,43.4,13.914,35938.374,85.998,6.8,0.903,4
176,25,10,10718,0,240,0,579920,43.52,51269183,527.967,43.4,13.914,35938.374,85.998,6.8,0.903,4
176,26,10,10728,2,242,0,579920,43.52,51269183,527.967,43.4,13.914,35938.374,85.998,6.8,0.903,4
176,27,10,10738,1,243,0,592765,43.52,51269183,527.967,43.4,13.914,35938.374,85.998,6.8,0.903,4
176,28,14,10752,1,244,6546,599311,43.52,51269183,527.967,43.4,13.914,35938.374,85.998,6.8,0.903,4
176,29,9,10761,2,246,6579,605890,43.52,51269183,527.967,43.4,13.914,35938.374,85.998,6.8,0.903,4
176,30,4,10765,1,247,0,605890,43.52,51269183,527.967,43.4,13.914,35938.374,85.998,6.8,0.903,4
176,31,9,10774,1,248,0,614384,43.52,51269183,527.967,43.4,13.914,35938.374,85.998,6.8,0.903,4
176,32,6,10780,2,250,4682,619066,43.52,51269183,527.967,43.4,13.914,35938.374,85.998,6.8,0.903,4
176,33,13,10793,0,250,3319,622385,43.52,51269183,527.967,43.4,13.914,35938.374,85.998,6.8,0.903,4
176,34,8,10801,2,252,3360,625745,43.52,51269183,527.967,43.4,13.914,35938.374,85.998,6.8,0.903,4
176,35,3,10804,2,254,5634,631379,43.52,51269183,527.967,43.4,13.914,35938.374,85.998,6.8,0.903,4
176,36,2,10806,1,255,3707,635086,43.52,51269183,527.967,43.4,13.914,35938.374,85.998,6.8,0.903,4
176,37,4,10810,1,256,5873,640959,43.52,51269183,527.967,43.4,13.914,35938.374,85.998,6.8,0.903,4
176,38,12,10822,0,256,5037,645996,43.52,51269183,527.967,43.4,13.914,35938.374,85.998,6.8,0.903,4
176,39,18,10840,0,256,4881,650877,43.52,51269183,527.967,43.4,13.914,35938.374,85.998,6.8,0.903,4
176,40,34,10874,0,256,0,650877,43.52,51269183,527.967,43.4,13.914,35938.374,85.998,6.8,0.903,4
176,41,35,10909,0,256,0,657570,43.52,51269183,527.967,43.4,13.914,35938.374,85.998,6.8,0.903,4
176,42,27,10936,2,258,6990,664560,43.52,51269183,527.967,43.4,13.914,35938.374,85.998,6.8,0.903,4
176,43,26,10962,1,259,11781,676341,43.52,51269183,527.967,43.4,13.914,35938.374,85.998,6.8,0.903,4
176,44,29,10991,1,260,14421,690762,43.52,51269183,527.967,43.4,13.914,35938.374,85.998,6.8,0.903,4
176,45,27,11018,0,260,16110,706872,43.52,51269183,527.967,43.4,13.914,35938.374,85.998,6.8,0.903,4
176,46,19,11037,2,262,0,706872,43.52,51269183,527.967,43.4,13.914,35938.374,85.998,6.8,0.903,4
176,47,13,11050,0,262,0,729993,43.52,51269183,527.967,43.4,13.914,35938.374,85.998,6.8,0.903,4
176,48,15,11065,1,263,7125,737118,43.52,51269183,527.967,43.4,13.914,35938.374,85.998,6.8,0.903,4
176,49,13,11078,0,263,11531,748649,43.52,51269183,527.967,43.4,13.914,35938.374,85.998,6.8,0.903,4
176,50,32,11110,0,263,11433,760082,39.81,51269183,527.967,43.4,13.914,35938.374,85.998,6.8,0.903,4
176,51,12,11122,1,264,10513,770595,39.81,51269183,527.967,43.4,13.914,35938.374,85.998,6.8,0.903,4
176,52,20,11142,0,264,11537,782132,39.81,51269183,527.967,43.4,13.914,35938.374,85.998,6.8,0.903,4
176,53,23,11165,2,266,10719,792851,39.81,51269183,527.967,43.4,13.914,35938.374,85.998,6.8,0.903,4
176,54,25,11190,0,266,0,792851,39.81,51269183,527.967,43.4,13.914,35938.374,85.998,6.8,0.903,4
176,55,16,11206,1,267,0,807348,39.81,51269183,527.967,43.4,13.914,35938.374,85.998,6.8,0.903,4
176,56,19,11225,2,269,10083,817431,39.81,51269183,527.967,43.4,13.914,35938.374,85.998,6.8,0.903,4
176,57,40,11265,0,269,14384,831815,39.81,51269183,527.967,43.4,13.914,35938.374,85.998,6.8,0.903,4
176,58,79,11344,0,269,14481,846296,39.81,51269183,527.967,43.4,13.914,35938.374,85.998,6.8,0.903,4
176,59,58,11402,0,269,14267,860563,56.94,51269183,527.967,43.4,13.914,35938.374,85.998,6.8,0.903,4
176,60,39,11441,0,269,16040,876603,56.94,51269183,527.967,43.4,13.914,35938.374,85.998,6.8,0.903,4
176,61,27,11468,1,270,10925,887528,56.94,51269183,527.967,43.4,13.914,35938.374,85.998,6.8,0.903,4
176,62,35,11503,1,271,9805,897333,56.94,51269183,527.967,43.4,13.914,35938.374,85.998,6.8,0.903,4
176,63,38,11541,1,272,13596,910929,56.94,51269183,527.967,43.4,13.914,35938.374,85.998,6.8,0.903,4
176,64,49,11590,1,273,18058,928987,56.94,51269183,527.967,43.4,13.914,35938.374,85.998,6.8,0.903,4
176,65,39,11629,0,273,16672,945659,56.94,51269183,527.967,43.4,13.914,35938.374,85.998,6.8,0.903,4
176,66,39,11668,0,273,16535,962194,56.94,51269183,527.967,43.4,13.914,35938.374,85.998,6.8,0.903,4
176,67,51,11719,0,273,15157,977351,56.94,51269183,527.967,43.4,13.914,35938.374,85.998,6.8,0.903,4
176,68,57,11776,0,273,8937,986288,56.94,51269183,527.967,43.4,13.914,35938.374,85.998,6.8,0.903,4
176,69,38,11814,0,273,7552,993840,56.94,51269183,527.967,43.4,13.914,35938.374,85.998,6.8,0.903,4
176,70,38,11852,1,274,14698,1008538,56.94,51269183,527.967,43.4,13.914,35938.374,85.998,6.8,0.903,4
176,71,50,11902,2,276,17211,1025749,56.94,51269183,527.967,43.4,13.914,35938.374,85.998,6.8,0.903,4
176,72,45,11947,0,276,15645,1041394,56.94,51269183,527.967,43.4,13.914,35938.374,85.998,6.8,0.903,4
176,73,56,12003,1,277,15849,1057243,56.94,51269183,527.967,43.4,13.914,35938.374,85.998,6.8,0.903,4
176,74,48,12051,0,277,14109,1071352,56.94,51269183,527.967,43.4,13.914,35938.374,85.998,6.8,0.903,4
176,75,33,12084,0,277,7620,1078972,56.94,51269183,527.967,43.4,13.914,35938.374,85.998,6.8,0.903,4
176,76,37,12121,0,277,5954,1084926,56.94,51269183,527.967,43.4,13.914,35938.374,85.998,6.8,0.903,4
176,77,34,12155,1,278,12209,1097135,56.94,51269183,527.967,43.4,13.914,35938.374,85.998,6.8,0.903,4
176,78,43,12198,1,279,14199,1111334,56.94,51269183,527.967,43.4,13.914,35938.374,85.998,6.8,0.903,4
176,79,59,12257,1,280,12664,1123998,56.94,51269183,527.967,43.4,13.914,35938.374,85.998,6.8,0.903,4
176,80,49,12306,0,280,12875,1136873,56.94,51269183,527.967,43.4,13.914,35938.374,85.998,6.8,0.903,4
176,81,67,12373,0,280,12558,1149431,56.94,51269183,527.967,43.4,13.914,35938.374,85.998,6.8,0.903,4
176,82,48,12421,0,280,6961,1156392,56.94,51269183,527.967,43.4,13.914,35938.374,85.998,6.8,0.903,4
176,83,17,12438,0,280,6271,1162663,56.94,51269183,527.967,43.4,13.914,35938.374,85.998,6.8,0.903,4
176,84,46,12484,1,281,11071,1173734,56.94,51269183,527.967,43.4,13.914,35938.374,85.998,6.8,0.903,4
176,85,51,12535,0,281,14618,1188352,56.94,51269183,527.967,43.4,13.914,35938.374,85.998,6.8,0.903,4
176,86,28,12563,1,282,13226,1201578,56.94,51269183,527.967,43.4,13.914,35938.374,85.998,6.8,0.903,4
176,87,39,12602,0,282,11909,1213487,56.94,51269183,527.967,43.4,13.914,35938.374,85.998,6.8,0.903,4
176,88,51,12653,0,282,10427,1223914,56.94,51269183,527.967,43.4,13.914,35938.374,85.998,6.8,0.903,4
176,89,62,12715,0,282,8776,1232690,56.94,51269183,527.967,43.4,13.914,35938.374,85.998,6.8,0.903,4
176,90,42,12757,0,282,8765,1241455,56.94,51269183,527.967,43.4,13.914,35938.374,85.998,6.8,0.903,4
176,91,43,12800,0,282,11502,1252957,56.94,51269183,527.967,43.4,13.914,35938.374,85.998,6.8,0.903,4
176,92,50,12850,0,282,12748,1265705,56.94,51269183,527.967,43.4,13.914,35938.374,85.998,6.8,0.903,4
176,93,54,12904,0,282,10475,1276180,56.94,51269183,527.967,43.4,13.914,35938.374,85.998,6.8,0.903,4
176,94,63,12967,0,282,10021,1286201,56.94,51269183,527.967,43.4,13.914,35938.374,85.998,6.8,0.903,4
176,95,63,13030,1,283,11001,1297202,54.17,51269183,527.967,43.4,13.914,35938.374,85.998,6.8,0.903,4
176,96,61,13091,0,283,0,1297202,54.17,51269183,527.967,43.4,13.914,35938.374,85.998,6.8,0.903,4
176,97,0,13091,0,283,0,1310504,54.17,51269183,527.967,43.4,13.914,35938.374,85.998,6.8,0.903,4
176,98,90,13181,2,285,12015,1322519,54.17,51269183,527.967,43.4,13.914,35938.374,85.998,6.8,0.903,4
176,99,63,13244,0,285,13204,1335723,54.17,51269183,527.967,43.4,13.914,35938.374,85.998,6.8,0.903,4
176,100,49,13293,2,287,12136,1347859,54.17,51269183,527.967,43.4,13.914,35938.374,85.998,6.8,0.903,4
176,101,45,13338,1,288,13504,1361363,54.17,51269183,527.967,43.4,13.914,35938.374,85.998,6.8,0.903,4
176,102,35,13373,0,288,0,1361363,48.61,51269183,527.967,43.4,13.914,35938.374,85.998,6.8,0.903,4
176,103,44,13417,1,289,0,1380314,48.61,51269183,527.967,43.4,13.914,35938.374,85.998,6.8,0.903,4
176,104,62,13479,0,289,6153,1386467,48.61,51269183,527.967,43.4,13.914,35938.374,85.998,6.8,0.903,4
176,105,33,13512,0,289,9860,1396327,48.61,51269183,527.967,43.4,13.914,35938.374,85.998,6.8,0.903,4
176,106,39,13551,0,289,11692,1408019,48.61,51269183,527.967,43.4,13.914,35938.374,85.998,6.8,0.903,4
176,107,61,13612,2,291,9925,1417944,48.61,51269183,527.967,43.4,13.914,35938.374,85.998,6.8,0.903,4
176,108,60,13672,2,293,9963,1427907,48.61,51269183,527.967,43.4,13.914,35938.374,85.998,6.8,0.903,4
176,109,39,13711,1,294,9374,1437281,48.61,51269183,527.967,43.4,13.914,35938.374,85.998,6.8,0.903,4
176,110,34,13745,1,295,6065,1443346,48.61,51269183,527.967,43.4,13.914,35938.374,85.998,6.8,0.903,4
176,111,26,13771,1,296,5545,1448891,48.61,51269183,527.967,43.4,13.914,35938.374,85.998,6.8,0.903,4
176,112,45,13816,0,296,9635,1458526,48.61,51269183,527.967,43.4,13.914,35938.374,85.998,6.8,0.903,4
176,113,63,13879,1,297,11794,1470320,48.61,51269183,527.967,43.4,13.914,35938.374,85.998,6.8,0.903,4
176,114,59,13938,0,297,9116,1479436,48.61,51269183,527.967,43.4,13.914,35938.374,85.998,6.8,0.903,4
176,115,41,13979,1,298,10332,1489768,48.61,51269183,527.967,43.4,13.914,35938.374,85.998,6.8,0.903,4
176,116,113,14092,0,298,9185,1498953,48.61,51269183,527.967,43.4,13.914,35938.374,85.998,6.8,0.903,4
176,117,58,14150,0,298,4759,1503712,48.61,51269183,527.967,43.4,13.914,35938.374,85.998,6.8,0.903,4
176,118,25,14175,1,299,4492,1508204,48.61,51269183,527.967,43.4,13.914,35938.374,85.998,6.8,0.903,4
176,119,28,14203,1,300,9056,1517260,48.61,51269183,527.967,43.4,13.914,35938.374,85.998,6.8,0.903,4
176,120,48,14251,0,300,10721,1527981,48.61,51269183,527.967,43.4,13.914,35938.374,85.998,6.8,0.903,4
176,121,18,14269,0,300,9216,1537197,48.61,51269183,527.967,43.4,13.914,35938.374,85.998,6.8,0.903,4
176,122,36,14305,1,301,8269,1545466,48.61,51269183,527.967,43.4,13.914,35938.374,85.998,6.8,0.903,4
176,123,31,14336,0,301,8086,1553552,48.61,51269183,527.967,43.4,13.914,35938.374,85.998,6.8,0.903,4
176,124,0,14336,0,301,4926,1558478,48.61,51269183,527.967,43.4,13.914,35938.374,85.998,6.8,0.903,4
176,125,53,14389,0,301,3878,1562356,48.61,51269183,527.967,43.4,13.914,35938.374,85.998,6.8,0.903,4
176,126,34,14423,0,301,8700,1571056,48.61,51269183,527.967,43.4,13.914,35938.374,85.998,6.8,0.903,4
176,127,33,14456,1,302,8641,1579697,48.61,51269183,527.967,43.4,13.914,35938.374,85.998,6.8,0.903,4
176,128,43,14499,0,302,8759,1588456,48.61,51269183,527.967,43.4,13.914,35938.374,85.998,6.8,0.903,4
176,129,20,14519,1,303,8128,1596584,48.61,51269183,527.967,43.4,13.914,35938.374,85.998,6.8,0.903,4
176,130,43,14562,1,304,7825,1604409,48.61,51269183,527.967,43.4,13.914,35938.374,85.998,6.8,0.903,4
176,131,36,14598,1,305,3438,1607847,48.61,51269183,527.967,43.4,13.914,35938.374,85.998,6.8,0.903,4
176,132,28,14626,0,305,4060,1611907,48.61,51269183,527.967,43.4,13.914,35938.374,85.998,6.8,0.903,4
176,133,34,14660,0,305,8448,1620355,48.61,51269183,527.967,43.4,13.914,35938.374,85.998,6.8,0.903,4
176,134,54,14714,0,305,8922,1629277,48.61,51269183,527.967,43.4,13.914,35938.374,85.998,6.8,0.903,4
176,135,56,14770,0,305,7823,1637100,48.61,51269183,527.967,43.4,13.914,35938.374,85.998,6.8,0.903,4
176,136,103,14873,0,305,7852,1644952,48.61,51269183,527.967,43.4,13.914,35938.374,85.998,6.8,0.903,4
176,137,166,15039,0,305,8726,1653678,48.61,51269183,527.967,43.4,13.914,35938.374,85.998,6.8,0.903,4
176,138,279,15318,0,305,6104,1659782,54.17,51269183,527.967,43.4,13.914,35938.374,85.998,6.8,0.903,4
176,139,197,15515,0,305,5724,1665506,54.17,51269183,527.967,43.4,13.914,35938.374,85.998,6.8,0.903,4
176,140,246,15761,1,306,6317,1671823,54.17,51269183,527.967,43.4,13.914,35938.374,85.998,6.8,0.903,4
176,141,297,16058,0,306,12219,1684042,54.17,51269183,527.967,43.4,13.914,35938.374,85.998,6.8,0.903,4
176,142,288,16346,1,307,15043,1699085,54.17,51269183,527.967,43.4,13.914,35938.374,85.998,6.8,0.903,4
176,143,324,16670,2,309,16993,1716078,54.17,51269183,527.967,43.4,13.914,35938.374,85.998,6.8,0.903,4
176,144,332,17002,0,309,17295,1733373,54.17,51269183,527.967,43.4,13.914,35938.374,85.998,6.8,0.903,4
176,145,397,17399,0,309,10249,1743622,54.17,51269183,527.967,43.4,13.914,35938.374,85.998,6.8,0.903,4
176,146,266,17665,0,309,12805,1756427,54.17,51269183,527.967,43.4,13.914,35938.374,85.998,6.8,0.903,4
176,147,280,17945,1,310,19048,1775475,54.17,51269183,527.967,43.4,13.914,35938.374,85.998,6.8,0.903,4
176,148,320,18265,2,312,21236,1796711,54.17,51269183,527.967,43.4,13.914,35938.374,85.998,6.8,0.903,4
176,149,441,18706,1,313,20827,1817538,54.17,51269183,527.967,43.4,13.914,35938.374,85.998,6.8,0.903,4
176,150,371,19077,3,316,19468,1837006,54.17,51269183,527.967,43.4,13.914,35938.374,85.998,6.8,0.903,4
176,151,323,19400,5,321,18277,1855283,54.17,51269183,527.967,43.4,13.914,35938.374,85.998,6.8,0.903,4
176,152,299,19699,2,323,10866,1866149,54.17,51269183,527.967,43.4,13.914,35938.374,85.998,6.8,0.903,4
176,153,248,19947,1,324,13664,1879813,54.17,51269183,527.967,43.4,13.914,35938.374,85.998,6.8,0.903,4
176,154,235,20182,0,324,22524,1902337,54.17,51269183,527.967,43.4,13.914,35938.374,85.998,6.8,0.903,4
176,155,267,20449,2,326,21210,1923547,54.17,51269183,527.967,43.4,13.914,35938.374,85.998,6.8,0.903,4
176,156,195,20644,3,329,21481,1945028,54.17,51269183,527.967,43.4,13.914,35938.374,85.998,6.8,0.903,4
176,157,198,20842,2,331,0,1945028,54.17,51269183,527.967,43.4,13.914,35938.374,85.998,6.8,0.903,4
176,158,0,20842,0,331,0,1984968,54.17,51269183,527.967,43.4,13.914,35938.374,85.998,6.8,0.903,4
176,159,335,21177,3,334,11346,1996314,54.17,51269183,527.967,43.4,13.914,35938.374,85.998,6.8,0.903,4
176,160,119,21296,2,336,7874,2004188,54.17,51269183,527.967,43.4,13.914,35938.374,85.998,6.8,0.903,4
176,161,136,21432,5,341,18520,2022708,54.17,51269183,527.967,43.4,13.914,35938.374,85.998,6.8,0.903,4
176,162,156,21588,3,344,22993,2045701,54.17,51269183,527.967,43.4,13.914,35938.374,85.998,6.8,0.903,4
176,163,155,21743,2,346,20872,2066573,54.17,51269183,527.967,43.4,13.914,35938.374,85.998,6.8,0.903,4
176,164,176,21919,4,350,23215,2089788,54.17,51269183,527.967,43.4,13.914,35938.374,85.998,6.8,0.903,4
176,165,136,22055,5,355,17843,2107631,54.17,51269183,527.967,43.4,13.914,35938.374,85.998,6.8,0.903,4
176,166,121,22176,3,358,7934,2115565,54.17,51269183,527.967,43.4,13.914,35938.374,85.998,6.8,0.903,4
176,167,109,22285,5,363,7961,2123526,54.17,51269183,527.967,43.4,13.914,35938.374,85.998,6.8,0.903,4
176,168,106,22391,4,367,13742,2137268,54.17,51269183,527.967,43.4,13.914,35938.374,85.998,6.8,0.903,4
176,169,113,22504,0,367,15722,2152990,54.17,51269183,527.967,43.4,13.914,35938.374,85.998,6.8,0.903,4
176,170,153,22657,5,372,13394,2166384,54.17,51269183,527.967,43.4,13.914,35938.374,85.998,6.8,0.903,4
176,171,126,22783,5,377,14578,2180962,54.17,51269183,527.967,43.4,13.914,35938.374,85.998,6.8,0.903,4
176,172,110,22893,1,378,13495,2194457,54.17,51269183,527.967,43.4,13.914,35938.374,85.998,6.8,0.903,4
176,173,82,22975,5,383,7970,2202427,54.17,51269183,527.967,43.4,13.914,35938.374,85.998,6.8,0.903,4
176,174,70,23045,2,385,6626,2209053,54.17,51269183,527.967,43.4,13.914,35938.374,85.998,6.8,0.903,4
176,175,61,23106,3,388,12837,2221890,54.17,51269183,527.967,43.4,13.914,35938.374,85.998,6.8,0.903,4
176,176,110,23216,0,388,14482,2236372,54.17,51269183,527.967,43.4,13.914,35938.374,85.998,6.8,0.903,4
176,177,125,23341,5,393,11845,2248217,54.17,51269183,527.967,43.4,13.914,35938.374,85.998,6.8,0.903,4
176,178,114,23455,2,395,12484,2260701,54.17,51269183,527.967,43.4,13.914,35938.374,85.998,6.8,0.903,4
176,179,61,23516,4,399,11136,2271837,57.41,51269183,527.967,43.4,13.914,35938.374,85.998,6.8,0.903,4
176,180,95,23611,2,401,5802,2277639,57.41,51269183,527.967,43.4,13.914,35938.374,85.998,6.8,0.903,4
176,181,50,23661,5,406,5077,2282716,54.63,51269183,527.967,43.4,13.914,35938.374,85.998,6.8,0.903,4
176,182,38,23699,1,407,10272,2292988,54.63,51269183,527.967,43.4,13.914,35938.374,85.998,6.8,0.903,4
176,183,113,23812,6,413,9415,2302403,54.63,51269183,527.967,43.4,13.914,35938.374,85.998,6.8,0.903,4
176,184,0,23812,0,413,6003,2308406,54.63,51269183,527.967,43.4,13.914,35938.374,85.998,6.8,0.903,4
176,185,140,23952,3,416,5376,2313782,56.48,51269183,527.967,43.4,13.914,35938.374,85.998,6.8,0.903,4
176,186,75,24027,4,420,4790,2318572,59.26,51269183,527.967,43.4,13.914,35938.374,85.998,6.8,0.903,4
176,187,64,24091,1,421,5657,2324229,56.48,51269183,527.967,43.4,13.914,35938.374,85.998,6.8,0.903,4
176,188,73,24164,1,422,5702,2329931,56.48,51269183,527.967,43.4,13.914,35938.374,85.998,6.8,0.903,4
176,189,75,24239,0,422,12765,2342696,56.48,51269183,527.967,43.4,13.914,35938.374,85.998,6.8,0.903,4
176,190,114,24353,3,425,13239,2355935,56.48,51269183,527.967,43.4,13.914,35938.374,85.998,6.8,0.903,4
176,191,69,24422,2,427,11931,2367866,56.48,51269183,527.967,43.4,13.914,35938.374,85.998,6.8,0.903,4
176,192,54,24476,1,428,11668,2379534,56.48,51269183,527.967,43.4,13.914,35938.374,85.998,6.8,0.903,4
176,193,72,24548,2,430,6168,2385702,56.48,51269183,527.967,43.4,13.914,35938.374,85.998,6.8,0.903,4
176,194,58,24606,2,432,5478,2391180,56.48,51269183,527.967,43.4,13.914,35938.374,85.998,6.8,0.903,4
176,195,97,24703,1,433,5238,2396418,55.09,51269183,527.967,43.4,13.914,35938.374,85.998,6.8,0.903,4
176,196,102,24805,1,434,12229,2408647,55.09,51269183,527.967,43.4,13.914,35938.374,85.998,6.8,0.903,4
176,197,84,24889,4,438,14411,2423058,55.09,51269183,527.967,43.4,13.914,35938.374,85.998,6.8,0.903,4
176,198,99,24988,1,439,9419,2432477,55.09,51269183,527.967,43.4,13.914,35938.374,85.998,6.8,0.903,4
176,199,47,25035,2,441,9594,2442071,55.09,51269183,527.967,43.4,13.914,35938.374,85.998,6.8,0.903,4
176,200,73,25108,2,443,9138,2451209,55.09,51269183,527.967,43.4,13.914,35938.374,85.998,6.8,0.903,4
176,201,91,25199,1,444,5539,2456748,55.09,51269183,527.967,43.4,13.914,35938.374,85.998,6.8,0.903,4
176,202,76,25275,0,444,5715,2462463,55.09,51269183,527.967,43.4,13.914,35938.374,85.998,6.8,0.903,4
176,203,58,25333,3,447,9469,2471932,55.09,51269183,527.967,43.4,13.914,35938.374,85.998,6.8,0.903,4
176,204,91,25424,3,450,0,2471932,55.09,51269183,527.967,43.4,13.914,35938.374,85.998,6.8,0.903,4
178,1,7413,111680,849,8189,0,0,85.19,46754783,93.105,45.5,19.436,34272.36,99.403,7.17,0.891,4
178,2,7583,119263,864,9053,0,0,85.19,46754783,93.105,45.5,19.436,34272.36,99.403,7.17,0.891,4
178,3,7272,126535,950,10003,0,0,85.19,46754783,93.105,45.5,19.436,34272.36,99.403,7.17,0.891,4
178,4,6663,133198,932,10935,0,0,85.19,46754783,93.105,45.5,19.436,34272.36,99.403,7.17,0.891,4
178,5,5533,138731,809,11744,0,0,85.19,46754783,93.105,45.5,19.436,34272.36,99.403,7.17,0.891,4
178,6,3667,142398,674,12418,0,0,85.19,46754783,93.105,45.5,19.436,34272.36,99.403,7.17,0.891,4
178,7,5209,147607,637,13055,0,0,85.19,46754783,93.105,45.5,19.436,34272.36,99.403,7.17,0.891,4
178,8,5583,153190,743,13798,0,0,85.19,46754783,93.105,45.5,19.436,34272.36,99.403,7.17,0.891,4
178,9,5745,158935,757,14555,0,0,85.19,46754783,93.105,45.5,19.436,34272.36,99.403,7.17,0.891,4
178,10,4537,163472,683,15238,0,0,85.19,46754783,93.105,45.5,19.436,34272.36,99.403,7.17,0.891,4
178,11,4550,168022,605,15843,0,0,85.19,46754783,93.105,45.5,19.436,34272.36,99.403,7.17,0.891,4
178,12,3899,171921,510,16353,0,0,85.19,46754783,93.105,45.5,19.436,34272.36,99.403,7.17,0.891,4
178,13,3030,174951,619,16972,0,930230,85.19,46754783,93.105,45.5,19.436,34272.36,99.403,7.17,0.891,4
178,14,3116,178067,517,17489,0,930230,85.19,46754783,93.105,45.5,19.436,34272.36,99.403,7.17,0.891,4
178,15,4424,182491,787,18276,0,930230,85.19,46754783,93.105,45.5,19.436,34272.36,99.403,7.17,0.891,4
178,16,3820,186311,617,18893,0,930230,85.19,46754783,93.105,45.5,19.436,34272.36,99.403,7.17,0.891,4
178,17,3818,190129,585,19478,0,930230,85.19,46754783,93.105,45.5,19.436,34272.36,99.403,7.17,0.891,4
178,18,3836,193965,565,20043,0,930230,85.19,46754783,93.105,45.5,19.436,34272.36,99.403,7.17,0.891,4
178,19,-713,193252,410,20453,0,930230,85.19,46754783,93.105,45.5,19.436,34272.36,99.403,7.17,0.891,4
178,20,2218,195470,399,20852,0,930230,85.19,46754783,93.105,45.5,19.436,34272.36,99.403,7.17,0.891,4
178,21,2951,198421,430,21282,0,930230,85.19,46754783,93.105,45.5,19.436,34272.36,99.403,7.17,0.891,4
178,22,2312,200733,435,21717,0,930230,85.19,46754783,93.105,45.5,19.436,34272.36,99.403,7.17,0.891,4
178,23,2916,203649,440,22157,0,1035522,85.19,46754783,93.105,45.5,19.436,34272.36,99.403,7.17,0.891,4
178,24,2114,205763,367,22524,0,1035522,85.19,46754783,93.105,45.5,19.436,34272.36,99.403,7.17,0.891,4
178,25,2506,208269,378,22902,0,1035522,85.19,46754783,93.105,45.5,19.436,34272.36,99.403,7.17,0.891,4
178,26,1641,209910,288,23190,0,1035522,85.19,46754783,93.105,45.5,19.436,34272.36,99.403,7.17,0.891,4
178,27,1660,211570,0,23190,0,1035522,85.19,46754783,93.105,45.5,19.436,34272.36,99.403,7.17,0.891,4
178,28,1525,213095,632,23822,0,1035522,85.19,46754783,93.105,45.5,19.436,34272.36,99.403,7.17,0.891,4
178,29,847,213942,453,24275,0,1035522,85.19,46754783,93.105,45.5,19.436,34272.36,99.403,7.17,0.891,4
178,30,1241,215183,268,24543,0,1351130,85.19,46754783,93.105,45.5,19.436,34272.36,99.403,7.17,0.891,4
178,31,1387,216570,281,24824,0,1351130,85.19,46754783,93.105,45.5,19.436,34272.36,99.403,7.17,0.891,4
178,32,1234,217804,276,25100,0,1351130,85.19,46754783,93.105,45.5,19.436,34272.36,99.403,7.17,0.891,4
178,33,935,218739,164,25264,0,1351130,85.19,46754783,93.105,45.5,19.436,34272.36,99.403,7.17,0.891,4
178,34,466,219205,164,25428,0,1351130,81.94,46754783,93.105,45.5,19.436,34272.36,99.403,7.17,0.891,4
178,35,1039,220244,185,25613,0,1351130,81.94,46754783,93.105,45.5,19.436,34272.36,99.403,7.17,0.891,4
178,36,880,221124,244,25857,0,1351130,81.94,46754783,93.105,45.5,19.436,34272.36,99.403,7.17,0.891,4
178,37,921,222045,213,26070,0,1625211,81.94,46754783,93.105,45.5,19.436,34272.36,99.403,7.17,0.891,4
178,38,1173,223218,181,26251,0,1625211,81.94,46754783,93.105,45.5,19.436,34272.36,99.403,7.17,0.891,4
178,39,743,223961,227,26478,0,1625211,81.94,46754783,93.105,45.5,19.436,34272.36,99.403,7.17,0.891,4
178,40,3416,227377,143,26621,0,1625211,81.94,46754783,93.105,45.5,19.436,34272.36,99.403,7.17,0.891,4
178,41,393,227770,123,26744,0,1625211,81.94,46754783,93.105,45.5,19.436,34272.36,99.403,7.17,0.891,4
178,42,482,228252,176,26920,0,1625211,81.94,46754783,93.105,45.5,19.436,34272.36,99.403,7.17,0.891,4
178,43,439,228691,184,27104,0,1625211,83.33,46754783,93.105,45.5,19.436,34272.36,99.403,7.17,0.891,4
178,44,849,229540,217,27321,0,1919411,83.33,46754783,93.105,45.5,19.436,34272.36,99.403,7.17,0.891,4
178,45,643,230183,138,27459,0,1919411,83.33,46754783,93.105,45.5,19.436,34272.36,99.403,7.17,0.891,4
178,46,515,230698,104,27563,0,1919411,83.33,46754783,93.105,45.5,19.436,34272.36,99.403,7.17,0.891,4
178,47,652,231350,87,27650,0,1919411,79.17,46754783,93.105,45.5,19.436,34272.36,99.403,7.17,0.891,4
178,48,256,231606,59,27709,0,1919411,79.17,46754783,93.105,45.5,19.436,34272.36,99.403,7.17,0.891,4
178,49,431,232037,69,27778,0,1919411,79.17,46754783,93.105,45.5,19.436,34272.36,99.403,7.17,0.891,4
178,50,518,232555,110,27888,0,1919411,79.17,46754783,93.105,45.5,19.436,34272.36,99.403,7.17,0.891,4
178,51,482,233037,52,27940,0,2221497,79.17,46754783,93.105,45.5,19.436,34272.36,99.403,7.17,0.891,4
178,52,1787,234824,688,28628,0,2221497,75.46,46754783,93.105,45.5,19.436,34272.36,99.403,7.17,0.891,4
178,53,466,235290,50,28678,0,2221497,75.46,46754783,93.105,45.5,19.436,34272.36,99.403,7.17,0.891,4
178,54,482,235772,74,28752,0,2221497,75.46,46754783,93.105,45.5,19.436,34272.36,99.403,7.17,0.891,4
178,55,-372,235400,-1918,26834,0,2221497,75.46,46754783,93.105,45.5,19.436,34272.36,99.403,7.17,0.891,4
178,56,859,236259,283,27117,0,2221497,71.76,46754783,93.105,45.5,19.436,34272.36,99.403,7.17,0.891,4
178,57,510,236769,1,27118,0,2221497,68.06,46754783,93.105,45.5,19.436,34272.36,99.403,7.17,0.891,4
178,58,1137,237906,1,27119,0,2536234,68.06,46754783,93.105,45.5,19.436,34272.36,99.403,7.17,0.891,4
178,59,658,238564,2,27121,0,2536234,68.06,46754783,93.105,45.5,19.436,34272.36,99.403,7.17,0.891,4
178,60,664,239228,4,27125,0,2536234,68.06,46754783,93.105,45.5,19.436,34272.36,99.403,7.17,0.891,4
178,61,201,239429,2,27127,0,2536234,68.06,46754783,93.105,45.5,19.436,34272.36,99.403,7.17,0.891,4
178,62,209,239638,0,27127,0,2536234,66.67,46754783,93.105,45.5,19.436,34272.36,99.403,7.17,0.891,4
178,63,294,239932,0,27127,0,2536234,66.67,46754783,93.105,45.5,19.436,34272.36,99.403,7.17,0.891,4
178,64,394,240326,1,27128,0,2536234,66.67,46754783,93.105,45.5,19.436,34272.36,99.403,7.17,0.891,4
178,65,334,240660,5,27133,0,2822880,66.67,46754783,93.105,45.5,19.436,34272.36,99.403,7.17,0.891,4
178,66,318,240978,1,27134,0,2822880,66.67,46754783,93.105,45.5,19.436,34272.36,99.403,7.17,0.891,4
178,67,332,241310,1,27135,0,2822880,66.67,46754783,93.105,45.5,19.436,34272.36,99.403,7.17,0.891,4
178,68,240,241550,1,27136,0,2822880,66.67,46754783,93.105,45.5,19.436,34272.36,99.403,7.17,0.891,4
178,69,167,241717,0,27136,0,2822880,57.41,46754783,93.105,45.5,19.436,34272.36,99.403,7.17,0.891,4
178,70,249,241966,0,27136,0,2822880,57.41,46754783,93.105,45.5,19.436,34272.36,99.403,7.17,0.891,4
178,71,314,242280,0,27136,0,2822880,57.41,46754783,93.105,45.5,19.436,34272.36,99.403,7.17,0.891,4
178,72,427,242707,0,27136,0,3061738,57.41,46754783,93.105,45.5,19.436,34272.36,99.403,7.17,0.891,4
178,73,502,243209,0,27136,0,3061738,57.41,46754783,93.105,45.5,19.436,34272.36,99.403,7.17,0.891,4
178,74,396,243605,0,27136,0,3061738,57.41,46754783,93.105,45.5,19.436,34272.36,99.403,7.17,0.891,4
178,75,323,243928,0,27136,0,3061738,57.41,46754783,93.105,45.5,19.436,34272.36,99.403,7.17,0.891,4
178,76,181,244109,0,27136,0,3061738,57.41,46754783,93.105,45.5,19.436,34272.36,99.403,7.17,0.891,4
178,77,219,244328,0,27136,0,3061738,57.41,46754783,93.105,45.5,19.436,34272.36,99.403,7.17,0.891,4
178,78,355,244683,0,27136,0,3061738,57.41,46754783,93.105,45.5,19.436,34272.36,99.403,7.17,0.891,4
178,79,585,245268,0,27136,0,3290388,57.41,46754783,93.105,45.5,19.436,34272.36,99.403,7.17,0.891,4
178,80,307,245575,1179,28315,0,3290388,57.41,46754783,93.105,45.5,19.436,34272.36,99.403,7.17,0.891,4
178,81,363,245938,7,28322,0,3290388,57.41,46754783,93.105,45.5,19.436,34272.36,99.403,7.17,0.891,4
178,82,334,246272,1,28323,0,3290388,39.35,46754783,93.105,45.5,19.436,34272.36,99.403,7.17,0.891,4
178,83,232,246504,1,28324,0,3290388,39.35,46754783,93.105,45.5,19.436,34272.36,99.403,7.17,0.891,4
178,84,248,246752,1,28325,0,3290388,39.35,46754783,93.105,45.5,19.436,34272.36,99.403,7.17,0.891,4
178,85,334,247086,2,28327,0,3290388,39.35,46754783,93.105,45.5,19.436,34272.36,99.403,7.17,0.891,4
178,86,400,247486,3,28330,0,3470130,39.35,46754783,93.105,45.5,19.436,34272.36,99.403,7.17,0.891,4
178,87,419,247905,8,28338,0,3470130,39.35,46754783,93.105,45.5,19.436,34272.36,99.403,7.17,0.891,4
178,88,564,248469,3,28341,0,3470130,39.35,46754783,93.105,45.5,19.436,34272.36,99.403,7.17,0.891,4
178,89,301,248770,2,28343,0,3470130,39.35,46754783,93.105,45.5,19.436,34272.36,99.403,7.17,0.891,4
178,90,200,248970,3,28346,0,3470130,39.35,46754783,93.105,45.5,19.436,34272.36,99.403,7.17,0.891,4
178,91,301,249271,9,28355,0,3470130,39.35,46754783,93.105,45.5,19.436,34272.36,99.403,7.17,0.891,4
178,92,388,249659,8,28363,0,3470130,39.35,46754783,93.105,45.5,19.436,34272.36,99.403,7.17,0.891,4
178,93,444,250103,5,28368,0,3644458,39.35,46754783,93.105,45.5,19.436,34272.36,99.403,7.17,0.891,4
178,94,442,250545,17,28385,0,3644458,39.35,46754783,93.105,45.5,19.436,34272.36,99.403,7.17,0.891,4
178,95,0,250545,0,28385,0,3644458,55.09,46754783,93.105,45.5,19.436,34272.36,99.403,7.17,0.891,4
178,96,0,250545,0,28385,0,3644458,55.09,46754783,93.105,45.5,19.436,34272.36,99.403,7.17,0.891,4
178,97,1244,251789,3,28388,0,3644458,55.09,46754783,93.105,45.5,19.436,34272.36,99.403,7.17,0.891,4
178,98,341,252130,4,28392,0,3644458,55.09,46754783,93.105,45.5,19.436,34272.36,99.403,7.17,0.891,4
178,99,383,252513,4,28396,0,3644458,55.09,46754783,93.105,45.5,19.436,34272.36,99.403,7.17,0.891,4
178,100,543,253056,5,28401,0,3849701,55.09,46754783,93.105,45.5,19.436,34272.36,99.403,7.17,0.891,4
178,101,852,253908,2,28403,0,3849701,55.09,46754783,93.105,45.5,19.436,34272.36,99.403,7.17,0.891,4
178,102,0,253908,0,28403,0,3849701,55.09,46754783,93.105,45.5,19.436,34272.36,99.403,7.17,0.891,4
178,103,0,253908,0,28403,0,3849701,55.09,46754783,93.105,45.5,19.436,34272.36,99.403,7.17,0.891,4
178,104,2045,255953,3,28406,0,3849701,55.09,46754783,93.105,45.5,19.436,34272.36,99.403,7.17,0.891,4
178,105,666,256619,3,28409,0,3849701,55.09,46754783,93.105,45.5,19.436,34272.36,99.403,7.17,0.891,4
178,106,875,257494,4,28413,0,3849701,64.35,46754783,93.105,45.5,19.436,34272.36,99.403,7.17,0.891,4
178,107,1361,258855,3,28416,0,4073664,64.35,46754783,93.105,45.5,19.436,34272.36,99.403,7.17,0.891,4
178,108,1400,260255,4,28420,0,4073664,64.35,46754783,93.105,45.5,19.436,34272.36,99.403,7.17,0.891,4
178,109,0,260255,0,28420,0,4073664,64.35,46754783,93.105,45.5,19.436,34272.36,99.403,7.17,0.891,4
178,110,0,260255,0,28420,0,4073664,64.35,46754783,93.105,45.5,19.436,34272.36,99.403,7.17,0.891,4
178,111,4581,264836,2,28422,0,4073664,64.35,46754783,93.105,45.5,19.436,34272.36,99.403,7.17,0.891,4
178,112,1358,266194,2,28424,0,4073664,64.35,46754783,93.105,45.5,19.436,34272.36,99.403,7.17,0.891,4
178,113,1357,267551,2,28426,0,4073664,64.35,46754783,93.105,45.5,19.436,34272.36,99.403,7.17,0.891,4
178,114,2615,270166,3,28429,0,4347022,64.35,46754783,93.105,45.5,19.436,34272.36,99.403,7.17,0.891,4
178,115,2255,272421,3,28432,0,4347022,64.35,46754783,93.105,45.5,19.436,34272.36,99.403,7.17,0.891,4
178,116,0,272421,0,28432,0,4347022,64.35,46754783,93.105,45.5,19.436,34272.36,99.403,7.17,0.891,4
178,117,0,272421,0,28432,0,4347022,64.35,46754783,93.105,45.5,19.436,34272.36,99.403,7.17,0.891,4
178,118,6361,278782,2,28434,0,4347022,64.35,46754783,93.105,45.5,19.436,34272.36,99.403,7.17,0.891,4
178,119,1828,280610,2,28436,0,4347022,64.35,46754783,93.105,45.5,19.436,34272.36,99.403,7.17,0.891,4
178,120,2031,282641,5,28441,0,4347022,64.35,46754783,93.105,45.5,19.436,34272.36,99.403,7.17,0.891,4
178,121,2789,285430,2,28443,0,4652493,64.35,46754783,93.105,45.5,19.436,34272.36,99.403,7.17,0.891,4
178,122,3092,288522,2,28445,0,4652493,64.35,46754783,93.105,45.5,19.436,34272.36,99.403,7.17,0.891,4
178,123,0,288522,0,28445,0,4652493,64.35,46754783,93.105,45.5,19.436,34272.36,99.403,7.17,0.891,4
178,124,0,288522,0,28445,0,4652493,64.35,46754783,93.105,45.5,19.436,34272.36,99.403,7.17,0.891,4
178,125,8532,297054,27,28472,0,4652493,64.35,46754783,93.105,45.5,19.436,34272.36,99.403,7.17,0.891,4
178,126,5760,302814,26,28498,0,4652493,64.35,46754783,93.105,45.5,19.436,34272.36,99.403,7.17,0.891,4
178,127,2953,305767,1,28499,0,4652493,64.35,46754783,93.105,45.5,19.436,34272.36,99.403,7.17,0.891,4
178,128,4088,309855,1,28500,0,4983935,64.35,46754783,93.105,45.5,19.436,34272.36,99.403,7.17,0.891,4
178,129,4507,314362,3,28503,0,4983935,64.35,46754783,93.105,45.5,19.436,34272.36,99.403,7.17,0.891,4
178,130,0,314362,0,28503,0,4983935,64.35,46754783,93.105,45.5,19.436,34272.36,99.403,7.17,0.891,4
178,131,0,314362,0,28503,0,4983935,64.35,46754783,93.105,45.5,19.436,34272.36,99.403,7.17,0.891,4
178,132,8618,322980,73,28576,0,4983935,60.65,46754783,93.105,45.5,19.436,34272.36,99.403,7.17,0.891,4
178,133,3632,326612,5,28581,0,4983935,60.65,46754783,93.105,45.5,19.436,34272.36,99.403,7.17,0.891,4
178,134,3172,329784,-2,28579,0,4983935,60.65,46754783,93.105,45.5,19.436,34272.36,99.403,7.17,0.891,4
178,135,7550,337334,26,28605,0,5367311,60.65,46754783,93.105,45.5,19.436,34272.36,99.403,7.17,0.891,4
178,136,5479,342813,12,28617,0,5367311,62.5,46754783,93.105,45.5,19.436,34272.36,99.403,7.17,0.891,4
178,137,0,342813,0,28617,0,5367311,62.5,46754783,93.105,45.5,19.436,34272.36,99.403,7.17,0.891,4
178,138,0,342813,0,28617,0,5367311,62.5,46754783,93.105,45.5,19.436,34272.36,99.403,7.17,0.891,4
178,139,16269,359082,29,28646,0,5367311,62.5,46754783,93.105,45.5,19.436,34272.36,99.403,7.17,0.891,4
178,140,5114,364196,24,28670,0,5367311,62.5,46754783,93.105,45.5,19.436,34272.36,99.403,7.17,0.891,4
178,141,6671,370867,127,28797,0,5367311,62.5,46754783,93.105,45.5,19.436,34272.36,99.403,7.17,0.891,4
178,142,7039,377906,16,28813,0,5849939,62.5,46754783,93.105,45.5,19.436,34272.36,99.403,7.17,0.891,4
178,143,8148,386054,25,28838,0,5849939,62.5,46754783,93.105,45.5,19.436,34272.36,99.403,7.17,0.891,4
178,144,0,386054,0,28838,0,5849939,62.5,46754783,93.105,45.5,19.436,34272.36,99.403,7.17,0.891,4
178,145,0,386054,0,28838,0,5849939,62.5,46754783,93.105,45.5,19.436,34272.36,99.403,7.17,0.891,4
178,146,19382,405436,34,28872,0,5849939,62.5,46754783,93.105,45.5,19.436,34272.36,99.403,7.17,0.891,4
178,147,7117,412553,52,28924,0,5849939,62.5,46754783,93.105,45.5,19.436,34272.36,99.403,7.17,0.891,4
178,148,7296,419849,47,28971,0,5849939,62.5,46754783,93.105,45.5,19.436,34272.36,99.403,7.17,0.891,4
178,149,9658,429507,25,28996,0,6416533,62.5,46754783,93.105,45.5,19.436,34272.36,99.403,7.17,0.891,4
178,150,9779,439286,15,29011,0,6416533,62.5,46754783,93.105,45.5,19.436,34272.36,99.403,7.17,0.891,4
178,151,0,439286,0,29011,0,6416533,62.5,46754783,93.105,45.5,19.436,34272.36,99.403,7.17,0.891,4
178,152,0,439286,0,29011,0,6416533,62.5,46754783,93.105,45.5,19.436,34272.36,99.403,7.17,0.891,4
178,153,23572,462858,83,29094,0,6416533,62.5,46754783,93.105,45.5,19.436,34272.36,99.403,7.17,0.891,4
178,154,8115,470973,58,29152,0,6416533,62.5,46754783,93.105,45.5,19.436,34272.36,99.403,7.17,0.891,4
178,155,8581,479554,42,29194,0,6416533,62.5,46754783,93.105,45.5,19.436,34272.36,99.403,7.17,0.891,4
178,156,8959,488513,40,29234,0,7042795,62.5,46754783,93.105,45.5,19.436,34272.36,99.403,7.17,0.891,4
178,157,10476,498989,184,29418,0,7042795,62.5,46754783,93.105,45.5,19.436,34272.36,99.403,7.17,0.891,4
178,158,0,498989,0,29418,0,7042795,62.5,46754783,93.105,45.5,19.436,34272.36,99.403,7.17,0.891,4
178,159,0,498989,0,29418,0,7042795,62.5,46754783,93.105,45.5,19.436,34272.36,99.403,7.17,0.891,4
178,160,26560,525549,98,29516,0,7042795,55.09,46754783,93.105,45.5,19.436,34272.36,99.403,7.17,0.891,4
178,161,8964,534513,78,29594,0,7042795,55.09,46754783,93.105,45.5,19.436,34272.36,99.403,7.17,0.891,4
178,162,8866,543379,34,29628,0,7042795,55.09,46754783,93.105,45.5,19.436,34272.36,99.403,7.17,0.891,4
178,163,10764,554143,71,29699,0,7899400,55.09,46754783,93.105,45.5,19.436,34272.36,99.403,7.17,0.891,4
178,164,12183,566326,48,29747,0,7899400,55.09,46754783,93.105,45.5,19.436,34272.36,99.403,7.17,0.891,4
178,165,0,566326,0,29747,0,7899400,55.09,46754783,93.105,45.5,19.436,34272.36,99.403,7.17,0.891,4
178,166,0,566326,0,29747,0,7899400,55.09,46754783,93.105,45.5,19.436,34272.36,99.403,7.17,0.891,4
178,167,27404,593730,101,29848,0,7899400,55.09,46754783,93.105,45.5,19.436,34272.36,99.403,7.17,0.891,4
178,168,9437,603167,156,30004,0,7899400,55.09,46754783,93.105,45.5,19.436,34272.36,99.403,7.17,0.891,4
178,169,11193,614360,239,30243,0,7899400,55.09,46754783,93.105,45.5,19.436,34272.36,99.403,7.17,0.891,4
178,170,11291,625651,162,30405,0,8582722,55.09,46754783,93.105,45.5,19.436,34272.36,99.403,7.17,0.891,4
178,171,14389,640040,90,30495,0,8582722,55.09,46754783,93.105,45.5,19.436,34272.36,99.403,7.17,0.891,4
178,172,0,640040,0,30495,0,8582722,55.09,46754783,93.105,45.5,19.436,34272.36,99.403,7.17,0.891,4
178,173,0,640040,0,30495,0,8582722,55.09,46754783,93.105,45.5,19.436,34272.36,99.403,7.17,0.891,4
178,174,31428,671468,168,30663,0,8582722,55.09,46754783,93.105,45.5,19.436,34272.36,99.403,7.17,0.891,4
178,175,10799,682267,241,30904,0,8582722,55.09,46754783,93.105,45.5,19.436,34272.36,99.403,7.17,0.891,4
178,176,11289,693556,130,31034,0,8582722,55.09,46754783,93.105,45.5,19.436,34272.36,99.403,7.17,0.891,4
178,177,10653,704209,84,31118,0,9338927,55.09,46754783,93.105,45.5,19.436,34272.36,99.403,7.17,0.891,4
178,178,12272,716481,114,31232,0,9338927,55.09,46754783,93.105,45.5,19.436,34272.36,99.403,7.17,0.891,4
178,179,0,716481,0,31232,0,9338927,55.09,46754783,93.105,45.5,19.436,34272.36,99.403,7.17,0.891,4
178,180,0,716481,0,31232,0,9338927,55.09,46754783,93.105,45.5,19.436,34272.36,99.403,7.17,0.891,4
178,181,31785,748266,179,31411,0,9338927,55.09,46754783,93.105,45.5,19.436,34272.36,99.403,7.17,0.891,4
178,182,9906,758172,203,31614,0,9338927,55.09,46754783,93.105,45.5,19.436,34272.36,99.403,7.17,0.891,4
178,183,11016,769188,177,31791,0,9338927,55.09,46754783,93.105,45.5,19.436,34272.36,99.403,7.17,0.891,4
178,184,9419,778607,182,31973,0,10121252,55.09,46754783,93.105,45.5,19.436,34272.36,99.403,7.17,0.891,4
178,185,11325,789932,113,32086,0,10121252,55.09,46754783,93.105,45.5,19.436,34272.36,99.403,7.17,0.891,4
178,186,0,789932,0,32086,0,10121252,55.09,46754783,93.105,45.5,19.436,34272.36,99.403,7.17,0.891,4
178,187,0,789932,0,32086,0,10121252,55.09,46754783,93.105,45.5,19.436,34272.36,99.403,7.17,0.891,4
178,188,23480,813412,139,32225,0,10121252,55.09,46754783,93.105,45.5,19.436,34272.36,99.403,7.17,0.891,4
178,189,11998,825410,261,32486,0,10121252,55.09,46754783,93.105,45.5,19.436,34272.36,99.403,7.17,0.891,4
178,190,10491,835901,76,32562,0,10121252,55.09,46754783,93.105,45.5,19.436,34272.36,99.403,7.17,0.891,4
178,191,12423,848324,126,32688,0,10923025,55.09,46754783,93.105,45.5,19.436,34272.36,99.403,7.17,0.891,4
178,192,12788,861112,241,32929,0,10923025,55.09,46754783,93.105,45.5,19.436,34272.36,99.403,7.17,0.891,4
178,193,0,861112,0,32929,0,10923025,55.09,46754783,93.105,45.5,19.436,34272.36,99.403,7.17,0.891,4
178,194,0,861112,0,32929,0,10923025,55.09,46754783,93.105,45.5,19.436,34272.36,99.403,7.17,0.891,4
178,195,27856,888968,195,33124,0,10923025,55.09,46754783,93.105,45.5,19.436,34272.36,99.403,7.17,0.891,4
178,196,7118,896086,80,33204,0,10923025,55.09,46754783,93.105,45.5,19.436,34272.36,99.403,7.17,0.891,4
178,197,11970,908056,209,33413,0,10923025,55.09,46754783,93.105,45.5,19.436,34272.36,99.403,7.17,0.891,4
178,198,13318,921374,140,33553,0,11636260,55.09,46754783,93.105,45.5,19.436,34272.36,99.403,7.17,0.891,4
178,199,15186,936560,222,33775,123194,11759454,55.09,46754783,93.105,45.5,19.436,34272.36,99.403,7.17,0.891,4
178,200,0,936560,0,33775,0,11759454,55.09,46754783,93.105,45.5,19.436,34272.36,99.403,7.17,0.891,4
178,201,0,936560,0,33775,0,11759454,55.09,46754783,93.105,45.5,19.436,34272.36,99.403,7.17,0.891,4
178,202,37889,974449,217,33992,0,11759454,55.09,46754783,93.105,45.5,19.436,34272.36,99.403,7.17,0.891,4
178,203,13873,988322,218,34210,0,11759454,55.09,46754783,93.105,45.5,19.436,34272.36,99.403,7.17,0.891,4
178,204,13873,988322,218,34210,0,11759454,55.09,46754783,93.105,45.5,19.436,34272.36,99.403,7.17,0.891,4
179,1,2,122,1,2,219,2785,100,21413250,341.955,34.1,10.069,11669.077,197.093,10.68,0.77,0
179,2,21,143,0,2,250,3035,100,21413250,341.955,34.1,10.069,11669.077,197.093,10.68,0.77,0
179,3,5,148,1,3,311,3346,100,21413250,341.955,34.1,10.069,11669.077,197.093,10.68,0.77,0
179,4,3,151,1,4,295,3641,100,21413250,341.955,34.1,10.069,11669.077,197.093,10.68,0.77,0
179,5,8,159,1,5,324,3965,100,21413250,341.955,34.1,10.069,11669.077,197.093,10.68,0.77,0
179,6,7,166,0,5,394,4359,100,21413250,341.955,34.1,10.069,11669.077,197.093,10.68,0.77,0
179,7,12,178,0,5,353,4712,100,21413250,341.955,34.1,10.069,11669.077,197.093,10.68,0.77,0
179,8,7,185,1,6,376,5088,100,21413250,341.955,34.1,10.069,11669.077,197.093,10.68,0.77,0
179,9,4,189,1,7,287,5375,100,21413250,341.955,34.1,10.069,11669.077,197.093,10.68,0.77,0
179,10,1,190,0,7,397,5772,100,21413250,341.955,34.1,10.069,11669.077,197.093,10.68,0.77,0
179,11,7,197,0,7,393,6165,100,21413250,341.955,34.1,10.069,11669.077,197.093,10.68,0.77,0
179,12,2,199,0,7,609,6774,100,21413250,341.955,34.1,10.069,11669.077,197.093,10.68,0.77,0
179,13,11,210,0,7,431,7205,100,21413250,341.955,34.1,10.069,11669.077,197.093,10.68,0.77,0
179,14,8,218,0,7,342,7547,100,21413250,341.955,34.1,10.069,11669.077,197.093,10.68,0.77,0
179,15,15,233,0,7,465,8012,100,21413250,341.955,34.1,10.069,11669.077,197.093,10.68,0.77,0
179,16,4,237,0,7,548,8560,100,21413250,341.955,34.1,10.069,11669.077,197.093,10.68,0.77,0
179,17,1,238,0,7,710,9270,100,21413250,341.955,34.1,10.069,11669.077,197.093,10.68,0.77,0
179,18,6,244,0,7,522,9792,83.33,21413250,341.955,34.1,10.069,11669.077,197.093,10.68,0.77,0
179,19,10,254,0,7,702,10494,83.33,21413250,341.955,34.1,10.069,11669.077,197.093,10.68,0.77,0
179,20,41,295,0,7,642,11136,81.48,21413250,341.955,34.1,10.069,11669.077,197.093,10.68,0.77,0
179,21,9,304,0,7,650,11786,81.48,21413250,341.955,34.1,10.069,11669.077,197.093,10.68,0.77,0
179,22,6,310,0,7,774,12560,77.78,21413250,341.955,34.1,10.069,11669.077,197.093,10.68,0.77,0
179,23,20,330,0,7,1141,13701,77.78,21413250,341.955,34.1,10.069,11669.077,197.093,10.68,0.77,0
179,24,38,368,0,7,876,14577,79.63,21413250,341.955,34.1,10.069,11669.077,197.093,10.68,0.77,0
179,25,52,420,0,7,816,15393,79.63,21413250,341.955,34.1,10.069,11669.077,197.093,10.68,0.77,0
179,26,42,462,0,7,1075,16468,79.63,21413250,341.955,34.1,10.069,11669.077,197.093,10.68,0.77,0
179,27,61,523,0,7,1869,18337,79.63,21413250,341.955,34.1,10.069,11669.077,197.093,10.68,0.77,0
179,28,65,588,0,7,1139,19476,79.63,21413250,341.955,34.1,10.069,11669.077,197.093,10.68,0.77,0
179,29,31,619,0,7,1545,21021,79.63,21413250,341.955,34.1,10.069,11669.077,197.093,10.68,0.77,0
179,30,30,649,0,7,1397,22418,79.63,21413250,341.955,34.1,10.069,11669.077,197.093,10.68,0.77,0
179,31,16,665,0,7,1107,23525,79.63,21413250,341.955,34.1,10.069,11669.077,197.093,10.68,0.77,0
179,32,25,690,0,7,1681,25206,79.63,21413250,341.955,34.1,10.069,11669.077,197.093,10.68,0.77,0
179,33,15,705,0,7,1636,26842,79.63,21413250,341.955,34.1,10.069,11669.077,197.093,10.68,0.77,0
179,34,13,718,0,7,1045,27887,79.63,21413250,341.955,34.1,10.069,11669.077,197.093,10.68,0.77,0
179,35,37,755,1,8,1491,29378,79.63,21413250,341.955,34.1,10.069,11669.077,197.093,10.68,0.77,0
179,36,16,771,1,9,1147,30525,79.63,21413250,341.955,34.1,10.069,11669.077,197.093,10.68,0.77,0
179,37,26,797,0,9,1553,32078,79.63,21413250,341.955,34.1,10.069,11669.077,197.093,10.68,0.77,0
179,38,27,824,0,9,1821,33899,79.63,21413250,341.955,34.1,10.069,11669.077,197.093,10.68,0.77,0
179,39,11,835,0,9,1424,35323,79.63,21413250,341.955,34.1,10.069,11669.077,197.093,10.68,0.77,0
179,40,12,847,0,9,1282,36605,79.63,21413250,341.955,34.1,10.069,11669.077,197.093,10.68,0.77,0
179,41,16,863,0,9,1057,37662,79.63,21413250,341.955,34.1,10.069,11669.077,197.093,10.68,0.77,0
179,42,6,869,0,9,1078,38740,79.63,21413250,341.955,34.1,10.069,11669.077,197.093,10.68,0.77,0
179,43,20,889,0,9,889,39629,82.41,21413250,341.955,34.1,10.069,11669.077,197.093,10.68,0.77,0
179,44,26,915,0,9,1489,41118,82.41,21413250,341.955,34.1,10.069,11669.077,197.093,10.68,0.77,0
179,45,10,925,0,9,938,42056,82.41,21413250,341.955,34.1,10.069,11669.077,197.093,10.68,0.77,0
179,46,10,935,0,9,1081,43137,82.41,21413250,341.955,34.1,10.069,11669.077,197.093,10.68,0.77,0
179,47,25,960,0,9,1254,44391,82.41,21413250,341.955,34.1,10.069,11669.077,197.093,10.68,0.77,0
179,48,21,981,0,9,960,45351,82.41,21413250,341.955,34.1,10.069,11669.077,197.093,10.68,0.77,0
179,49,11,992,0,9,1062,46413,82.41,21413250,341.955,34.1,10.069,11669.077,197.093,10.68,0.77,0
179,50,35,1027,0,9,1108,47521,82.41,21413250,341.955,34.1,10.069,11669.077,197.093,10.68,0.77,0
179,51,1,1028,0,9,1603,49124,82.41,21413250,341.955,34.1,10.069,11669.077,197.093,10.68,0.77,0
179,52,27,1055,0,9,1970,51094,79.63,21413250,341.955,34.1,10.069,11669.077,197.093,10.68,0.77,0
179,53,13,1068,0,9,1998,53092,79.63,21413250,341.955,34.1,10.069,11669.077,197.093,10.68,0.77,0
179,54,21,1089,0,9,1742,54834,79.63,21413250,341.955,34.1,10.069,11669.077,197.093,10.68,0.77,0
179,55,52,1141,0,9,1347,56181,79.63,21413250,341.955,34.1,10.069,11669.077,197.093,10.68,0.77,0
179,56,41,1182,1,10,1146,57327,76.85,21413250,341.955,34.1,10.069,11669.077,197.093,10.68,0.77,0
179,57,137,1319,0,10,1838,59165,76.85,21413250,341.955,34.1,10.069,11669.077,197.093,10.68,0.77,0
179,58,150,1469,0,10,1713,60878,76.85,21413250,341.955,34.1,10.069,11669.077,197.093,10.68,0.77,0
179,59,61,1530,0,10,1330,62208,76.85,21413250,341.955,34.1,10.069,11669.077,197.093,10.68,0.77,0
179,60,28,1558,0,10,1727,63935,76.85,21413250,341.955,34.1,10.069,11669.077,197.093,10.68,0.77,0
179,61,62,1620,0,10,1420,65355,76.85,21413250,341.955,34.1,10.069,11669.077,197.093,10.68,0.77,0
179,62,13,1633,0,10,1066,66421,76.85,21413250,341.955,34.1,10.069,11669.077,197.093,10.68,0.77,0
179,63,10,1643,1,11,1783,68204,76.85,21413250,341.955,34.1,10.069,11669.077,197.093,10.68,0.77,0
179,64,40,1683,0,11,2086,70290,76.85,21413250,341.955,34.1,10.069,11669.077,197.093,10.68,0.77,0
179,65,66,1749,0,11,1890,72180,76.85,21413250,341.955,34.1,10.069,11669.077,197.093,10.68,0.77,0
179,66,48,1797,0,11,1816,73996,76.85,21413250,341.955,34.1,10.069,11669.077,197.093,10.68,0.77,0
179,67,4,1801,0,11,1243,75239,76.85,21413250,341.955,34.1,10.069,11669.077,197.093,10.68,0.77,0
179,68,13,1814,0,11,1718,76957,76.85,21413250,341.955,34.1,10.069,11669.077,197.093,10.68,0.77,0
179,69,21,1835,0,11,1766,78723,60.19,21413250,341.955,34.1,10.069,11669.077,197.093,10.68,0.77,0
179,70,22,1857,0,11,1579,80302,60.19,21413250,341.955,34.1,10.069,11669.077,197.093,10.68,0.77,0
179,71,2,1859,0,11,1433,81735,60.19,21413250,341.955,34.1,10.069,11669.077,197.093,10.68,0.77,0
179,72,10,1869,0,11,1677,83412,55.56,21413250,341.955,34.1,10.069,11669.077,197.093,10.68,0.77,0
179,73,8,1877,0,11,1390,84802,55.56,21413250,341.955,34.1,10.069,11669.077,197.093,10.68,0.77,0
179,74,3,1880,0,11,1165,85967,55.56,21413250,341.955,34.1,10.069,11669.077,197.093,10.68,0.77,0
179,75,4,1884,0,11,1116,87083,55.56,21413250,341.955,34.1,10.069,11669.077,197.093,10.68,0.77,0
179,76,5,1889,0,11,1651,88734,55.56,21413250,341.955,34.1,10.069,11669.077,197.093,10.68,0.77,0
179,77,16,1905,0,11,1276,90010,55.56,21413250,341.955,34.1,10.069,11669.077,197.093,10.68,0.77,0
179,78,10,1915,0,11,1381,91391,55.56,21413250,341.955,34.1,10.069,11669.077,197.093,10.68,0.77,0
179,79,9,1924,0,11,1374,92765,55.56,21413250,341.955,34.1,10.069,11669.077,197.093,10.68,0.77,0
179,80,23,1947,0,11,1495,94260,55.56,21413250,341.955,34.1,10.069,11669.077,197.093,10.68,0.77,0
179,81,3,1950,0,11,827,95087,55.56,21413250,341.955,34.1,10.069,11669.077,197.093,10.68,0.77,0
179,82,0,1950,0,11,1181,96268,55.56,21413250,341.955,34.1,10.069,11669.077,197.093,10.68,0.77,0
179,83,0,1950,0,11,1134,97402,55.56,21413250,341.955,34.1,10.069,11669.077,197.093,10.68,0.77,0
179,84,1,1951,0,11,1232,98634,55.56,21413250,341.955,34.1,10.069,11669.077,197.093,10.68,0.77,0
179,85,40,1991,0,11,1349,99983,55.56,21413250,341.955,34.1,10.069,11669.077,197.093,10.68,0.77,0
179,86,10,2001,0,11,1243,101226,55.56,21413250,341.955,34.1,10.069,11669.077,197.093,10.68,0.77,0
179,87,9,2010,0,11,1439,102665,55.56,21413250,341.955,34.1,10.069,11669.077,197.093,10.68,0.77,0
179,88,4,2014,0,11,1607,104272,55.56,21413250,341.955,34.1,10.069,11669.077,197.093,10.68,0.77,0
179,89,19,2033,0,11,833,105105,53.7,21413250,341.955,34.1,10.069,11669.077,197.093,10.68,0.77,0
179,90,4,2037,0,11,1340,106445,53.7,21413250,341.955,34.1,10.069,11669.077,197.093,10.68,0.77,0
179,91,5,2042,0,11,1365,107810,53.7,21413250,341.955,34.1,10.069,11669.077,197.093,10.68,0.77,0
179,92,5,2047,0,11,1296,109106,53.7,21413250,341.955,34.1,10.069,11669.077,197.093,10.68,0.77,0
179,93,7,2054,0,11,1399,110505,53.7,21413250,341.955,34.1,10.069,11669.077,197.093,10.68,0.77,0
179,94,12,2066,0,11,1519,112024,53.7,21413250,341.955,34.1,10.069,11669.077,197.093,10.68,0.77,0
179,95,3,2069,0,11,852,112876,53.7,21413250,341.955,34.1,10.069,11669.077,197.093,10.68,0.77,0
179,96,5,2074,0,11,599,113475,53.7,21413250,341.955,34.1,10.069,11669.077,197.093,10.68,0.77,0
179,97,2,2076,0,11,1290,114765,50,21413250,341.955,34.1,10.069,11669.077,197.093,10.68,0.77,0
179,98,2,2078,0,11,1610,116375,50,21413250,341.955,34.1,10.069,11669.077,197.093,10.68,0.77,0
179,99,3,2081,0,11,1182,117557,50,21413250,341.955,34.1,10.069,11669.077,197.093,10.68,0.77,0
179,100,13,2094,0,11,1424,118981,50,21413250,341.955,34.1,10.069,11669.077,197.093,10.68,0.77,0
179,101,256,2350,0,11,1749,120730,50,21413250,341.955,34.1,10.069,11669.077,197.093,10.68,0.77,0
179,102,104,2454,0,11,1341,122071,50,21413250,341.955,34.1,10.069,11669.077,197.093,10.68,0.77,0
179,103,57,2511,0,11,2251,124322,50,21413250,341.955,34.1,10.069,11669.077,197.093,10.68,0.77,0
179,104,106,2617,0,11,1310,125632,53.7,21413250,341.955,34.1,10.069,11669.077,197.093,10.68,0.77,0
179,105,29,2646,0,11,2288,127920,53.7,21413250,341.955,34.1,10.069,11669.077,197.093,10.68,0.77,0
179,106,19,2665,0,11,2470,130390,53.7,21413250,341.955,34.1,10.069,11669.077,197.093,10.68,0.77,0
179,107,9,2674,0,11,2406,132796,53.7,21413250,341.955,34.1,10.069,11669.077,197.093,10.68,0.77,0
179,108,13,2687,0,11,2723,135519,53.7,21413250,341.955,34.1,10.069,11669.077,197.093,10.68,0.77,0
179,109,10,2697,0,11,1888,137407,53.7,21413250,341.955,34.1,10.069,11669.077,197.093,10.68,0.77,0
179,110,7,2704,0,11,2184,139591,53.7,21413250,341.955,34.1,10.069,11669.077,197.093,10.68,0.77,0
179,111,20,2724,0,11,1924,141515,53.7,21413250,341.955,34.1,10.069,11669.077,197.093,10.68,0.77,0
179,112,6,2730,0,11,2158,143673,53.7,21413250,341.955,34.1,10.069,11669.077,197.093,10.68,0.77,0
179,113,0,2730,0,11,1700,145373,53.7,21413250,341.955,34.1,10.069,11669.077,197.093,10.68,0.77,0
179,114,22,2752,0,11,2012,147385,53.7,21413250,341.955,34.1,10.069,11669.077,197.093,10.68,0.77,0
179,115,1,2753,0,11,1811,149196,53.7,21413250,341.955,34.1,10.069,11669.077,197.093,10.68,0.77,0
179,116,11,2764,0,11,2018,151214,53.7,21413250,341.955,34.1,10.069,11669.077,197.093,10.68,0.77,0
179,117,6,2770,0,11,1851,153065,53.7,21413250,341.955,34.1,10.069,11669.077,197.093,10.68,0.77,0
179,118,12,2782,0,11,1126,154191,50,21413250,341.955,34.1,10.069,11669.077,197.093,10.68,0.77,0
179,119,23,2805,0,11,1349,155540,50,21413250,341.955,34.1,10.069,11669.077,197.093,10.68,0.77,0
179,120,5,2810,0,11,1403,156943,50,21413250,341.955,34.1,10.069,11669.077,197.093,10.68,0.77,0
179,121,1,2811,0,11,1683,158626,50,21413250,341.955,34.1,10.069,11669.077,197.093,10.68,0.77,0
179,122,3,2814,0,11,1600,160226,50,21413250,341.955,34.1,10.069,11669.077,197.093,10.68,0.77,0
179,123,1,2815,0,11,1864,162090,41.67,21413250,341.955,34.1,10.069,11669.077,197.093,10.68,0.77,0
179,124,0,2815,0,11,1540,163630,41.67,21413250,341.955,34.1,10.069,11669.077,197.093,10.68,0.77,0
179,125,8,2823,0,11,1712,165342,41.67,21413250,341.955,34.1,10.069,11669.077,197.093,10.68,0.77,0
179,126,5,2828,0,11,1395,166737,41.67,21413250,341.955,34.1,10.069,11669.077,197.093,10.68,0.77,0
179,127,6,2834,0,11,935,167672,41.67,21413250,341.955,34.1,10.069,11669.077,197.093,10.68,0.77,0
179,128,5,2839,0,11,1085,168757,41.67,21413250,341.955,34.1,10.069,11669.077,197.093,10.68,0.77,0
179,129,0,2839,0,11,1069,169826,41.67,21413250,341.955,34.1,10.069,11669.077,197.093,10.68,0.77,0
179,130,0,2839,0,11,1343,171169,41.67,21413250,341.955,34.1,10.069,11669.077,197.093,10.68,0.77,0
179,131,2,2841,0,11,1803,172972,41.67,21413250,341.955,34.1,10.069,11669.077,197.093,10.68,0.77,0
179,132,3,2844,0,11,1519,174491,41.67,21413250,341.955,34.1,10.069,11669.077,197.093,10.68,0.77,0
179,133,27,2871,0,11,2909,177400,41.67,21413250,341.955,34.1,10.069,11669.077,197.093,10.68,0.77,0
179,134,9,2880,0,11,2549,179949,41.67,21413250,341.955,34.1,10.069,11669.077,197.093,10.68,0.77,0
179,135,1,2881,0,11,2732,182681,41.67,21413250,341.955,34.1,10.069,11669.077,197.093,10.68,0.77,0
179,136,1,2882,0,11,2437,185118,41.67,21413250,341.955,34.1,10.069,11669.077,197.093,10.68,0.77,0
179,137,4,2886,0,11,2839,187957,41.67,21413250,341.955,34.1,10.069,11669.077,197.093,10.68,0.77,0
179,138,4,2890,0,11,1561,189518,41.67,21413250,341.955,34.1,10.069,11669.077,197.093,10.68,0.77,0
179,139,3,2893,0,11,1989,191507,41.67,21413250,341.955,34.1,10.069,11669.077,197.093,10.68,0.77,0
179,140,7,2900,0,11,3518,195025,41.67,21413250,341.955,34.1,10.069,11669.077,197.093,10.68,0.77,0
179,141,2,2902,0,11,2247,197272,33.33,21413250,341.955,34.1,10.069,11669.077,197.093,10.68,0.77,0
179,142,0,2902,0,11,2876,200148,25.93,21413250,341.955,34.1,10.069,11669.077,197.093,10.68,0.77,0
179,143,16,2918,0,11,2759,202907,25.93,21413250,341.955,34.1,10.069,11669.077,197.093,10.68,0.77,0
179,144,23,2941,0,11,2800,205707,25.93,21413250,341.955,34.1,10.069,11669.077,197.093,10.68,0.77,0
179,145,6,2947,1,12,2690,208397,25.93,21413250,341.955,34.1,10.069,11669.077,197.093,10.68,0.77,0
179,146,6,2953,0,12,2693,211090,25.93,21413250,341.955,34.1,10.069,11669.077,197.093,10.68,0.77,0
179,147,6,2959,0,12,2372,213462,25.93,21413250,341.955,34.1,10.069,11669.077,197.093,10.68,0.77,0
179,148,12,2971,0,12,2847,216309,25.93,21413250,341.955,34.1,10.069,11669.077,197.093,10.68,0.77,0
179,149,13,2984,0,12,2853,219162,25.93,21413250,341.955,34.1,10.069,11669.077,197.093,10.68,0.77,0
179,150,2,2986,0,12,2748,221910,25.93,21413250,341.955,34.1,10.069,11669.077,197.093,10.68,0.77,0
179,151,3,2989,0,12,2072,223982,25.93,21413250,341.955,34.1,10.069,11669.077,197.093,10.68,0.77,0
179,152,6,2995,0,12,2129,226111,25.93,21413250,341.955,34.1,10.069,11669.077,197.093,10.68,0.77,0
179,153,17,3012,0,12,1941,228052,25.93,21413250,341.955,34.1,10.069,11669.077,197.093,10.68,0.77,0
179,154,37,3049,0,12,2495,230547,25.93,21413250,341.955,34.1,10.069,11669.077,197.093,10.68,0.77,0
179,155,43,3092,0,12,2163,232710,25.93,21413250,341.955,34.1,10.069,11669.077,197.093,10.68,0.77,0
179,156,9,3101,0,12,2511,235221,25.93,21413250,341.955,34.1,10.069,11669.077,197.093,10.68,0.77,0
179,157,10,3111,0,12,2389,237610,25.93,21413250,341.955,34.1,10.069,11669.077,197.093,10.68,0.77,0
179,158,4,3115,0,12,2297,239907,25.93,21413250,341.955,34.1,10.069,11669.077,197.093,10.68,0.77,0
179,159,6,3121,0,12,1724,241631,25.93,21413250,341.955,34.1,10.069,11669.077,197.093,10.68,0.77,0
179,160,2,3123,0,12,1353,242984,25.93,21413250,341.955,34.1,10.069,11669.077,197.093,10.68,0.77,0
179,161,0,3123,0,12,2128,245112,25.93,21413250,341.955,34.1,10.069,11669.077,197.093,10.68,0.77,0
179,162,17,3140,0,12,1776,246888,25.93,21413250,341.955,34.1,10.069,11669.077,197.093,10.68,0.77,0
179,163,7,3147,0,12,2440,249328,23.15,21413250,341.955,34.1,10.069,11669.077,197.093,10.68,0.77,0
179,164,8,3155,0,12,2464,251792,23.15,21413250,341.955,34.1,10.069,11669.077,197.093,10.68,0.77,0
179,165,14,3169,0,12,2050,253842,23.15,21413250,341.955,34.1,10.069,11669.077,197.093,10.68,0.77,0
179,166,27,3196,0,12,2201,256043,23.15,21413250,341.955,34.1,10.069,11669.077,197.093,10.68,0.77,0
179,167,38,3234,0,12,1434,257477,23.15,21413250,341.955,34.1,10.069,11669.077,197.093,10.68,0.77,0
179,168,28,3262,1,13,2301,259778,23.15,21413250,341.955,34.1,10.069,11669.077,197.093,10.68,0.77,0
179,169,9,3271,0,13,2600,262378,23.15,21413250,341.955,34.1,10.069,11669.077,197.093,10.68,0.77,0
179,170,0,3271,0,13,1965,264343,23.15,21413250,341.955,34.1,10.069,11669.077,197.093,10.68,0.77,0
179,171,5,3276,0,13,1714,266057,23.15,21413250,341.955,34.1,10.069,11669.077,197.093,10.68,0.77,0
179,172,5,3281,0,13,2314,268371,23.15,21413250,341.955,34.1,10.069,11669.077,197.093,10.68,0.77,0
179,173,2,3283,0,13,1112,269483,23.15,21413250,341.955,34.1,10.069,11669.077,197.093,10.68,0.77,0
179,174,4,3287,0,13,1398,270881,23.15,21413250,341.955,34.1,10.069,11669.077,197.093,10.68,0.77,0
179,175,12,3299,0,13,2827,273708,23.15,21413250,341.955,34.1,10.069,11669.077,197.093,10.68,0.77,0
179,176,14,3313,0,13,1882,275590,23.15,21413250,341.955,34.1,10.069,11669.077,197.093,10.68,0.77,0
179,177,11,3324,0,13,2555,278145,23.15,21413250,341.955,34.1,10.069,11669.077,197.093,10.68,0.77,0
179,178,9,3333,0,13,1595,279740,23.15,21413250,341.955,34.1,10.069,11669.077,197.093,10.68,0.77,0
179,179,12,3345,0,13,2457,282197,23.15,21413250,341.955,34.1,10.069,11669.077,197.093,10.68,0.77,0
179,180,4,3349,0,13,1862,284059,23.15,21413250,341.955,34.1,10.069,11669.077,197.093,10.68,0.77,0
179,181,11,3360,0,13,1398,285457,23.15,21413250,341.955,34.1,10.069,11669.077,197.093,10.68,0.77,0
179,182,3,3363,0,13,2407,287864,23.15,21413250,341.955,34.1,10.069,11669.077,197.093,10.68,0.77,0
179,183,11,3374,0,13,1724,289588,23.15,21413250,341.955,34.1,10.069,11669.077,197.093,10.68,0.77,0
179,184,6,3380,0,13,1517,291105,23.15,21413250,341.955,34.1,10.069,11669.077,197.093,10.68,0.77,0
179,185,2,3382,0,13,2114,293219,23.15,21413250,341.955,34.1,10.069,11669.077,197.093,10.68,0.77,0
179,186,6,3388,0,13,2244,295463,23.15,21413250,341.955,34.1,10.069,11669.077,197.093,10.68,0.77,0
179,187,8,3396,0,13,1148,296611,23.15,21413250,341.955,34.1,10.069,11669.077,197.093,10.68,0.77,0
179,188,6,3402,0,13,1890,298501,23.15,21413250,341.955,34.1,10.069,11669.077,197.093,10.68,0.77,0
179,189,331,3733,0,13,4880,303381,23.15,21413250,341.955,34.1,10.069,11669.077,197.093,10.68,0.77,0
179,190,519,4252,0,13,5608,308989,23.15,21413250,341.955,34.1,10.069,11669.077,197.093,10.68,0.77,0
179,191,207,4459,0,13,4824,313813,23.15,21413250,341.955,34.1,10.069,11669.077,197.093,10.68,0.77,0
179,192,29,4488,0,13,7196,321009,23.15,21413250,341.955,34.1,10.069,11669.077,197.093,10.68,0.77,0
179,193,35,4523,0,13,7495,328504,23.15,21413250,341.955,34.1,10.069,11669.077,197.093,10.68,0.77,0
179,194,105,4628,0,13,7248,335752,23.15,21413250,341.955,34.1,10.069,11669.077,197.093,10.68,0.77,0
179,195,124,4752,0,13,6591,342343,23.15,21413250,341.955,34.1,10.069,11669.077,197.093,10.68,0.77,0
179,196,92,4844,0,13,6566,348909,23.15,21413250,341.955,34.1,10.069,11669.077,197.093,10.68,0.77,0
179,197,194,5038,0,13,8789,357698,23.15,21413250,341.955,34.1,10.069,11669.077,197.093,10.68,0.77,0
179,198,132,5170,0,13,8161,365859,23.15,21413250,341.955,34.1,10.069,11669.077,197.093,10.68,0.77,0
179,199,74,5244,0,13,8589,374448,23.15,21413250,341.955,34.1,10.069,11669.077,197.093,10.68,0.77,0
179,200,110,5354,0,13,9513,383961,23.15,21413250,341.955,34.1,10.069,11669.077,197.093,10.68,0.77,0
179,201,121,5475,0,13,7099,391060,23.15,21413250,341.955,34.1,10.069,11669.077,197.093,10.68,0.77,0
179,202,63,5538,0,13,7136,398196,23.15,21413250,341.955,34.1,10.069,11669.077,197.093,10.68,0.77,0
179,203,87,5625,0,13,0,398196,23.15,21413250,341.955,34.1,10.069,11669.077,197.093,10.68,0.77,0
179,204,186,5811,0,13,0,398196,23.15,21413250,341.955,34.1,10.069,11669.077,197.093,10.68,0.77,0
180,1,1,7,0,2,0,0,76.85,43849269,23.258,19.7,3.548,4466.507,431.388,15.67,0.502,4
180,2,0,7,0,2,0,0,76.85,43849269,23.258,19.7,3.548,4466.507,431.388,15.67,0.502,4
180,3,0,7,0,2,0,0,76.85,43849269,23.258,19.7,3.548,4466.507,431.388,15.67,0.502,4
180,4,0,7,0,2,0,0,76.85,43849269,23.258,19.7,3.548,4466.507,431.388,15.67,0.502,4
180,5,3,10,0,2,0,0,76.85,43849269,23.258,19.7,3.548,4466.507,431.388,15.67,0.502,4
180,6,2,12,0,2,0,0,76.85,43849269,23.258,19.7,3.548,4466.507,431.388,15.67,0.502,4
180,7,0,12,0,2,0,0,76.85,43849269,23.258,19.7,3.548,4466.507,431.388,15.67,0.502,4
180,8,2,14,0,2,0,0,76.85,43849269,23.258,19.7,3.548,4466.507,431.388,15.67,0.502,4
180,9,0,14,0,2,0,0,76.85,43849269,23.258,19.7,3.548,4466.507,431.388,15.67,0.502,4
180,10,0,14,0,2,0,0,76.85,43849269,23.258,19.7,3.548,4466.507,431.388,15.67,0.502,4
180,11,1,15,0,2,0,0,76.85,43849269,23.258,19.7,3.548,4466.507,431.388,15.67,0.502,4
180,12,4,19,0,2,0,0,76.85,43849269,23.258,19.7,3.548,4466.507,431.388,15.67,0.502,4
180,13,0,19,0,2,0,0,79.63,43849269,23.258,19.7,3.548,4466.507,431.388,15.67,0.502,4
180,14,10,29,2,4,0,0,79.63,43849269,23.258,19.7,3.548,4466.507,431.388,15.67,0.502,4
180,15,3,32,1,5,0,0,79.63,43849269,23.258,19.7,3.548,4466.507,431.388,15.67,0.502,4
180,16,0,32,0,5,0,0,79.63,43849269,23.258,19.7,3.548,4466.507,431.388,15.67,0.502,4
180,17,0,32,0,5,0,0,79.63,43849269,23.258,19.7,3.548,4466.507,431.388,15.67,0.502,4
180,18,0,32,0,5,0,0,87.04,43849269,23.258,19.7,3.548,4466.507,431.388,15.67,0.502,4
180,19,34,66,5,10,0,0,87.04,43849269,23.258,19.7,3.548,4466.507,431.388,15.67,0.502,4
180,20,0,66,0,10,0,0,87.04,43849269,23.258,19.7,3.548,4466.507,431.388,15.67,0.502,4
180,21,26,92,2,12,0,0,87.04,43849269,23.258,19.7,3.548,4466.507,431.388,15.67,0.502,4
180,22,15,107,0,12,0,0,87.04,43849269,23.258,19.7,3.548,4466.507,431.388,15.67,0.502,4
180,23,33,140,1,13,0,0,87.04,43849269,23.258,19.7,3.548,4466.507,431.388,15.67,0.502,4
180,24,22,162,0,13,0,0,87.04,43849269,23.258,19.7,3.548,4466.507,431.388,15.67,0.502,4
180,25,12,174,3,16,0,0,87.04,43849269,23.258,19.7,3.548,4466.507,431.388,15.67,0.502,4
180,26,39,213,1,17,0,0,87.04,43849269,23.258,19.7,3.548,4466.507,431.388,15.67,0.502,4
180,27,24,237,4,21,0,0,87.04,43849269,23.258,19.7,3.548,4466.507,431.388,15.67,0.502,4
180,28,38,275,1,22,0,0,87.04,43849269,23.258,19.7,3.548,4466.507,431.388,15.67,0.502,4
180,29,43,318,3,25,0,0,87.04,43849269,23.258,19.7,3.548,4466.507,431.388,15.67,0.502,4
180,30,57,375,3,28,0,0,87.04,43849269,23.258,19.7,3.548,4466.507,431.388,15.67,0.502,4
180,31,67,442,3,31,0,0,87.04,43849269,23.258,19.7,3.548,4466.507,431.388,15.67,0.502,4
180,32,0,442,0,31,0,0,87.04,43849269,23.258,19.7,3.548,4466.507,431.388,15.67,0.502,4
180,33,150,592,10,41,0,0,87.04,43849269,23.258,19.7,3.548,4466.507,431.388,15.67,0.502,4
180,34,86,678,0,41,0,0,87.04,43849269,23.258,19.7,3.548,4466.507,431.388,15.67,0.502,4
180,35,0,678,0,41,0,0,87.04,43849269,23.258,19.7,3.548,4466.507,431.388,15.67,0.502,4
180,36,100,778,4,45,0,0,87.04,43849269,23.258,19.7,3.548,4466.507,431.388,15.67,0.502,4
180,37,74,852,4,49,0,0,87.04,43849269,23.258,19.7,3.548,4466.507,431.388,15.67,0.502,4
180,38,78,930,3,52,0,0,87.04,43849269,23.258,19.7,3.548,4466.507,431.388,15.67,0.502,4
180,39,181,1111,7,59,0,0,87.04,43849269,23.258,19.7,3.548,4466.507,431.388,15.67,0.502,4
180,40,53,1164,5,64,0,0,87.04,43849269,23.258,19.7,3.548,4466.507,431.388,15.67,0.502,4
180,41,199,1363,6,70,0,0,87.04,43849269,23.258,19.7,3.548,4466.507,431.388,15.67,0.502,4
180,42,163,1526,4,74,0,0,87.04,43849269,23.258,19.7,3.548,4466.507,431.388,15.67,0.502,4
180,43,135,1661,6,80,0,0,87.04,43849269,23.258,19.7,3.548,4466.507,431.388,15.67,0.502,4
180,44,157,1818,10,90,0,0,87.04,43849269,23.258,19.7,3.548,4466.507,431.388,15.67,0.502,4
180,45,146,1964,1,91,0,0,87.04,43849269,23.258,19.7,3.548,4466.507,431.388,15.67,0.502,4
180,46,0,1964,0,91,0,0,87.04,43849269,23.258,19.7,3.548,4466.507,431.388,15.67,0.502,4
180,47,0,1964,0,91,0,0,87.04,43849269,23.258,19.7,3.548,4466.507,431.388,15.67,0.502,4
180,48,325,2289,6,97,0,0,87.04,43849269,23.258,19.7,3.548,4466.507,431.388,15.67,0.502,4
180,49,302,2591,8,105,0,0,87.04,43849269,23.258,19.7,3.548,4466.507,431.388,15.67,0.502,4
180,50,0,2591,0,105,0,0,87.04,43849269,23.258,19.7,3.548,4466.507,431.388,15.67,0.502,4
180,51,137,2728,6,111,0,0,87.04,43849269,23.258,19.7,3.548,4466.507,431.388,15.67,0.502,4
180,52,410,3138,10,121,0,0,87.04,43849269,23.258,19.7,3.548,4466.507,431.388,15.67,0.502,4
180,53,240,3378,16,137,0,0,87.04,43849269,23.258,19.7,3.548,4466.507,431.388,15.67,0.502,4
180,54,250,3628,9,146,0,0,87.04,43849269,23.258,19.7,3.548,4466.507,431.388,15.67,0.502,4
180,55,6,3634,0,146,0,0,87.04,43849269,23.258,19.7,3.548,4466.507,431.388,15.67,0.502,4
180,56,192,3826,19,165,0,0,87.04,43849269,23.258,19.7,3.548,4466.507,431.388,15.67,0.502,4
180,57,150,3976,5,170,0,0,87.04,43849269,23.258,19.7,3.548,4466.507,431.388,15.67,0.502,4
180,58,170,4146,14,184,0,0,87.04,43849269,23.258,19.7,3.548,4466.507,431.388,15.67,0.502,4
180,59,200,4346,11,195,0,0,91.67,43849269,23.258,19.7,3.548,4466.507,431.388,15.67,0.502,4
180,60,175,4521,38,233,0,0,91.67,43849269,23.258,19.7,3.548,4466.507,431.388,15.67,0.502,4
180,61,279,4800,29,262,0,0,91.67,43849269,23.258,19.7,3.548,4466.507,431.388,15.67,0.502,4
180,62,226,5026,24,286,0,0,91.67,43849269,23.258,19.7,3.548,4466.507,431.388,15.67,0.502,4
180,63,147,5173,12,298,0,0,91.67,43849269,23.258,19.7,3.548,4466.507,431.388,15.67,0.502,4
180,64,137,5310,9,307,0,0,91.67,43849269,23.258,19.7,3.548,4466.507,431.388,15.67,0.502,4
180,65,0,5310,0,307,0,0,91.67,43849269,23.258,19.7,3.548,4466.507,431.388,15.67,0.502,4
180,66,189,5499,7,314,0,0,91.67,43849269,23.258,19.7,3.548,4466.507,431.388,15.67,0.502,4
180,67,215,5714,19,333,0,0,91.67,43849269,23.258,19.7,3.548,4466.507,431.388,15.67,0.502,4
180,68,151,5865,14,347,0,0,91.67,43849269,23.258,19.7,3.548,4466.507,431.388,15.67,0.502,4
180,69,218,6083,12,359,0,0,91.67,43849269,23.258,19.7,3.548,4466.507,431.388,15.67,0.502,4
180,70,159,6242,13,372,0,0,91.67,43849269,23.258,19.7,3.548,4466.507,431.388,15.67,0.502,4
180,71,0,6242,0,372,0,0,91.67,43849269,23.258,19.7,3.548,4466.507,431.388,15.67,0.502,4
180,72,185,6427,17,389,0,0,91.67,43849269,23.258,19.7,3.548,4466.507,431.388,15.67,0.502,4
180,73,303,6730,24,413,0,0,84.26,43849269,23.258,19.7,3.548,4466.507,431.388,15.67,0.502,4
180,74,149,6879,20,433,0,0,84.26,43849269,23.258,19.7,3.548,4466.507,431.388,15.67,0.502,4
180,75,0,6879,0,433,0,0,84.26,43849269,23.258,19.7,3.548,4466.507,431.388,15.67,0.502,4
180,76,341,7220,26,459,0,0,84.26,43849269,23.258,19.7,3.548,4466.507,431.388,15.67,0.502,4
180,77,0,7220,0,459,0,0,84.26,43849269,23.258,19.7,3.548,4466.507,431.388,15.67,0.502,4
180,78,520,7740,18,477,0,0,84.26,43849269,23.258,19.7,3.548,4466.507,431.388,15.67,0.502,4
180,79,280,8020,10,487,0,0,84.26,43849269,23.258,19.7,3.548,4466.507,431.388,15.67,0.502,4
180,80,0,8020,0,487,0,0,84.26,43849269,23.258,19.7,3.548,4466.507,431.388,15.67,0.502,4
180,81,296,8316,19,506,0,0,84.26,43849269,23.258,19.7,3.548,4466.507,431.388,15.67,0.502,4
180,82,264,8580,15,521,0,0,84.26,43849269,23.258,19.7,3.548,4466.507,431.388,15.67,0.502,4
180,83,0,8580,0,521,0,0,84.26,43849269,23.258,19.7,3.548,4466.507,431.388,15.67,0.502,4
180,84,118,8698,12,533,0,0,84.26,43849269,23.258,19.7,3.548,4466.507,431.388,15.67,0.502,4
180,85,191,8889,15,548,0,0,84.26,43849269,23.258,19.7,3.548,4466.507,431.388,15.67,0.502,4
180,86,0,8889,0,548,0,0,84.26,43849269,23.258,19.7,3.548,4466.507,431.388,15.67,0.502,4
180,87,95,8984,8,556,0,0,84.26,43849269,23.258,19.7,3.548,4466.507,431.388,15.67,0.502,4
180,88,273,9257,16,572,0,0,84.26,43849269,23.258,19.7,3.548,4466.507,431.388,15.67,0.502,4
180,89,1,9258,0,572,0,0,84.26,43849269,23.258,19.7,3.548,4466.507,431.388,15.67,0.502,4
180,90,0,9258,0,572,0,0,84.26,43849269,23.258,19.7,3.548,4466.507,431.388,15.67,0.502,4
180,91,0,9258,0,572,0,0,84.26,43849269,23.258,19.7,3.548,4466.507,431.388,15.67,0.502,4
180,92,0,9258,0,572,0,0,84.26,43849269,23.258,19.7,3.548,4466.507,431.388,15.67,0.502,4
180,93,315,9573,30,602,0,0,84.26,43849269,23.258,19.7,3.548,4466.507,431.388,15.67,0.502,4
180,94,0,9573,0,602,0,0,84.26,43849269,23.258,19.7,3.548,4466.507,431.388,15.67,0.502,4
180,95,90,9663,2,604,0,0,84.26,43849269,23.258,19.7,3.548,4466.507,431.388,15.67,0.502,4
180,96,0,9663,0,604,0,0,84.26,43849269,23.258,19.7,3.548,4466.507,431.388,15.67,0.502,4
180,97,104,9767,4,608,0,0,84.26,43849269,23.258,19.7,3.548,4466.507,431.388,15.67,0.502,4
180,98,0,9767,0,608,0,0,84.26,43849269,23.258,19.7,3.548,4466.507,431.388,15.67,0.502,4
180,99,230,9997,14,622,0,0,74.07,43849269,23.258,19.7,3.548,4466.507,431.388,15.67,0.502,4
180,100,87,10084,14,636,0,0,74.07,43849269,23.258,19.7,3.548,4466.507,431.388,15.67,0.502,4
180,101,74,10158,5,641,0,0,74.07,43849269,23.258,19.7,3.548,4466.507,431.388,15.67,0.502,4
180,102,46,10204,8,649,0,0,74.07,43849269,23.258,19.7,3.548,4466.507,431.388,15.67,0.502,4
180,103,46,10250,1,650,0,0,74.07,43849269,23.258,19.7,3.548,4466.507,431.388,15.67,0.502,4
180,104,0,10250,0,650,0,0,71.3,43849269,23.258,19.7,3.548,4466.507,431.388,15.67,0.502,4
180,105,66,10316,7,657,0,0,71.3,43849269,23.258,19.7,3.548,4466.507,431.388,15.67,0.502,4
180,106,0,10316,0,657,0,0,71.3,43849269,23.258,19.7,3.548,4466.507,431.388,15.67,0.502,4
180,107,211,10527,11,668,0,0,71.3,43849269,23.258,19.7,3.548,4466.507,431.388,15.67,0.502,4
180,108,0,10527,0,668,0,0,71.3,43849269,23.258,19.7,3.548,4466.507,431.388,15.67,0.502,4
180,109,0,10527,0,668,0,0,71.3,43849269,23.258,19.7,3.548,4466.507,431.388,15.67,0.502,4
180,110,155,10682,5,673,0,0,71.3,43849269,23.258,19.7,3.548,4466.507,431.388,15.67,0.502,4
180,111,80,10762,7,680,0,0,71.3,43849269,23.258,19.7,3.548,4466.507,431.388,15.67,0.502,4
180,112,230,10992,13,693,0,0,71.3,43849269,23.258,19.7,3.548,4466.507,431.388,15.67,0.502,4
180,113,135,11127,13,706,0,0,71.3,43849269,23.258,19.7,3.548,4466.507,431.388,15.67,0.502,4
180,114,0,11127,0,706,0,0,71.3,43849269,23.258,19.7,3.548,4466.507,431.388,15.67,0.502,4
180,115,110,11237,2,708,0,0,71.3,43849269,23.258,19.7,3.548,4466.507,431.388,15.67,0.502,4
180,116,0,11237,0,708,0,0,71.3,43849269,23.258,19.7,3.548,4466.507,431.388,15.67,0.502,4
180,117,65,11302,7,715,0,0,71.3,43849269,23.258,19.7,3.548,4466.507,431.388,15.67,0.502,4
180,118,83,11385,2,717,0,0,71.3,43849269,23.258,19.7,3.548,4466.507,431.388,15.67,0.502,4
180,119,39,11424,3,720,0,0,71.3,43849269,23.258,19.7,3.548,4466.507,431.388,15.67,0.502,4
180,120,72,11496,5,725,0,0,71.3,43849269,23.258,19.7,3.548,4466.507,431.388,15.67,0.502,4
180,121,0,11496,0,725,0,0,71.3,43849269,23.258,19.7,3.548,4466.507,431.388,15.67,0.502,4
180,122,0,11496,0,725,0,0,71.3,43849269,23.258,19.7,3.548,4466.507,431.388,15.67,0.502,4
180,123,148,11644,21,746,0,0,71.3,43849269,23.258,19.7,3.548,4466.507,431.388,15.67,0.502,4
180,124,0,11644,0,746,0,0,71.3,43849269,23.258,19.7,3.548,4466.507,431.388,15.67,0.502,4
180,125,94,11738,6,752,0,0,71.3,43849269,23.258,19.7,3.548,4466.507,431.388,15.67,0.502,4
180,126,0,11738,0,752,0,0,71.3,43849269,23.258,19.7,3.548,4466.507,431.388,15.67,0.502,4
180,127,42,11780,11,763,0,0,69.91,43849269,23.258,19.7,3.548,4466.507,431.388,15.67,0.502,4
180,128,0,11780,0,763,0,0,69.91,43849269,23.258,19.7,3.548,4466.507,431.388,15.67,0.502,4
180,129,0,11780,0,763,0,0,69.91,43849269,23.258,19.7,3.548,4466.507,431.388,15.67,0.502,4
180,130,70,11850,6,769,0,0,69.91,43849269,23.258,19.7,3.548,4466.507,431.388,15.67,0.502,4
180,131,44,11894,4,773,0,0,69.91,43849269,23.258,19.7,3.548,4466.507,431.388,15.67,0.502,4
180,132,0,11894,0,773,0,0,69.91,43849269,23.258,19.7,3.548,4466.507,431.388,15.67,0.502,4
180,133,62,11956,8,781,0,0,69.91,43849269,23.258,19.7,3.548,4466.507,431.388,15.67,0.502,4
180,134,77,12033,5,786,0,0,69.91,43849269,23.258,19.7,3.548,4466.507,431.388,15.67,0.502,4
180,135,82,12115,6,792,0,0,69.91,43849269,23.258,19.7,3.548,4466.507,431.388,15.67,0.502,4
180,136,0,12115,0,792,0,0,69.91,43849269,23.258,19.7,3.548,4466.507,431.388,15.67,0.502,4
180,137,47,12162,1,793,0,0,69.91,43849269,23.258,19.7,3.548,4466.507,431.388,15.67,0.502,4
180,138,152,12314,5,798,0,0,69.91,43849269,23.258,19.7,3.548,4466.507,431.388,15.67,0.502,4
180,139,96,12410,5,803,0,0,69.91,43849269,23.258,19.7,3.548,4466.507,431.388,15.67,0.502,4
180,140,0,12410,0,803,0,0,69.91,43849269,23.258,19.7,3.548,4466.507,431.388,15.67,0.502,4
180,141,75,12485,2,805,0,0,75.46,43849269,23.258,19.7,3.548,4466.507,431.388,15.67,0.502,4
180,142,61,12546,3,808,0,0,75.46,43849269,23.258,19.7,3.548,4466.507,431.388,15.67,0.502,4
180,143,40,12586,4,812,0,0,75.46,43849269,23.258,19.7,3.548,4466.507,431.388,15.67,0.502,4
180,144,37,12623,0,812,0,0,75.46,43849269,23.258,19.7,3.548,4466.507,431.388,15.67,0.502,4
180,145,0,12623,0,812,0,0,75.46,43849269,23.258,19.7,3.548,4466.507,431.388,15.67,0.502,4
180,146,213,12836,3,815,0,0,75.46,43849269,23.258,19.7,3.548,4466.507,431.388,15.67,0.502,4
180,147,0,12836,0,815,0,0,75.46,43849269,23.258,19.7,3.548,4466.507,431.388,15.67,0.502,4
180,148,138,12974,4,819,0,0,75.46,43849269,23.258,19.7,3.548,4466.507,431.388,15.67,0.502,4
180,149,0,12974,0,819,0,0,75.46,43849269,23.258,19.7,3.548,4466.507,431.388,15.67,0.502,4
180,150,71,13045,4,823,0,0,75.46,43849269,23.258,19.7,3.548,4466.507,431.388,15.67,0.502,4
180,151,0,13045,0,823,0,0,75.46,43849269,23.258,19.7,3.548,4466.507,431.388,15.67,0.502,4
180,152,144,13189,0,823,0,0,75.46,43849269,23.258,19.7,3.548,4466.507,431.388,15.67,0.502,4
180,153,0,13189,0,823,0,0,75.46,43849269,23.258,19.7,3.548,4466.507,431.388,15.67,0.502,4
180,154,0,13189,0,823,0,0,62.96,43849269,23.258,19.7,3.548,4466.507,431.388,15.67,0.502,4
180,155,0,13189,0,823,0,0,62.96,43849269,23.258,19.7,3.548,4466.507,431.388,15.67,0.502,4
180,156,0,13189,0,823,0,0,62.96,43849269,23.258,19.7,3.548,4466.507,431.388,15.67,0.502,4
180,157,0,13189,0,823,0,0,62.96,43849269,23.258,19.7,3.548,4466.507,431.388,15.67,0.502,4
180,158,0,13189,0,823,0,0,62.96,43849269,23.258,19.7,3.548,4466.507,431.388,15.67,0.502,4
180,159,0,13189,0,823,0,0,62.96,43849269,23.258,19.7,3.548,4466.507,431.388,15.67,0.502,4
180,160,218,13407,9,832,0,0,62.96,43849269,23.258,19.7,3.548,4466.507,431.388,15.67,0.502,4
180,161,30,13437,1,833,0,0,68.52,43849269,23.258,19.7,3.548,4466.507,431.388,15.67,0.502,4
180,162,0,13437,0,833,0,0,68.52,43849269,23.258,19.7,3.548,4466.507,431.388,15.67,0.502,4
180,163,0,13437,0,833,0,0,68.52,43849269,23.258,19.7,3.548,4466.507,431.388,15.67,0.502,4
180,164,0,13437,0,833,0,0,62.96,43849269,23.258,19.7,3.548,4466.507,431.388,15.67,0.502,4
180,165,0,13437,0,833,0,0,62.96,43849269,23.258,19.7,3.548,4466.507,431.388,15.67,0.502,4
180,166,33,13470,1,834,0,0,62.96,43849269,23.258,19.7,3.548,4466.507,431.388,15.67,0.502,4
180,167,0,13470,0,834,0,0,62.96,43849269,23.258,19.7,3.548,4466.507,431.388,15.67,0.502,4
180,168,65,13535,2,836,0,0,62.96,43849269,23.258,19.7,3.548,4466.507,431.388,15.67,0.502,4
180,169,0,13535,0,836,0,0,62.96,43849269,23.258,19.7,3.548,4466.507,431.388,15.67,0.502,4
180,170,0,13535,0,836,0,0,62.96,43849269,23.258,19.7,3.548,4466.507,431.388,15.67,0.502,4
180,171,0,13535,0,836,0,0,62.96,43849269,23.258,19.7,3.548,4466.507,431.388,15.67,0.502,4
180,172,0,13535,0,836,0,0,57.41,43849269,23.258,19.7,3.548,4466.507,431.388,15.67,0.502,4
180,173,0,13535,0,836,0,0,57.41,43849269,23.258,19.7,3.548,4466.507,431.388,15.67,0.502,4
180,174,20,13555,0,836,0,0,57.41,43849269,23.258,19.7,3.548,4466.507,431.388,15.67,0.502,4
180,175,0,13555,0,836,0,0,57.41,43849269,23.258,19.7,3.548,4466.507,431.388,15.67,0.502,4
180,176,23,13578,0,836,0,0,57.41,43849269,23.258,19.7,3.548,4466.507,431.388,15.67,0.502,4
180,177,0,13578,0,836,0,0,57.41,43849269,23.258,19.7,3.548,4466.507,431.388,15.67,0.502,4
180,178,14,13592,0,836,0,0,53.7,43849269,23.258,19.7,3.548,4466.507,431.388,15.67,0.502,4
180,179,0,13592,0,836,0,0,51.85,43849269,23.258,19.7,3.548,4466.507,431.388,15.67,0.502,4
180,180,14,13606,0,836,0,0,51.85,43849269,23.258,19.7,3.548,4466.507,431.388,15.67,0.502,4
180,181,0,13606,0,836,0,0,51.85,43849269,23.258,19.7,3.548,4466.507,431.388,15.67,0.502,4
180,182,0,13606,0,836,0,0,51.85,43849269,23.258,19.7,3.548,4466.507,431.388,15.67,0.502,4
180,183,0,13606,0,836,0,0,51.85,43849269,23.258,19.7,3.548,4466.507,431.388,15.67,0.502,4
180,184,34,13640,0,836,0,0,51.85,43849269,23.258,19.7,3.548,4466.507,431.388,15.67,0.502,4
180,185,13,13653,0,836,0,0,51.85,43849269,23.258,19.7,3.548,4466.507,431.388,15.67,0.502,4
180,186,0,13653,0,836,0,0,51.85,43849269,23.258,19.7,3.548,4466.507,431.388,15.67,0.502,4
180,187,0,13653,0,836,0,0,51.85,43849269,23.258,19.7,3.548,4466.507,431.388,15.67,0.502,4
180,188,0,13653,0,836,0,0,51.85,43849269,23.258,19.7,3.548,4466.507,431.388,15.67,0.502,4
180,189,0,13653,0,836,0,0,51.85,43849269,23.258,19.7,3.548,4466.507,431.388,15.67,0.502,4
180,190,0,13653,0,836,0,0,51.85,43849269,23.258,19.7,3.548,4466.507,431.388,15.67,0.502,4
180,191,15,13668,0,836,0,0,51.85,43849269,23.258,19.7,3.548,4466.507,431.388,15.67,0.502,4
180,192,0,13668,0,836,0,0,54.63,43849269,23.258,19.7,3.548,4466.507,431.388,15.67,0.502,4
180,193,2,13670,0,836,0,0,54.63,43849269,23.258,19.7,3.548,4466.507,431.388,15.67,0.502,4
180,194,0,13670,0,836,0,0,54.63,43849269,23.258,19.7,3.548,4466.507,431.388,15.67,0.502,4
180,195,0,13670,0,836,0,0,54.63,43849269,23.258,19.7,3.548,4466.507,431.388,15.67,0.502,4
180,196,15,13685,0,836,0,0,54.63,43849269,23.258,19.7,3.548,4466.507,431.388,15.67,0.502,4
180,197,6,13691,0,836,0,0,54.63,43849269,23.258,19.7,3.548,4466.507,431.388,15.67,0.502,4
180,198,0,13691,0,836,0,0,54.63,43849269,23.258,19.7,3.548,4466.507,431.388,15.67,0.502,4
180,199,0,13691,0,836,0,0,54.63,43849269,23.258,19.7,3.548,4466.507,431.388,15.67,0.502,4
180,200,0,13691,0,836,0,0,54.63,43849269,23.258,19.7,3.548,4466.507,431.388,15.67,0.502,4
180,201,0,13691,0,836,0,0,54.63,43849269,23.258,19.7,3.548,4466.507,431.388,15.67,0.502,4
180,202,0,13691,0,836,0,0,54.63,43849269,23.258,19.7,3.548,4466.507,431.388,15.67,0.502,4
180,203,6,13697,0,836,0,0,54.63,43849269,23.258,19.7,3.548,4466.507,431.388,15.67,0.502,4
180,204,27,13724,0,836,0,0,54.63,43849269,23.258,19.7,3.548,4466.507,431.388,15.67,0.502,4
181,1,2,10,0,0,0,0,71.3,586634,3.612,29.6,6.933,13767.119,258.314,12.54,0.72,0
181,2,0,10,0,0,0,0,71.3,586634,3.612,29.6,6.933,13767.119,258.314,12.54,0.72,0
181,3,0,10,0,0,0,0,71.3,586634,3.612,29.6,6.933,13767.119,258.314,12.54,0.72,0
181,4,0,10,1,1,0,0,71.3,586634,3.612,29.6,6.933,13767.119,258.314,12.54,0.72,0
181,5,0,10,0,1,0,0,71.3,586634,3.612,29.6,6.933,13767.119,258.314,12.54,0.72,0
181,6,0,10,0,1,0,0,82.41,586634,3.612,29.6,6.933,13767.119,258.314,12.54,0.72,0
181,7,0,10,0,1,0,0,82.41,586634,3.612,29.6,6.933,13767.119,258.314,12.54,0.72,0
181,8,0,10,0,1,0,0,82.41,586634,3.612,29.6,6.933,13767.119,258.314,12.54,0.72,0
181,9,0,10,0,1,0,0,82.41,586634,3.612,29.6,6.933,13767.119,258.314,12.54,0.72,0
181,10,0,10,0,1,0,0,82.41,586634,3.612,29.6,6.933,13767.119,258.314,12.54,0.72,0
181,11,0,10,0,1,0,0,82.41,586634,3.612,29.6,6.933,13767.119,258.314,12.54,0.72,0
181,12,0,10,0,1,0,0,82.41,586634,3.612,29.6,6.933,13767.119,258.314,12.54,0.72,0
181,13,0,10,0,1,0,0,82.41,586634,3.612,29.6,6.933,13767.119,258.314,12.54,0.72,0
181,14,0,10,0,1,0,0,82.41,586634,3.612,29.6,6.933,13767.119,258.314,12.54,0.72,0
181,15,0,10,0,1,0,0,82.41,586634,3.612,29.6,6.933,13767.119,258.314,12.54,0.72,0
181,16,0,10,0,1,0,0,82.41,586634,3.612,29.6,6.933,13767.119,258.314,12.54,0.72,0
181,17,0,10,0,1,0,0,82.41,586634,3.612,29.6,6.933,13767.119,258.314,12.54,0.72,0
181,18,0,10,0,1,0,0,82.41,586634,3.612,29.6,6.933,13767.119,258.314,12.54,0.72,0
181,19,0,10,0,1,0,0,82.41,586634,3.612,29.6,6.933,13767.119,258.314,12.54,0.72,0
181,20,0,10,0,1,0,0,82.41,586634,3.612,29.6,6.933,13767.119,258.314,12.54,0.72,0
181,21,0,10,0,1,0,0,82.41,586634,3.612,29.6,6.933,13767.119,258.314,12.54,0.72,0
181,22,0,10,0,1,0,0,82.41,586634,3.612,29.6,6.933,13767.119,258.314,12.54,0.72,0
181,23,0,10,0,1,0,0,82.41,586634,3.612,29.6,6.933,13767.119,258.314,12.54,0.72,0
181,24,0,10,0,1,0,0,82.41,586634,3.612,29.6,6.933,13767.119,258.314,12.54,0.72,0
181,25,0,10,0,1,0,0,82.41,586634,3.612,29.6,6.933,13767.119,258.314,12.54,0.72,0
181,26,0,10,0,1,0,0,82.41,586634,3.612,29.6,6.933,13767.119,258.314,12.54,0.72,0
181,27,0,10,0,1,0,0,82.41,586634,3.612,29.6,6.933,13767.119,258.314,12.54,0.72,0
181,28,0,10,0,1,0,0,82.41,586634,3.612,29.6,6.933,13767.119,258.314,12.54,0.72,0
181,29,0,10,0,1,0,0,82.41,586634,3.612,29.6,6.933,13767.119,258.314,12.54,0.72,0
181,30,0,10,0,1,0,0,82.41,586634,3.612,29.6,6.933,13767.119,258.314,12.54,0.72,0
181,31,0,10,0,1,0,0,82.41,586634,3.612,29.6,6.933,13767.119,258.314,12.54,0.72,0
181,32,0,10,0,1,0,0,82.41,586634,3.612,29.6,6.933,13767.119,258.314,12.54,0.72,0
181,33,0,10,0,1,0,0,82.41,586634,3.612,29.6,6.933,13767.119,258.314,12.54,0.72,0
181,34,0,10,0,1,0,0,82.41,586634,3.612,29.6,6.933,13767.119,258.314,12.54,0.72,0
181,35,0,10,0,1,0,0,82.41,586634,3.612,29.6,6.933,13767.119,258.314,12.54,0.72,0
181,36,0,10,0,1,0,0,82.41,586634,3.612,29.6,6.933,13767.119,258.314,12.54,0.72,0
181,37,0,10,0,1,0,0,82.41,586634,3.612,29.6,6.933,13767.119,258.314,12.54,0.72,0
181,38,0,10,0,1,0,0,82.41,586634,3.612,29.6,6.933,13767.119,258.314,12.54,0.72,0
181,39,0,10,0,1,0,0,82.41,586634,3.612,29.6,6.933,13767.119,258.314,12.54,0.72,0
181,40,0,10,0,1,0,0,79.63,586634,3.612,29.6,6.933,13767.119,258.314,12.54,0.72,0
181,41,0,10,0,1,0,0,79.63,586634,3.612,29.6,6.933,13767.119,258.314,12.54,0.72,0
181,42,0,10,0,1,0,0,79.63,586634,3.612,29.6,6.933,13767.119,258.314,12.54,0.72,0
181,43,0,10,0,1,0,0,79.63,586634,3.612,29.6,6.933,13767.119,258.314,12.54,0.72,0
181,44,0,10,0,1,0,0,79.63,586634,3.612,29.6,6.933,13767.119,258.314,12.54,0.72,0
181,45,0,10,0,1,0,0,79.63,586634,3.612,29.6,6.933,13767.119,258.314,12.54,0.72,0
181,46,0,10,0,1,0,0,79.63,586634,3.612,29.6,6.933,13767.119,258.314,12.54,0.72,0
181,47,0,10,0,1,0,0,79.63,586634,3.612,29.6,6.933,13767.119,258.314,12.54,0.72,0
181,48,0,10,0,1,0,0,79.63,586634,3.612,29.6,6.933,13767.119,258.314,12.54,0.72,0
181,49,1,11,0,1,0,0,79.63,586634,3.612,29.6,6.933,13767.119,258.314,12.54,0.72,0
181,50,0,11,0,1,0,0,74.07,586634,3.612,29.6,6.933,13767.119,258.314,12.54,0.72,0
181,51,0,11,0,1,0,0,74.07,586634,3.612,29.6,6.933,13767.119,258.314,12.54,0.72,0
181,52,0,11,0,1,0,0,74.07,586634,3.612,29.6,6.933,13767.119,258.314,12.54,0.72,0
181,53,0,11,0,1,0,0,74.07,586634,3.612,29.6,6.933,13767.119,258.314,12.54,0.72,0
181,54,0,11,0,1,0,0,70.37,586634,3.612,29.6,6.933,13767.119,258.314,12.54,0.72,0
181,55,0,11,0,1,0,0,70.37,586634,3.612,29.6,6.933,13767.119,258.314,12.54,0.72,0
181,56,0,11,0,1,0,0,72.22,586634,3.612,29.6,6.933,13767.119,258.314,12.54,0.72,0
181,57,0,11,0,1,0,0,72.22,586634,3.612,29.6,6.933,13767.119,258.314,12.54,0.72,0
181,58,1,12,0,1,0,0,72.22,586634,3.612,29.6,6.933,13767.119,258.314,12.54,0.72,0
181,59,0,12,0,1,0,0,72.22,586634,3.612,29.6,6.933,13767.119,258.314,12.54,0.72,0
181,60,0,12,0,1,0,0,69.44,586634,3.612,29.6,6.933,13767.119,258.314,12.54,0.72,0
181,61,2,14,0,1,0,0,77.78,586634,3.612,29.6,6.933,13767.119,258.314,12.54,0.72,0
181,62,9,23,0,1,0,0,77.78,586634,3.612,29.6,6.933,13767.119,258.314,12.54,0.72,0
181,63,21,44,0,1,0,0,77.78,586634,3.612,29.6,6.933,13767.119,258.314,12.54,0.72,0
181,64,10,54,0,1,0,0,77.78,586634,3.612,29.6,6.933,13767.119,258.314,12.54,0.72,0
181,65,20,74,0,1,0,0,93.52,586634,3.612,29.6,6.933,13767.119,258.314,12.54,0.72,0
181,66,8,82,0,1,0,0,93.52,586634,3.612,29.6,6.933,13767.119,258.314,12.54,0.72,0
181,67,9,91,0,1,0,0,93.52,586634,3.612,29.6,6.933,13767.119,258.314,12.54,0.72,0
181,68,9,100,0,1,0,0,93.52,586634,3.612,29.6,6.933,13767.119,258.314,12.54,0.72,0
181,69,22,122,0,1,0,0,93.52,586634,3.612,29.6,6.933,13767.119,258.314,12.54,0.72,0
181,70,8,130,1,2,0,0,93.52,586634,3.612,29.6,6.933,13767.119,258.314,12.54,0.72,0
181,71,7,137,0,2,0,0,93.52,586634,3.612,29.6,6.933,13767.119,258.314,12.54,0.72,0
181,72,0,137,0,2,0,0,93.52,586634,3.612,29.6,6.933,13767.119,258.314,12.54,0.72,0
181,73,31,168,0,2,0,0,93.52,586634,3.612,29.6,6.933,13767.119,258.314,12.54,0.72,0
181,74,19,187,1,3,0,0,93.52,586634,3.612,29.6,6.933,13767.119,258.314,12.54,0.72,0
181,75,9,196,0,3,0,0,93.52,586634,3.612,29.6,6.933,13767.119,258.314,12.54,0.72,0
181,76,12,208,0,3,0,0,93.52,586634,3.612,29.6,6.933,13767.119,258.314,12.54,0.72,0
181,77,21,229,2,5,0,0,93.52,586634,3.612,29.6,6.933,13767.119,258.314,12.54,0.72,0
181,78,7,236,1,6,0,0,93.52,586634,3.612,29.6,6.933,13767.119,258.314,12.54,0.72,0
181,79,25,261,0,6,0,0,93.52,586634,3.612,29.6,6.933,13767.119,258.314,12.54,0.72,0
181,80,16,277,1,7,0,0,93.52,586634,3.612,29.6,6.933,13767.119,258.314,12.54,0.72,0
181,81,16,293,1,8,0,0,93.52,586634,3.612,29.6,6.933,13767.119,258.314,12.54,0.72,0
181,82,9,302,0,8,0,0,81.48,586634,3.612,29.6,6.933,13767.119,258.314,12.54,0.72,0
181,83,12,314,0,8,0,0,81.48,586634,3.612,29.6,6.933,13767.119,258.314,12.54,0.72,0
181,84,5,319,0,8,0,0,81.48,586634,3.612,29.6,6.933,13767.119,258.314,12.54,0.72,0
181,85,0,319,1,9,0,0,81.48,586634,3.612,29.6,6.933,13767.119,258.314,12.54,0.72,0
181,86,38,357,1,10,0,0,81.48,586634,3.612,29.6,6.933,13767.119,258.314,12.54,0.72,0
181,87,16,373,0,10,0,0,81.48,586634,3.612,29.6,6.933,13767.119,258.314,12.54,0.72,0
181,88,18,391,0,10,0,0,81.48,586634,3.612,29.6,6.933,13767.119,258.314,12.54,0.72,0
181,89,0,391,0,10,0,0,81.48,586634,3.612,29.6,6.933,13767.119,258.314,12.54,0.72,0
181,90,99,490,1,11,0,0,81.48,586634,3.612,29.6,6.933,13767.119,258.314,12.54,0.72,0
181,91,11,501,2,13,0,0,81.48,586634,3.612,29.6,6.933,13767.119,258.314,12.54,0.72,0
181,92,16,517,0,13,0,0,81.48,586634,3.612,29.6,6.933,13767.119,258.314,12.54,0.72,0
181,93,18,535,0,13,0,0,81.48,586634,3.612,29.6,6.933,13767.119,258.314,12.54,0.72,0
181,94,12,547,0,13,0,0,81.48,586634,3.612,29.6,6.933,13767.119,258.314,12.54,0.72,0
181,95,14,561,0,13,0,0,81.48,586634,3.612,29.6,6.933,13767.119,258.314,12.54,0.72,0
181,96,4,565,1,14,0,0,89.81,586634,3.612,29.6,6.933,13767.119,258.314,12.54,0.72,0
181,97,29,594,0,14,0,0,86.11,586634,3.612,29.6,6.933,13767.119,258.314,12.54,0.72,0
181,98,20,614,0,14,0,0,86.11,586634,3.612,29.6,6.933,13767.119,258.314,12.54,0.72,0
181,99,0,614,0,14,0,0,86.11,586634,3.612,29.6,6.933,13767.119,258.314,12.54,0.72,0
181,100,51,665,3,17,0,0,86.11,586634,3.612,29.6,6.933,13767.119,258.314,12.54,0.72,0
181,101,29,694,0,17,0,0,86.11,586634,3.612,29.6,6.933,13767.119,258.314,12.54,0.72,0
181,102,32,726,1,18,0,0,86.11,586634,3.612,29.6,6.933,13767.119,258.314,12.54,0.72,0
181,103,15,741,0,18,0,0,86.11,586634,3.612,29.6,6.933,13767.119,258.314,12.54,0.72,0
181,104,0,741,0,18,0,0,86.11,586634,3.612,29.6,6.933,13767.119,258.314,12.54,0.72,0
181,105,39,780,0,18,0,0,86.11,586634,3.612,29.6,6.933,13767.119,258.314,12.54,0.72,0
181,106,21,801,0,18,0,0,86.11,586634,3.612,29.6,6.933,13767.119,258.314,12.54,0.72,0
181,107,48,849,0,18,0,0,86.11,586634,3.612,29.6,6.933,13767.119,258.314,12.54,0.72,0
181,108,69,918,0,18,0,0,86.11,586634,3.612,29.6,6.933,13767.119,258.314,12.54,0.72,0
181,109,25,943,1,19,0,0,86.11,586634,3.612,29.6,6.933,13767.119,258.314,12.54,0.72,0
181,110,58,1001,1,20,0,0,86.11,586634,3.612,29.6,6.933,13767.119,258.314,12.54,0.72,0
181,111,28,1029,1,21,0,0,86.11,586634,3.612,29.6,6.933,13767.119,258.314,12.54,0.72,0
181,112,50,1079,0,21,0,0,83.33,586634,3.612,29.6,6.933,13767.119,258.314,12.54,0.72,0
181,113,52,1131,0,21,0,0,83.33,586634,3.612,29.6,6.933,13767.119,258.314,12.54,0.72,0
181,114,45,1176,0,21,0,0,83.33,586634,3.612,29.6,6.933,13767.119,258.314,12.54,0.72,0
181,115,58,1234,2,23,0,0,83.33,586634,3.612,29.6,6.933,13767.119,258.314,12.54,0.72,0
181,116,71,1305,0,23,0,0,83.33,586634,3.612,29.6,6.933,13767.119,258.314,12.54,0.72,0
181,117,76,1381,0,23,0,0,81.48,586634,3.612,29.6,6.933,13767.119,258.314,12.54,0.72,0
181,118,58,1439,0,23,0,0,75.93,586634,3.612,29.6,6.933,13767.119,258.314,12.54,0.72,0
181,119,44,1483,1,24,0,0,75.93,586634,3.612,29.6,6.933,13767.119,258.314,12.54,0.72,0
181,120,27,1510,0,24,0,0,75.93,586634,3.612,29.6,6.933,13767.119,258.314,12.54,0.72,0
181,121,97,1607,2,26,0,0,75.93,586634,3.612,29.6,6.933,13767.119,258.314,12.54,0.72,0
181,122,43,1650,0,26,0,0,75.93,586634,3.612,29.6,6.933,13767.119,258.314,12.54,0.72,0
181,123,56,1706,0,26,0,0,75.93,586634,3.612,29.6,6.933,13767.119,258.314,12.54,0.72,0
181,124,54,1760,0,26,0,0,75.93,586634,3.612,29.6,6.933,13767.119,258.314,12.54,0.72,0
181,125,89,1849,1,27,0,0,75.93,586634,3.612,29.6,6.933,13767.119,258.314,12.54,0.72,0
181,126,44,1893,0,27,0,0,75.93,586634,3.612,29.6,6.933,13767.119,258.314,12.54,0.72,0
181,127,88,1981,0,27,0,0,75.93,586634,3.612,29.6,6.933,13767.119,258.314,12.54,0.72,0
181,128,69,2050,0,27,0,0,75.93,586634,3.612,29.6,6.933,13767.119,258.314,12.54,0.72,0
181,129,46,2096,2,29,0,0,75.93,586634,3.612,29.6,6.933,13767.119,258.314,12.54,0.72,0
181,130,107,2203,0,29,0,0,75.93,586634,3.612,29.6,6.933,13767.119,258.314,12.54,0.72,0
181,131,103,2306,0,29,0,0,75.93,586634,3.612,29.6,6.933,13767.119,258.314,12.54,0.72,0
181,132,85,2391,0,29,0,0,79.63,586634,3.612,29.6,6.933,13767.119,258.314,12.54,0.72,0
181,133,98,2489,1,30,0,0,85.19,586634,3.612,29.6,6.933,13767.119,258.314,12.54,0.72,0
181,134,70,2559,9,39,0,0,85.19,586634,3.612,29.6,6.933,13767.119,258.314,12.54,0.72,0
181,135,94,2653,0,39,0,0,85.19,586634,3.612,29.6,6.933,13767.119,258.314,12.54,0.72,0
181,136,108,2761,1,40,0,0,85.19,586634,3.612,29.6,6.933,13767.119,258.314,12.54,0.72,0
181,137,77,2838,1,41,0,0,85.19,586634,3.612,29.6,6.933,13767.119,258.314,12.54,0.72,0
181,138,123,2961,1,42,0,0,85.19,586634,3.612,29.6,6.933,13767.119,258.314,12.54,0.72,0
181,139,55,3016,5,47,0,0,85.19,586634,3.612,29.6,6.933,13767.119,258.314,12.54,0.72,0
181,140,61,3077,1,48,0,0,85.19,586634,3.612,29.6,6.933,13767.119,258.314,12.54,0.72,0
181,141,139,3216,6,54,0,0,85.19,586634,3.612,29.6,6.933,13767.119,258.314,12.54,0.72,0
181,142,79,3295,0,54,0,0,85.19,586634,3.612,29.6,6.933,13767.119,258.314,12.54,0.72,0
181,143,71,3366,1,55,0,0,85.19,586634,3.612,29.6,6.933,13767.119,258.314,12.54,0.72,0
181,144,94,3460,1,56,0,0,85.19,586634,3.612,29.6,6.933,13767.119,258.314,12.54,0.72,0
181,145,109,3569,1,57,0,0,85.19,586634,3.612,29.6,6.933,13767.119,258.314,12.54,0.72,0
181,146,38,3607,1,58,0,0,85.19,586634,3.612,29.6,6.933,13767.119,258.314,12.54,0.72,0
181,147,25,3632,2,60,0,0,85.19,586634,3.612,29.6,6.933,13767.119,258.314,12.54,0.72,0
181,148,66,3698,1,61,0,0,85.19,586634,3.612,29.6,6.933,13767.119,258.314,12.54,0.72,0
181,149,26,3724,1,62,0,0,85.19,586634,3.612,29.6,6.933,13767.119,258.314,12.54,0.72,0
181,150,69,3793,4,66,0,0,96.3,586634,3.612,29.6,6.933,13767.119,258.314,12.54,0.72,0
181,151,55,3848,0,66,0,0,96.3,586634,3.612,29.6,6.933,13767.119,258.314,12.54,0.72,0
181,152,106,3954,1,67,0,0,96.3,586634,3.612,29.6,6.933,13767.119,258.314,12.54,0.72,0
181,153,55,4009,0,67,0,0,96.3,586634,3.612,29.6,6.933,13767.119,258.314,12.54,0.72,0
181,154,25,4034,4,71,0,0,96.3,586634,3.612,29.6,6.933,13767.119,258.314,12.54,0.72,0
181,155,55,4089,1,72,0,0,96.3,586634,3.612,29.6,6.933,13767.119,258.314,12.54,0.72,0
181,156,60,4149,0,72,0,0,96.3,586634,3.612,29.6,6.933,13767.119,258.314,12.54,0.72,0
181,157,66,4215,1,73,0,0,96.3,586634,3.612,29.6,6.933,13767.119,258.314,12.54,0.72,0
181,158,37,4252,2,75,0,0,96.3,586634,3.612,29.6,6.933,13767.119,258.314,12.54,0.72,0
181,159,68,4320,2,77,0,0,96.3,586634,3.612,29.6,6.933,13767.119,258.314,12.54,0.72,0
181,160,26,4346,8,85,0,0,96.3,586634,3.612,29.6,6.933,13767.119,258.314,12.54,0.72,0
181,161,14,4360,6,91,0,0,96.3,586634,3.612,29.6,6.933,13767.119,258.314,12.54,0.72,0
181,162,59,4419,0,91,0,0,96.3,586634,3.612,29.6,6.933,13767.119,258.314,12.54,0.72,0
181,163,28,4447,1,92,0,0,96.3,586634,3.612,29.6,6.933,13767.119,258.314,12.54,0.72,0
181,164,30,4477,1,93,0,0,100,586634,3.612,29.6,6.933,13767.119,258.314,12.54,0.72,0
181,165,52,4529,0,93,0,0,100,586634,3.612,29.6,6.933,13767.119,258.314,12.54,0.72,0
181,166,50,4579,0,93,0,0,100,586634,3.612,29.6,6.933,13767.119,258.314,12.54,0.72,0
181,167,3,4582,0,93,0,0,100,586634,3.612,29.6,6.933,13767.119,258.314,12.54,0.72,0
181,168,29,4611,2,95,0,0,70.37,586634,3.612,29.6,6.933,13767.119,258.314,12.54,0.72,0
181,169,14,4625,0,95,0,0,70.37,586634,3.612,29.6,6.933,13767.119,258.314,12.54,0.72,0
181,170,20,4645,0,95,0,0,70.37,586634,3.612,29.6,6.933,13767.119,258.314,12.54,0.72,0
181,171,26,4671,0,95,0,0,70.37,586634,3.612,29.6,6.933,13767.119,258.314,12.54,0.72,0
181,172,20,4691,1,96,0,0,70.37,586634,3.612,29.6,6.933,13767.119,258.314,12.54,0.72,0
181,173,18,4709,1,97,0,0,70.37,586634,3.612,29.6,6.933,13767.119,258.314,12.54,0.72,0
181,174,14,4723,0,97,0,0,70.37,586634,3.612,29.6,6.933,13767.119,258.314,12.54,0.72,0
181,175,17,4740,0,97,0,0,70.37,586634,3.612,29.6,6.933,13767.119,258.314,12.54,0.72,0
181,176,19,4759,3,100,0,0,70.37,586634,3.612,29.6,6.933,13767.119,258.314,12.54,0.72,0
181,177,20,4779,1,101,0,0,70.37,586634,3.612,29.6,6.933,13767.119,258.314,12.54,0.72,0
181,178,10,4789,1,102,0,0,70.37,586634,3.612,29.6,6.933,13767.119,258.314,12.54,0.72,0
181,179,28,4817,0,102,0,0,70.37,586634,3.612,29.6,6.933,13767.119,258.314,12.54,0.72,0
181,180,14,4831,0,102,0,0,70.37,586634,3.612,29.6,6.933,13767.119,258.314,12.54,0.72,0
181,181,4,4835,0,102,0,0,67.59,586634,3.612,29.6,6.933,13767.119,258.314,12.54,0.72,0
181,182,1,4836,0,102,0,0,67.59,586634,3.612,29.6,6.933,13767.119,258.314,12.54,0.72,0
181,183,27,4863,2,104,0,0,67.59,586634,3.612,29.6,6.933,13767.119,258.314,12.54,0.72,0
181,184,14,4877,0,104,0,0,63.89,586634,3.612,29.6,6.933,13767.119,258.314,12.54,0.72,0
181,185,14,4891,1,105,0,0,63.89,586634,3.612,29.6,6.933,13767.119,258.314,12.54,0.72,0
181,186,8,4899,0,105,0,0,63.89,586634,3.612,29.6,6.933,13767.119,258.314,12.54,0.72,0
181,187,25,4924,1,106,0,0,63.89,586634,3.612,29.6,6.933,13767.119,258.314,12.54,0.72,0
181,188,17,4941,0,106,0,0,63.89,586634,3.612,29.6,6.933,13767.119,258.314,12.54,0.72,0
181,189,13,4954,0,106,0,0,68.52,586634,3.612,29.6,6.933,13767.119,258.314,12.54,0.72,0
181,190,11,4965,0,106,0,0,68.52,586634,3.612,29.6,6.933,13767.119,258.314,12.54,0.72,0
181,191,14,4979,0,106,0,0,68.52,586634,3.612,29.6,6.933,13767.119,258.314,12.54,0.72,0
181,192,25,5004,0,106,0,0,68.52,586634,3.612,29.6,6.933,13767.119,258.314,12.54,0.72,0
181,193,14,5018,0,106,0,0,68.52,586634,3.612,29.6,6.933,13767.119,258.314,12.54,0.72,0
181,194,17,5035,1,107,0,0,68.52,586634,3.612,29.6,6.933,13767.119,258.314,12.54,0.72,0
181,195,16,5051,0,107,0,0,68.52,586634,3.612,29.6,6.933,13767.119,258.314,12.54,0.72,0
181,196,7,5058,0,107,0,0,68.52,586634,3.612,29.6,6.933,13767.119,258.314,12.54,0.72,0
181,197,14,5072,0,107,0,0,68.52,586634,3.612,29.6,6.933,13767.119,258.314,12.54,0.72,0
181,198,11,5083,1,108,0,0,68.52,586634,3.612,29.6,6.933,13767.119,258.314,12.54,0.72,0
181,199,11,5094,1,109,0,0,68.52,586634,3.612,29.6,6.933,13767.119,258.314,12.54,0.72,0
181,200,19,5113,0,109,0,0,68.52,586634,3.612,29.6,6.933,13767.119,258.314,12.54,0.72,0
181,201,10,5123,0,109,0,0,68.52,586634,3.612,29.6,6.933,13767.119,258.314,12.54,0.72,0
181,202,7,5130,0,109,0,0,68.52,586634,3.612,29.6,6.933,13767.119,258.314,12.54,0.72,0
181,203,3,5133,0,109,0,0,68.52,586634,3.612,29.6,6.933,13767.119,258.314,12.54,0.72,0
181,204,11,5144,0,109,0,0,68.52,586634,3.612,29.6,6.933,13767.119,258.314,12.54,0.72,0
182,1,0,9,0,0,0,0,86.11,1160164,79.492,21.5,3.163,7738.975,333.436,3.94,0.588,0
182,2,0,9,0,0,0,0,86.11,1160164,79.492,21.5,3.163,7738.975,333.436,3.94,0.588,0
182,3,0,9,0,0,0,0,89.81,1160164,79.492,21.5,3.163,7738.975,333.436,3.94,0.588,0
182,4,0,9,0,0,0,0,89.81,1160164,79.492,21.5,3.163,7738.975,333.436,3.94,0.588,0
182,5,0,9,0,0,0,0,89.81,1160164,79.492,21.5,3.163,7738.975,333.436,3.94,0.588,0
182,6,0,9,0,0,0,0,89.81,1160164,79.492,21.5,3.163,7738.975,333.436,3.94,0.588,0
182,7,1,10,0,0,0,0,89.81,1160164,79.492,21.5,3.163,7738.975,333.436,3.94,0.588,0
182,8,0,10,0,0,0,0,89.81,1160164,79.492,21.5,3.163,7738.975,333.436,3.94,0.588,0
182,9,2,12,0,0,0,0,89.81,1160164,79.492,21.5,3.163,7738.975,333.436,3.94,0.588,0
182,10,0,12,0,0,0,0,89.81,1160164,79.492,21.5,3.163,7738.975,333.436,3.94,0.588,0
182,11,0,12,0,0,0,0,89.81,1160164,79.492,21.5,3.163,7738.975,333.436,3.94,0.588,0
182,12,2,14,0,0,0,0,89.81,1160164,79.492,21.5,3.163,7738.975,333.436,3.94,0.588,0
182,13,0,14,0,0,0,0,89.81,1160164,79.492,21.5,3.163,7738.975,333.436,3.94,0.588,0
182,14,1,15,0,0,0,0,89.81,1160164,79.492,21.5,3.163,7738.975,333.436,3.94,0.588,0
182,15,0,15,0,0,0,0,89.81,1160164,79.492,21.5,3.163,7738.975,333.436,3.94,0.588,0
182,16,1,16,0,0,0,0,84.26,1160164,79.492,21.5,3.163,7738.975,333.436,3.94,0.588,0
182,17,0,16,0,0,0,0,84.26,1160164,79.492,21.5,3.163,7738.975,333.436,3.94,0.588,0
182,18,3,19,1,1,0,0,84.26,1160164,79.492,21.5,3.163,7738.975,333.436,3.94,0.588,0
182,19,0,19,0,1,0,0,84.26,1160164,79.492,21.5,3.163,7738.975,333.436,3.94,0.588,0
182,20,3,22,0,1,0,0,84.26,1160164,79.492,21.5,3.163,7738.975,333.436,3.94,0.588,0
182,21,2,24,0,1,0,0,84.26,1160164,79.492,21.5,3.163,7738.975,333.436,3.94,0.588,0
182,22,0,24,0,1,0,0,84.26,1160164,79.492,21.5,3.163,7738.975,333.436,3.94,0.588,0
182,23,7,31,0,1,0,0,84.26,1160164,79.492,21.5,3.163,7738.975,333.436,3.94,0.588,0
182,24,1,32,0,1,0,0,84.26,1160164,79.492,21.5,3.163,7738.975,333.436,3.94,0.588,0
182,25,8,40,0,1,0,0,84.26,1160164,79.492,21.5,3.163,7738.975,333.436,3.94,0.588,0
182,26,0,40,0,1,0,0,84.26,1160164,79.492,21.5,3.163,7738.975,333.436,3.94,0.588,0
182,27,19,59,0,1,0,0,84.26,1160164,79.492,21.5,3.163,7738.975,333.436,3.94,0.588,0
182,28,6,65,0,1,0,0,84.26,1160164,79.492,21.5,3.163,7738.975,333.436,3.94,0.588,0
182,29,6,71,0,1,0,0,84.26,1160164,79.492,21.5,3.163,7738.975,333.436,3.94,0.588,0
182,30,20,91,0,1,0,0,84.26,1160164,79.492,21.5,3.163,7738.975,333.436,3.94,0.588,0
182,31,9,100,0,1,0,0,84.26,1160164,79.492,21.5,3.163,7738.975,333.436,3.94,0.588,0
182,32,6,106,0,1,0,0,84.26,1160164,79.492,21.5,3.163,7738.975,333.436,3.94,0.588,0
182,33,2,108,0,1,0,0,84.26,1160164,79.492,21.5,3.163,7738.975,333.436,3.94,0.588,0
182,34,4,112,0,1,0,0,84.26,1160164,79.492,21.5,3.163,7738.975,333.436,3.94,0.588,0
182,35,4,116,0,1,0,0,84.26,1160164,79.492,21.5,3.163,7738.975,333.436,3.94,0.588,0
182,36,0,116,0,1,0,0,84.26,1160164,79.492,21.5,3.163,7738.975,333.436,3.94,0.588,0
182,37,7,123,1,2,0,0,84.26,1160164,79.492,21.5,3.163,7738.975,333.436,3.94,0.588,0
182,38,30,153,0,2,0,0,84.26,1160164,79.492,21.5,3.163,7738.975,333.436,3.94,0.588,0
182,39,6,159,0,2,0,0,84.26,1160164,79.492,21.5,3.163,7738.975,333.436,3.94,0.588,0
182,40,4,163,0,2,0,0,84.26,1160164,79.492,21.5,3.163,7738.975,333.436,3.94,0.588,0
182,41,9,172,0,2,0,0,84.26,1160164,79.492,21.5,3.163,7738.975,333.436,3.94,0.588,0
182,42,3,175,0,2,0,0,84.26,1160164,79.492,21.5,3.163,7738.975,333.436,3.94,0.588,0
182,43,9,184,0,2,0,0,84.26,1160164,79.492,21.5,3.163,7738.975,333.436,3.94,0.588,0
182,44,3,187,0,2,0,0,84.26,1160164,79.492,21.5,3.163,7738.975,333.436,3.94,0.588,0
182,45,0,187,0,2,0,0,84.26,1160164,79.492,21.5,3.163,7738.975,333.436,3.94,0.588,0
182,46,3,190,0,2,0,0,84.26,1160164,79.492,21.5,3.163,7738.975,333.436,3.94,0.588,0
182,47,12,202,0,2,0,0,84.26,1160164,79.492,21.5,3.163,7738.975,333.436,3.94,0.588,0
182,48,1,203,0,2,0,0,84.26,1160164,79.492,21.5,3.163,7738.975,333.436,3.94,0.588,0
182,49,0,203,0,2,0,0,84.26,1160164,79.492,21.5,3.163,7738.975,333.436,3.94,0.588,0
182,50,5,208,0,2,0,0,84.26,1160164,79.492,21.5,3.163,7738.975,333.436,3.94,0.588,0
182,51,9,217,0,2,0,0,84.26,1160164,79.492,21.5,3.163,7738.975,333.436,3.94,0.588,0
182,52,3,220,0,2,0,0,84.26,1160164,79.492,21.5,3.163,7738.975,333.436,3.94,0.588,0
182,53,0,220,0,2,0,0,84.26,1160164,79.492,21.5,3.163,7738.975,333.436,3.94,0.588,0
182,54,18,238,0,2,0,0,84.26,1160164,79.492,21.5,3.163,7738.975,333.436,3.94,0.588,0
182,55,12,250,0,2,0,0,84.26,1160164,79.492,21.5,3.163,7738.975,333.436,3.94,0.588,0
182,56,6,256,0,2,0,0,84.26,1160164,79.492,21.5,3.163,7738.975,333.436,3.94,0.588,0
182,57,5,261,0,2,0,0,84.26,1160164,79.492,21.5,3.163,7738.975,333.436,3.94,0.588,0
182,58,11,272,0,2,0,0,84.26,1160164,79.492,21.5,3.163,7738.975,333.436,3.94,0.588,0
182,59,7,279,0,2,0,0,84.26,1160164,79.492,21.5,3.163,7738.975,333.436,3.94,0.588,0
182,60,0,279,0,2,0,0,84.26,1160164,79.492,21.5,3.163,7738.975,333.436,3.94,0.588,0
182,61,4,283,0,2,0,0,84.26,1160164,79.492,21.5,3.163,7738.975,333.436,3.94,0.588,0
182,62,2,285,0,2,0,0,84.26,1160164,79.492,21.5,3.163,7738.975,333.436,3.94,0.588,0
182,63,8,293,1,3,0,0,84.26,1160164,79.492,21.5,3.163,7738.975,333.436,3.94,0.588,0
182,64,0,293,0,3,0,0,84.26,1160164,79.492,21.5,3.163,7738.975,333.436,3.94,0.588,0
182,65,2,295,0,3,0,0,84.26,1160164,79.492,21.5,3.163,7738.975,333.436,3.94,0.588,0
182,66,5,300,0,3,0,0,84.26,1160164,79.492,21.5,3.163,7738.975,333.436,3.94,0.588,0
182,67,5,305,0,3,0,0,84.26,1160164,79.492,21.5,3.163,7738.975,333.436,3.94,0.588,0
182,68,17,322,0,3,0,0,84.26,1160164,79.492,21.5,3.163,7738.975,333.436,3.94,0.588,0
182,69,11,333,0,3,0,0,84.26,1160164,79.492,21.5,3.163,7738.975,333.436,3.94,0.588,0
182,70,7,340,0,3,0,0,84.26,1160164,79.492,21.5,3.163,7738.975,333.436,3.94,0.588,0
182,71,31,371,0,3,0,0,84.26,1160164,79.492,21.5,3.163,7738.975,333.436,3.94,0.588,0
182,72,27,398,0,3,0,0,84.26,1160164,79.492,21.5,3.163,7738.975,333.436,3.94,0.588,0
182,73,51,449,0,3,0,0,84.26,1160164,79.492,21.5,3.163,7738.975,333.436,3.94,0.588,0
182,74,23,472,0,3,0,0,84.26,1160164,79.492,21.5,3.163,7738.975,333.436,3.94,0.588,0
182,75,14,486,0,3,0,0,84.26,1160164,79.492,21.5,3.163,7738.975,333.436,3.94,0.588,0
182,76,4,490,1,4,0,0,84.26,1160164,79.492,21.5,3.163,7738.975,333.436,3.94,0.588,0
182,77,16,506,0,4,0,0,84.26,1160164,79.492,21.5,3.163,7738.975,333.436,3.94,0.588,0
182,78,14,520,0,4,0,0,84.26,1160164,79.492,21.5,3.163,7738.975,333.436,3.94,0.588,0
182,79,43,563,0,4,0,0,84.26,1160164,79.492,21.5,3.163,7738.975,333.436,3.94,0.588,0
182,80,23,586,0,4,0,0,84.26,1160164,79.492,21.5,3.163,7738.975,333.436,3.94,0.588,0
182,81,37,623,0,4,0,0,84.26,1160164,79.492,21.5,3.163,7738.975,333.436,3.94,0.588,0
182,82,4,627,1,5,0,0,84.26,1160164,79.492,21.5,3.163,7738.975,333.436,3.94,0.588,0
182,83,8,635,0,5,0,0,84.26,1160164,79.492,21.5,3.163,7738.975,333.436,3.94,0.588,0
182,84,8,643,1,6,0,0,84.26,1160164,79.492,21.5,3.163,7738.975,333.436,3.94,0.588,0
182,85,31,674,1,7,0,0,84.26,1160164,79.492,21.5,3.163,7738.975,333.436,3.94,0.588,0
182,86,16,690,0,7,0,0,84.26,1160164,79.492,21.5,3.163,7738.975,333.436,3.94,0.588,0
182,87,16,706,1,8,0,0,84.26,1160164,79.492,21.5,3.163,7738.975,333.436,3.94,0.588,0
182,88,22,728,0,8,0,0,84.26,1160164,79.492,21.5,3.163,7738.975,333.436,3.94,0.588,0
182,89,17,745,0,8,0,0,84.26,1160164,79.492,21.5,3.163,7738.975,333.436,3.94,0.588,0
182,90,36,781,3,11,0,0,84.26,1160164,79.492,21.5,3.163,7738.975,333.436,3.94,0.588,0
182,91,14,795,0,11,0,0,84.26,1160164,79.492,21.5,3.163,7738.975,333.436,3.94,0.588,0
182,92,17,812,0,11,0,0,84.26,1160164,79.492,21.5,3.163,7738.975,333.436,3.94,0.588,0
182,93,28,840,0,11,0,0,84.26,1160164,79.492,21.5,3.163,7738.975,333.436,3.94,0.588,0
182,94,33,873,0,11,0,0,84.26,1160164,79.492,21.5,3.163,7738.975,333.436,3.94,0.588,0
182,95,36,909,2,13,0,0,84.26,1160164,79.492,21.5,3.163,7738.975,333.436,3.94,0.588,0
182,96,45,954,0,13,0,0,84.26,1160164,79.492,21.5,3.163,7738.975,333.436,3.94,0.588,0
182,97,34,988,0,13,0,0,84.26,1160164,79.492,21.5,3.163,7738.975,333.436,3.94,0.588,0
182,98,23,1011,0,13,0,0,84.26,1160164,79.492,21.5,3.163,7738.975,333.436,3.94,0.588,0
182,99,45,1056,1,14,0,0,80.56,1160164,79.492,21.5,3.163,7738.975,333.436,3.94,0.588,0
182,100,82,1138,0,14,0,0,80.56,1160164,79.492,21.5,3.163,7738.975,333.436,3.94,0.588,0
182,101,75,1213,3,17,0,0,80.56,1160164,79.492,21.5,3.163,7738.975,333.436,3.94,0.588,0
182,102,44,1257,1,18,0,0,80.56,1160164,79.492,21.5,3.163,7738.975,333.436,3.94,0.588,0
182,103,54,1311,0,18,0,0,80.56,1160164,79.492,21.5,3.163,7738.975,333.436,3.94,0.588,0
182,104,40,1351,2,20,0,0,80.56,1160164,79.492,21.5,3.163,7738.975,333.436,3.94,0.588,0
182,105,38,1389,0,20,0,0,80.56,1160164,79.492,21.5,3.163,7738.975,333.436,3.94,0.588,0
182,106,45,1434,0,20,0,0,80.56,1160164,79.492,21.5,3.163,7738.975,333.436,3.94,0.588,0
182,107,55,1489,0,20,0,0,80.56,1160164,79.492,21.5,3.163,7738.975,333.436,3.94,0.588,0
182,108,63,1552,1,21,0,0,80.56,1160164,79.492,21.5,3.163,7738.975,333.436,3.94,0.588,0
182,109,67,1619,0,21,0,0,80.56,1160164,79.492,21.5,3.163,7738.975,333.436,3.94,0.588,0
182,110,110,1729,0,21,0,0,80.56,1160164,79.492,21.5,3.163,7738.975,333.436,3.94,0.588,0
182,111,64,1793,0,21,0,0,80.56,1160164,79.492,21.5,3.163,7738.975,333.436,3.94,0.588,0
182,112,33,1826,2,23,0,0,80.56,1160164,79.492,21.5,3.163,7738.975,333.436,3.94,0.588,0
182,113,68,1894,1,24,0,0,80.56,1160164,79.492,21.5,3.163,7738.975,333.436,3.94,0.588,0
182,114,44,1938,1,25,0,0,80.56,1160164,79.492,21.5,3.163,7738.975,333.436,3.94,0.588,0
182,115,83,2021,3,28,0,0,80.56,1160164,79.492,21.5,3.163,7738.975,333.436,3.94,0.588,0
182,116,52,2073,0,28,0,0,80.56,1160164,79.492,21.5,3.163,7738.975,333.436,3.94,0.588,0
182,117,69,2142,0,28,0,0,80.56,1160164,79.492,21.5,3.163,7738.975,333.436,3.94,0.588,0
182,118,65,2207,4,32,0,0,80.56,1160164,79.492,21.5,3.163,7738.975,333.436,3.94,0.588,0
182,119,109,2316,2,34,0,0,80.56,1160164,79.492,21.5,3.163,7738.975,333.436,3.94,0.588,0
182,120,88,2404,5,39,0,0,80.56,1160164,79.492,21.5,3.163,7738.975,333.436,3.94,0.588,0
182,121,147,2551,1,40,0,0,80.56,1160164,79.492,21.5,3.163,7738.975,333.436,3.94,0.588,0
182,122,26,2577,0,40,0,0,80.56,1160164,79.492,21.5,3.163,7738.975,333.436,3.94,0.588,0
182,123,71,2648,1,41,0,0,80.56,1160164,79.492,21.5,3.163,7738.975,333.436,3.94,0.588,0
182,124,58,2706,2,43,0,0,80.56,1160164,79.492,21.5,3.163,7738.975,333.436,3.94,0.588,0
182,125,69,2775,0,43,0,0,80.56,1160164,79.492,21.5,3.163,7738.975,333.436,3.94,0.588,0
182,126,63,2838,2,45,0,0,80.56,1160164,79.492,21.5,3.163,7738.975,333.436,3.94,0.588,0
182,127,18,2856,4,49,0,0,80.56,1160164,79.492,21.5,3.163,7738.975,333.436,3.94,0.588,0
182,128,53,2909,4,53,0,0,80.56,1160164,79.492,21.5,3.163,7738.975,333.436,3.94,0.588,0
182,129,59,2968,2,55,0,0,80.56,1160164,79.492,21.5,3.163,7738.975,333.436,3.94,0.588,0
182,130,68,3036,1,56,0,0,80.56,1160164,79.492,21.5,3.163,7738.975,333.436,3.94,0.588,0
182,131,92,3128,0,56,0,0,80.56,1160164,79.492,21.5,3.163,7738.975,333.436,3.94,0.588,0
182,132,108,3236,2,58,0,0,80.56,1160164,79.492,21.5,3.163,7738.975,333.436,3.94,0.588,0
182,133,73,3309,3,61,0,0,80.56,1160164,79.492,21.5,3.163,7738.975,333.436,3.94,0.588,0
182,134,101,3410,2,63,0,0,80.56,1160164,79.492,21.5,3.163,7738.975,333.436,3.94,0.588,0
182,135,115,3525,0,63,0,0,80.56,1160164,79.492,21.5,3.163,7738.975,333.436,3.94,0.588,0
182,136,74,3599,2,65,0,0,80.56,1160164,79.492,21.5,3.163,7738.975,333.436,3.94,0.588,0
182,137,71,3670,3,68,0,0,80.56,1160164,79.492,21.5,3.163,7738.975,333.436,3.94,0.588,0
182,138,75,3745,1,69,0,0,80.56,1160164,79.492,21.5,3.163,7738.975,333.436,3.94,0.588,0
182,139,94,3839,1,70,0,0,80.56,1160164,79.492,21.5,3.163,7738.975,333.436,3.94,0.588,0
182,140,55,3894,3,73,0,0,64.81,1160164,79.492,21.5,3.163,7738.975,333.436,3.94,0.588,0
182,141,95,3989,3,76,0,0,64.81,1160164,79.492,21.5,3.163,7738.975,333.436,3.94,0.588,0
182,142,69,4058,3,79,0,0,64.81,1160164,79.492,21.5,3.163,7738.975,333.436,3.94,0.588,0
182,143,52,4110,2,81,0,0,64.81,1160164,79.492,21.5,3.163,7738.975,333.436,3.94,0.588,0
182,144,18,4128,0,81,0,0,64.81,1160164,79.492,21.5,3.163,7738.975,333.436,3.94,0.588,0
182,145,61,4189,2,83,0,0,64.81,1160164,79.492,21.5,3.163,7738.975,333.436,3.94,0.588,0
182,146,36,4225,2,85,0,0,64.81,1160164,79.492,21.5,3.163,7738.975,333.436,3.94,0.588,0
182,147,79,4304,0,85,0,0,64.81,1160164,79.492,21.5,3.163,7738.975,333.436,3.94,0.588,0
182,148,23,4327,1,86,0,0,64.81,1160164,79.492,21.5,3.163,7738.975,333.436,3.94,0.588,0
182,149,60,4387,2,88,0,0,64.81,1160164,79.492,21.5,3.163,7738.975,333.436,3.94,0.588,0
182,150,46,4433,1,89,0,0,64.81,1160164,79.492,21.5,3.163,7738.975,333.436,3.94,0.588,0
182,151,28,4461,2,91,0,0,64.81,1160164,79.492,21.5,3.163,7738.975,333.436,3.94,0.588,0
182,152,49,4510,0,91,0,0,64.81,1160164,79.492,21.5,3.163,7738.975,333.436,3.94,0.588,0
182,153,51,4561,0,91,0,0,64.81,1160164,79.492,21.5,3.163,7738.975,333.436,3.94,0.588,0
182,154,16,4577,0,91,0,0,64.81,1160164,79.492,21.5,3.163,7738.975,333.436,3.94,0.588,0
182,155,41,4618,3,94,0,0,64.81,1160164,79.492,21.5,3.163,7738.975,333.436,3.94,0.588,0
182,156,50,4668,0,94,0,0,64.81,1160164,79.492,21.5,3.163,7738.975,333.436,3.94,0.588,0
182,157,52,4720,0,94,0,0,64.81,1160164,79.492,21.5,3.163,7738.975,333.436,3.94,0.588,0
182,158,60,4780,0,94,0,0,64.81,1160164,79.492,21.5,3.163,7738.975,333.436,3.94,0.588,0
182,159,39,4819,0,94,0,0,64.81,1160164,79.492,21.5,3.163,7738.975,333.436,3.94,0.588,0
182,160,34,4853,0,94,0,0,64.81,1160164,79.492,21.5,3.163,7738.975,333.436,3.94,0.588,0
182,161,31,4884,0,94,0,0,64.81,1160164,79.492,21.5,3.163,7738.975,333.436,3.94,0.588,0
182,162,20,4904,2,96,0,0,64.81,1160164,79.492,21.5,3.163,7738.975,333.436,3.94,0.588,0
182,163,32,4936,1,97,0,0,64.81,1160164,79.492,21.5,3.163,7738.975,333.436,3.94,0.588,0
182,164,58,4994,1,98,0,0,64.81,1160164,79.492,21.5,3.163,7738.975,333.436,3.94,0.588,0
182,165,31,5025,0,98,0,0,64.81,1160164,79.492,21.5,3.163,7738.975,333.436,3.94,0.588,0
182,166,25,5050,0,98,0,0,64.81,1160164,79.492,21.5,3.163,7738.975,333.436,3.94,0.588,0
182,167,25,5075,0,98,0,0,64.81,1160164,79.492,21.5,3.163,7738.975,333.436,3.94,0.588,0
182,168,29,5104,3,101,0,0,64.81,1160164,79.492,21.5,3.163,7738.975,333.436,3.94,0.588,0
182,169,24,5128,0,101,0,0,64.81,1160164,79.492,21.5,3.163,7738.975,333.436,3.94,0.588,0
182,170,27,5155,0,101,0,0,64.81,1160164,79.492,21.5,3.163,7738.975,333.436,3.94,0.588,0
182,171,36,5191,2,103,0,0,64.81,1160164,79.492,21.5,3.163,7738.975,333.436,3.94,0.588,0
182,172,24,5215,0,103,0,0,64.81,1160164,79.492,21.5,3.163,7738.975,333.436,3.94,0.588,0
182,173,30,5245,1,104,0,0,64.81,1160164,79.492,21.5,3.163,7738.975,333.436,3.94,0.588,0
182,174,24,5269,0,104,0,0,64.81,1160164,79.492,21.5,3.163,7738.975,333.436,3.94,0.588,0
182,175,13,5282,0,104,0,0,64.81,1160164,79.492,21.5,3.163,7738.975,333.436,3.94,0.588,0
182,176,25,5307,2,106,0,0,64.81,1160164,79.492,21.5,3.163,7738.975,333.436,3.94,0.588,0
182,177,36,5343,2,108,0,0,64.81,1160164,79.492,21.5,3.163,7738.975,333.436,3.94,0.588,0
182,178,32,5375,0,108,0,0,64.81,1160164,79.492,21.5,3.163,7738.975,333.436,3.94,0.588,0
182,179,24,5399,0,108,0,0,64.81,1160164,79.492,21.5,3.163,7738.975,333.436,3.94,0.588,0
182,180,20,5419,0,108,0,0,64.81,1160164,79.492,21.5,3.163,7738.975,333.436,3.94,0.588,0
182,181,12,5431,0,108,0,0,64.81,1160164,79.492,21.5,3.163,7738.975,333.436,3.94,0.588,0
182,182,21,5452,0,108,0,0,64.81,1160164,79.492,21.5,3.163,7738.975,333.436,3.94,0.588,0
182,183,10,5462,0,108,0,0,64.81,1160164,79.492,21.5,3.163,7738.975,333.436,3.94,0.588,0
182,184,20,5482,1,109,0,0,64.81,1160164,79.492,21.5,3.163,7738.975,333.436,3.94,0.588,0
182,185,18,5500,2,111,0,0,59.26,1160164,79.492,21.5,3.163,7738.975,333.436,3.94,0.588,0
182,186,21,5521,0,111,0,0,59.26,1160164,79.492,21.5,3.163,7738.975,333.436,3.94,0.588,0
182,187,9,5530,0,111,0,0,59.26,1160164,79.492,21.5,3.163,7738.975,333.436,3.94,0.588,0
182,188,39,5569,0,111,0,0,59.26,1160164,79.492,21.5,3.163,7738.975,333.436,3.94,0.588,0
182,189,10,5579,1,112,0,0,59.26,1160164,79.492,21.5,3.163,7738.975,333.436,3.94,0.588,0
182,190,19,5598,0,112,0,0,59.26,1160164,79.492,21.5,3.163,7738.975,333.436,3.94,0.588,0
182,191,19,5617,1,113,0,0,59.26,1160164,79.492,21.5,3.163,7738.975,333.436,3.94,0.588,0
182,192,15,5632,0,113,0,0,59.26,1160164,79.492,21.5,3.163,7738.975,333.436,3.94,0.588,0
182,193,12,5644,0,113,0,0,59.26,1160164,79.492,21.5,3.163,7738.975,333.436,3.94,0.588,0
182,194,16,5660,0,113,0,0,59.26,1160164,79.492,21.5,3.163,7738.975,333.436,3.94,0.588,0
182,195,9,5669,0,113,0,0,59.26,1160164,79.492,21.5,3.163,7738.975,333.436,3.94,0.588,0
182,196,14,5683,0,113,0,0,59.26,1160164,79.492,21.5,3.163,7738.975,333.436,3.94,0.588,0
182,197,13,5696,1,114,0,0,59.26,1160164,79.492,21.5,3.163,7738.975,333.436,3.94,0.588,0
182,198,19,5715,0,114,0,0,59.26,1160164,79.492,21.5,3.163,7738.975,333.436,3.94,0.588,0
182,199,18,5733,1,115,0,0,59.26,1160164,79.492,21.5,3.163,7738.975,333.436,3.94,0.588,0
182,200,13,5746,0,115,0,0,59.26,1160164,79.492,21.5,3.163,7738.975,333.436,3.94,0.588,0
182,201,19,5765,0,115,0,0,59.26,1160164,79.492,21.5,3.163,7738.975,333.436,3.94,0.588,0
182,202,15,5780,1,116,0,0,59.26,1160164,79.492,21.5,3.163,7738.975,333.436,3.94,0.588,0
182,203,8,5788,0,116,0,0,59.26,1160164,79.492,21.5,3.163,7738.975,333.436,3.94,0.588,0
182,204,12,5800,0,116,0,0,59.26,1160164,79.492,21.5,3.163,7738.975,333.436,3.94,0.588,0
183,1,475,4835,45,290,0,0,40.74,10099270,24.718,41,19.985,46949.283,133.982,4.79,0.933,0
183,2,486,5321,48,338,0,0,40.74,10099270,24.718,41,19.985,46949.283,133.982,4.79,0.933,0
183,3,554,5875,53,391,0,0,40.74,10099270,24.718,41,19.985,46949.283,133.982,4.79,0.933,0
183,4,601,6476,70,461,0,0,46.3,10099270,24.718,41,19.985,46949.283,133.982,4.79,0.933,0
183,5,357,6833,80,541,0,0,46.3,10099270,24.718,41,19.985,46949.283,133.982,4.79,0.933,0
183,6,340,7173,70,611,0,0,46.3,10099270,24.718,41,19.985,46949.283,133.982,4.79,0.933,0
183,7,389,7562,85,696,0,0,46.3,10099270,24.718,41,19.985,46949.283,133.982,4.79,0.933,0
183,8,738,8300,90,786,0,0,46.3,10099270,24.718,41,19.985,46949.283,133.982,4.79,0.933,0
183,9,654,8954,84,870,0,0,46.3,10099270,24.718,41,19.985,46949.283,133.982,4.79,0.933,0
183,10,645,9599,115,985,0,0,46.3,10099270,24.718,41,19.985,46949.283,133.982,4.79,0.933,0
183,11,454,10053,86,1071,0,0,46.3,10099270,24.718,41,19.985,46949.283,133.982,4.79,0.933,0
183,12,395,10448,90,1161,0,0,46.3,10099270,24.718,41,19.985,46949.283,133.982,4.79,0.933,0
183,13,464,10912,102,1263,0,0,46.3,10099270,24.718,41,19.985,46949.283,133.982,4.79,0.933,0
183,14,437,11349,97,1360,0,0,46.3,10099270,24.718,41,19.985,46949.283,133.982,4.79,0.933,0
183,15,479,11828,84,1444,0,0,46.3,10099270,24.718,41,19.985,46949.283,133.982,4.79,0.933,0
183,16,604,12432,92,1536,0,0,46.3,10099270,24.718,41,19.985,46949.283,133.982,4.79,0.933,0
183,17,623,13055,115,1651,0,0,46.3,10099270,24.718,41,19.985,46949.283,133.982,4.79,0.933,0
183,18,688,13743,111,1762,0,0,46.3,10099270,24.718,41,19.985,46949.283,133.982,4.79,0.933,0
183,19,532,14275,83,1845,0,0,46.3,10099270,24.718,41,19.985,46949.283,133.982,4.79,0.933,0
183,20,388,14663,86,1931,0,0,46.3,10099270,24.718,41,19.985,46949.283,133.982,4.79,0.933,0
183,21,461,15124,87,2018,0,0,46.3,10099270,24.718,41,19.985,46949.283,133.982,4.79,0.933,0
183,22,707,15831,85,2103,0,0,46.3,10099270,24.718,41,19.985,46949.283,133.982,4.79,0.933,0
183,23,722,16553,62,2165,0,0,46.3,10099270,24.718,41,19.985,46949.283,133.982,4.79,0.933,0
183,24,758,17311,77,2242,0,0,46.3,10099270,24.718,41,19.985,46949.283,133.982,4.79,0.933,0
183,25,780,18091,86,2328,0,0,46.3,10099270,24.718,41,19.985,46949.283,133.982,4.79,0.933,0
183,26,473,18564,89,2417,0,0,46.3,10099270,24.718,41,19.985,46949.283,133.982,4.79,0.933,0
183,27,300,18864,73,2490,0,0,46.3,10099270,24.718,41,19.985,46949.283,133.982,4.79,0.933,0
183,28,563,19427,74,2564,0,0,46.3,10099270,24.718,41,19.985,46949.283,133.982,4.79,0.933,0
183,29,742,20169,74,2638,0,0,46.3,10099270,24.718,41,19.985,46949.283,133.982,4.79,0.933,0
183,30,799,20968,83,2721,0,0,46.3,10099270,24.718,41,19.985,46949.283,133.982,4.79,0.933,0
183,31,635,21603,83,2804,0,0,46.3,10099270,24.718,41,19.985,46949.283,133.982,4.79,0.933,0
183,32,532,22135,78,2882,0,0,46.3,10099270,24.718,41,19.985,46949.283,133.982,4.79,0.933,0
183,33,299,22434,78,2960,0,0,46.3,10099270,24.718,41,19.985,46949.283,133.982,4.79,0.933,0
183,34,261,22695,73,3033,0,0,46.3,10099270,24.718,41,19.985,46949.283,133.982,4.79,0.933,0
183,35,477,23172,75,3108,0,0,46.3,10099270,24.718,41,19.985,46949.283,133.982,4.79,0.933,0
183,36,657,23829,84,3192,0,0,46.3,10099270,24.718,41,19.985,46949.283,133.982,4.79,0.933,0
183,37,745,24574,72,3264,0,0,46.3,10099270,24.718,41,19.985,46949.283,133.982,4.79,0.933,0
183,38,784,25358,73,3337,0,0,46.3,10099270,24.718,41,19.985,46949.283,133.982,4.79,0.933,0
183,39,700,26058,80,3417,0,0,46.3,10099270,24.718,41,19.985,46949.283,133.982,4.79,0.933,0
183,40,509,26567,60,3477,0,0,46.3,10099270,24.718,41,19.985,46949.283,133.982,4.79,0.933,0
183,41,279,26846,69,3546,0,0,46.3,10099270,24.718,41,19.985,46949.283,133.982,4.79,0.933,0
183,42,455,27301,73,3619,0,0,46.3,10099270,24.718,41,19.985,46949.283,133.982,4.79,0.933,0
183,43,754,28055,65,3684,0,0,46.3,10099270,24.718,41,19.985,46949.283,133.982,4.79,0.933,0
183,44,698,28753,61,3745,0,0,46.3,10099270,24.718,41,19.985,46949.283,133.982,4.79,0.933,0
183,45,657,29410,50,3795,0,0,46.3,10099270,24.718,41,19.985,46949.283,133.982,4.79,0.933,0
183,46,688,30098,46,3841,0,0,46.3,10099270,24.718,41,19.985,46949.283,133.982,4.79,0.933,0
183,47,358,30456,59,3900,0,0,46.3,10099270,24.718,41,19.985,46949.283,133.982,4.79,0.933,0
183,48,259,30715,49,3949,0,0,46.3,10099270,24.718,41,19.985,46949.283,133.982,4.79,0.933,0
183,49,430,31145,53,4002,0,0,46.3,10099270,24.718,41,19.985,46949.283,133.982,4.79,0.933,0
183,50,666,31811,59,4061,0,0,46.3,10099270,24.718,41,19.985,46949.283,133.982,4.79,0.933,0
183,51,808,32619,42,4103,0,0,46.3,10099270,24.718,41,19.985,46949.283,133.982,4.79,0.933,0
183,52,610,33229,52,4155,0,0,46.3,10099270,24.718,41,19.985,46949.283,133.982,4.79,0.933,0
183,53,532,33761,55,4210,0,0,46.3,10099270,24.718,41,19.985,46949.283,133.982,4.79,0.933,0
183,54,403,34164,56,4266,0,0,46.3,10099270,24.718,41,19.985,46949.283,133.982,4.79,0.933,0
183,55,210,34374,55,4321,0,0,46.3,10099270,24.718,41,19.985,46949.283,133.982,4.79,0.933,0
183,56,491,34865,45,4366,0,0,46.3,10099270,24.718,41,19.985,46949.283,133.982,4.79,0.933,0
183,57,746,35611,42,4408,0,0,46.3,10099270,24.718,41,19.985,46949.283,133.982,4.79,0.933,0
183,58,800,36411,28,4436,0,0,46.3,10099270,24.718,41,19.985,46949.283,133.982,4.79,0.933,0
183,59,774,37185,38,4474,0,0,46.3,10099270,24.718,41,19.985,46949.283,133.982,4.79,0.933,0
183,60,773,37958,40,4514,0,0,46.3,10099270,24.718,41,19.985,46949.283,133.982,4.79,0.933,0
183,61,432,38390,41,4555,0,0,46.3,10099270,24.718,41,19.985,46949.283,133.982,4.79,0.933,0
183,62,265,38655,39,4594,0,0,46.3,10099270,24.718,41,19.985,46949.283,133.982,4.79,0.933,0
183,63,648,39303,46,4640,0,0,46.3,10099270,24.718,41,19.985,46949.283,133.982,4.79,0.933,0
183,64,901,40204,39,4679,0,0,46.3,10099270,24.718,41,19.985,46949.283,133.982,4.79,0.933,0
183,65,1046,41250,37,4716,0,0,46.3,10099270,24.718,41,19.985,46949.283,133.982,4.79,0.933,0
183,66,1039,42289,28,4744,0,0,46.3,10099270,24.718,41,19.985,46949.283,133.982,4.79,0.933,0
183,67,1146,43435,43,4787,0,0,46.3,10099270,24.718,41,19.985,46949.283,133.982,4.79,0.933,0
183,68,780,44215,37,4824,0,0,46.3,10099270,24.718,41,19.985,46949.283,133.982,4.79,0.933,0
183,69,462,44677,30,4854,0,0,46.3,10099270,24.718,41,19.985,46949.283,133.982,4.79,0.933,0
183,70,677,45354,33,4887,0,0,46.3,10099270,24.718,41,19.985,46949.283,133.982,4.79,0.933,0
183,71,936,46290,38,4925,0,0,46.3,10099270,24.718,41,19.985,46949.283,133.982,4.79,0.933,0
183,72,1437,47727,33,4958,0,0,46.3,10099270,24.718,41,19.985,46949.283,133.982,4.79,0.933,0
183,73,1293,49020,40,4998,0,0,46.3,10099270,24.718,41,19.985,46949.283,133.982,4.79,0.933,0
183,74,1329,50349,36,5034,0,0,40.74,10099270,24.718,41,19.985,46949.283,133.982,4.79,0.933,0
183,75,1032,51381,30,5064,0,0,40.74,10099270,24.718,41,19.985,46949.283,133.982,4.79,0.933,0
183,76,418,51799,33,5097,0,0,38.89,10099270,24.718,41,19.985,46949.283,133.982,4.79,0.933,0
183,77,685,52484,27,5124,0,0,38.89,10099270,24.718,41,19.985,46949.283,133.982,4.79,0.933,0
183,78,1209,53693,31,5155,0,0,38.89,10099270,24.718,41,19.985,46949.283,133.982,4.79,0.933,0
183,79,1457,55150,28,5183,0,0,38.89,10099270,24.718,41,19.985,46949.283,133.982,4.79,0.933,0
183,80,1494,56644,33,5216,0,0,38.89,10099270,24.718,41,19.985,46949.283,133.982,4.79,0.933,0
183,81,1209,57853,29,5245,0,0,38.89,10099270,24.718,41,19.985,46949.283,133.982,4.79,0.933,0
183,82,698,58551,30,5275,0,0,38.89,10099270,24.718,41,19.985,46949.283,133.982,4.79,0.933,0
183,83,321,58872,29,5304,0,0,38.89,10099270,24.718,41,19.985,46949.283,133.982,4.79,0.933,0
183,84,800,59672,22,5326,0,0,38.89,10099270,24.718,41,19.985,46949.283,133.982,4.79,0.933,0
183,85,1309,60981,20,5346,0,0,38.89,10099270,24.718,41,19.985,46949.283,133.982,4.79,0.933,0
183,86,1698,62679,25,5371,0,0,38.89,10099270,24.718,41,19.985,46949.283,133.982,4.79,0.933,0
183,87,1279,63958,22,5393,0,0,38.89,10099270,24.718,41,19.985,46949.283,133.982,4.79,0.933,0
183,88,1204,65162,24,5417,0,0,38.89,10099270,24.718,41,19.985,46949.283,133.982,4.79,0.933,0
183,89,755,65917,11,5428,0,0,38.89,10099270,24.718,41,19.985,46949.283,133.982,4.79,0.933,0
183,90,415,66332,14,5442,0,0,38.89,10099270,24.718,41,19.985,46949.283,133.982,4.79,0.933,0
183,91,727,67059,23,5465,0,0,38.89,10099270,24.718,41,19.985,46949.283,133.982,4.79,0.933,0
183,92,803,67862,16,5481,0,0,38.89,10099270,24.718,41,19.985,46949.283,133.982,4.79,0.933,0
183,93,684,68546,21,5502,0,0,38.89,10099270,24.718,41,19.985,46949.283,133.982,4.79,0.933,0
183,94,687,69233,16,5518,0,0,38.89,10099270,24.718,41,19.985,46949.283,133.982,4.79,0.933,0
183,95,694,69927,15,5533,0,0,38.89,10099270,24.718,41,19.985,46949.283,133.982,4.79,0.933,0
183,96,364,70291,8,5541,0,0,38.89,10099270,24.718,41,19.985,46949.283,133.982,4.79,0.933,0
183,97,315,70606,15,5556,0,0,38.89,10099270,24.718,41,19.985,46949.283,133.982,4.79,0.933,0
183,98,251,70857,9,5565,0,0,38.89,10099270,24.718,41,19.985,46949.283,133.982,4.79,0.933,0
183,99,278,71135,15,5580,0,0,38.89,10099270,24.718,41,19.985,46949.283,133.982,4.79,0.933,0
183,100,533,71668,12,5592,0,0,38.89,10099270,24.718,41,19.985,46949.283,133.982,4.79,0.933,0
183,101,334,72002,11,5603,0,0,38.89,10099270,24.718,41,19.985,46949.283,133.982,4.79,0.933,0
183,102,369,72371,15,5618,0,0,38.89,10099270,24.718,41,19.985,46949.283,133.982,4.79,0.933,0
183,103,308,72679,14,5632,0,0,38.89,10099270,24.718,41,19.985,46949.283,133.982,4.79,0.933,0
183,104,106,72785,10,5642,9913,0,38.89,10099270,24.718,41,19.985,46949.283,133.982,4.79,0.933,0
183,105,170,72955,9,5651,9913,0,38.89,10099270,24.718,41,19.985,46949.283,133.982,4.79,0.933,0
183,106,312,73267,14,5665,9913,0,38.89,10099270,24.718,41,19.985,46949.283,133.982,4.79,0.933,0
183,107,287,73554,8,5673,9913,0,38.89,10099270,24.718,41,19.985,46949.283,133.982,4.79,0.933,0
183,108,268,73822,6,5679,9913,0,38.89,10099270,24.718,41,19.985,46949.283,133.982,4.79,0.933,0
183,109,284,74106,6,5685,9913,0,38.89,10099270,24.718,41,19.985,46949.283,133.982,4.79,0.933,0
183,110,191,74297,7,5692,9913,0,38.89,10099270,24.718,41,19.985,46949.283,133.982,4.79,0.933,0
183,111,110,74407,11,5703,8449,0,38.89,10099270,24.718,41,19.985,46949.283,133.982,4.79,0.933,0
183,112,131,74538,8,5711,8449,0,38.89,10099270,24.718,41,19.985,46949.283,133.982,4.79,0.933,0
183,113,226,74764,7,5718,8449,0,38.89,10099270,24.718,41,19.985,46949.283,133.982,4.79,0.933,0
183,114,297,75061,7,5725,8449,0,38.89,10099270,24.718,41,19.985,46949.283,133.982,4.79,0.933,0
183,115,220,75281,6,5731,8449,0,38.89,10099270,24.718,41,19.985,46949.283,133.982,4.79,0.933,0
183,116,262,75543,5,5736,8449,0,38.89,10099270,24.718,41,19.985,46949.283,133.982,4.79,0.933,0
183,117,138,75681,3,5739,8449,0,38.89,10099270,24.718,41,19.985,46949.283,133.982,4.79,0.933,0
183,118,42,75723,1,5740,7566,0,38.89,10099270,24.718,41,19.985,46949.283,133.982,4.79,0.933,0
183,119,71,75794,2,5742,7566,0,38.89,10099270,24.718,41,19.985,46949.283,133.982,4.79,0.933,0
183,120,283,76077,6,5748,7566,0,38.89,10099270,24.718,41,19.985,46949.283,133.982,4.79,0.933,0
183,121,301,76378,6,5754,7566,0,38.89,10099270,24.718,41,19.985,46949.283,133.982,4.79,0.933,0
183,122,302,76680,2,5756,7566,0,37.04,10099270,24.718,41,19.985,46949.283,133.982,4.79,0.933,0
183,123,258,76938,0,5756,7566,0,37.04,10099270,24.718,41,19.985,46949.283,133.982,4.79,0.933,0
183,124,303,77241,3,5759,7566,0,37.04,10099270,24.718,41,19.985,46949.283,133.982,4.79,0.933,0
183,125,38,77279,3,5762,7674,0,37.04,10099270,24.718,41,19.985,46949.283,133.982,4.79,0.933,0
183,126,165,77444,3,5765,7674,0,37.04,10099270,24.718,41,19.985,46949.283,133.982,4.79,0.933,0
183,127,333,77777,4,5769,7674,0,37.04,10099270,24.718,41,19.985,46949.283,133.982,4.79,0.933,0
183,128,425,78202,2,5771,7674,0,37.04,10099270,24.718,41,19.985,46949.283,133.982,4.79,0.933,0
183,129,378,78580,3,5774,7674,0,37.04,10099270,24.718,41,19.985,46949.283,133.982,4.79,0.933,0
183,130,380,78960,4,5778,7674,0,37.04,10099270,24.718,41,19.985,46949.283,133.982,4.79,0.933,0
183,131,260,79220,3,5781,7674,0,37.04,10099270,24.718,41,19.985,46949.283,133.982,4.79,0.933,0
183,132,73,79293,1,5782,8090,0,37.04,10099270,24.718,41,19.985,46949.283,133.982,4.79,0.933,0
183,133,196,79489,4,5786,8090,0,37.04,10099270,24.718,41,19.985,46949.283,133.982,4.79,0.933,0
183,134,417,79906,2,5788,8090,0,37.04,10099270,24.718,41,19.985,46949.283,133.982,4.79,0.933,0
183,135,443,80349,4,5792,8090,0,37.04,10099270,24.718,41,19.985,46949.283,133.982,4.79,0.933,0
183,136,363,80712,3,5795,8090,0,37.04,10099270,24.718,41,19.985,46949.283,133.982,4.79,0.933,0
183,137,344,81056,6,5801,8090,0,37.04,10099270,24.718,41,19.985,46949.283,133.982,4.79,0.933,0
183,138,226,81282,2,5803,8090,0,37.04,10099270,24.718,41,19.985,46949.283,133.982,4.79,0.933,0
183,139,63,81345,1,5804,9364,0,37.04,10099270,24.718,41,19.985,46949.283,133.982,4.79,0.933,0
183,140,174,81519,0,5804,9364,0,37.04,10099270,24.718,41,19.985,46949.283,133.982,4.79,0.933,0
183,141,314,81833,3,5807,9364,0,37.04,10099270,24.718,41,19.985,46949.283,133.982,4.79,0.933,0
183,142,351,82184,5,5812,9364,0,37.04,10099270,24.718,41,19.985,46949.283,133.982,4.79,0.933,0
183,143,333,82517,1,5813,9364,0,37.04,10099270,24.718,41,19.985,46949.283,133.982,4.79,0.933,0
183,144,298,82815,2,5815,9364,0,37.04,10099270,24.718,41,19.985,46949.283,133.982,4.79,0.933,0
183,145,160,82975,5,5820,9364,0,37.04,10099270,24.718,41,19.985,46949.283,133.982,4.79,0.933,0
183,146,57,83032,1,5821,12151,0,37.04,10099270,24.718,41,19.985,46949.283,133.982,4.79,0.933,0
183,147,174,83206,3,5824,12151,0,37.04,10099270,24.718,41,19.985,46949.283,133.982,4.79,0.933,0
183,148,222,83428,1,5825,12151,0,37.04,10099270,24.718,41,19.985,46949.283,133.982,4.79,0.933,0
183,149,244,83672,1,5826,12151,0,37.04,10099270,24.718,41,19.985,46949.283,133.982,4.79,0.933,0
183,150,202,83874,2,5828,12151,0,37.04,10099270,24.718,41,19.985,46949.283,133.982,4.79,0.933,0
183,151,179,84053,1,5829,12151,0,37.04,10099270,24.718,41,19.985,46949.283,133.982,4.79,0.933,0
183,152,131,84184,1,5830,12151,0,37.04,10099270,24.718,41,19.985,46949.283,133.982,4.79,0.933,0
183,153,48,84232,1,5831,18027,0,37.04,10099270,24.718,41,19.985,46949.283,133.982,4.79,0.933,0
183,154,162,84394,3,5834,18027,0,37.04,10099270,24.718,41,19.985,46949.283,133.982,4.79,0.933,0
183,155,171,84565,2,5836,18027,0,37.04,10099270,24.718,41,19.985,46949.283,133.982,4.79,0.933,0
183,156,213,84778,3,5839,18027,0,37.04,10099270,24.718,41,19.985,46949.283,133.982,4.79,0.933,0
183,157,286,85064,2,5841,18027,0,37.04,10099270,24.718,41,19.985,46949.283,133.982,4.79,0.933,0
183,158,262,85326,2,5843,18027,0,37.04,10099270,24.718,41,19.985,46949.283,133.982,4.79,0.933,0
183,159,171,85497,0,5843,18027,0,37.04,10099270,24.718,41,19.985,46949.283,133.982,4.79,0.933,0
183,160,67,85564,0,5843,20382,0,37.04,10099270,24.718,41,19.985,46949.283,133.982,4.79,0.933,0
183,161,185,85749,3,5846,20382,0,37.04,10099270,24.718,41,19.985,46949.283,133.982,4.79,0.933,0
183,162,236,85985,1,5847,20382,0,37.04,10099270,24.718,41,19.985,46949.283,133.982,4.79,0.933,0
183,163,314,86299,1,5848,20382,0,37.04,10099270,24.718,41,19.985,46949.283,133.982,4.79,0.933,0
183,164,255,86554,2,5850,20382,0,37.04,10099270,24.718,41,19.985,46949.283,133.982,4.79,0.933,0
183,165,292,86846,2,5852,20382,0,37.04,10099270,24.718,41,19.985,46949.283,133.982,4.79,0.933,0
183,166,206,87052,4,5856,20382,0,37.04,10099270,24.718,41,19.985,46949.283,133.982,4.79,0.933,0
183,167,106,87158,1,5857,19924,0,37.04,10099270,24.718,41,19.985,46949.283,133.982,4.79,0.933,0
183,168,220,87378,2,5859,19924,0,37.04,10099270,24.718,41,19.985,46949.283,133.982,4.79,0.933,0
183,169,292,87670,2,5861,19924,0,37.04,10099270,24.718,41,19.985,46949.283,133.982,4.79,0.933,0
183,170,330,88000,1,5862,19924,0,37.04,10099270,24.718,41,19.985,46949.283,133.982,4.79,0.933,0
183,171,389,88389,2,5864,19924,0,37.04,10099270,24.718,41,19.985,46949.283,133.982,4.79,0.933,0
183,172,437,88826,1,5865,19924,0,37.04,10099270,24.718,41,19.985,46949.283,133.982,4.79,0.933,0
183,173,279,89105,1,5866,19924,0,37.04,10099270,24.718,41,19.985,46949.283,133.982,4.79,0.933,0
183,174,133,89238,1,5867,18407,0,37.04,10099270,24.718,41,19.985,46949.283,133.982,4.79,0.933,0
183,175,266,89504,4,5871,18407,0,37.04,10099270,24.718,41,19.985,46949.283,133.982,4.79,0.933,0
183,176,438,89942,2,5873,18407,0,37.04,10099270,24.718,41,19.985,46949.283,133.982,4.79,0.933,0
183,177,553,90495,1,5874,18407,0,37.04,10099270,24.718,41,19.985,46949.283,133.982,4.79,0.933,0
183,178,540,91035,0,5874,18407,0,37.04,10099270,24.718,41,19.985,46949.283,133.982,4.79,0.933,0
183,179,630,91665,1,5875,18407,0,37.04,10099270,24.718,41,19.985,46949.283,133.982,4.79,0.933,0
183,180,325,91990,4,5879,18407,0,37.04,10099270,24.718,41,19.985,46949.283,133.982,4.79,0.933,0
183,181,167,92157,2,5881,18580,0,37.04,10099270,24.718,41,19.985,46949.283,133.982,4.79,0.933,0
183,182,378,92535,1,5882,18580,0,37.04,10099270,24.718,41,19.985,46949.283,133.982,4.79,0.933,0
183,183,613,93148,1,5883,18580,0,37.04,10099270,24.718,41,19.985,46949.283,133.982,4.79,0.933,0
183,184,688,93836,1,5884,18580,0,37.04,10099270,24.718,41,19.985,46949.283,133.982,4.79,0.933,0
183,185,633,94469,4,5888,18580,0,37.04,10099270,24.718,41,19.985,46949.283,133.982,4.79,0.933,0
183,186,712,95181,1,5889,18580,0,37.04,10099270,24.718,41,19.985,46949.283,133.982,4.79,0.933,0
183,187,461,95642,3,5892,18580,0,37.04,10099270,24.718,41,19.985,46949.283,133.982,4.79,0.933,0
183,188,155,95797,3,5895,19852,0,37.04,10099270,24.718,41,19.985,46949.283,133.982,4.79,0.933,0
183,189,374,96171,3,5898,19852,0,37.04,10099270,24.718,41,19.985,46949.283,133.982,4.79,0.933,0
183,190,786,96957,2,5900,19852,0,37.04,10099270,24.718,41,19.985,46949.283,133.982,4.79,0.933,0
183,191,831,97788,4,5904,19852,0,37.04,10099270,24.718,41,19.985,46949.283,133.982,4.79,0.933,0
183,192,836,98624,3,5907,19852,0,37.04,10099270,24.718,41,19.985,46949.283,133.982,4.79,0.933,0
183,193,783,99407,1,5908,19852,0,37.04,10099270,24.718,41,19.985,46949.283,133.982,4.79,0.933,0
183,194,509,99916,4,5912,19852,0,37.04,10099270,24.718,41,19.985,46949.283,133.982,4.79,0.933,0
183,195,161,100077,3,5915,0,0,37.04,10099270,24.718,41,19.985,46949.283,133.982,4.79,0.933,0
183,196,637,100714,1,5916,0,0,37.04,10099270,24.718,41,19.985,46949.283,133.982,4.79,0.933,0
183,197,916,101630,2,5918,0,0,37.04,10099270,24.718,41,19.985,46949.283,133.982,4.79,0.933,0
183,198,969,102599,1,5919,0,0,37.04,10099270,24.718,41,19.985,46949.283,133.982,4.79,0.933,0
183,199,906,103505,1,5920,0,0,37.04,10099270,24.718,41,19.985,46949.283,133.982,4.79,0.933,0
183,200,1180,104685,2,5922,0,0,37.04,10099270,24.718,41,19.985,46949.283,133.982,4.79,0.933,0
183,201,698,105383,0,5922,0,0,37.04,10099270,24.718,41,19.985,46949.283,133.982,4.79,0.933,0
183,202,321,105704,0,5922,0,0,37.04,10099270,24.718,41,19.985,46949.283,133.982,4.79,0.933,0
183,203,676,106380,0,5922,0,0,37.04,10099270,24.718,41,19.985,46949.283,133.982,4.79,0.933,0
183,204,676,106380,0,5922,0,0,37.04,10099270,24.718,41,19.985,46949.283,133.982,4.79,0.933,0
184,1,696,16108,78,373,6702,145587,73.15,8654618,214.243,43.1,18.436,57410.166,99.739,5.59,0.944,0
184,2,962,17070,5,378,7021,152608,73.15,8654618,214.243,43.1,18.436,57410.166,99.739,5.59,0.944,0
184,3,1124,18194,54,432,6517,159125,73.15,8654618,214.243,43.1,18.436,57410.166,99.739,5.59,0.944,0
184,4,1033,19227,52,484,5204,164329,73.15,8654618,214.243,43.1,18.436,57410.166,99.739,5.59,0.944,0
184,5,974,20201,56,540,3305,167634,73.15,8654618,214.243,43.1,18.436,57410.166,99.739,5.59,0.944,0
184,6,821,21022,19,559,4112,171746,73.15,8654618,214.243,43.1,18.436,57410.166,99.739,5.59,0.944,0
184,7,552,21574,25,584,6870,178616,73.15,8654618,214.243,43.1,18.436,57410.166,99.739,5.59,0.944,0
184,8,590,22164,57,641,6561,185177,73.15,8654618,214.243,43.1,18.436,57410.166,99.739,5.59,0.944,0
184,9,546,22710,64,705,6016,191193,73.15,8654618,214.243,43.1,18.436,57410.166,99.739,5.59,0.944,0
184,10,785,23495,51,756,3981,195174,73.15,8654618,214.243,43.1,18.436,57410.166,99.739,5.59,0.944,0
184,11,733,24228,49,805,2798,197972,73.15,8654618,214.243,43.1,18.436,57410.166,99.739,5.59,0.944,0
184,12,592,24820,26,831,2300,200272,73.15,8654618,214.243,43.1,18.436,57410.166,99.739,5.59,0.944,0
184,13,400,25220,27,858,2197,202469,73.15,8654618,214.243,43.1,18.436,57410.166,99.739,5.59,0.944,0
184,14,279,25499,0,858,3923,206392,73.15,8654618,214.243,43.1,18.436,57410.166,99.739,5.59,0.944,0
184,15,254,25753,42,900,5590,211982,73.15,8654618,214.243,43.1,18.436,57410.166,99.739,5.59,0.944,0
184,16,583,26336,73,973,5137,217119,73.15,8654618,214.243,43.1,18.436,57410.166,99.739,5.59,0.944,0
184,17,315,26651,43,1016,4598,221717,73.15,8654618,214.243,43.1,18.436,57410.166,99.739,5.59,0.944,0
184,18,346,26997,42,1058,3649,225366,73.15,8654618,214.243,43.1,18.436,57410.166,99.739,5.59,0.944,0
184,19,325,27322,52,1110,2119,227485,73.15,8654618,214.243,43.1,18.436,57410.166,99.739,5.59,0.944,0
184,20,336,27658,24,1134,3427,230912,73.15,8654618,214.243,43.1,18.436,57410.166,99.739,5.59,0.944,0
184,21,168,27826,7,1141,4973,235885,73.15,8654618,214.243,43.1,18.436,57410.166,99.739,5.59,0.944,0
184,22,155,27981,45,1186,4653,240538,73.15,8654618,214.243,43.1,18.436,57410.166,99.739,5.59,0.944,0
184,23,205,28186,30,1216,4562,245100,73.15,8654618,214.243,43.1,18.436,57410.166,99.739,5.59,0.944,0
184,24,228,28414,51,1267,4793,249893,73.15,8654618,214.243,43.1,18.436,57410.166,99.739,5.59,0.944,0
184,25,181,28595,41,1308,4033,253926,73.15,8654618,214.243,43.1,18.436,57410.166,99.739,5.59,0.944,0
184,26,216,28811,20,1328,2363,256289,73.15,8654618,214.243,43.1,18.436,57410.166,99.739,5.59,0.944,0
184,27,167,28978,8,1336,3749,260038,69.44,8654618,214.243,43.1,18.436,57410.166,99.739,5.59,0.944,0
184,28,103,29081,16,1352,5594,265632,69.44,8654618,214.243,43.1,18.436,57410.166,99.739,5.59,0.944,0
184,29,100,29181,27,1379,5810,271442,69.44,8654618,214.243,43.1,18.436,57410.166,99.739,5.59,0.944,0
184,30,143,29324,28,1407,4850,276292,69.44,8654618,214.243,43.1,18.436,57410.166,99.739,5.59,0.944,0
184,31,179,29503,15,1422,4451,280743,69.44,8654618,214.243,43.1,18.436,57410.166,99.739,5.59,0.944,0
184,32,119,29622,12,1434,3120,283863,69.44,8654618,214.243,43.1,18.436,57410.166,99.739,5.59,0.944,0
184,33,112,29734,32,1466,2519,286382,69.44,8654618,214.243,43.1,18.436,57410.166,99.739,5.59,0.944,0
184,34,88,29822,6,1472,3862,290244,69.44,8654618,214.243,43.1,18.436,57410.166,99.739,5.59,0.944,0
184,35,76,29898,4,1476,5890,296134,69.44,8654618,214.243,43.1,18.436,57410.166,99.739,5.59,0.944,0
184,36,28,29926,6,1482,5376,301510,69.44,8654618,214.243,43.1,18.436,57410.166,99.739,5.59,0.944,0
184,37,51,29977,22,1504,4664,306174,69.44,8654618,214.243,43.1,18.436,57410.166,99.739,5.59,0.944,0
184,38,66,30043,13,1517,4356,310530,69.44,8654618,214.243,43.1,18.436,57410.166,99.739,5.59,0.944,0
184,39,81,30124,8,1525,3136,313666,69.44,8654618,214.243,43.1,18.436,57410.166,99.739,5.59,0.944,0
184,40,44,30168,6,1531,1431,315097,69.44,8654618,214.243,43.1,18.436,57410.166,99.739,5.59,0.944,0
184,41,54,30222,6,1537,5076,320173,65.74,8654618,214.243,43.1,18.436,57410.166,99.739,5.59,0.944,0
184,42,39,30261,5,1542,5567,325740,65.74,8654618,214.243,43.1,18.436,57410.166,99.739,5.59,0.944,0
184,43,36,30297,18,1560,6231,331971,65.74,8654618,214.243,43.1,18.436,57410.166,99.739,5.59,0.944,0
184,44,33,30330,3,1563,5706,337677,65.74,8654618,214.243,43.1,18.436,57410.166,99.739,5.59,0.944,0
184,45,50,30380,25,1588,5598,343275,65.74,8654618,214.243,43.1,18.436,57410.166,99.739,5.59,0.944,0
184,46,51,30431,6,1594,3270,346545,65.74,8654618,214.243,43.1,18.436,57410.166,99.739,5.59,0.944,0
184,47,58,30489,7,1601,1744,348289,65.74,8654618,214.243,43.1,18.436,57410.166,99.739,5.59,0.944,0
184,48,15,30504,1,1602,4414,352703,65.74,8654618,214.243,43.1,18.436,57410.166,99.739,5.59,0.944,0
184,49,10,30514,0,1602,5999,358702,65.74,8654618,214.243,43.1,18.436,57410.166,99.739,5.59,0.944,0
184,50,21,30535,11,1613,4864,363566,65.74,8654618,214.243,43.1,18.436,57410.166,99.739,5.59,0.944,0
184,51,40,30575,16,1629,2117,365683,65.74,8654618,214.243,43.1,18.436,57410.166,99.739,5.59,0.944,0
184,52,36,30611,8,1637,3565,369248,65.74,8654618,214.243,43.1,18.436,57410.166,99.739,5.59,0.944,0
184,53,13,30624,0,1637,2528,371776,65.74,8654618,214.243,43.1,18.436,57410.166,99.739,5.59,0.944,0
184,54,18,30642,4,1641,1660,373436,65.74,8654618,214.243,43.1,18.436,57410.166,99.739,5.59,0.944,0
184,55,11,30653,0,1641,4004,377440,65.74,8654618,214.243,43.1,18.436,57410.166,99.739,5.59,0.944,0
184,56,10,30663,0,1641,5695,383135,65.74,8654618,214.243,43.1,18.436,57410.166,99.739,5.59,0.944,0
184,57,15,30678,6,1647,5001,388136,65.74,8654618,214.243,43.1,18.436,57410.166,99.739,5.59,0.944,0
184,58,0,30678,0,1647,4193,392329,65.74,8654618,214.243,43.1,18.436,57410.166,99.739,5.59,0.944,0
184,59,35,30713,7,1654,3712,396041,65.74,8654618,214.243,43.1,18.436,57410.166,99.739,5.59,0.944,0
184,60,32,30745,2,1656,2588,398629,62.96,8654618,214.243,43.1,18.436,57410.166,99.739,5.59,0.944,0
184,61,17,30762,0,1656,1572,400201,62.96,8654618,214.243,43.1,18.436,57410.166,99.739,5.59,0.944,0
184,62,17,30779,0,1656,1782,401983,62.96,8654618,214.243,43.1,18.436,57410.166,99.739,5.59,0.944,0
184,63,9,30788,0,1656,4282,406265,62.96,8654618,214.243,43.1,18.436,57410.166,99.739,5.59,0.944,0
184,64,3,30791,0,1656,5267,411532,62.96,8654618,214.243,43.1,18.436,57410.166,99.739,5.59,0.944,0
184,65,19,30810,3,1659,5217,416749,62.96,8654618,214.243,43.1,18.436,57410.166,99.739,5.59,0.944,0
184,66,20,30830,0,1659,4821,421570,62.96,8654618,214.243,43.1,18.436,57410.166,99.739,5.59,0.944,0
184,67,23,30853,0,1659,3121,424691,50,8654618,214.243,43.1,18.436,57410.166,99.739,5.59,0.944,0
184,68,20,30873,1,1660,1542,426233,50,8654618,214.243,43.1,18.436,57410.166,99.739,5.59,0.944,0
184,69,9,30882,0,1660,4713,430946,48.15,8654618,214.243,43.1,18.436,57410.166,99.739,5.59,0.944,0
184,70,7,30889,0,1660,6493,437439,48.15,8654618,214.243,43.1,18.436,57410.166,99.739,5.59,0.944,0
184,71,16,30905,2,1662,6600,444039,48.15,8654618,214.243,43.1,18.436,57410.166,99.739,5.59,0.944,0
184,72,23,30928,12,1674,5610,449649,48.15,8654618,214.243,43.1,18.436,57410.166,99.739,5.59,0.944,0
184,73,33,30961,0,1674,6456,456105,48.15,8654618,214.243,43.1,18.436,57410.166,99.739,5.59,0.944,0
184,74,19,30980,2,1676,4358,460463,48.15,8654618,214.243,43.1,18.436,57410.166,99.739,5.59,0.944,0
184,75,31,31011,0,1676,1795,462258,48.15,8654618,214.243,43.1,18.436,57410.166,99.739,5.59,0.944,0
184,76,23,31034,0,1676,6506,468764,48.15,8654618,214.243,43.1,18.436,57410.166,99.739,5.59,0.944,0
184,77,14,31048,0,1676,10045,478809,48.15,8654618,214.243,43.1,18.436,57410.166,99.739,5.59,0.944,0
184,78,15,31063,1,1677,9617,488426,48.15,8654618,214.243,43.1,18.436,57410.166,99.739,5.59,0.944,0
184,79,37,31100,0,1677,8433,496859,48.15,8654618,214.243,43.1,18.436,57410.166,99.739,5.59,0.944,0
184,80,17,31117,0,1677,7586,504445,48.15,8654618,214.243,43.1,18.436,57410.166,99.739,5.59,0.944,0
184,81,92,31209,0,1677,4698,509143,48.15,8654618,214.243,43.1,18.436,57410.166,99.739,5.59,0.944,0
184,82,0,31209,0,1677,1779,510922,48.15,8654618,214.243,43.1,18.436,57410.166,99.739,5.59,0.944,0
184,83,0,31209,2,1679,8204,519126,37.04,8654618,214.243,43.1,18.436,57410.166,99.739,5.59,0.944,0
184,84,18,31227,0,1679,11674,530800,37.04,8654618,214.243,43.1,18.436,57410.166,99.739,5.59,0.944,0
184,85,22,31249,0,1679,9151,539951,37.04,8654618,214.243,43.1,18.436,57410.166,99.739,5.59,0.944,0
184,86,44,31293,2,1681,9263,549214,37.04,8654618,214.243,43.1,18.436,57410.166,99.739,5.59,0.944,0
184,87,52,31345,0,1681,10193,559407,37.04,8654618,214.243,43.1,18.436,57410.166,99.739,5.59,0.944,0
184,88,58,31403,0,1681,6447,565854,37.04,8654618,214.243,43.1,18.436,57410.166,99.739,5.59,0.944,0
184,89,69,31472,0,1681,2536,568390,37.04,8654618,214.243,43.1,18.436,57410.166,99.739,5.59,0.944,0
184,90,62,31534,0,1681,14089,582479,37.04,8654618,214.243,43.1,18.436,57410.166,99.739,5.59,0.944,0
184,91,35,31569,0,1681,15034,597513,37.04,8654618,214.243,43.1,18.436,57410.166,99.739,5.59,0.944,0
184,92,62,31631,2,1683,11242,608755,37.04,8654618,214.243,43.1,18.436,57410.166,99.739,5.59,0.944,0
184,93,220,31851,1,1684,10892,619647,37.04,8654618,214.243,43.1,18.436,57410.166,99.739,5.59,0.944,0
184,94,33,31884,1,1685,10380,630027,41.2,8654618,214.243,43.1,18.436,57410.166,99.739,5.59,0.944,0
184,95,133,32017,0,1685,6216,636243,41.2,8654618,214.243,43.1,18.436,57410.166,99.739,5.59,0.944,0
184,96,97,32114,0,1685,2521,638764,41.2,8654618,214.243,43.1,18.436,57410.166,99.739,5.59,0.944,0
184,97,70,32184,0,1685,7826,646590,41.2,8654618,214.243,43.1,18.436,57410.166,99.739,5.59,0.944,0
184,98,46,32230,0,1685,9998,656588,41.2,8654618,214.243,43.1,18.436,57410.166,99.739,5.59,0.944,0
184,99,54,32284,0,1685,8869,665457,41.2,8654618,214.243,43.1,18.436,57410.166,99.739,5.59,0.944,0
184,100,129,32413,0,1685,8533,673990,41.2,8654618,214.243,43.1,18.436,57410.166,99.739,5.59,0.944,0
184,101,88,32501,0,1685,7698,681688,41.2,8654618,214.243,43.1,18.436,57410.166,99.739,5.59,0.944,0
184,102,104,32605,0,1685,4745,686433,41.2,8654618,214.243,43.1,18.436,57410.166,99.739,5.59,0.944,0
184,103,108,32713,0,1685,1946,688379,41.2,8654618,214.243,43.1,18.436,57410.166,99.739,5.59,0.944,0
184,104,85,32798,0,1685,6846,695225,41.2,8654618,214.243,43.1,18.436,57410.166,99.739,5.59,0.944,0
184,105,63,32861,0,1685,8812,704037,41.2,8654618,214.243,43.1,18.436,57410.166,99.739,5.59,0.944,0
184,106,70,32931,2,1687,7753,711790,41.2,8654618,214.243,43.1,18.436,57410.166,99.739,5.59,0.944,0
184,107,132,33063,0,1687,7285,719075,41.2,8654618,214.243,43.1,18.436,57410.166,99.739,5.59,0.944,0
184,108,142,33205,0,1687,6723,725798,41.2,8654618,214.243,43.1,18.436,57410.166,99.739,5.59,0.944,0
184,109,91,33296,0,1687,3769,729567,41.2,8654618,214.243,43.1,18.436,57410.166,99.739,5.59,0.944,0
184,110,110,33406,0,1687,1776,731343,41.2,8654618,214.243,43.1,18.436,57410.166,99.739,5.59,0.944,0
184,111,98,33504,0,1687,5686,737029,41.2,8654618,214.243,43.1,18.436,57410.166,99.739,5.59,0.944,0
184,112,43,33547,0,1687,6832,743861,41.2,8654618,214.243,43.1,18.436,57410.166,99.739,5.59,0.944,0
184,113,108,33655,3,1690,6723,750584,41.2,8654618,214.243,43.1,18.436,57410.166,99.739,5.59,0.944,0
184,114,141,33796,2,1692,5514,756098,41.2,8654618,214.243,43.1,18.436,57410.166,99.739,5.59,0.944,0
184,115,117,33913,1,1693,5544,761642,41.2,8654618,214.243,43.1,18.436,57410.166,99.739,5.59,0.944,0
184,116,154,34067,6,1699,3632,765274,41.2,8654618,214.243,43.1,18.436,57410.166,99.739,5.59,0.944,0
184,117,148,34215,0,1699,1789,767063,41.2,8654618,214.243,43.1,18.436,57410.166,99.739,5.59,0.944,0
184,118,110,34325,1,1700,5536,772599,41.2,8654618,214.243,43.1,18.436,57410.166,99.739,5.59,0.944,0
184,119,65,34390,0,1700,7339,779938,41.2,8654618,214.243,43.1,18.436,57410.166,99.739,5.59,0.944,0
184,120,132,34522,2,1702,6852,786790,41.2,8654618,214.243,43.1,18.436,57410.166,99.739,5.59,0.944,0
184,121,192,34714,0,1702,7088,793878,41.2,8654618,214.243,43.1,18.436,57410.166,99.739,5.59,0.944,0
184,122,219,34933,1,1703,5711,799589,44.91,8654618,214.243,43.1,18.436,57410.166,99.739,5.59,0.944,0
184,123,137,35070,0,1703,3056,802645,44.91,8654618,214.243,43.1,18.436,57410.166,99.739,5.59,0.944,0
184,124,342,35412,2,1705,2132,804777,44.91,8654618,214.243,43.1,18.436,57410.166,99.739,5.59,0.944,0
184,125,49,35461,0,1705,6237,811014,44.91,8654618,214.243,43.1,18.436,57410.166,99.739,5.59,0.944,0
184,126,66,35527,0,1705,7326,818340,44.91,8654618,214.243,43.1,18.436,57410.166,99.739,5.59,0.944,0
184,127,130,35657,0,1705,6795,825135,44.91,8654618,214.243,43.1,18.436,57410.166,99.739,5.59,0.944,0
184,128,181,35838,0,1705,6621,831756,44.91,8654618,214.243,43.1,18.436,57410.166,99.739,5.59,0.944,0
184,129,181,36019,3,1708,6169,837925,44.91,8654618,214.243,43.1,18.436,57410.166,99.739,5.59,0.944,0
184,130,161,36180,3,1711,3728,841653,44.91,8654618,214.243,43.1,18.436,57410.166,99.739,5.59,0.944,0
184,131,182,36362,0,1711,2035,843688,44.91,8654618,214.243,43.1,18.436,57410.166,99.739,5.59,0.944,0
184,132,152,36514,0,1711,6059,849747,44.91,8654618,214.243,43.1,18.436,57410.166,99.739,5.59,0.944,0
184,133,105,36619,0,1711,7377,857124,44.91,8654618,214.243,43.1,18.436,57410.166,99.739,5.59,0.944,0
184,134,187,36806,1,1712,6730,863854,44.91,8654618,214.243,43.1,18.436,57410.166,99.739,5.59,0.944,0
184,135,273,37079,1,1713,7361,871215,44.91,8654618,214.243,43.1,18.436,57410.166,99.739,5.59,0.944,0
184,136,233,37312,1,1714,7349,878564,44.91,8654618,214.243,43.1,18.436,57410.166,99.739,5.59,0.944,0
184,137,268,37580,0,1714,4862,883426,44.91,8654618,214.243,43.1,18.436,57410.166,99.739,5.59,0.944,0
184,138,251,37831,0,1714,2449,885875,44.91,8654618,214.243,43.1,18.436,57410.166,99.739,5.59,0.944,0
184,139,200,38031,1,1715,8249,894124,44.91,8654618,214.243,43.1,18.436,57410.166,99.739,5.59,0.944,0
184,140,125,38156,0,1715,10582,904706,44.91,8654618,214.243,43.1,18.436,57410.166,99.739,5.59,0.944,0
184,141,196,38352,1,1716,9444,914150,44.91,8654618,214.243,43.1,18.436,57410.166,99.739,5.59,0.944,0
184,142,310,38662,2,1718,10141,924291,44.91,8654618,214.243,43.1,18.436,57410.166,99.739,5.59,0.944,0
184,143,264,38926,0,1718,9995,934286,44.91,8654618,214.243,43.1,18.436,57410.166,99.739,5.59,0.944,0
184,144,306,39232,0,1718,6155,940441,44.91,8654618,214.243,43.1,18.436,57410.166,99.739,5.59,0.944,0
184,145,294,39526,1,1719,3315,943756,44.91,8654618,214.243,43.1,18.436,57410.166,99.739,5.59,0.944,0
184,146,276,39802,0,1719,9990,953746,44.91,8654618,214.243,43.1,18.436,57410.166,99.739,5.59,0.944,0
184,147,157,39959,1,1720,13208,966954,44.91,8654618,214.243,43.1,18.436,57410.166,99.739,5.59,0.944,0
184,148,202,40161,2,1722,12880,979834,44.91,8654618,214.243,43.1,18.436,57410.166,99.739,5.59,0.944,0
184,149,379,40540,0,1722,13158,992992,44.91,8654618,214.243,43.1,18.436,57410.166,99.739,5.59,0.944,0
184,150,360,40900,1,1723,12576,1005568,44.91,8654618,214.243,43.1,18.436,57410.166,99.739,5.59,0.944,0
184,151,340,41240,1,1724,8407,1013975,44.91,8654618,214.243,43.1,18.436,57410.166,99.739,5.59,0.944,0
184,152,375,41615,0,1724,3861,1017836,44.91,8654618,214.243,43.1,18.436,57410.166,99.739,5.59,0.944,0
184,153,291,41906,0,1724,11413,1029249,44.91,8654618,214.243,43.1,18.436,57410.166,99.739,5.59,0.944,0
184,154,163,42069,1,1725,16452,1045701,43.06,8654618,214.243,43.1,18.436,57410.166,99.739,5.59,0.944,0
184,155,216,42285,1,1726,16059,1061760,43.06,8654618,214.243,43.1,18.436,57410.166,99.739,5.59,0.944,0
184,156,370,42655,0,1726,15543,1077303,43.06,8654618,214.243,43.1,18.436,57410.166,99.739,5.59,0.944,0
184,157,472,43127,4,1730,14504,1091807,43.06,8654618,214.243,43.1,18.436,57410.166,99.739,5.59,0.944,0
184,158,297,43424,1,1731,9532,1101339,43.06,8654618,214.243,43.1,18.436,57410.166,99.739,5.59,0.944,0
184,159,425,43849,0,1731,4340,1105679,43.06,8654618,214.243,43.1,18.436,57410.166,99.739,5.59,0.944,0
184,160,444,44293,1,1732,13428,1119107,43.06,8654618,214.243,43.1,18.436,57410.166,99.739,5.59,0.944,0
184,161,191,44484,2,1734,17566,1136673,43.06,8654618,214.243,43.1,18.436,57410.166,99.739,5.59,0.944,0
184,162,245,44729,0,1734,16447,1153120,43.06,8654618,214.243,43.1,18.436,57410.166,99.739,5.59,0.944,0
184,163,468,45197,0,1734,15722,1168842,43.06,8654618,214.243,43.1,18.436,57410.166,99.739,5.59,0.944,0
184,164,405,45602,2,1736,14197,1183039,43.06,8654618,214.243,43.1,18.436,57410.166,99.739,5.59,0.944,0
184,165,528,46130,3,1739,9873,1192912,43.06,8654618,214.243,43.1,18.436,57410.166,99.739,5.59,0.944,0
184,166,465,46595,3,1742,4169,1197081,43.06,8654618,214.243,43.1,18.436,57410.166,99.739,5.59,0.944,0
184,167,473,47068,4,1746,12851,1209932,43.06,8654618,214.243,43.1,18.436,57410.166,99.739,5.59,0.944,0
184,168,257,47325,0,1746,16821,1226753,43.06,8654618,214.243,43.1,18.436,57410.166,99.739,5.59,0.944,0
184,169,315,47640,1,1747,15458,1242211,43.06,8654618,214.243,43.1,18.436,57410.166,99.739,5.59,0.944,0
184,170,514,48154,7,1754,15174,1257385,43.06,8654618,214.243,43.1,18.436,57410.166,99.739,5.59,0.944,0
184,171,530,48684,8,1762,13392,1270777,43.06,8654618,214.243,43.1,18.436,57410.166,99.739,5.59,0.944,0
184,172,487,49171,2,1764,7810,1278587,43.06,8654618,214.243,43.1,18.436,57410.166,99.739,5.59,0.944,0
184,173,0,49171,0,1764,3582,1282169,43.06,8654618,214.243,43.1,18.436,57410.166,99.739,5.59,0.944,0
184,174,0,49171,0,1764,10368,1292537,43.06,8654618,214.243,43.1,18.436,57410.166,99.739,5.59,0.944,0
184,175,1093,50264,5,1769,13425,1305962,43.06,8654618,214.243,43.1,18.436,57410.166,99.739,5.59,0.944,0
184,176,284,50548,3,1772,12932,1318894,43.06,8654618,214.243,43.1,18.436,57410.166,99.739,5.59,0.944,0
184,177,436,50984,0,1772,11910,1330804,43.06,8654618,214.243,43.1,18.436,57410.166,99.739,5.59,0.944,0
184,178,508,51492,4,1776,11246,1342050,43.06,8654618,214.243,43.1,18.436,57410.166,99.739,5.59,0.944,0
184,179,255,51747,1,1777,6010,1348060,43.06,8654618,214.243,43.1,18.436,57410.166,99.739,5.59,0.944,0
184,180,117,51864,1,1778,2832,1350892,43.06,8654618,214.243,43.1,18.436,57410.166,99.739,5.59,0.944,0
184,181,0,51864,0,1778,9392,1360284,43.06,8654618,214.243,43.1,18.436,57410.166,99.739,5.59,0.944,0
184,182,664,52528,1,1779,12467,1372751,43.06,8654618,214.243,43.1,18.436,57410.166,99.739,5.59,0.944,0
184,183,223,52751,2,1781,11892,1384643,43.06,8654618,214.243,43.1,18.436,57410.166,99.739,5.59,0.944,0
184,184,411,53162,1,1782,12059,1396702,43.06,8654618,214.243,43.1,18.436,57410.166,99.739,5.59,0.944,0
184,185,550,53712,1,1783,11248,1407950,43.06,8654618,214.243,43.1,18.436,57410.166,99.739,5.59,0.944,0
184,186,551,54263,0,1783,7610,1415560,43.06,8654618,214.243,43.1,18.436,57410.166,99.739,5.59,0.944,0
184,187,0,54263,0,1783,3559,1419119,43.06,8654618,214.243,43.1,18.436,57410.166,99.739,5.59,0.944,0
184,188,0,54263,0,1783,11893,1431012,43.06,8654618,214.243,43.1,18.436,57410.166,99.739,5.59,0.944,0
184,189,1540,55803,3,1786,14877,1445889,43.06,8654618,214.243,43.1,18.436,57410.166,99.739,5.59,0.944,0
184,190,699,56502,0,1786,15457,1461346,43.06,8654618,214.243,43.1,18.436,57410.166,99.739,5.59,0.944,0
184,191,0,56502,0,1786,15859,1477205,43.06,8654618,214.243,43.1,18.436,57410.166,99.739,5.59,0.944,0
184,192,2243,58745,4,1790,16040,1493245,43.06,8654618,214.243,43.1,18.436,57410.166,99.739,5.59,0.944,0
184,193,1485,60230,3,1793,10858,1504103,33.8,8654618,214.243,43.1,18.436,57410.166,99.739,5.59,0.944,0
184,194,0,60230,0,1793,5142,1509245,33.8,8654618,214.243,43.1,18.436,57410.166,99.739,5.59,0.944,0
184,195,0,60230,0,1793,15089,1524334,33.8,8654618,214.243,43.1,18.436,57410.166,99.739,5.59,0.944,0
184,196,4057,64287,7,1800,20348,1544682,33.8,8654618,214.243,43.1,18.436,57410.166,99.739,5.59,0.944,0
184,197,1439,65726,7,1807,20411,1565093,33.8,8654618,214.243,43.1,18.436,57410.166,99.739,5.59,0.944,0
184,198,2724,68450,7,1814,22205,1587298,33.8,8654618,214.243,43.1,18.436,57410.166,99.739,5.59,0.944,0
184,199,2690,71140,3,1817,24400,1611698,33.8,8654618,214.243,43.1,18.436,57410.166,99.739,5.59,0.944,0
184,200,3087,74227,5,1822,15996,1627694,33.8,8654618,214.243,43.1,18.436,57410.166,99.739,5.59,0.944,0
184,201,0,74227,0,1822,8422,1636116,33.8,8654618,214.243,43.1,18.436,57410.166,99.739,5.59,0.944,0
184,202,195,74422,1,1823,10396,1646512,35.19,8654618,214.243,43.1,18.436,57410.166,99.739,5.59,0.944,0
184,203,8737,83159,14,1837,0,1646512,35.19,8654618,214.243,43.1,18.436,57410.166,99.739,5.59,0.944,0
184,204,3008,86167,7,1844,0,1646512,35.19,8654618,214.243,43.1,18.436,57410.166,99.739,5.59,0.944,0
188,1,0,19,0,1,0,0,47.22,59734213,64.699,17.7,3.108,2683.304,217.288,5.75,0.538,4
188,2,1,20,0,1,0,0,47.22,59734213,64.699,17.7,3.108,2683.304,217.288,5.75,0.538,4
188,3,1,21,0,1,0,0,47.22,59734213,64.699,17.7,3.108,2683.304,217.288,5.75,0.538,4
188,4,0,21,0,1,0,0,47.22,59734213,64.699,17.7,3.108,2683.304,217.288,5.75,0.538,4
188,5,0,21,0,1,0,0,47.22,59734213,64.699,17.7,3.108,2683.304,217.288,5.75,0.538,4
188,6,1,22,0,1,0,0,47.22,59734213,64.699,17.7,3.108,2683.304,217.288,5.75,0.538,4
188,7,2,24,0,1,0,0,47.22,59734213,64.699,17.7,3.108,2683.304,217.288,5.75,0.538,4
188,8,0,24,0,1,0,0,47.22,59734213,64.699,17.7,3.108,2683.304,217.288,5.75,0.538,4
188,9,1,25,0,1,0,0,47.22,59734213,64.699,17.7,3.108,2683.304,217.288,5.75,0.538,4
188,10,0,25,0,1,0,0,47.22,59734213,64.699,17.7,3.108,2683.304,217.288,5.75,0.538,4
188,11,7,32,2,3,0,0,47.22,59734213,64.699,17.7,3.108,2683.304,217.288,5.75,0.538,4
188,12,0,32,0,3,0,0,50,59734213,64.699,17.7,3.108,2683.304,217.288,5.75,0.538,4
188,13,0,32,0,3,0,0,50,59734213,64.699,17.7,3.108,2683.304,217.288,5.75,0.538,4
188,14,14,46,0,3,0,0,50,59734213,64.699,17.7,3.108,2683.304,217.288,5.75,0.538,4
188,15,7,53,0,3,0,0,50,59734213,64.699,17.7,3.108,2683.304,217.288,5.75,0.538,4
188,16,35,88,1,4,0,0,50,59734213,64.699,17.7,3.108,2683.304,217.288,5.75,0.538,4
188,17,6,94,0,4,0,0,50,59734213,64.699,17.7,3.108,2683.304,217.288,5.75,0.538,4
188,18,53,147,1,5,0,0,50,59734213,64.699,17.7,3.108,2683.304,217.288,5.75,0.538,4
188,19,1,148,0,5,0,0,50,59734213,64.699,17.7,3.108,2683.304,217.288,5.75,0.538,4
188,20,22,170,0,5,0,0,50,59734213,64.699,17.7,3.108,2683.304,217.288,5.75,0.538,4
188,21,0,170,0,5,0,0,50,59734213,64.699,17.7,3.108,2683.304,217.288,5.75,0.538,4
188,22,84,254,3,8,0,0,50,59734213,64.699,17.7,3.108,2683.304,217.288,5.75,0.538,4
188,23,31,285,2,10,0,0,50,59734213,64.699,17.7,3.108,2683.304,217.288,5.75,0.538,4
188,24,0,285,0,10,0,0,50,59734213,64.699,17.7,3.108,2683.304,217.288,5.75,0.538,4
188,25,15,300,0,10,0,0,50,59734213,64.699,17.7,3.108,2683.304,217.288,5.75,0.538,4
188,26,0,300,0,10,0,0,50,59734213,64.699,17.7,3.108,2683.304,217.288,5.75,0.538,4
188,27,0,300,0,10,0,0,50,59734213,64.699,17.7,3.108,2683.304,217.288,5.75,0.538,4
188,28,0,300,0,10,0,0,50,59734213,64.699,17.7,3.108,2683.304,217.288,5.75,0.538,4
188,29,6,306,0,10,0,0,50,59734213,64.699,17.7,3.108,2683.304,217.288,5.75,0.538,4
188,30,174,480,6,16,0,0,50,59734213,64.699,17.7,3.108,2683.304,217.288,5.75,0.538,4
188,31,0,480,0,16,0,0,50,59734213,64.699,17.7,3.108,2683.304,217.288,5.75,0.538,4
188,32,0,480,0,16,0,0,50,59734213,64.699,17.7,3.108,2683.304,217.288,5.75,0.538,4
188,33,0,480,0,16,0,0,50,59734213,64.699,17.7,3.108,2683.304,217.288,5.75,0.538,4
188,34,0,480,0,16,0,0,50,59734213,64.699,17.7,3.108,2683.304,217.288,5.75,0.538,4
188,35,0,480,2,18,0,0,50,59734213,64.699,17.7,3.108,2683.304,217.288,5.75,0.538,4
188,36,0,480,0,18,0,0,50,59734213,64.699,17.7,3.108,2683.304,217.288,5.75,0.538,4
188,37,0,480,0,18,0,0,50,59734213,64.699,17.7,3.108,2683.304,217.288,5.75,0.538,4
188,38,29,509,3,21,0,0,50,59734213,64.699,17.7,3.108,2683.304,217.288,5.75,0.538,4
188,39,0,509,0,21,0,0,50,59734213,64.699,17.7,3.108,2683.304,217.288,5.75,0.538,4
188,40,0,509,0,21,0,0,50,59734213,64.699,17.7,3.108,2683.304,217.288,5.75,0.538,4
188,41,0,509,0,21,0,0,50,59734213,64.699,17.7,3.108,2683.304,217.288,5.75,0.538,4
188,42,0,509,0,21,0,0,50,59734213,64.699,17.7,3.108,2683.304,217.288,5.75,0.538,4
188,43,0,509,0,21,0,0,50,59734213,64.699,17.7,3.108,2683.304,217.288,5.75,0.538,4
188,44,0,509,0,21,0,0,50,59734213,64.699,17.7,3.108,2683.304,217.288,5.75,0.538,4
188,45,0,509,0,21,0,0,50,59734213,64.699,17.7,3.108,2683.304,217.288,5.75,0.538,4
188,46,0,509,0,21,0,0,50,59734213,64.699,17.7,3.108,2683.304,217.288,5.75,0.538,4
188,47,0,509,0,21,0,0,50,59734213,64.699,17.7,3.108,2683.304,217.288,5.75,0.538,4
188,48,0,509,0,21,0,0,38.89,59734213,64.699,17.7,3.108,2683.304,217.288,5.75,0.538,4
188,49,0,509,0,21,0,0,38.89,59734213,64.699,17.7,3.108,2683.304,217.288,5.75,0.538,4
188,50,0,509,0,21,0,0,38.89,59734213,64.699,17.7,3.108,2683.304,217.288,5.75,0.538,4
188,51,0,509,0,21,0,0,38.89,59734213,64.699,17.7,3.108,2683.304,217.288,5.75,0.538,4
188,52,0,509,0,21,0,0,38.89,59734213,64.699,17.7,3.108,2683.304,217.288,5.75,0.538,4
188,53,0,509,0,21,0,0,38.89,59734213,64.699,17.7,3.108,2683.304,217.288,5.75,0.538,4
188,54,0,509,0,21,0,0,38.89,59734213,64.699,17.7,3.108,2683.304,217.288,5.75,0.538,4
188,55,0,509,0,21,0,0,38.89,59734213,64.699,17.7,3.108,2683.304,217.288,5.75,0.538,4
188,56,0,509,0,21,0,0,38.89,59734213,64.699,17.7,3.108,2683.304,217.288,5.75,0.538,4
188,57,0,509,0,21,0,0,41.67,59734213,64.699,17.7,3.108,2683.304,217.288,5.75,0.538,4
188,58,0,509,0,21,0,0,41.67,59734213,64.699,17.7,3.108,2683.304,217.288,5.75,0.538,4
188,59,0,509,0,21,0,0,41.67,59734213,64.699,17.7,3.108,2683.304,217.288,5.75,0.538,4
188,60,0,509,0,21,0,0,41.67,59734213,64.699,17.7,3.108,2683.304,217.288,5.75,0.538,4
188,61,0,509,0,21,0,0,41.67,59734213,64.699,17.7,3.108,2683.304,217.288,5.75,0.538,4
188,62,0,509,0,21,0,0,32.41,59734213,64.699,17.7,3.108,2683.304,217.288,5.75,0.538,4
188,63,0,509,0,21,0,0,32.41,59734213,64.699,17.7,3.108,2683.304,217.288,5.75,0.538,4
188,64,0,509,0,21,0,0,32.41,59734213,64.699,17.7,3.108,2683.304,217.288,5.75,0.538,4
188,65,0,509,0,21,0,0,32.41,59734213,64.699,17.7,3.108,2683.304,217.288,5.75,0.538,4
188,66,0,509,0,21,0,0,32.41,59734213,64.699,17.7,3.108,2683.304,217.288,5.75,0.538,4
188,67,0,509,0,21,0,0,32.41,59734213,64.699,17.7,3.108,2683.304,217.288,5.75,0.538,4
188,68,0,509,0,21,0,0,32.41,59734213,64.699,17.7,3.108,2683.304,217.288,5.75,0.538,4
188,69,0,509,0,21,0,0,32.41,59734213,64.699,17.7,3.108,2683.304,217.288,5.75,0.538,4
188,70,0,509,0,21,0,0,32.41,59734213,64.699,17.7,3.108,2683.304,217.288,5.75,0.538,4
188,71,0,509,0,21,0,0,32.41,59734213,64.699,17.7,3.108,2683.304,217.288,5.75,0.538,4
188,72,0,509,0,21,0,0,32.41,59734213,64.699,17.7,3.108,2683.304,217.288,5.75,0.538,4
188,73,0,509,0,21,0,0,32.41,59734213,64.699,17.7,3.108,2683.304,217.288,5.75,0.538,4
188,74,0,509,0,21,0,0,32.41,59734213,64.699,17.7,3.108,2683.304,217.288,5.75,0.538,4
188,75,0,509,0,21,0,0,32.41,59734213,64.699,17.7,3.108,2683.304,217.288,5.75,0.538,4
188,76,0,509,0,21,0,0,32.41,59734213,64.699,17.7,3.108,2683.304,217.288,5.75,0.538,4
188,77,0,509,0,21,0,0,32.41,59734213,64.699,17.7,3.108,2683.304,217.288,5.75,0.538,4
188,78,0,509,0,21,0,0,32.41,59734213,64.699,17.7,3.108,2683.304,217.288,5.75,0.538,4
188,79,0,509,0,21,0,0,32.41,59734213,64.699,17.7,3.108,2683.304,217.288,5.75,0.538,4
188,80,0,509,0,21,0,0,32.41,59734213,64.699,17.7,3.108,2683.304,217.288,5.75,0.538,4
188,81,0,509,0,21,0,0,32.41,59734213,64.699,17.7,3.108,2683.304,217.288,5.75,0.538,4
188,82,0,509,0,21,0,0,32.41,59734213,64.699,17.7,3.108,2683.304,217.288,5.75,0.538,4
188,83,0,509,0,21,0,0,32.41,59734213,64.699,17.7,3.108,2683.304,217.288,5.75,0.538,4
188,84,0,509,0,21,0,0,32.41,59734213,64.699,17.7,3.108,2683.304,217.288,5.75,0.538,4
188,85,0,509,0,21,0,0,32.41,59734213,64.699,17.7,3.108,2683.304,217.288,5.75,0.538,4
188,86,0,509,0,21,0,0,32.41,59734213,64.699,17.7,3.108,2683.304,217.288,5.75,0.538,4
188,87,0,509,0,21,0,0,32.41,59734213,64.699,17.7,3.108,2683.304,217.288,5.75,0.538,4
188,88,0,509,0,21,0,0,32.41,59734213,64.699,17.7,3.108,2683.304,217.288,5.75,0.538,4
188,89,0,509,0,21,0,0,32.41,59734213,64.699,17.7,3.108,2683.304,217.288,5.75,0.538,4
188,90,0,509,0,21,0,0,25,59734213,64.699,17.7,3.108,2683.304,217.288,5.75,0.538,4
188,91,0,509,0,21,0,0,25,59734213,64.699,17.7,3.108,2683.304,217.288,5.75,0.538,4
188,92,0,509,0,21,0,0,25,59734213,64.699,17.7,3.108,2683.304,217.288,5.75,0.538,4
188,93,0,509,0,21,0,0,25,59734213,64.699,17.7,3.108,2683.304,217.288,5.75,0.538,4
188,94,0,509,0,21,0,0,25,59734213,64.699,17.7,3.108,2683.304,217.288,5.75,0.538,4
188,95,0,509,0,21,0,0,25,59734213,64.699,17.7,3.108,2683.304,217.288,5.75,0.538,4
188,96,0,509,0,21,0,0,25,59734213,64.699,17.7,3.108,2683.304,217.288,5.75,0.538,4
188,97,0,509,0,21,0,0,25,59734213,64.699,17.7,3.108,2683.304,217.288,5.75,0.538,4
188,98,0,509,0,21,0,0,25,59734213,64.699,17.7,3.108,2683.304,217.288,5.75,0.538,4
188,99,0,509,0,21,0,0,25,59734213,64.699,17.7,3.108,2683.304,217.288,5.75,0.538,4
188,100,0,509,0,21,0,0,25,59734213,64.699,17.7,3.108,2683.304,217.288,5.75,0.538,4
188,101,0,509,0,21,0,0,25,59734213,64.699,17.7,3.108,2683.304,217.288,5.75,0.538,4
188,102,0,509,0,21,0,0,25,59734213,64.699,17.7,3.108,2683.304,217.288,5.75,0.538,4
188,103,0,509,0,21,0,0,25,59734213,64.699,17.7,3.108,2683.304,217.288,5.75,0.538,4
188,104,0,509,0,21,0,0,25,59734213,64.699,17.7,3.108,2683.304,217.288,5.75,0.538,4
188,105,0,509,0,21,0,0,25,59734213,64.699,17.7,3.108,2683.304,217.288,5.75,0.538,4
188,106,0,509,0,21,0,0,25,59734213,64.699,17.7,3.108,2683.304,217.288,5.75,0.538,4
188,107,0,509,0,21,0,0,25,59734213,64.699,17.7,3.108,2683.304,217.288,5.75,0.538,4
188,108,0,509,0,21,0,0,25,59734213,64.699,17.7,3.108,2683.304,217.288,5.75,0.538,4
188,109,0,509,0,21,0,0,25,59734213,64.699,17.7,3.108,2683.304,217.288,5.75,0.538,4
188,110,0,509,0,21,0,0,25,59734213,64.699,17.7,3.108,2683.304,217.288,5.75,0.538,4
188,111,0,509,0,21,0,0,27.78,59734213,64.699,17.7,3.108,2683.304,217.288,5.75,0.538,4
188,112,0,509,0,21,0,0,27.78,59734213,64.699,17.7,3.108,2683.304,217.288,5.75,0.538,4
188,113,0,509,0,21,0,0,27.78,59734213,64.699,17.7,3.108,2683.304,217.288,5.75,0.538,4
188,114,0,509,0,21,0,0,27.78,59734213,64.699,17.7,3.108,2683.304,217.288,5.75,0.538,4
188,115,0,509,0,21,0,0,27.78,59734213,64.699,17.7,3.108,2683.304,217.288,5.75,0.538,4
188,116,0,509,0,21,0,0,27.78,59734213,64.699,17.7,3.108,2683.304,217.288,5.75,0.538,4
188,117,0,509,0,21,0,0,27.78,59734213,64.699,17.7,3.108,2683.304,217.288,5.75,0.538,4
188,118,0,509,0,21,0,0,27.78,59734213,64.699,17.7,3.108,2683.304,217.288,5.75,0.538,4
188,119,0,509,0,21,0,0,27.78,59734213,64.699,17.7,3.108,2683.304,217.288,5.75,0.538,4
188,120,0,509,0,21,0,0,27.78,59734213,64.699,17.7,3.108,2683.304,217.288,5.75,0.538,4
188,121,0,509,0,21,0,0,27.78,59734213,64.699,17.7,3.108,2683.304,217.288,5.75,0.538,4
188,122,0,509,0,21,0,0,27.78,59734213,64.699,17.7,3.108,2683.304,217.288,5.75,0.538,4
188,123,0,509,0,21,0,0,27.78,59734213,64.699,17.7,3.108,2683.304,217.288,5.75,0.538,4
188,124,0,509,0,21,0,0,27.78,59734213,64.699,17.7,3.108,2683.304,217.288,5.75,0.538,4
188,125,0,509,0,21,0,0,27.78,59734213,64.699,17.7,3.108,2683.304,217.288,5.75,0.538,4
188,126,0,509,0,21,0,0,27.78,59734213,64.699,17.7,3.108,2683.304,217.288,5.75,0.538,4
188,127,0,509,0,21,0,0,27.78,59734213,64.699,17.7,3.108,2683.304,217.288,5.75,0.538,4
188,128,0,509,0,21,0,0,27.78,59734213,64.699,17.7,3.108,2683.304,217.288,5.75,0.538,4
188,129,0,509,0,21,0,0,27.78,59734213,64.699,17.7,3.108,2683.304,217.288,5.75,0.538,4
188,130,0,509,0,21,0,0,27.78,59734213,64.699,17.7,3.108,2683.304,217.288,5.75,0.538,4
188,131,0,509,0,21,0,0,27.78,59734213,64.699,17.7,3.108,2683.304,217.288,5.75,0.538,4
188,132,0,509,0,21,0,0,27.78,59734213,64.699,17.7,3.108,2683.304,217.288,5.75,0.538,4
188,133,0,509,0,21,0,0,27.78,59734213,64.699,17.7,3.108,2683.304,217.288,5.75,0.538,4
188,134,0,509,0,21,0,0,27.78,59734213,64.699,17.7,3.108,2683.304,217.288,5.75,0.538,4
188,135,0,509,0,21,0,0,27.78,59734213,64.699,17.7,3.108,2683.304,217.288,5.75,0.538,4
188,136,0,509,0,21,0,0,27.78,59734213,64.699,17.7,3.108,2683.304,217.288,5.75,0.538,4
188,137,0,509,0,21,0,0,27.78,59734213,64.699,17.7,3.108,2683.304,217.288,5.75,0.538,4
188,138,0,509,0,21,0,0,27.78,59734213,64.699,17.7,3.108,2683.304,217.288,5.75,0.538,4
188,139,0,509,0,21,0,0,27.78,59734213,64.699,17.7,3.108,2683.304,217.288,5.75,0.538,4
188,140,0,509,0,21,0,0,22.22,59734213,64.699,17.7,3.108,2683.304,217.288,5.75,0.538,4
188,141,0,509,0,21,0,0,22.22,59734213,64.699,17.7,3.108,2683.304,217.288,5.75,0.538,4
188,142,0,509,0,21,0,0,22.22,59734213,64.699,17.7,3.108,2683.304,217.288,5.75,0.538,4
188,143,0,509,0,21,0,0,22.22,59734213,64.699,17.7,3.108,2683.304,217.288,5.75,0.538,4
188,144,0,509,0,21,0,0,22.22,59734213,64.699,17.7,3.108,2683.304,217.288,5.75,0.538,4
188,145,0,509,0,21,0,0,22.22,59734213,64.699,17.7,3.108,2683.304,217.288,5.75,0.538,4
188,146,0,509,0,21,0,0,22.22,59734213,64.699,17.7,3.108,2683.304,217.288,5.75,0.538,4
188,147,0,509,0,21,0,0,22.22,59734213,64.699,17.7,3.108,2683.304,217.288,5.75,0.538,4
188,148,0,509,0,21,0,0,22.22,59734213,64.699,17.7,3.108,2683.304,217.288,5.75,0.538,4
188,149,0,509,0,21,0,0,25,59734213,64.699,17.7,3.108,2683.304,217.288,5.75,0.538,4
188,150,0,509,0,21,0,0,25,59734213,64.699,17.7,3.108,2683.304,217.288,5.75,0.538,4
188,151,0,509,0,21,0,0,25,59734213,64.699,17.7,3.108,2683.304,217.288,5.75,0.538,4
188,152,0,509,0,21,0,0,25,59734213,64.699,17.7,3.108,2683.304,217.288,5.75,0.538,4
188,153,0,509,0,21,0,0,25,59734213,64.699,17.7,3.108,2683.304,217.288,5.75,0.538,4
188,154,0,509,0,21,0,0,25,59734213,64.699,17.7,3.108,2683.304,217.288,5.75,0.538,4
188,155,0,509,0,21,0,0,25,59734213,64.699,17.7,3.108,2683.304,217.288,5.75,0.538,4
188,156,0,509,0,21,0,0,25,59734213,64.699,17.7,3.108,2683.304,217.288,5.75,0.538,4
188,157,0,509,0,21,0,0,25,59734213,64.699,17.7,3.108,2683.304,217.288,5.75,0.538,4
188,158,0,509,0,21,0,0,25,59734213,64.699,17.7,3.108,2683.304,217.288,5.75,0.538,4
188,159,0,509,0,21,0,0,25,59734213,64.699,17.7,3.108,2683.304,217.288,5.75,0.538,4
188,160,0,509,0,21,0,0,25,59734213,64.699,17.7,3.108,2683.304,217.288,5.75,0.538,4
188,161,0,509,0,21,0,0,25,59734213,64.699,17.7,3.108,2683.304,217.288,5.75,0.538,4
188,162,0,509,0,21,0,0,25,59734213,64.699,17.7,3.108,2683.304,217.288,5.75,0.538,4
188,163,0,509,0,21,0,0,25,59734213,64.699,17.7,3.108,2683.304,217.288,5.75,0.538,4
188,164,0,509,0,21,0,0,25,59734213,64.699,17.7,3.108,2683.304,217.288,5.75,0.538,4
188,165,0,509,0,21,0,0,25,59734213,64.699,17.7,3.108,2683.304,217.288,5.75,0.538,4
188,166,0,509,0,21,0,0,25,59734213,64.699,17.7,3.108,2683.304,217.288,5.75,0.538,4
188,167,0,509,0,21,0,0,25,59734213,64.699,17.7,3.108,2683.304,217.288,5.75,0.538,4
188,168,0,509,0,21,0,0,25,59734213,64.699,17.7,3.108,2683.304,217.288,5.75,0.538,4
188,169,0,509,0,21,0,0,25,59734213,64.699,17.7,3.108,2683.304,217.288,5.75,0.538,4
188,170,0,509,0,21,0,0,8.33,59734213,64.699,17.7,3.108,2683.304,217.288,5.75,0.538,4
188,171,0,509,0,21,0,0,8.33,59734213,64.699,17.7,3.108,2683.304,217.288,5.75,0.538,4
188,172,0,509,0,21,0,0,8.33,59734213,64.699,17.7,3.108,2683.304,217.288,5.75,0.538,4
188,173,0,509,0,21,0,0,8.33,59734213,64.699,17.7,3.108,2683.304,217.288,5.75,0.538,4
188,174,0,509,0,21,0,0,8.33,59734213,64.699,17.7,3.108,2683.304,217.288,5.75,0.538,4
188,175,0,509,0,21,0,0,8.33,59734213,64.699,17.7,3.108,2683.304,217.288,5.75,0.538,4
188,176,0,509,0,21,0,0,8.33,59734213,64.699,17.7,3.108,2683.304,217.288,5.75,0.538,4
188,177,0,509,0,21,0,0,8.33,59734213,64.699,17.7,3.108,2683.304,217.288,5.75,0.538,4
188,178,0,509,0,21,0,0,8.33,59734213,64.699,17.7,3.108,2683.304,217.288,5.75,0.538,4
188,179,0,509,0,21,0,0,8.33,59734213,64.699,17.7,3.108,2683.304,217.288,5.75,0.538,4
188,180,0,509,0,21,0,0,8.33,59734213,64.699,17.7,3.108,2683.304,217.288,5.75,0.538,4
188,181,0,509,0,21,0,0,8.33,59734213,64.699,17.7,3.108,2683.304,217.288,5.75,0.538,4
188,182,0,509,0,21,0,0,8.33,59734213,64.699,17.7,3.108,2683.304,217.288,5.75,0.538,4
188,183,0,509,0,21,0,0,8.33,59734213,64.699,17.7,3.108,2683.304,217.288,5.75,0.538,4
188,184,0,509,0,21,0,0,8.33,59734213,64.699,17.7,3.108,2683.304,217.288,5.75,0.538,4
188,185,0,509,0,21,0,0,8.33,59734213,64.699,17.7,3.108,2683.304,217.288,5.75,0.538,4
188,186,0,509,0,21,0,0,8.33,59734213,64.699,17.7,3.108,2683.304,217.288,5.75,0.538,4
188,187,0,509,0,21,0,0,8.33,59734213,64.699,17.7,3.108,2683.304,217.288,5.75,0.538,4
188,188,0,509,0,21,0,0,8.33,59734213,64.699,17.7,3.108,2683.304,217.288,5.75,0.538,4
188,189,0,509,0,21,0,0,8.33,59734213,64.699,17.7,3.108,2683.304,217.288,5.75,0.538,4
188,190,0,509,0,21,0,0,8.33,59734213,64.699,17.7,3.108,2683.304,217.288,5.75,0.538,4
188,191,0,509,0,21,0,0,8.33,59734213,64.699,17.7,3.108,2683.304,217.288,5.75,0.538,4
188,192,0,509,0,21,0,0,8.33,59734213,64.699,17.7,3.108,2683.304,217.288,5.75,0.538,4
188,193,0,509,0,21,0,0,8.33,59734213,64.699,17.7,3.108,2683.304,217.288,5.75,0.538,4
188,194,0,509,0,21,0,0,8.33,59734213,64.699,17.7,3.108,2683.304,217.288,5.75,0.538,4
188,195,0,509,0,21,0,0,8.33,59734213,64.699,17.7,3.108,2683.304,217.288,5.75,0.538,4
188,196,0,509,0,21,0,0,8.33,59734213,64.699,17.7,3.108,2683.304,217.288,5.75,0.538,4
188,197,0,509,0,21,0,0,8.33,59734213,64.699,17.7,3.108,2683.304,217.288,5.75,0.538,4
188,198,0,509,0,21,0,0,8.33,59734213,64.699,17.7,3.108,2683.304,217.288,5.75,0.538,4
188,199,0,509,0,21,0,0,8.33,59734213,64.699,17.7,3.108,2683.304,217.288,5.75,0.538,4
188,200,0,509,0,21,0,0,8.33,59734213,64.699,17.7,3.108,2683.304,217.288,5.75,0.538,4
188,201,0,509,0,21,0,0,8.33,59734213,64.699,17.7,3.108,2683.304,217.288,5.75,0.538,4
188,202,0,509,0,21,0,0,8.33,59734213,64.699,17.7,3.108,2683.304,217.288,5.75,0.538,4
188,203,0,509,0,21,0,0,8.33,59734213,64.699,17.7,3.108,2683.304,217.288,5.75,0.538,4
188,204,0,509,0,21,0,0,8.33,59734213,64.699,17.7,3.108,2683.304,217.288,5.75,0.538,4
189,1,0,1651,0,10,2777,66240,68.06,69799978,135.132,40.1,11.373,16277.671,109.861,7.04,0.755,4
189,2,120,1771,2,12,2963,69203,68.06,69799978,135.132,40.1,11.373,16277.671,109.861,7.04,0.755,4
189,3,104,1875,3,15,2762,71965,76.85,69799978,135.132,40.1,11.373,16277.671,109.861,7.04,0.755,4
189,4,103,1978,4,19,3189,75154,76.85,69799978,135.132,40.1,11.373,16277.671,109.861,7.04,0.755,4
189,5,191,2169,4,23,3525,78679,76.85,69799978,135.132,40.1,11.373,16277.671,109.861,7.04,0.755,4
189,6,51,2220,3,26,3891,82570,76.85,69799978,135.132,40.1,11.373,16277.671,109.861,7.04,0.755,4
189,7,38,2258,0,26,4738,87308,76.85,69799978,135.132,40.1,11.373,16277.671,109.861,7.04,0.755,4
189,8,111,2369,4,30,3804,91112,76.85,69799978,135.132,40.1,11.373,16277.671,109.861,7.04,0.755,4
189,9,54,2423,2,32,3577,94689,76.85,69799978,135.132,40.1,11.373,16277.671,109.861,7.04,0.755,4
189,10,50,2473,1,33,3776,98465,76.85,69799978,135.132,40.1,11.373,16277.671,109.861,7.04,0.755,4
189,11,45,2518,2,35,3892,102357,76.85,69799978,135.132,40.1,11.373,16277.671,109.861,7.04,0.755,4
189,12,33,2551,3,38,2754,105111,76.85,69799978,135.132,40.1,11.373,16277.671,109.861,7.04,0.755,4
189,13,28,2579,2,40,3698,108809,76.85,69799978,135.132,40.1,11.373,16277.671,109.861,7.04,0.755,4
189,14,34,2613,1,41,3904,112713,76.85,69799978,135.132,40.1,11.373,16277.671,109.861,7.04,0.755,4
189,15,30,2643,2,43,4879,117592,76.85,69799978,135.132,40.1,11.373,16277.671,109.861,7.04,0.755,4
189,16,29,2672,3,46,5419,123011,76.85,69799978,135.132,40.1,11.373,16277.671,109.861,7.04,0.755,4
189,17,28,2700,1,47,4892,127903,76.85,69799978,135.132,40.1,11.373,16277.671,109.861,7.04,0.755,4
189,18,0,2700,0,47,6176,134079,76.85,69799978,135.132,40.1,11.373,16277.671,109.861,7.04,0.755,4
189,19,33,2733,0,47,4466,138545,76.85,69799978,135.132,40.1,11.373,16277.671,109.861,7.04,0.755,4
189,20,32,2765,0,47,4224,142769,76.85,69799978,135.132,40.1,11.373,16277.671,109.861,7.04,0.755,4
189,21,27,2792,0,47,5517,148286,76.85,69799978,135.132,40.1,11.373,16277.671,109.861,7.04,0.755,4
189,22,19,2811,1,48,6933,155219,76.85,69799978,135.132,40.1,11.373,16277.671,109.861,7.04,0.755,4
189,23,28,2839,2,50,9222,164441,76.85,69799978,135.132,40.1,11.373,16277.671,109.861,7.04,0.755,4
189,24,0,2839,0,50,6527,170968,76.85,69799978,135.132,40.1,11.373,16277.671,109.861,7.04,0.755,4
189,25,15,2854,0,50,5619,176587,76.85,69799978,135.132,40.1,11.373,16277.671,109.861,7.04,0.755,4
189,26,68,2922,1,51,5836,182423,76.85,69799978,135.132,40.1,11.373,16277.671,109.861,7.04,0.755,4
189,27,0,2922,0,51,8072,190495,76.85,69799978,135.132,40.1,11.373,16277.671,109.861,7.04,0.755,4
189,28,16,2938,3,54,9765,200260,76.85,69799978,135.132,40.1,11.373,16277.671,109.861,7.04,0.755,4
189,29,0,2938,0,54,8772,209032,76.85,69799978,135.132,40.1,11.373,16277.671,109.861,7.04,0.755,4
189,30,16,2954,0,54,11423,220455,76.85,69799978,135.132,40.1,11.373,16277.671,109.861,7.04,0.755,4
189,31,6,2960,0,54,7530,227985,76.85,69799978,135.132,40.1,11.373,16277.671,109.861,7.04,0.755,4
189,32,0,2960,0,54,9243,237228,76.85,69799978,135.132,40.1,11.373,16277.671,109.861,7.04,0.755,4
189,33,6,2966,0,54,6085,243313,75,69799978,135.132,40.1,11.373,16277.671,109.861,7.04,0.755,4
189,34,3,2969,0,54,6511,249824,75,69799978,135.132,40.1,11.373,16277.671,109.861,7.04,0.755,4
189,35,18,2987,0,54,7326,257150,75,69799978,135.132,40.1,11.373,16277.671,109.861,7.04,0.755,4
189,36,1,2988,0,54,6191,263341,75,69799978,135.132,40.1,11.373,16277.671,109.861,7.04,0.755,4
189,37,1,2989,1,55,7667,271008,75,69799978,135.132,40.1,11.373,16277.671,109.861,7.04,0.755,4
189,38,3,2992,0,55,7916,278924,75,69799978,135.132,40.1,11.373,16277.671,109.861,7.04,0.755,4
189,39,8,3000,0,55,6194,285118,75,69799978,135.132,40.1,11.373,16277.671,109.861,7.04,0.755,4
189,40,4,3004,1,56,5576,290694,75,69799978,135.132,40.1,11.373,16277.671,109.861,7.04,0.755,4
189,41,11,3015,0,56,5759,296453,75,69799978,135.132,40.1,11.373,16277.671,109.861,7.04,0.755,4
189,42,0,3015,0,56,6785,303238,75,69799978,135.132,40.1,11.373,16277.671,109.861,7.04,0.755,4
189,43,2,3017,0,56,7440,310678,75,69799978,135.132,40.1,11.373,16277.671,109.861,7.04,0.755,4
189,44,0,3017,0,56,7010,317688,75,69799978,135.132,40.1,11.373,16277.671,109.861,7.04,0.755,4
189,45,1,3018,0,56,8075,325763,75,69799978,135.132,40.1,11.373,16277.671,109.861,7.04,0.755,4
189,46,7,3025,0,56,6491,332254,75,69799978,135.132,40.1,11.373,16277.671,109.861,7.04,0.755,4
189,47,3,3028,0,56,4043,336297,73.15,69799978,135.132,40.1,11.373,16277.671,109.861,7.04,0.755,4
189,48,0,3028,0,56,6761,343058,73.15,69799978,135.132,40.1,11.373,16277.671,109.861,7.04,0.755,4
189,49,3,3031,0,56,7656,350714,75,69799978,135.132,40.1,11.373,16277.671,109.861,7.04,0.755,4
189,50,3,3034,0,56,8534,359248,75,69799978,135.132,40.1,11.373,16277.671,109.861,7.04,0.755,4
189,51,0,3034,0,56,8627,367875,75,69799978,135.132,40.1,11.373,16277.671,109.861,7.04,0.755,4
189,52,3,3037,0,56,7736,375611,75,69799978,135.132,40.1,11.373,16277.671,109.861,7.04,0.755,4
189,53,3,3040,0,56,7914,383525,75,69799978,135.132,40.1,11.373,16277.671,109.861,7.04,0.755,4
189,54,0,3040,0,56,4298,387823,75,69799978,135.132,40.1,11.373,16277.671,109.861,7.04,0.755,4
189,55,2,3042,1,57,8194,396017,75,69799978,135.132,40.1,11.373,16277.671,109.861,7.04,0.755,4
189,56,0,3042,0,57,9193,405210,75,69799978,135.132,40.1,11.373,16277.671,109.861,7.04,0.755,4
189,57,3,3045,0,57,10021,415231,75,69799978,135.132,40.1,11.373,16277.671,109.861,7.04,0.755,4
189,58,9,3054,0,57,9181,424412,75,69799978,135.132,40.1,11.373,16277.671,109.861,7.04,0.755,4
189,59,11,3065,0,57,8759,433171,75,69799978,135.132,40.1,11.373,16277.671,109.861,7.04,0.755,4
189,60,11,3076,0,57,7758,440929,75,69799978,135.132,40.1,11.373,16277.671,109.861,7.04,0.755,4
189,61,5,3081,0,57,4797,445726,75,69799978,135.132,40.1,11.373,16277.671,109.861,7.04,0.755,4
189,62,0,3081,0,57,8103,453829,75,69799978,135.132,40.1,11.373,16277.671,109.861,7.04,0.755,4
189,63,1,3082,0,57,10293,464122,75,69799978,135.132,40.1,11.373,16277.671,109.861,7.04,0.755,4
189,64,1,3083,1,58,6696,470818,75,69799978,135.132,40.1,11.373,16277.671,109.861,7.04,0.755,4
189,65,18,3101,0,58,10029,480847,75,69799978,135.132,40.1,11.373,16277.671,109.861,7.04,0.755,4
189,66,1,3102,0,58,8963,489810,75,69799978,135.132,40.1,11.373,16277.671,109.861,7.04,0.755,4
189,67,2,3104,0,58,5259,495069,62.96,69799978,135.132,40.1,11.373,16277.671,109.861,7.04,0.755,4
189,68,8,3112,0,58,5081,500150,62.96,69799978,135.132,40.1,11.373,16277.671,109.861,7.04,0.755,4
189,69,7,3119,0,58,8670,508820,62.96,69799978,135.132,40.1,11.373,16277.671,109.861,7.04,0.755,4
189,70,0,3119,0,58,10526,519346,62.96,69799978,135.132,40.1,11.373,16277.671,109.861,7.04,0.755,4
189,71,6,3125,0,58,7940,527286,62.96,69799978,135.132,40.1,11.373,16277.671,109.861,7.04,0.755,4
189,72,0,3125,0,58,10366,537652,62.96,69799978,135.132,40.1,11.373,16277.671,109.861,7.04,0.755,4
189,73,0,3125,0,58,8818,546470,62.96,69799978,135.132,40.1,11.373,16277.671,109.861,7.04,0.755,4
189,74,4,3129,0,58,5626,552096,62.96,69799978,135.132,40.1,11.373,16277.671,109.861,7.04,0.755,4
189,75,5,3134,0,58,4798,556894,62.96,69799978,135.132,40.1,11.373,16277.671,109.861,7.04,0.755,4
189,76,1,3135,0,58,7963,564857,59.26,69799978,135.132,40.1,11.373,16277.671,109.861,7.04,0.755,4
189,77,0,3135,0,58,8936,573793,59.26,69799978,135.132,40.1,11.373,16277.671,109.861,7.04,0.755,4
189,78,0,3135,0,58,8002,581795,59.26,69799978,135.132,40.1,11.373,16277.671,109.861,7.04,0.755,4
189,79,6,3141,0,58,8137,589932,59.26,69799978,135.132,40.1,11.373,16277.671,109.861,7.04,0.755,4
189,80,0,3141,0,58,6891,596823,59.26,69799978,135.132,40.1,11.373,16277.671,109.861,7.04,0.755,4
189,81,5,3146,0,58,3943,600766,59.26,69799978,135.132,40.1,11.373,16277.671,109.861,7.04,0.755,4
189,82,1,3147,0,58,3605,604371,59.26,69799978,135.132,40.1,11.373,16277.671,109.861,7.04,0.755,4
189,83,1,3148,0,58,6205,610576,59.26,69799978,135.132,40.1,11.373,16277.671,109.861,7.04,0.755,4
189,84,3,3151,0,58,5779,616355,59.26,69799978,135.132,40.1,11.373,16277.671,109.861,7.04,0.755,4
189,85,5,3156,0,58,5263,621618,59.26,69799978,135.132,40.1,11.373,16277.671,109.861,7.04,0.755,4
189,86,2,3158,0,58,6671,628289,59.26,69799978,135.132,40.1,11.373,16277.671,109.861,7.04,0.755,4
189,87,0,3158,0,58,4320,632609,59.26,69799978,135.132,40.1,11.373,16277.671,109.861,7.04,0.755,4
189,88,4,3162,0,58,3543,636152,59.26,69799978,135.132,40.1,11.373,16277.671,109.861,7.04,0.755,4
189,89,0,3162,0,58,2547,638699,59.26,69799978,135.132,40.1,11.373,16277.671,109.861,7.04,0.755,4
189,90,0,3162,0,58,6437,645136,59.26,69799978,135.132,40.1,11.373,16277.671,109.861,7.04,0.755,4
189,91,9,3171,0,58,5259,650395,59.26,69799978,135.132,40.1,11.373,16277.671,109.861,7.04,0.755,4
189,92,2,3173,0,58,4380,654775,49.07,69799978,135.132,40.1,11.373,16277.671,109.861,7.04,0.755,4
189,93,6,3179,0,58,4645,659420,49.07,69799978,135.132,40.1,11.373,16277.671,109.861,7.04,0.755,4
189,94,1,3180,0,58,4255,663675,49.07,69799978,135.132,40.1,11.373,16277.671,109.861,7.04,0.755,4
189,95,5,3185,0,58,2406,666081,49.07,69799978,135.132,40.1,11.373,16277.671,109.861,7.04,0.755,4
189,96,5,3190,0,58,2529,668610,49.07,69799978,135.132,40.1,11.373,16277.671,109.861,7.04,0.755,4
189,97,5,3195,0,58,3114,671724,49.07,69799978,135.132,40.1,11.373,16277.671,109.861,7.04,0.755,4
189,98,0,3195,0,58,3000,674724,49.07,69799978,135.132,40.1,11.373,16277.671,109.861,7.04,0.755,4
189,99,2,3197,0,58,3515,678239,49.07,69799978,135.132,40.1,11.373,16277.671,109.861,7.04,0.755,4
189,100,5,3202,0,58,4335,682574,49.07,69799978,135.132,40.1,11.373,16277.671,109.861,7.04,0.755,4
189,101,0,3202,0,58,5076,687650,49.07,69799978,135.132,40.1,11.373,16277.671,109.861,7.04,0.755,4
189,102,14,3216,0,58,3317,690967,49.07,69799978,135.132,40.1,11.373,16277.671,109.861,7.04,0.755,4
189,103,1,3217,0,58,2813,693780,49.07,69799978,135.132,40.1,11.373,16277.671,109.861,7.04,0.755,4
189,104,3,3220,0,58,4121,697901,49.07,69799978,135.132,40.1,11.373,16277.671,109.861,7.04,0.755,4
189,105,7,3227,0,58,6127,704028,49.07,69799978,135.132,40.1,11.373,16277.671,109.861,7.04,0.755,4
189,106,5,3232,0,58,5387,709415,49.07,69799978,135.132,40.1,11.373,16277.671,109.861,7.04,0.755,4
189,107,4,3236,0,58,8355,717770,49.07,69799978,135.132,40.1,11.373,16277.671,109.861,7.04,0.755,4
189,108,3,3239,0,58,6028,723798,49.07,69799978,135.132,40.1,11.373,16277.671,109.861,7.04,0.755,4
189,109,7,3246,0,58,4881,728679,49.07,69799978,135.132,40.1,11.373,16277.671,109.861,7.04,0.755,4
189,110,3,3249,0,58,3320,731999,49.07,69799978,135.132,40.1,11.373,16277.671,109.861,7.04,0.755,4
189,111,1,3250,0,58,4730,736729,49.07,69799978,135.132,40.1,11.373,16277.671,109.861,7.04,0.755,4
189,112,5,3255,0,58,4473,741202,49.07,69799978,135.132,40.1,11.373,16277.671,109.861,7.04,0.755,4
189,113,6,3261,0,58,6655,747857,49.07,69799978,135.132,40.1,11.373,16277.671,109.861,7.04,0.755,4
189,114,8,3269,0,58,5778,753635,49.07,69799978,135.132,40.1,11.373,16277.671,109.861,7.04,0.755,4
189,115,10,3279,0,58,5772,759407,49.07,69799978,135.132,40.1,11.373,16277.671,109.861,7.04,0.755,4
189,116,3,3282,0,58,3897,763304,49.07,69799978,135.132,40.1,11.373,16277.671,109.861,7.04,0.755,4
189,117,9,3291,0,58,2962,766266,49.07,69799978,135.132,40.1,11.373,16277.671,109.861,7.04,0.755,4
189,118,4,3295,0,58,4326,770592,49.07,69799978,135.132,40.1,11.373,16277.671,109.861,7.04,0.755,4
189,119,2,3297,0,58,4624,775216,49.07,69799978,135.132,40.1,11.373,16277.671,109.861,7.04,0.755,4
189,120,1,3298,0,58,5658,780874,49.07,69799978,135.132,40.1,11.373,16277.671,109.861,7.04,0.755,4
189,121,6,3304,0,58,6915,787789,49.07,69799978,135.132,40.1,11.373,16277.671,109.861,7.04,0.755,4
189,122,6,3310,0,58,5029,792818,49.07,69799978,135.132,40.1,11.373,16277.671,109.861,7.04,0.755,4
189,123,2,3312,0,58,3685,796503,49.07,69799978,135.132,40.1,11.373,16277.671,109.861,7.04,0.755,4
189,124,5,3317,0,58,3188,799691,49.07,69799978,135.132,40.1,11.373,16277.671,109.861,7.04,0.755,4
189,125,3,3320,0,58,3707,803398,49.07,69799978,135.132,40.1,11.373,16277.671,109.861,7.04,0.755,4
189,126,1,3321,0,58,3968,807366,49.07,69799978,135.132,40.1,11.373,16277.671,109.861,7.04,0.755,4
189,127,7,3328,0,58,4599,811965,49.07,69799978,135.132,40.1,11.373,16277.671,109.861,7.04,0.755,4
189,128,2,3330,0,58,3990,815955,49.07,69799978,135.132,40.1,11.373,16277.671,109.861,7.04,0.755,4
189,129,15,3345,0,58,4540,820495,49.07,69799978,135.132,40.1,11.373,16277.671,109.861,7.04,0.755,4
189,130,3,3348,0,58,4379,824874,49.07,69799978,135.132,40.1,11.373,16277.671,109.861,7.04,0.755,4
189,131,3,3351,0,58,3552,828426,49.07,69799978,135.132,40.1,11.373,16277.671,109.861,7.04,0.755,4
189,132,0,3351,0,58,3556,831982,49.07,69799978,135.132,40.1,11.373,16277.671,109.861,7.04,0.755,4
189,133,0,3351,0,58,4136,836118,49.07,69799978,135.132,40.1,11.373,16277.671,109.861,7.04,0.755,4
189,134,5,3356,0,58,4003,840121,49.07,69799978,135.132,40.1,11.373,16277.671,109.861,7.04,0.755,4
189,135,0,3356,0,58,4034,844155,49.07,69799978,135.132,40.1,11.373,16277.671,109.861,7.04,0.755,4
189,136,20,3376,0,58,3244,847399,46.3,69799978,135.132,40.1,11.373,16277.671,109.861,7.04,0.755,4
189,137,0,3376,0,58,3356,850755,46.3,69799978,135.132,40.1,11.373,16277.671,109.861,7.04,0.755,4
189,138,1,3377,0,58,3072,853827,46.3,69799978,135.132,40.1,11.373,16277.671,109.861,7.04,0.755,4
189,139,1,3378,0,58,4262,858089,46.3,69799978,135.132,40.1,11.373,16277.671,109.861,7.04,0.755,4
189,140,0,3378,0,58,4200,862289,46.3,69799978,135.132,40.1,11.373,16277.671,109.861,7.04,0.755,4
189,141,4,3382,0,58,6208,868497,46.3,69799978,135.132,40.1,11.373,16277.671,109.861,7.04,0.755,4
189,142,7,3389,0,58,5473,873970,46.3,69799978,135.132,40.1,11.373,16277.671,109.861,7.04,0.755,4
189,143,1,3390,0,58,4297,878267,46.3,69799978,135.132,40.1,11.373,16277.671,109.861,7.04,0.755,4
189,144,0,3390,0,58,3568,881835,46.3,69799978,135.132,40.1,11.373,16277.671,109.861,7.04,0.755,4
189,145,5,3395,0,58,2666,884501,46.3,69799978,135.132,40.1,11.373,16277.671,109.861,7.04,0.755,4
189,146,2,3397,0,58,5347,889848,46.3,69799978,135.132,40.1,11.373,16277.671,109.861,7.04,0.755,4
189,147,5,3402,0,58,3688,893536,46.3,69799978,135.132,40.1,11.373,16277.671,109.861,7.04,0.755,4
189,148,1,3403,0,58,5209,898745,46.3,69799978,135.132,40.1,11.373,16277.671,109.861,7.04,0.755,4
189,149,1,3404,0,58,4866,903611,46.3,69799978,135.132,40.1,11.373,16277.671,109.861,7.04,0.755,4
189,150,6,3410,0,58,4755,908366,46.3,69799978,135.132,40.1,11.373,16277.671,109.861,7.04,0.755,4
189,151,1,3411,0,58,3560,911926,46.3,69799978,135.132,40.1,11.373,16277.671,109.861,7.04,0.755,4
189,152,0,3411,0,58,3684,915610,46.3,69799978,135.132,40.1,11.373,16277.671,109.861,7.04,0.755,4
189,153,1,3412,0,58,4988,920598,46.3,69799978,135.132,40.1,11.373,16277.671,109.861,7.04,0.755,4
189,154,5,3417,0,58,4220,924818,46.3,69799978,135.132,40.1,11.373,16277.671,109.861,7.04,0.755,4
189,155,8,3425,0,58,3821,928639,46.3,69799978,135.132,40.1,11.373,16277.671,109.861,7.04,0.755,4
189,156,2,3427,0,58,4687,933326,46.3,69799978,135.132,40.1,11.373,16277.671,109.861,7.04,0.755,4
189,157,4,3431,0,58,4562,937888,46.3,69799978,135.132,40.1,11.373,16277.671,109.861,7.04,0.755,4
189,158,0,3431,0,58,2903,940791,46.3,69799978,135.132,40.1,11.373,16277.671,109.861,7.04,0.755,4
189,159,13,3444,0,58,3458,944249,46.3,69799978,135.132,40.1,11.373,16277.671,109.861,7.04,0.755,4
189,160,1,3445,0,58,4737,948986,40.74,69799978,135.132,40.1,11.373,16277.671,109.861,7.04,0.755,4
189,161,1,3446,0,58,6175,955161,40.74,69799978,135.132,40.1,11.373,16277.671,109.861,7.04,0.755,4
189,162,1,3447,0,58,5363,960524,40.74,69799978,135.132,40.1,11.373,16277.671,109.861,7.04,0.755,4
189,163,7,3454,0,58,4987,965511,40.74,69799978,135.132,40.1,11.373,16277.671,109.861,7.04,0.755,4
189,164,7,3461,0,58,5010,970521,40.74,69799978,135.132,40.1,11.373,16277.671,109.861,7.04,0.755,4
189,165,5,3466,0,58,5008,975529,40.74,69799978,135.132,40.1,11.373,16277.671,109.861,7.04,0.755,4
189,166,7,3473,0,58,2985,978514,40.74,69799978,135.132,40.1,11.373,16277.671,109.861,7.04,0.755,4
189,167,2,3475,0,58,4381,982895,40.74,69799978,135.132,40.1,11.373,16277.671,109.861,7.04,0.755,4
189,168,5,3480,0,58,4100,986995,40.74,69799978,135.132,40.1,11.373,16277.671,109.861,7.04,0.755,4
189,169,10,3490,0,58,4235,991230,40.74,69799978,135.132,40.1,11.373,16277.671,109.861,7.04,0.755,4
189,170,0,3490,0,58,4027,995257,40.74,69799978,135.132,40.1,11.373,16277.671,109.861,7.04,0.755,4
189,171,7,3497,0,58,4360,999617,40.74,69799978,135.132,40.1,11.373,16277.671,109.861,7.04,0.755,4
189,172,3,3500,1,59,3002,1002619,40.74,69799978,135.132,40.1,11.373,16277.671,109.861,7.04,0.755,4
189,173,6,3506,0,59,3137,1005756,40.74,69799978,135.132,40.1,11.373,16277.671,109.861,7.04,0.755,4
189,174,0,3506,0,59,5208,1010964,40.74,69799978,135.132,40.1,11.373,16277.671,109.861,7.04,0.755,4
189,175,5,3511,0,59,5520,1016484,43.52,69799978,135.132,40.1,11.373,16277.671,109.861,7.04,0.755,4
189,176,3,3514,0,59,4600,1021084,43.52,69799978,135.132,40.1,11.373,16277.671,109.861,7.04,0.755,4
189,177,2,3516,0,59,4679,1025763,43.52,69799978,135.132,40.1,11.373,16277.671,109.861,7.04,0.755,4
189,178,3,3519,0,59,4490,1030253,43.52,69799978,135.132,40.1,11.373,16277.671,109.861,7.04,0.755,4
189,179,3,3522,0,59,4099,1034352,43.52,69799978,135.132,40.1,11.373,16277.671,109.861,7.04,0.755,4
189,180,1,3523,0,59,3767,1038119,43.52,69799978,135.132,40.1,11.373,16277.671,109.861,7.04,0.755,4
189,181,22,3545,0,59,4895,1043014,43.52,69799978,135.132,40.1,11.373,16277.671,109.861,7.04,0.755,4
189,182,14,3559,0,59,5361,1048375,43.52,69799978,135.132,40.1,11.373,16277.671,109.861,7.04,0.755,4
189,183,5,3564,0,59,4990,1053365,43.52,69799978,135.132,40.1,11.373,16277.671,109.861,7.04,0.755,4
189,184,5,3569,0,59,4341,1057706,43.52,69799978,135.132,40.1,11.373,16277.671,109.861,7.04,0.755,4
189,185,6,3575,0,59,4097,1061803,43.52,69799978,135.132,40.1,11.373,16277.671,109.861,7.04,0.755,4
189,186,8,3583,0,59,3126,1064929,43.52,69799978,135.132,40.1,11.373,16277.671,109.861,7.04,0.755,4
189,187,0,3583,0,59,3757,1068686,43.52,69799978,135.132,40.1,11.373,16277.671,109.861,7.04,0.755,4
189,188,7,3590,0,59,3949,1072635,43.52,69799978,135.132,40.1,11.373,16277.671,109.861,7.04,0.755,4
189,189,10,3600,0,59,3697,1076332,43.52,69799978,135.132,40.1,11.373,16277.671,109.861,7.04,0.755,4
189,190,15,3615,0,59,3990,1080322,43.52,69799978,135.132,40.1,11.373,16277.671,109.861,7.04,0.755,4
189,191,7,3622,0,59,4370,1084692,43.52,69799978,135.132,40.1,11.373,16277.671,109.861,7.04,0.755,4
189,192,6,3628,0,59,5688,1090380,43.52,69799978,135.132,40.1,11.373,16277.671,109.861,7.04,0.755,4
189,193,6,3634,0,59,0,1090380,43.52,69799978,135.132,40.1,11.373,16277.671,109.861,7.04,0.755,4
189,194,0,3634,0,59,0,1090380,43.52,69799978,135.132,40.1,11.373,16277.671,109.861,7.04,0.755,4
189,195,7,3641,0,59,0,1090380,43.52,69799978,135.132,40.1,11.373,16277.671,109.861,7.04,0.755,4
189,196,2,3643,0,59,0,1090380,43.52,69799978,135.132,40.1,11.373,16277.671,109.861,7.04,0.755,4
189,197,9,3652,0,59,0,1090380,43.52,69799978,135.132,40.1,11.373,16277.671,109.861,7.04,0.755,4
189,198,13,3665,0,59,0,1090380,43.52,69799978,135.132,40.1,11.373,16277.671,109.861,7.04,0.755,4
189,199,4,3669,0,59,0,1090380,43.52,69799978,135.132,40.1,11.373,16277.671,109.861,7.04,0.755,4
189,200,10,3679,0,59,0,1090380,43.52,69799978,135.132,40.1,11.373,16277.671,109.861,7.04,0.755,4
189,201,7,3686,0,59,0,1090380,43.52,69799978,135.132,40.1,11.373,16277.671,109.861,7.04,0.755,4
189,202,5,3691,0,59,0,1090380,43.52,69799978,135.132,40.1,11.373,16277.671,109.861,7.04,0.755,4
189,203,9,3700,0,59,0,1090380,43.52,69799978,135.132,40.1,11.373,16277.671,109.861,7.04,0.755,4
189,204,9,3709,0,59,0,1090380,43.52,69799978,135.132,40.1,11.373,16277.671,109.861,7.04,0.755,4
190,1,0,1,0,0,0,0,75,1318442,87.176,18,3.556,6570.102,335.346,6.86,0.625,0
190,2,0,1,0,0,0,0,75,1318442,87.176,18,3.556,6570.102,335.346,6.86,0.625,0
190,3,0,1,0,0,0,0,75,1318442,87.176,18,3.556,6570.102,335.346,6.86,0.625,0
190,4,0,1,0,0,0,0,75,1318442,87.176,18,3.556,6570.102,335.346,6.86,0.625,0
190,5,0,1,0,0,0,0,75,1318442,87.176,18,3.556,6570.102,335.346,6.86,0.625,0
190,6,0,1,0,0,0,0,75,1318442,87.176,18,3.556,6570.102,335.346,6.86,0.625,0
190,7,0,1,0,0,0,0,75,1318442,87.176,18,3.556,6570.102,335.346,6.86,0.625,0
190,8,0,1,0,0,0,0,75,1318442,87.176,18,3.556,6570.102,335.346,6.86,0.625,0
190,9,0,1,0,0,0,0,75,1318442,87.176,18,3.556,6570.102,335.346,6.86,0.625,0
190,10,1,2,0,0,0,0,75,1318442,87.176,18,3.556,6570.102,335.346,6.86,0.625,0
190,11,0,2,0,0,0,0,75,1318442,87.176,18,3.556,6570.102,335.346,6.86,0.625,0
190,12,0,2,0,0,0,0,75,1318442,87.176,18,3.556,6570.102,335.346,6.86,0.625,0
190,13,0,2,0,0,0,0,77.78,1318442,87.176,18,3.556,6570.102,335.346,6.86,0.625,0
190,14,2,4,0,0,0,0,77.78,1318442,87.176,18,3.556,6570.102,335.346,6.86,0.625,0
190,15,2,6,0,0,0,0,77.78,1318442,87.176,18,3.556,6570.102,335.346,6.86,0.625,0
190,16,0,6,0,0,0,0,77.78,1318442,87.176,18,3.556,6570.102,335.346,6.86,0.625,0
190,17,12,18,0,0,0,0,77.78,1318442,87.176,18,3.556,6570.102,335.346,6.86,0.625,0
190,18,0,18,0,0,0,0,77.78,1318442,87.176,18,3.556,6570.102,335.346,6.86,0.625,0
190,19,0,18,0,0,0,0,77.78,1318442,87.176,18,3.556,6570.102,335.346,6.86,0.625,0
190,20,1,19,0,0,0,0,77.78,1318442,87.176,18,3.556,6570.102,335.346,6.86,0.625,0
190,21,3,22,0,0,0,0,77.78,1318442,87.176,18,3.556,6570.102,335.346,6.86,0.625,0
190,22,1,23,0,0,0,0,77.78,1318442,87.176,18,3.556,6570.102,335.346,6.86,0.625,0
190,23,0,23,0,0,0,0,77.78,1318442,87.176,18,3.556,6570.102,335.346,6.86,0.625,0
190,24,0,23,0,0,0,0,77.78,1318442,87.176,18,3.556,6570.102,335.346,6.86,0.625,0
190,25,1,24,0,0,0,0,77.78,1318442,87.176,18,3.556,6570.102,335.346,6.86,0.625,0
190,26,0,24,0,0,0,0,77.78,1318442,87.176,18,3.556,6570.102,335.346,6.86,0.625,0
190,27,0,24,0,0,0,0,77.78,1318442,87.176,18,3.556,6570.102,335.346,6.86,0.625,0
190,28,0,24,0,0,0,0,77.78,1318442,87.176,18,3.556,6570.102,335.346,6.86,0.625,0
190,29,0,24,0,0,0,0,77.78,1318442,87.176,18,3.556,6570.102,335.346,6.86,0.625,0
190,30,0,24,0,0,0,0,66.67,1318442,87.176,18,3.556,6570.102,335.346,6.86,0.625,0
190,31,0,24,0,0,0,0,66.67,1318442,87.176,18,3.556,6570.102,335.346,6.86,0.625,0
190,32,0,24,0,0,0,0,66.67,1318442,87.176,18,3.556,6570.102,335.346,6.86,0.625,0
190,33,0,24,0,0,0,0,66.67,1318442,87.176,18,3.556,6570.102,335.346,6.86,0.625,0
190,34,0,24,0,0,0,0,66.67,1318442,87.176,18,3.556,6570.102,335.346,6.86,0.625,0
190,35,0,24,0,0,0,0,66.67,1318442,87.176,18,3.556,6570.102,335.346,6.86,0.625,0
190,36,0,24,0,0,0,0,66.67,1318442,87.176,18,3.556,6570.102,335.346,6.86,0.625,0
190,37,0,24,0,0,0,0,66.67,1318442,87.176,18,3.556,6570.102,335.346,6.86,0.625,0
190,38,0,24,0,0,0,0,66.67,1318442,87.176,18,3.556,6570.102,335.346,6.86,0.625,0
190,39,0,24,0,0,0,0,66.67,1318442,87.176,18,3.556,6570.102,335.346,6.86,0.625,0
190,40,0,24,0,0,0,0,66.67,1318442,87.176,18,3.556,6570.102,335.346,6.86,0.625,0
190,41,0,24,0,0,0,0,66.67,1318442,87.176,18,3.556,6570.102,335.346,6.86,0.625,0
190,42,0,24,0,0,0,0,66.67,1318442,87.176,18,3.556,6570.102,335.346,6.86,0.625,0
190,43,0,24,0,0,0,0,66.67,1318442,87.176,18,3.556,6570.102,335.346,6.86,0.625,0
190,44,0,24,0,0,0,0,66.67,1318442,87.176,18,3.556,6570.102,335.346,6.86,0.625,0
190,45,0,24,0,0,0,0,66.67,1318442,87.176,18,3.556,6570.102,335.346,6.86,0.625,0
190,46,0,24,0,0,0,0,66.67,1318442,87.176,18,3.556,6570.102,335.346,6.86,0.625,0
190,47,0,24,0,0,0,0,66.67,1318442,87.176,18,3.556,6570.102,335.346,6.86,0.625,0
190,48,0,24,0,0,0,0,66.67,1318442,87.176,18,3.556,6570.102,335.346,6.86,0.625,0
190,49,0,24,0,0,0,0,66.67,1318442,87.176,18,3.556,6570.102,335.346,6.86,0.625,0
190,50,0,24,0,0,0,0,66.67,1318442,87.176,18,3.556,6570.102,335.346,6.86,0.625,0
190,51,0,24,0,0,0,0,66.67,1318442,87.176,18,3.556,6570.102,335.346,6.86,0.625,0
190,52,0,24,0,0,0,0,66.67,1318442,87.176,18,3.556,6570.102,335.346,6.86,0.625,0
190,53,0,24,0,0,0,0,66.67,1318442,87.176,18,3.556,6570.102,335.346,6.86,0.625,0
190,54,0,24,0,0,0,0,66.67,1318442,87.176,18,3.556,6570.102,335.346,6.86,0.625,0
190,55,0,24,0,0,0,0,66.67,1318442,87.176,18,3.556,6570.102,335.346,6.86,0.625,0
190,56,0,24,0,0,0,0,66.67,1318442,87.176,18,3.556,6570.102,335.346,6.86,0.625,0
190,57,0,24,0,0,0,0,33.33,1318442,87.176,18,3.556,6570.102,335.346,6.86,0.625,0
190,58,0,24,0,0,0,0,33.33,1318442,87.176,18,3.556,6570.102,335.346,6.86,0.625,0
190,59,0,24,0,0,0,0,33.33,1318442,87.176,18,3.556,6570.102,335.346,6.86,0.625,0
190,60,0,24,0,0,0,0,33.33,1318442,87.176,18,3.556,6570.102,335.346,6.86,0.625,0
190,61,0,24,0,0,0,0,33.33,1318442,87.176,18,3.556,6570.102,335.346,6.86,0.625,0
190,62,0,24,0,0,0,0,33.33,1318442,87.176,18,3.556,6570.102,335.346,6.86,0.625,0
190,63,0,24,0,0,0,0,33.33,1318442,87.176,18,3.556,6570.102,335.346,6.86,0.625,0
190,64,0,24,0,0,0,0,33.33,1318442,87.176,18,3.556,6570.102,335.346,6.86,0.625,0
190,65,0,24,0,0,0,0,33.33,1318442,87.176,18,3.556,6570.102,335.346,6.86,0.625,0
190,66,0,24,0,0,0,0,33.33,1318442,87.176,18,3.556,6570.102,335.346,6.86,0.625,0
190,67,0,24,0,0,0,0,33.33,1318442,87.176,18,3.556,6570.102,335.346,6.86,0.625,0
190,68,0,24,0,0,0,0,33.33,1318442,87.176,18,3.556,6570.102,335.346,6.86,0.625,0
190,69,0,24,0,0,0,0,33.33,1318442,87.176,18,3.556,6570.102,335.346,6.86,0.625,0
190,70,0,24,0,0,0,0,33.33,1318442,87.176,18,3.556,6570.102,335.346,6.86,0.625,0
190,71,0,24,0,0,0,0,33.33,1318442,87.176,18,3.556,6570.102,335.346,6.86,0.625,0
190,72,0,24,0,0,0,0,33.33,1318442,87.176,18,3.556,6570.102,335.346,6.86,0.625,0
190,73,0,24,0,0,0,0,33.33,1318442,87.176,18,3.556,6570.102,335.346,6.86,0.625,0
190,74,0,24,0,0,0,0,33.33,1318442,87.176,18,3.556,6570.102,335.346,6.86,0.625,0
190,75,0,24,0,0,0,0,33.33,1318442,87.176,18,3.556,6570.102,335.346,6.86,0.625,0
190,76,0,24,0,0,0,0,33.33,1318442,87.176,18,3.556,6570.102,335.346,6.86,0.625,0
190,77,0,24,0,0,0,0,33.33,1318442,87.176,18,3.556,6570.102,335.346,6.86,0.625,0
190,78,0,24,0,0,0,0,33.33,1318442,87.176,18,3.556,6570.102,335.346,6.86,0.625,0
190,79,0,24,0,0,0,0,33.33,1318442,87.176,18,3.556,6570.102,335.346,6.86,0.625,0
190,80,0,24,0,0,0,0,33.33,1318442,87.176,18,3.556,6570.102,335.346,6.86,0.625,0
190,81,0,24,0,0,0,0,33.33,1318442,87.176,18,3.556,6570.102,335.346,6.86,0.625,0
190,82,0,24,0,0,0,0,33.33,1318442,87.176,18,3.556,6570.102,335.346,6.86,0.625,0
190,83,0,24,0,0,0,0,33.33,1318442,87.176,18,3.556,6570.102,335.346,6.86,0.625,0
190,84,0,24,0,0,0,0,33.33,1318442,87.176,18,3.556,6570.102,335.346,6.86,0.625,0
190,85,0,24,0,0,0,0,33.33,1318442,87.176,18,3.556,6570.102,335.346,6.86,0.625,0
190,86,0,24,0,0,0,0,33.33,1318442,87.176,18,3.556,6570.102,335.346,6.86,0.625,0
190,87,0,24,0,0,0,0,29.63,1318442,87.176,18,3.556,6570.102,335.346,6.86,0.625,0
190,88,0,24,0,0,0,0,29.63,1318442,87.176,18,3.556,6570.102,335.346,6.86,0.625,0
190,89,0,24,0,0,0,0,29.63,1318442,87.176,18,3.556,6570.102,335.346,6.86,0.625,0
190,90,0,24,0,0,0,0,29.63,1318442,87.176,18,3.556,6570.102,335.346,6.86,0.625,0
190,91,0,24,0,0,0,0,29.63,1318442,87.176,18,3.556,6570.102,335.346,6.86,0.625,0
190,92,0,24,0,0,0,0,29.63,1318442,87.176,18,3.556,6570.102,335.346,6.86,0.625,0
190,93,0,24,0,0,0,0,29.63,1318442,87.176,18,3.556,6570.102,335.346,6.86,0.625,0
190,94,0,24,0,0,0,0,29.63,1318442,87.176,18,3.556,6570.102,335.346,6.86,0.625,0
190,95,0,24,0,0,0,0,29.63,1318442,87.176,18,3.556,6570.102,335.346,6.86,0.625,0
190,96,0,24,0,0,0,0,29.63,1318442,87.176,18,3.556,6570.102,335.346,6.86,0.625,0
190,97,0,24,0,0,0,0,29.63,1318442,87.176,18,3.556,6570.102,335.346,6.86,0.625,0
190,98,0,24,0,0,0,0,29.63,1318442,87.176,18,3.556,6570.102,335.346,6.86,0.625,0
190,99,0,24,0,0,0,0,29.63,1318442,87.176,18,3.556,6570.102,335.346,6.86,0.625,0
190,100,0,24,0,0,0,0,29.63,1318442,87.176,18,3.556,6570.102,335.346,6.86,0.625,0
190,101,0,24,0,0,0,0,29.63,1318442,87.176,18,3.556,6570.102,335.346,6.86,0.625,0
190,102,0,24,0,0,0,0,29.63,1318442,87.176,18,3.556,6570.102,335.346,6.86,0.625,0
190,103,0,24,0,0,0,0,29.63,1318442,87.176,18,3.556,6570.102,335.346,6.86,0.625,0
190,104,0,24,0,0,0,0,29.63,1318442,87.176,18,3.556,6570.102,335.346,6.86,0.625,0
190,105,0,24,0,0,0,0,29.63,1318442,87.176,18,3.556,6570.102,335.346,6.86,0.625,0
190,106,0,24,0,0,0,0,29.63,1318442,87.176,18,3.556,6570.102,335.346,6.86,0.625,0
190,107,0,24,0,0,0,0,29.63,1318442,87.176,18,3.556,6570.102,335.346,6.86,0.625,0
190,108,0,24,0,0,0,0,29.63,1318442,87.176,18,3.556,6570.102,335.346,6.86,0.625,0
190,109,0,24,0,0,0,0,29.63,1318442,87.176,18,3.556,6570.102,335.346,6.86,0.625,0
190,110,0,24,0,0,0,0,29.63,1318442,87.176,18,3.556,6570.102,335.346,6.86,0.625,0
190,111,0,24,0,0,0,0,29.63,1318442,87.176,18,3.556,6570.102,335.346,6.86,0.625,0
190,112,0,24,0,0,0,0,29.63,1318442,87.176,18,3.556,6570.102,335.346,6.86,0.625,0
190,113,0,24,0,0,0,0,29.63,1318442,87.176,18,3.556,6570.102,335.346,6.86,0.625,0
190,114,0,24,0,0,0,0,29.63,1318442,87.176,18,3.556,6570.102,335.346,6.86,0.625,0
190,115,0,24,0,0,0,0,29.63,1318442,87.176,18,3.556,6570.102,335.346,6.86,0.625,0
190,116,0,24,0,0,0,0,29.63,1318442,87.176,18,3.556,6570.102,335.346,6.86,0.625,0
190,117,0,24,0,0,0,0,29.63,1318442,87.176,18,3.556,6570.102,335.346,6.86,0.625,0
190,118,0,24,0,0,0,0,29.63,1318442,87.176,18,3.556,6570.102,335.346,6.86,0.625,0
190,119,0,24,0,0,0,0,29.63,1318442,87.176,18,3.556,6570.102,335.346,6.86,0.625,0
190,120,0,24,0,0,0,0,29.63,1318442,87.176,18,3.556,6570.102,335.346,6.86,0.625,0
190,121,0,24,0,0,0,0,29.63,1318442,87.176,18,3.556,6570.102,335.346,6.86,0.625,0
190,122,0,24,0,0,0,0,29.63,1318442,87.176,18,3.556,6570.102,335.346,6.86,0.625,0
190,123,0,24,0,0,0,0,29.63,1318442,87.176,18,3.556,6570.102,335.346,6.86,0.625,0
190,124,0,24,0,0,0,0,29.63,1318442,87.176,18,3.556,6570.102,335.346,6.86,0.625,0
190,125,0,24,0,0,0,0,29.63,1318442,87.176,18,3.556,6570.102,335.346,6.86,0.625,0
190,126,0,24,0,0,0,0,29.63,1318442,87.176,18,3.556,6570.102,335.346,6.86,0.625,0
190,127,1,25,0,0,0,0,29.63,1318442,87.176,18,3.556,6570.102,335.346,6.86,0.625,0
190,128,0,25,0,0,0,0,29.63,1318442,87.176,18,3.556,6570.102,335.346,6.86,0.625,0
190,129,0,25,0,0,0,0,29.63,1318442,87.176,18,3.556,6570.102,335.346,6.86,0.625,0
190,130,0,25,0,0,0,0,29.63,1318442,87.176,18,3.556,6570.102,335.346,6.86,0.625,0
190,131,0,25,0,0,0,0,29.63,1318442,87.176,18,3.556,6570.102,335.346,6.86,0.625,0
190,132,0,25,0,0,0,0,29.63,1318442,87.176,18,3.556,6570.102,335.346,6.86,0.625,0
190,133,0,25,0,0,0,0,29.63,1318442,87.176,18,3.556,6570.102,335.346,6.86,0.625,0
190,134,0,25,0,0,0,0,29.63,1318442,87.176,18,3.556,6570.102,335.346,6.86,0.625,0
190,135,0,25,0,0,0,0,29.63,1318442,87.176,18,3.556,6570.102,335.346,6.86,0.625,0
190,136,0,25,0,0,0,0,29.63,1318442,87.176,18,3.556,6570.102,335.346,6.86,0.625,0
190,137,0,25,0,0,0,0,29.63,1318442,87.176,18,3.556,6570.102,335.346,6.86,0.625,0
190,138,0,25,0,0,0,0,29.63,1318442,87.176,18,3.556,6570.102,335.346,6.86,0.625,0
190,139,0,25,0,0,0,0,29.63,1318442,87.176,18,3.556,6570.102,335.346,6.86,0.625,0
190,140,0,25,0,0,0,0,29.63,1318442,87.176,18,3.556,6570.102,335.346,6.86,0.625,0
190,141,0,25,0,0,0,0,29.63,1318442,87.176,18,3.556,6570.102,335.346,6.86,0.625,0
190,142,0,25,0,0,0,0,29.63,1318442,87.176,18,3.556,6570.102,335.346,6.86,0.625,0
190,143,1,26,0,0,0,0,29.63,1318442,87.176,18,3.556,6570.102,335.346,6.86,0.625,0
190,144,0,26,0,0,0,0,29.63,1318442,87.176,18,3.556,6570.102,335.346,6.86,0.625,0
190,145,0,26,0,0,0,0,29.63,1318442,87.176,18,3.556,6570.102,335.346,6.86,0.625,0
190,146,0,26,0,0,0,0,29.63,1318442,87.176,18,3.556,6570.102,335.346,6.86,0.625,0
190,147,0,26,0,0,0,0,29.63,1318442,87.176,18,3.556,6570.102,335.346,6.86,0.625,0
190,148,0,26,0,0,0,0,29.63,1318442,87.176,18,3.556,6570.102,335.346,6.86,0.625,0
190,149,1,27,0,0,0,0,29.63,1318442,87.176,18,3.556,6570.102,335.346,6.86,0.625,0
190,150,0,27,0,0,0,0,29.63,1318442,87.176,18,3.556,6570.102,335.346,6.86,0.625,0
190,151,0,27,0,0,0,0,29.63,1318442,87.176,18,3.556,6570.102,335.346,6.86,0.625,0
190,152,0,27,0,0,0,0,29.63,1318442,87.176,18,3.556,6570.102,335.346,6.86,0.625,0
190,153,0,27,0,0,0,0,29.63,1318442,87.176,18,3.556,6570.102,335.346,6.86,0.625,0
190,154,0,27,0,0,0,0,29.63,1318442,87.176,18,3.556,6570.102,335.346,6.86,0.625,0
190,155,0,27,0,0,0,0,29.63,1318442,87.176,18,3.556,6570.102,335.346,6.86,0.625,0
190,156,0,27,0,0,0,0,29.63,1318442,87.176,18,3.556,6570.102,335.346,6.86,0.625,0
190,157,0,27,0,0,0,0,29.63,1318442,87.176,18,3.556,6570.102,335.346,6.86,0.625,0
190,158,0,27,0,0,0,0,29.63,1318442,87.176,18,3.556,6570.102,335.346,6.86,0.625,0
190,159,0,27,0,0,0,0,29.63,1318442,87.176,18,3.556,6570.102,335.346,6.86,0.625,0
190,160,0,27,0,0,0,0,29.63,1318442,87.176,18,3.556,6570.102,335.346,6.86,0.625,0
190,161,0,27,0,0,0,0,29.63,1318442,87.176,18,3.556,6570.102,335.346,6.86,0.625,0
190,162,0,27,0,0,0,0,29.63,1318442,87.176,18,3.556,6570.102,335.346,6.86,0.625,0
190,163,0,27,0,0,0,0,29.63,1318442,87.176,18,3.556,6570.102,335.346,6.86,0.625,0
190,164,0,27,0,0,0,0,29.63,1318442,87.176,18,3.556,6570.102,335.346,6.86,0.625,0
190,165,0,27,0,0,0,0,29.63,1318442,87.176,18,3.556,6570.102,335.346,6.86,0.625,0
190,166,0,27,0,0,0,0,29.63,1318442,87.176,18,3.556,6570.102,335.346,6.86,0.625,0
190,167,0,27,0,0,0,0,29.63,1318442,87.176,18,3.556,6570.102,335.346,6.86,0.625,0
190,168,0,27,0,0,0,0,29.63,1318442,87.176,18,3.556,6570.102,335.346,6.86,0.625,0
190,169,0,27,0,0,0,0,29.63,1318442,87.176,18,3.556,6570.102,335.346,6.86,0.625,0
190,170,0,27,0,0,0,0,29.63,1318442,87.176,18,3.556,6570.102,335.346,6.86,0.625,0
190,171,0,27,0,0,0,0,29.63,1318442,87.176,18,3.556,6570.102,335.346,6.86,0.625,0
190,172,0,27,0,0,0,0,29.63,1318442,87.176,18,3.556,6570.102,335.346,6.86,0.625,0
190,173,0,27,0,0,0,0,29.63,1318442,87.176,18,3.556,6570.102,335.346,6.86,0.625,0
190,174,0,27,0,0,0,0,29.63,1318442,87.176,18,3.556,6570.102,335.346,6.86,0.625,0
190,175,0,27,0,0,0,0,29.63,1318442,87.176,18,3.556,6570.102,335.346,6.86,0.625,0
190,176,0,27,0,0,0,0,29.63,1318442,87.176,18,3.556,6570.102,335.346,6.86,0.625,0
190,177,0,27,0,0,0,0,29.63,1318442,87.176,18,3.556,6570.102,335.346,6.86,0.625,0
190,178,0,27,0,0,0,0,29.63,1318442,87.176,18,3.556,6570.102,335.346,6.86,0.625,0
190,179,0,27,0,0,0,0,29.63,1318442,87.176,18,3.556,6570.102,335.346,6.86,0.625,0
190,180,0,27,0,0,0,0,29.63,1318442,87.176,18,3.556,6570.102,335.346,6.86,0.625,0
190,181,0,27,0,0,0,0,29.63,1318442,87.176,18,3.556,6570.102,335.346,6.86,0.625,0
190,182,1,28,0,0,0,0,29.63,1318442,87.176,18,3.556,6570.102,335.346,6.86,0.625,0
190,183,0,28,0,0,0,0,29.63,1318442,87.176,18,3.556,6570.102,335.346,6.86,0.625,0
190,184,0,28,0,0,0,0,29.63,1318442,87.176,18,3.556,6570.102,335.346,6.86,0.625,0
190,185,0,28,0,0,0,0,29.63,1318442,87.176,18,3.556,6570.102,335.346,6.86,0.625,0
190,186,0,28,0,0,0,0,29.63,1318442,87.176,18,3.556,6570.102,335.346,6.86,0.625,0
190,187,0,28,0,0,0,0,29.63,1318442,87.176,18,3.556,6570.102,335.346,6.86,0.625,0
190,188,0,28,0,0,0,0,29.63,1318442,87.176,18,3.556,6570.102,335.346,6.86,0.625,0
190,189,0,28,0,0,0,0,29.63,1318442,87.176,18,3.556,6570.102,335.346,6.86,0.625,0
190,190,0,28,0,0,0,0,29.63,1318442,87.176,18,3.556,6570.102,335.346,6.86,0.625,0
190,191,0,28,0,0,0,0,29.63,1318442,87.176,18,3.556,6570.102,335.346,6.86,0.625,0
190,192,0,28,0,0,0,0,29.63,1318442,87.176,18,3.556,6570.102,335.346,6.86,0.625,0
190,193,0,28,0,0,0,0,29.63,1318442,87.176,18,3.556,6570.102,335.346,6.86,0.625,0
190,194,0,28,0,0,0,0,29.63,1318442,87.176,18,3.556,6570.102,335.346,6.86,0.625,0
190,195,0,28,0,0,0,0,29.63,1318442,87.176,18,3.556,6570.102,335.346,6.86,0.625,0
190,196,1,29,0,0,0,0,29.63,1318442,87.176,18,3.556,6570.102,335.346,6.86,0.625,0
190,197,0,29,0,0,0,0,29.63,1318442,87.176,18,3.556,6570.102,335.346,6.86,0.625,0
190,198,0,29,0,0,0,0,29.63,1318442,87.176,18,3.556,6570.102,335.346,6.86,0.625,0
190,199,0,29,0,0,0,0,29.63,1318442,87.176,18,3.556,6570.102,335.346,6.86,0.625,0
190,200,0,29,0,0,0,0,29.63,1318442,87.176,18,3.556,6570.102,335.346,6.86,0.625,0
190,201,0,29,0,0,0,0,29.63,1318442,87.176,18,3.556,6570.102,335.346,6.86,0.625,0
190,202,0,29,0,0,0,0,29.63,1318442,87.176,18,3.556,6570.102,335.346,6.86,0.625,0
190,203,0,29,0,0,0,0,29.63,1318442,87.176,18,3.556,6570.102,335.346,6.86,0.625,0
190,204,0,29,0,0,0,0,29.63,1318442,87.176,18,3.556,6570.102,335.346,6.86,0.625,0
191,1,0,34,0,1,57,630,69.44,8278737,143.366,19.4,2.839,1429.813,280.033,6.15,0.503,0
191,2,2,36,1,2,94,724,73.15,8278737,143.366,19.4,2.839,1429.813,280.033,6.15,0.503,0
191,3,3,39,0,2,294,1018,73.15,8278737,143.366,19.4,2.839,1429.813,280.033,6.15,0.503,0
191,4,1,40,1,3,149,1167,73.15,8278737,143.366,19.4,2.839,1429.813,280.033,6.15,0.503,0
191,5,1,41,0,3,167,1334,73.15,8278737,143.366,19.4,2.839,1429.813,280.033,6.15,0.503,0
191,6,3,44,0,3,150,1484,73.15,8278737,143.366,19.4,2.839,1429.813,280.033,6.15,0.503,0
191,7,14,58,0,3,150,1634,73.15,8278737,143.366,19.4,2.839,1429.813,280.033,6.15,0.503,0
191,8,7,65,0,3,130,1764,73.15,8278737,143.366,19.4,2.839,1429.813,280.033,6.15,0.503,0
191,9,5,70,0,3,130,1894,73.15,8278737,143.366,19.4,2.839,1429.813,280.033,6.15,0.503,0
191,10,3,73,0,3,192,2086,73.15,8278737,143.366,19.4,2.839,1429.813,280.033,6.15,0.503,0
191,11,3,76,0,3,164,2250,73.15,8278737,143.366,19.4,2.839,1429.813,280.033,6.15,0.503,0
191,12,0,76,0,3,299,2549,73.15,8278737,143.366,19.4,2.839,1429.813,280.033,6.15,0.503,0
191,13,0,76,0,3,207,2756,73.15,8278737,143.366,19.4,2.839,1429.813,280.033,6.15,0.503,0
191,14,1,77,0,3,67,2823,73.15,8278737,143.366,19.4,2.839,1429.813,280.033,6.15,0.503,0
191,15,0,77,0,3,230,3053,73.15,8278737,143.366,19.4,2.839,1429.813,280.033,6.15,0.503,0
191,16,4,81,0,3,582,3635,73.15,8278737,143.366,19.4,2.839,1429.813,280.033,6.15,0.503,0
191,17,0,81,2,5,308,3943,73.15,8278737,143.366,19.4,2.839,1429.813,280.033,6.15,0.503,0
191,18,2,83,0,5,265,4208,73.15,8278737,143.366,19.4,2.839,1429.813,280.033,6.15,0.503,0
191,19,1,84,0,5,104,4312,73.15,8278737,143.366,19.4,2.839,1429.813,280.033,6.15,0.503,0
191,20,0,84,0,5,86,4398,73.15,8278737,143.366,19.4,2.839,1429.813,280.033,6.15,0.503,0
191,21,0,84,1,6,219,4617,73.15,8278737,143.366,19.4,2.839,1429.813,280.033,6.15,0.503,0
191,22,2,86,0,6,133,4750,73.15,8278737,143.366,19.4,2.839,1429.813,280.033,6.15,0.503,0
191,23,2,88,0,6,290,5040,73.15,8278737,143.366,19.4,2.839,1429.813,280.033,6.15,0.503,0
191,24,0,88,0,6,222,5262,73.15,8278737,143.366,19.4,2.839,1429.813,280.033,6.15,0.503,0
191,25,2,90,0,6,339,5601,73.15,8278737,143.366,19.4,2.839,1429.813,280.033,6.15,0.503,0
191,26,6,96,0,6,367,5968,73.15,8278737,143.366,19.4,2.839,1429.813,280.033,6.15,0.503,0
191,27,2,98,0,6,190,6158,73.15,8278737,143.366,19.4,2.839,1429.813,280.033,6.15,0.503,0
191,28,1,99,0,6,93,6251,73.15,8278737,143.366,19.4,2.839,1429.813,280.033,6.15,0.503,0
191,29,0,99,0,6,441,6692,73.15,8278737,143.366,19.4,2.839,1429.813,280.033,6.15,0.503,0
191,30,10,109,1,7,207,6899,73.15,8278737,143.366,19.4,2.839,1429.813,280.033,6.15,0.503,0
191,31,7,116,2,9,218,7117,73.15,8278737,143.366,19.4,2.839,1429.813,280.033,6.15,0.503,0
191,32,7,123,0,9,,7117,73.15,8278737,143.366,19.4,2.839,1429.813,280.033,6.15,0.503,0
191,33,0,123,0,9,325,7442,73.15,8278737,143.366,19.4,2.839,1429.813,280.033,6.15,0.503,0
191,34,1,124,0,9,466,7908,73.15,8278737,143.366,19.4,2.839,1429.813,280.033,6.15,0.503,0
191,35,2,126,0,9,471,8379,73.15,8278737,143.366,19.4,2.839,1429.813,280.033,6.15,0.503,0
191,36,2,128,0,9,473,8852,73.15,8278737,143.366,19.4,2.839,1429.813,280.033,6.15,0.503,0
191,37,0,128,0,9,432,9284,73.15,8278737,143.366,19.4,2.839,1429.813,280.033,6.15,0.503,0
191,38,7,135,0,9,390,9674,73.15,8278737,143.366,19.4,2.839,1429.813,280.033,6.15,0.503,0
191,39,10,145,1,10,437,10111,73.15,8278737,143.366,19.4,2.839,1429.813,280.033,6.15,0.503,0
191,40,8,153,0,10,283,10394,73.15,8278737,143.366,19.4,2.839,1429.813,280.033,6.15,0.503,0
191,41,21,174,1,11,184,10578,73.15,8278737,143.366,19.4,2.839,1429.813,280.033,6.15,0.503,0
191,42,7,181,0,11,480,11058,73.15,8278737,143.366,19.4,2.839,1429.813,280.033,6.15,0.503,0
191,43,18,199,0,11,333,11391,73.15,8278737,143.366,19.4,2.839,1429.813,280.033,6.15,0.503,0
191,44,20,219,0,11,422,11813,73.15,8278737,143.366,19.4,2.839,1429.813,280.033,6.15,0.503,0
191,45,19,238,0,11,244,12057,73.15,8278737,143.366,19.4,2.839,1429.813,280.033,6.15,0.503,0
191,46,25,263,0,11,470,12527,73.15,8278737,143.366,19.4,2.839,1429.813,280.033,6.15,0.503,0
191,47,35,298,0,11,103,12630,73.15,8278737,143.366,19.4,2.839,1429.813,280.033,6.15,0.503,0
191,48,3,301,0,11,839,13469,73.15,8278737,143.366,19.4,2.839,1429.813,280.033,6.15,0.503,0
191,49,29,330,1,12,373,13842,73.15,8278737,143.366,19.4,2.839,1429.813,280.033,6.15,0.503,0
191,50,8,338,0,12,371,14213,73.15,8278737,143.366,19.4,2.839,1429.813,280.033,6.15,0.503,0
191,51,2,340,0,12,571,14784,73.15,8278737,143.366,19.4,2.839,1429.813,280.033,6.15,0.503,0
191,52,14,354,0,12,390,15174,73.15,8278737,143.366,19.4,2.839,1429.813,280.033,6.15,0.503,0
191,53,9,363,0,12,830,16004,73.15,8278737,143.366,19.4,2.839,1429.813,280.033,6.15,0.503,0
191,54,10,373,0,12,760,16764,73.15,8278737,143.366,19.4,2.839,1429.813,280.033,6.15,0.503,0
191,55,8,381,0,12,302,17066,73.15,8278737,143.366,19.4,2.839,1429.813,280.033,6.15,0.503,0
191,56,5,386,1,13,452,17518,73.15,8278737,143.366,19.4,2.839,1429.813,280.033,6.15,0.503,0
191,57,5,391,0,13,528,18046,73.15,8278737,143.366,19.4,2.839,1429.813,280.033,6.15,0.503,0
191,58,4,395,0,13,667,18713,73.15,8278737,143.366,19.4,2.839,1429.813,280.033,6.15,0.503,0
191,59,27,422,0,13,466,19179,73.15,8278737,143.366,19.4,2.839,1429.813,280.033,6.15,0.503,0
191,60,6,428,0,13,543,19722,73.15,8278737,143.366,19.4,2.839,1429.813,280.033,6.15,0.503,0
191,61,5,433,0,13,374,20096,73.15,8278737,143.366,19.4,2.839,1429.813,280.033,6.15,0.503,0
191,62,9,442,0,13,421,20517,73.15,8278737,143.366,19.4,2.839,1429.813,280.033,6.15,0.503,0
191,63,1,443,0,13,448,20965,73.15,8278737,143.366,19.4,2.839,1429.813,280.033,6.15,0.503,0
191,64,2,445,0,13,567,21532,73.15,8278737,143.366,19.4,2.839,1429.813,280.033,6.15,0.503,0
191,65,7,452,0,13,297,21829,73.15,8278737,143.366,19.4,2.839,1429.813,280.033,6.15,0.503,0
191,66,13,465,0,13,344,22173,73.15,8278737,143.366,19.4,2.839,1429.813,280.033,6.15,0.503,0
191,67,20,485,0,13,271,22444,73.15,8278737,143.366,19.4,2.839,1429.813,280.033,6.15,0.503,0
191,68,2,487,0,13,591,23035,73.15,8278737,143.366,19.4,2.839,1429.813,280.033,6.15,0.503,0
191,69,8,495,0,13,237,23272,69.44,8278737,143.366,19.4,2.839,1429.813,280.033,6.15,0.503,0
191,70,2,497,0,13,246,23518,53.7,8278737,143.366,19.4,2.839,1429.813,280.033,6.15,0.503,0
191,71,4,501,0,13,487,24005,53.7,8278737,143.366,19.4,2.839,1429.813,280.033,6.15,0.503,0
191,72,21,522,0,13,370,24375,53.7,8278737,143.366,19.4,2.839,1429.813,280.033,6.15,0.503,0
191,73,2,524,0,13,444,24819,53.7,8278737,143.366,19.4,2.839,1429.813,280.033,6.15,0.503,0
191,74,1,525,0,13,599,25418,53.7,8278737,143.366,19.4,2.839,1429.813,280.033,6.15,0.503,0
191,75,5,530,0,13,125,25543,53.7,8278737,143.366,19.4,2.839,1429.813,280.033,6.15,0.503,0
191,76,1,531,0,13,63,25606,53.7,8278737,143.366,19.4,2.839,1429.813,280.033,6.15,0.503,0
191,77,1,532,0,13,431,26037,53.7,8278737,143.366,19.4,2.839,1429.813,280.033,6.15,0.503,0
191,78,5,537,0,13,424,26461,53.7,8278737,143.366,19.4,2.839,1429.813,280.033,6.15,0.503,0
191,79,7,544,0,13,315,26776,53.7,8278737,143.366,19.4,2.839,1429.813,280.033,6.15,0.503,0
191,80,3,547,0,13,579,27355,53.7,8278737,143.366,19.4,2.839,1429.813,280.033,6.15,0.503,0
191,81,8,555,0,13,486,27841,53.7,8278737,143.366,19.4,2.839,1429.813,280.033,6.15,0.503,0
191,82,6,561,0,13,162,28003,53.7,8278737,143.366,19.4,2.839,1429.813,280.033,6.15,0.503,0
191,83,8,569,0,13,79,28082,53.7,8278737,143.366,19.4,2.839,1429.813,280.033,6.15,0.503,0
191,84,0,569,0,13,444,28526,53.7,8278737,143.366,19.4,2.839,1429.813,280.033,6.15,0.503,0
191,85,7,576,0,13,178,28704,53.7,8278737,143.366,19.4,2.839,1429.813,280.033,6.15,0.503,0
191,86,7,583,1,14,224,28928,53.7,8278737,143.366,19.4,2.839,1429.813,280.033,6.15,0.503,0
191,87,5,588,0,14,436,29364,53.7,8278737,143.366,19.4,2.839,1429.813,280.033,6.15,0.503,0
191,88,3,591,0,14,535,29899,53.7,8278737,143.366,19.4,2.839,1429.813,280.033,6.15,0.503,0
191,89,24,615,0,14,434,30333,53.7,8278737,143.366,19.4,2.839,1429.813,280.033,6.15,0.503,0
191,90,27,642,0,14,41,30374,53.7,8278737,143.366,19.4,2.839,1429.813,280.033,6.15,0.503,0
191,91,1,643,0,14,407,30781,53.7,8278737,143.366,19.4,2.839,1429.813,280.033,6.15,0.503,0
191,92,7,650,0,14,510,31291,53.7,8278737,143.366,19.4,2.839,1429.813,280.033,6.15,0.503,0
191,93,11,661,0,14,710,32001,53.7,8278737,143.366,19.4,2.839,1429.813,280.033,6.15,0.503,0
191,94,6,667,0,14,283,32284,53.7,8278737,143.366,19.4,2.839,1429.813,280.033,6.15,0.503,0
191,95,4,671,0,14,491,32775,53.7,8278737,143.366,19.4,2.839,1429.813,280.033,6.15,0.503,0
191,96,5,676,1,15,141,32916,53.7,8278737,143.366,19.4,2.839,1429.813,280.033,6.15,0.503,0
191,97,4,680,0,15,51,32967,53.7,8278737,143.366,19.4,2.839,1429.813,280.033,6.15,0.503,0
191,98,0,680,0,15,382,33349,53.7,8278737,143.366,19.4,2.839,1429.813,280.033,6.15,0.503,0
191,99,9,689,0,15,261,33610,53.7,8278737,143.366,19.4,2.839,1429.813,280.033,6.15,0.503,0
191,100,6,695,0,15,508,34118,53.7,8278737,143.366,19.4,2.839,1429.813,280.033,6.15,0.503,0
191,101,9,704,0,15,509,34627,53.7,8278737,143.366,19.4,2.839,1429.813,280.033,6.15,0.503,0
191,102,6,710,0,15,546,35173,53.7,8278737,143.366,19.4,2.839,1429.813,280.033,6.15,0.503,0
191,103,8,718,0,15,301,35474,53.7,8278737,143.366,19.4,2.839,1429.813,280.033,6.15,0.503,0
191,104,2,720,0,15,384,35858,53.7,8278737,143.366,19.4,2.839,1429.813,280.033,6.15,0.503,0
191,105,1,721,0,15,436,36294,53.7,8278737,143.366,19.4,2.839,1429.813,280.033,6.15,0.503,0
191,106,10,731,0,15,429,36723,53.7,8278737,143.366,19.4,2.839,1429.813,280.033,6.15,0.503,0
191,107,9,740,0,15,379,37102,53.7,8278737,143.366,19.4,2.839,1429.813,280.033,6.15,0.503,0
191,108,9,749,0,15,302,37404,50.93,8278737,143.366,19.4,2.839,1429.813,280.033,6.15,0.503,0
191,109,0,749,0,15,340,37744,50.93,8278737,143.366,19.4,2.839,1429.813,280.033,6.15,0.503,0
191,110,17,766,0,15,319,38063,50.93,8278737,143.366,19.4,2.839,1429.813,280.033,6.15,0.503,0
191,111,8,774,0,15,103,38166,50.93,8278737,143.366,19.4,2.839,1429.813,280.033,6.15,0.503,0
191,112,9,783,0,15,301,38467,50.93,8278737,143.366,19.4,2.839,1429.813,280.033,6.15,0.503,0
191,113,7,790,0,15,325,38792,50.93,8278737,143.366,19.4,2.839,1429.813,280.033,6.15,0.503,0
191,114,16,806,1,16,581,39373,50.93,8278737,143.366,19.4,2.839,1429.813,280.033,6.15,0.503,0
191,115,22,828,0,16,456,39829,50.93,8278737,143.366,19.4,2.839,1429.813,280.033,6.15,0.503,0
191,116,11,839,1,17,577,40406,50.93,8278737,143.366,19.4,2.839,1429.813,280.033,6.15,0.503,0
191,117,14,853,0,17,374,40780,50.93,8278737,143.366,19.4,2.839,1429.813,280.033,6.15,0.503,0
191,118,15,868,1,18,93,40873,50.93,8278737,143.366,19.4,2.839,1429.813,280.033,6.15,0.503,0
191,119,6,874,0,18,389,41262,50.93,8278737,143.366,19.4,2.839,1429.813,280.033,6.15,0.503,0
191,120,22,896,0,18,412,41674,50.93,8278737,143.366,19.4,2.839,1429.813,280.033,6.15,0.503,0
191,121,0,896,0,18,385,42059,50.93,8278737,143.366,19.4,2.839,1429.813,280.033,6.15,0.503,0
191,122,31,927,0,18,474,42533,50.93,8278737,143.366,19.4,2.839,1429.813,280.033,6.15,0.503,0
191,123,14,941,1,19,410,42943,50.93,8278737,143.366,19.4,2.839,1429.813,280.033,6.15,0.503,0
191,124,17,958,0,19,418,43361,45.37,8278737,143.366,19.4,2.839,1429.813,280.033,6.15,0.503,0
191,125,3,961,0,19,364,43725,45.37,8278737,143.366,19.4,2.839,1429.813,280.033,6.15,0.503,0
191,126,15,976,0,19,829,44554,45.37,8278737,143.366,19.4,2.839,1429.813,280.033,6.15,0.503,0
191,127,12,988,0,19,415,44969,45.37,8278737,143.366,19.4,2.839,1429.813,280.033,6.15,0.503,0
191,128,13,1001,2,21,815,45784,45.37,8278737,143.366,19.4,2.839,1429.813,280.033,6.15,0.503,0
191,129,11,1012,1,22,646,46430,45.37,8278737,143.366,19.4,2.839,1429.813,280.033,6.15,0.503,0
191,130,16,1028,0,22,1062,47492,45.37,8278737,143.366,19.4,2.839,1429.813,280.033,6.15,0.503,0
191,131,18,1046,1,23,583,48075,45.37,8278737,143.366,19.4,2.839,1429.813,280.033,6.15,0.503,0
191,132,14,1060,0,23,373,48448,45.37,8278737,143.366,19.4,2.839,1429.813,280.033,6.15,0.503,0
191,133,7,1067,2,25,959,49407,45.37,8278737,143.366,19.4,2.839,1429.813,280.033,6.15,0.503,0
191,134,3,1070,1,26,828,50235,45.37,8278737,143.366,19.4,2.839,1429.813,280.033,6.15,0.503,0
191,135,22,1092,0,26,666,50901,45.37,8278737,143.366,19.4,2.839,1429.813,280.033,6.15,0.503,0
191,136,12,1104,0,26,639,51540,45.37,8278737,143.366,19.4,2.839,1429.813,280.033,6.15,0.503,0
191,137,20,1124,0,26,763,52303,45.37,8278737,143.366,19.4,2.839,1429.813,280.033,6.15,0.503,0
191,138,6,1130,1,27,731,53034,45.37,8278737,143.366,19.4,2.839,1429.813,280.033,6.15,0.503,0
191,139,17,1147,0,27,458,53492,45.37,8278737,143.366,19.4,2.839,1429.813,280.033,6.15,0.503,0
191,140,7,1154,0,27,769,54261,48.15,8278737,143.366,19.4,2.839,1429.813,280.033,6.15,0.503,0
191,141,19,1173,0,27,862,55123,48.15,8278737,143.366,19.4,2.839,1429.813,280.033,6.15,0.503,0
191,142,17,1190,0,27,635,55758,48.15,8278737,143.366,19.4,2.839,1429.813,280.033,6.15,0.503,0
191,143,22,1212,0,27,686,56444,48.15,8278737,143.366,19.4,2.839,1429.813,280.033,6.15,0.503,0
191,144,27,1239,0,27,967,57411,48.15,8278737,143.366,19.4,2.839,1429.813,280.033,6.15,0.503,0
191,145,36,1275,0,27,656,58067,48.15,8278737,143.366,19.4,2.839,1429.813,280.033,6.15,0.503,0
191,146,2,1277,0,27,1129,59196,48.15,8278737,143.366,19.4,2.839,1429.813,280.033,6.15,0.503,0
191,147,18,1295,0,27,1164,60360,48.15,8278737,143.366,19.4,2.839,1429.813,280.033,6.15,0.503,0
191,148,14,1309,0,27,770,61130,48.15,8278737,143.366,19.4,2.839,1429.813,280.033,6.15,0.503,0
191,149,17,1326,0,27,1008,62138,48.15,8278737,143.366,19.4,2.839,1429.813,280.033,6.15,0.503,0
191,150,0,1326,0,27,992,63130,48.15,8278737,143.366,19.4,2.839,1429.813,280.033,6.15,0.503,0
191,151,39,1365,0,27,979,64109,49.07,8278737,143.366,19.4,2.839,1429.813,280.033,6.15,0.503,0
191,152,25,1390,0,27,587,64696,49.07,8278737,143.366,19.4,2.839,1429.813,280.033,6.15,0.503,0
191,153,6,1396,0,27,501,65197,49.07,8278737,143.366,19.4,2.839,1429.813,280.033,6.15,0.503,0
191,154,4,1400,1,28,961,66158,49.07,8278737,143.366,19.4,2.839,1429.813,280.033,6.15,0.503,0
191,155,16,1416,0,28,938,67096,49.07,8278737,143.366,19.4,2.839,1429.813,280.033,6.15,0.503,0
191,156,18,1434,2,30,705,67801,49.07,8278737,143.366,19.4,2.839,1429.813,280.033,6.15,0.503,0
191,157,9,1443,1,31,796,68597,49.07,8278737,143.366,19.4,2.839,1429.813,280.033,6.15,0.503,0
191,158,14,1457,0,31,1253,69850,49.07,8278737,143.366,19.4,2.839,1429.813,280.033,6.15,0.503,0
191,159,20,1477,1,32,727,70577,49.07,8278737,143.366,19.4,2.839,1429.813,280.033,6.15,0.503,0
191,160,11,1488,0,32,582,71159,49.07,8278737,143.366,19.4,2.839,1429.813,280.033,6.15,0.503,0
191,161,5,1493,1,33,1412,72571,49.07,8278737,143.366,19.4,2.839,1429.813,280.033,6.15,0.503,0
191,162,20,1513,1,34,1001,73572,49.07,8278737,143.366,19.4,2.839,1429.813,280.033,6.15,0.503,0
191,163,15,1528,2,36,940,74512,49.07,8278737,143.366,19.4,2.839,1429.813,280.033,6.15,0.503,0
191,164,9,1537,1,37,984,75496,49.07,8278737,143.366,19.4,2.839,1429.813,280.033,6.15,0.503,0
191,165,11,1548,0,37,1155,76651,49.07,8278737,143.366,19.4,2.839,1429.813,280.033,6.15,0.503,0
191,166,7,1555,0,37,578,77229,49.07,8278737,143.366,19.4,2.839,1429.813,280.033,6.15,0.503,0
191,167,17,1572,0,37,538,77767,49.07,8278737,143.366,19.4,2.839,1429.813,280.033,6.15,0.503,0
191,168,6,1578,3,40,884,78651,49.07,8278737,143.366,19.4,2.839,1429.813,280.033,6.15,0.503,0
191,169,17,1595,0,40,1001,79652,49.07,8278737,143.366,19.4,2.839,1429.813,280.033,6.15,0.503,0
191,170,13,1608,0,40,887,80539,49.07,8278737,143.366,19.4,2.839,1429.813,280.033,6.15,0.503,0
191,171,10,1618,1,41,992,81531,49.07,8278737,143.366,19.4,2.839,1429.813,280.033,6.15,0.503,0
191,172,22,1640,0,41,1097,82628,49.07,8278737,143.366,19.4,2.839,1429.813,280.033,6.15,0.503,0
191,173,19,1659,0,41,502,83130,49.07,8278737,143.366,19.4,2.839,1429.813,280.033,6.15,0.503,0
191,174,7,1666,0,41,515,83645,49.07,8278737,143.366,19.4,2.839,1429.813,280.033,6.15,0.503,0
191,175,3,1669,0,41,995,84640,49.07,8278737,143.366,19.4,2.839,1429.813,280.033,6.15,0.503,0
191,176,14,1683,0,41,799,85439,49.07,8278737,143.366,19.4,2.839,1429.813,280.033,6.15,0.503,0
191,177,18,1701,0,41,790,86229,49.07,8278737,143.366,19.4,2.839,1429.813,280.033,6.15,0.503,0
191,178,6,1707,3,44,946,87175,49.07,8278737,143.366,19.4,2.839,1429.813,280.033,6.15,0.503,0
191,179,15,1722,0,44,1216,88391,49.07,8278737,143.366,19.4,2.839,1429.813,280.033,6.15,0.503,0
191,180,14,1736,2,46,685,89076,49.07,8278737,143.366,19.4,2.839,1429.813,280.033,6.15,0.503,0
191,181,7,1743,0,46,456,89532,49.07,8278737,143.366,19.4,2.839,1429.813,280.033,6.15,0.503,0
191,182,6,1749,1,47,987,90519,47.22,8278737,143.366,19.4,2.839,1429.813,280.033,6.15,0.503,0
191,183,10,1759,1,48,1066,91585,47.22,8278737,143.366,19.4,2.839,1429.813,280.033,6.15,0.503,0
191,184,25,1784,0,48,898,92483,47.22,8278737,143.366,19.4,2.839,1429.813,280.033,6.15,0.503,0
191,185,25,1809,0,48,1818,94301,47.22,8278737,143.366,19.4,2.839,1429.813,280.033,6.15,0.503,0
191,186,9,1818,0,48,1151,95452,47.22,8278737,143.366,19.4,2.839,1429.813,280.033,6.15,0.503,0
191,187,22,1840,0,48,665,96117,47.22,8278737,143.366,19.4,2.839,1429.813,280.033,6.15,0.503,0
191,188,14,1854,0,48,548,96665,47.22,8278737,143.366,19.4,2.839,1429.813,280.033,6.15,0.503,0
191,189,10,1864,0,48,1039,97704,47.22,8278737,143.366,19.4,2.839,1429.813,280.033,6.15,0.503,0
191,190,17,1881,1,49,938,98642,47.22,8278737,143.366,19.4,2.839,1429.813,280.033,6.15,0.503,0
191,191,17,1898,0,49,753,99395,47.22,8278737,143.366,19.4,2.839,1429.813,280.033,6.15,0.503,0
191,192,9,1907,0,49,966,100361,47.22,8278737,143.366,19.4,2.839,1429.813,280.033,6.15,0.503,0
191,193,14,1921,0,49,1189,101550,47.22,8278737,143.366,19.4,2.839,1429.813,280.033,6.15,0.503,0
191,194,14,1935,0,49,543,102093,47.22,8278737,143.366,19.4,2.839,1429.813,280.033,6.15,0.503,0
191,195,5,1940,0,49,494,102587,47.22,8278737,143.366,19.4,2.839,1429.813,280.033,6.15,0.503,0
191,196,9,1949,0,49,1117,103704,47.22,8278737,143.366,19.4,2.839,1429.813,280.033,6.15,0.503,0
191,197,23,1972,1,50,829,104533,47.22,8278737,143.366,19.4,2.839,1429.813,280.033,6.15,0.503,0
191,198,11,1983,1,51,764,105297,47.22,8278737,143.366,19.4,2.839,1429.813,280.033,6.15,0.503,0
191,199,13,1996,0,51,937,106234,47.22,8278737,143.366,19.4,2.839,1429.813,280.033,6.15,0.503,0
191,200,31,2027,0,51,1273,107507,47.22,8278737,143.366,19.4,2.839,1429.813,280.033,6.15,0.503,0
191,201,22,2049,0,51,692,108199,47.22,8278737,143.366,19.4,2.839,1429.813,280.033,6.15,0.503,0
191,202,8,2057,0,51,0,108199,47.22,8278737,143.366,19.4,2.839,1429.813,280.033,6.15,0.503,0
191,203,14,2071,0,51,0,108199,47.22,8278737,143.366,19.4,2.839,1429.813,280.033,6.15,0.503,0
191,204,33,2104,0,51,0,108199,47.22,8278737,143.366,19.4,2.839,1429.813,280.033,6.15,0.503,0
192,1,2,87,0,3,0,0,79.63,1399491,266.886,36.2,10.014,28763.071,228.467,10.97,0.784,0
192,2,2,89,2,5,0,0,79.63,1399491,266.886,36.2,10.014,28763.071,228.467,10.97,0.784,0
192,3,8,97,1,6,0,0,79.63,1399491,266.886,36.2,10.014,28763.071,228.467,10.97,0.784,0
192,4,3,100,0,6,0,0,79.63,1399491,266.886,36.2,10.014,28763.071,228.467,10.97,0.784,0
192,5,3,103,0,6,0,0,79.63,1399491,266.886,36.2,10.014,28763.071,228.467,10.97,0.784,0
192,6,1,104,1,7,0,0,79.63,1399491,266.886,36.2,10.014,28763.071,228.467,10.97,0.784,0
192,7,1,105,1,8,0,0,79.63,1399491,266.886,36.2,10.014,28763.071,228.467,10.97,0.784,0
192,8,2,107,0,8,0,0,79.63,1399491,266.886,36.2,10.014,28763.071,228.467,10.97,0.784,0
192,9,0,107,0,8,0,0,79.63,1399491,266.886,36.2,10.014,28763.071,228.467,10.97,0.784,0
192,10,2,109,0,8,0,0,79.63,1399491,266.886,36.2,10.014,28763.071,228.467,10.97,0.784,0
192,11,0,109,0,8,0,0,79.63,1399491,266.886,36.2,10.014,28763.071,228.467,10.97,0.784,0
192,12,3,112,0,8,0,0,79.63,1399491,266.886,36.2,10.014,28763.071,228.467,10.97,0.784,0
192,13,1,113,0,8,0,0,79.63,1399491,266.886,36.2,10.014,28763.071,228.467,10.97,0.784,0
192,14,0,113,0,8,0,0,79.63,1399491,266.886,36.2,10.014,28763.071,228.467,10.97,0.784,0
192,15,0,113,0,8,0,0,79.63,1399491,266.886,36.2,10.014,28763.071,228.467,10.97,0.784,0
192,16,1,114,0,8,0,0,79.63,1399491,266.886,36.2,10.014,28763.071,228.467,10.97,0.784,0
192,17,0,114,0,8,0,0,79.63,1399491,266.886,36.2,10.014,28763.071,228.467,10.97,0.784,0
192,18,0,114,0,8,0,0,79.63,1399491,266.886,36.2,10.014,28763.071,228.467,10.97,0.784,0
192,19,0,114,0,8,0,0,79.63,1399491,266.886,36.2,10.014,28763.071,228.467,10.97,0.784,0
192,20,0,114,0,8,0,0,79.63,1399491,266.886,36.2,10.014,28763.071,228.467,10.97,0.784,0
192,21,0,114,0,8,0,0,79.63,1399491,266.886,36.2,10.014,28763.071,228.467,10.97,0.784,0
192,22,1,115,0,8,0,0,79.63,1399491,266.886,36.2,10.014,28763.071,228.467,10.97,0.784,0
192,23,0,115,0,8,0,0,79.63,1399491,266.886,36.2,10.014,28763.071,228.467,10.97,0.784,0
192,24,0,115,0,8,0,0,79.63,1399491,266.886,36.2,10.014,28763.071,228.467,10.97,0.784,0
192,25,0,115,0,8,0,0,79.63,1399491,266.886,36.2,10.014,28763.071,228.467,10.97,0.784,0
192,26,0,115,0,8,0,0,79.63,1399491,266.886,36.2,10.014,28763.071,228.467,10.97,0.784,0
192,27,1,116,0,8,0,0,90.74,1399491,266.886,36.2,10.014,28763.071,228.467,10.97,0.784,0
192,28,0,116,0,8,0,0,90.74,1399491,266.886,36.2,10.014,28763.071,228.467,10.97,0.784,0
192,29,0,116,0,8,0,0,90.74,1399491,266.886,36.2,10.014,28763.071,228.467,10.97,0.784,0
192,30,0,116,0,8,0,0,90.74,1399491,266.886,36.2,10.014,28763.071,228.467,10.97,0.784,0
192,31,0,116,0,8,0,0,90.74,1399491,266.886,36.2,10.014,28763.071,228.467,10.97,0.784,0
192,32,0,116,0,8,0,0,90.74,1399491,266.886,36.2,10.014,28763.071,228.467,10.97,0.784,0
192,33,0,116,0,8,0,0,90.74,1399491,266.886,36.2,10.014,28763.071,228.467,10.97,0.784,0
192,34,0,116,0,8,0,0,90.74,1399491,266.886,36.2,10.014,28763.071,228.467,10.97,0.784,0
192,35,0,116,0,8,0,0,90.74,1399491,266.886,36.2,10.014,28763.071,228.467,10.97,0.784,0
192,36,0,116,0,8,0,0,90.74,1399491,266.886,36.2,10.014,28763.071,228.467,10.97,0.784,0
192,37,0,116,0,8,0,0,90.74,1399491,266.886,36.2,10.014,28763.071,228.467,10.97,0.784,0
192,38,0,116,0,8,0,0,90.74,1399491,266.886,36.2,10.014,28763.071,228.467,10.97,0.784,0
192,39,0,116,0,8,0,0,90.74,1399491,266.886,36.2,10.014,28763.071,228.467,10.97,0.784,0
192,40,0,116,0,8,0,0,90.74,1399491,266.886,36.2,10.014,28763.071,228.467,10.97,0.784,0
192,41,0,116,0,8,0,0,90.74,1399491,266.886,36.2,10.014,28763.071,228.467,10.97,0.784,0
192,42,0,116,0,8,0,0,90.74,1399491,266.886,36.2,10.014,28763.071,228.467,10.97,0.784,0
192,43,0,116,0,8,0,0,90.74,1399491,266.886,36.2,10.014,28763.071,228.467,10.97,0.784,0
192,44,0,116,0,8,0,0,90.74,1399491,266.886,36.2,10.014,28763.071,228.467,10.97,0.784,0
192,45,0,116,0,8,0,0,90.74,1399491,266.886,36.2,10.014,28763.071,228.467,10.97,0.784,0
192,46,0,116,0,8,0,0,90.74,1399491,266.886,36.2,10.014,28763.071,228.467,10.97,0.784,0
192,47,0,116,0,8,0,0,90.74,1399491,266.886,36.2,10.014,28763.071,228.467,10.97,0.784,0
192,48,0,116,0,8,0,0,90.74,1399491,266.886,36.2,10.014,28763.071,228.467,10.97,0.784,0
192,49,0,116,0,8,0,0,90.74,1399491,266.886,36.2,10.014,28763.071,228.467,10.97,0.784,0
192,50,0,116,0,8,0,0,90.74,1399491,266.886,36.2,10.014,28763.071,228.467,10.97,0.784,0
192,51,0,116,0,8,0,0,87.04,1399491,266.886,36.2,10.014,28763.071,228.467,10.97,0.784,0
192,52,0,116,0,8,0,0,87.04,1399491,266.886,36.2,10.014,28763.071,228.467,10.97,0.784,0
192,53,0,116,0,8,0,0,87.04,1399491,266.886,36.2,10.014,28763.071,228.467,10.97,0.784,0
192,54,0,116,0,8,0,0,87.04,1399491,266.886,36.2,10.014,28763.071,228.467,10.97,0.784,0
192,55,0,116,0,8,0,0,87.04,1399491,266.886,36.2,10.014,28763.071,228.467,10.97,0.784,0
192,56,0,116,0,8,0,0,87.04,1399491,266.886,36.2,10.014,28763.071,228.467,10.97,0.784,0
192,57,0,116,0,8,0,0,87.04,1399491,266.886,36.2,10.014,28763.071,228.467,10.97,0.784,0
192,58,0,116,0,8,0,0,87.04,1399491,266.886,36.2,10.014,28763.071,228.467,10.97,0.784,0
192,59,0,116,0,8,0,0,87.04,1399491,266.886,36.2,10.014,28763.071,228.467,10.97,0.784,0
192,60,0,116,0,8,0,0,87.04,1399491,266.886,36.2,10.014,28763.071,228.467,10.97,0.784,0
192,61,1,117,0,8,0,0,87.04,1399491,266.886,36.2,10.014,28763.071,228.467,10.97,0.784,0
192,62,0,117,0,8,0,0,87.04,1399491,266.886,36.2,10.014,28763.071,228.467,10.97,0.784,0
192,63,0,117,0,8,0,0,87.04,1399491,266.886,36.2,10.014,28763.071,228.467,10.97,0.784,0
192,64,0,117,0,8,0,0,87.04,1399491,266.886,36.2,10.014,28763.071,228.467,10.97,0.784,0
192,65,0,117,0,8,0,0,87.04,1399491,266.886,36.2,10.014,28763.071,228.467,10.97,0.784,0
192,66,0,117,0,8,0,0,87.04,1399491,266.886,36.2,10.014,28763.071,228.467,10.97,0.784,0
192,67,0,117,0,8,0,0,87.04,1399491,266.886,36.2,10.014,28763.071,228.467,10.97,0.784,0
192,68,0,117,0,8,0,0,87.04,1399491,266.886,36.2,10.014,28763.071,228.467,10.97,0.784,0
192,69,0,117,0,8,0,0,83.33,1399491,266.886,36.2,10.014,28763.071,228.467,10.97,0.784,0
192,70,0,117,0,8,0,0,77.78,1399491,266.886,36.2,10.014,28763.071,228.467,10.97,0.784,0
192,71,0,117,0,8,0,0,77.78,1399491,266.886,36.2,10.014,28763.071,228.467,10.97,0.784,0
192,72,0,117,0,8,0,0,77.78,1399491,266.886,36.2,10.014,28763.071,228.467,10.97,0.784,0
192,73,0,117,0,8,0,0,77.78,1399491,266.886,36.2,10.014,28763.071,228.467,10.97,0.784,0
192,74,0,117,0,8,0,0,77.78,1399491,266.886,36.2,10.014,28763.071,228.467,10.97,0.784,0
192,75,0,117,0,8,0,0,77.78,1399491,266.886,36.2,10.014,28763.071,228.467,10.97,0.784,0
192,76,6,123,0,8,0,0,77.78,1399491,266.886,36.2,10.014,28763.071,228.467,10.97,0.784,0
192,77,0,123,0,8,0,0,77.78,1399491,266.886,36.2,10.014,28763.071,228.467,10.97,0.784,0
192,78,0,123,0,8,0,0,77.78,1399491,266.886,36.2,10.014,28763.071,228.467,10.97,0.784,0
192,79,0,123,0,8,0,0,77.78,1399491,266.886,36.2,10.014,28763.071,228.467,10.97,0.784,0
192,80,0,123,0,8,0,0,77.78,1399491,266.886,36.2,10.014,28763.071,228.467,10.97,0.784,0
192,81,0,123,0,8,0,0,77.78,1399491,266.886,36.2,10.014,28763.071,228.467,10.97,0.784,0
192,82,0,123,0,8,0,0,77.78,1399491,266.886,36.2,10.014,28763.071,228.467,10.97,0.784,0
192,83,0,123,0,8,0,0,60.19,1399491,266.886,36.2,10.014,28763.071,228.467,10.97,0.784,0
192,84,0,123,0,8,0,0,60.19,1399491,266.886,36.2,10.014,28763.071,228.467,10.97,0.784,0
192,85,0,123,0,8,0,0,60.19,1399491,266.886,36.2,10.014,28763.071,228.467,10.97,0.784,0
192,86,0,123,0,8,0,0,60.19,1399491,266.886,36.2,10.014,28763.071,228.467,10.97,0.784,0
192,87,0,123,0,8,0,0,60.19,1399491,266.886,36.2,10.014,28763.071,228.467,10.97,0.784,0
192,88,1,124,0,8,0,0,60.19,1399491,266.886,36.2,10.014,28763.071,228.467,10.97,0.784,0
192,89,0,124,0,8,0,0,60.19,1399491,266.886,36.2,10.014,28763.071,228.467,10.97,0.784,0
192,90,2,126,0,8,0,0,60.19,1399491,266.886,36.2,10.014,28763.071,228.467,10.97,0.784,0
192,91,0,126,0,8,0,0,60.19,1399491,266.886,36.2,10.014,28763.071,228.467,10.97,0.784,0
192,92,4,130,0,8,0,0,60.19,1399491,266.886,36.2,10.014,28763.071,228.467,10.97,0.784,0
192,93,0,130,0,8,0,0,60.19,1399491,266.886,36.2,10.014,28763.071,228.467,10.97,0.784,0
192,94,0,130,0,8,0,0,60.19,1399491,266.886,36.2,10.014,28763.071,228.467,10.97,0.784,0
192,95,0,130,0,8,0,0,60.19,1399491,266.886,36.2,10.014,28763.071,228.467,10.97,0.784,0
192,96,0,130,0,8,0,0,60.19,1399491,266.886,36.2,10.014,28763.071,228.467,10.97,0.784,0
192,97,3,133,0,8,0,0,60.19,1399491,266.886,36.2,10.014,28763.071,228.467,10.97,0.784,0
192,98,0,133,0,8,0,0,60.19,1399491,266.886,36.2,10.014,28763.071,228.467,10.97,0.784,0
192,99,0,133,0,8,0,0,60.19,1399491,266.886,36.2,10.014,28763.071,228.467,10.97,0.784,0
192,100,0,133,0,8,0,0,60.19,1399491,266.886,36.2,10.014,28763.071,228.467,10.97,0.784,0
192,101,0,133,0,8,0,0,60.19,1399491,266.886,36.2,10.014,28763.071,228.467,10.97,0.784,0
192,102,0,133,0,8,0,0,60.19,1399491,266.886,36.2,10.014,28763.071,228.467,10.97,0.784,0
192,103,0,133,0,8,0,0,60.19,1399491,266.886,36.2,10.014,28763.071,228.467,10.97,0.784,0
192,104,0,133,0,8,0,0,60.19,1399491,266.886,36.2,10.014,28763.071,228.467,10.97,0.784,0
192,105,0,133,0,8,0,0,60.19,1399491,266.886,36.2,10.014,28763.071,228.467,10.97,0.784,0
192,106,0,133,0,8,0,0,60.19,1399491,266.886,36.2,10.014,28763.071,228.467,10.97,0.784,0
192,107,0,133,0,8,0,0,60.19,1399491,266.886,36.2,10.014,28763.071,228.467,10.97,0.784,0
192,108,0,133,0,8,0,0,60.19,1399491,266.886,36.2,10.014,28763.071,228.467,10.97,0.784,0
192,109,3,136,0,8,0,0,60.19,1399491,266.886,36.2,10.014,28763.071,228.467,10.97,0.784,0
192,110,1,137,0,8,0,0,60.19,1399491,266.886,36.2,10.014,28763.071,228.467,10.97,0.784,0
192,111,0,137,0,8,0,0,60.19,1399491,266.886,36.2,10.014,28763.071,228.467,10.97,0.784,0
192,112,0,137,0,8,0,0,60.19,1399491,266.886,36.2,10.014,28763.071,228.467,10.97,0.784,0
192,113,2,139,0,8,0,0,60.19,1399491,266.886,36.2,10.014,28763.071,228.467,10.97,0.784,0
192,114,2,141,0,8,0,0,60.19,1399491,266.886,36.2,10.014,28763.071,228.467,10.97,0.784,0
192,115,0,141,0,8,0,0,60.19,1399491,266.886,36.2,10.014,28763.071,228.467,10.97,0.784,0
192,116,1,142,0,8,0,0,60.19,1399491,266.886,36.2,10.014,28763.071,228.467,10.97,0.784,0
192,117,5,147,0,8,0,0,60.19,1399491,266.886,36.2,10.014,28763.071,228.467,10.97,0.784,0
192,118,0,147,0,8,0,0,60.19,1399491,266.886,36.2,10.014,28763.071,228.467,10.97,0.784,0
192,119,1,148,0,8,0,0,60.19,1399491,266.886,36.2,10.014,28763.071,228.467,10.97,0.784,0
192,120,6,154,0,8,0,0,60.19,1399491,266.886,36.2,10.014,28763.071,228.467,10.97,0.784,0
192,121,2,156,0,8,0,0,60.19,1399491,266.886,36.2,10.014,28763.071,228.467,10.97,0.784,0
192,122,8,164,0,8,0,0,60.19,1399491,266.886,36.2,10.014,28763.071,228.467,10.97,0.784,0
192,123,5,169,0,8,0,0,60.19,1399491,266.886,36.2,10.014,28763.071,228.467,10.97,0.784,0
192,124,4,173,0,8,0,0,60.19,1399491,266.886,36.2,10.014,28763.071,228.467,10.97,0.784,0
192,125,9,182,0,8,0,0,60.19,1399491,266.886,36.2,10.014,28763.071,228.467,10.97,0.784,0
192,126,0,182,0,8,0,0,60.19,1399491,266.886,36.2,10.014,28763.071,228.467,10.97,0.784,0
192,127,12,194,0,8,0,0,60.19,1399491,266.886,36.2,10.014,28763.071,228.467,10.97,0.784,0
192,128,5,199,0,8,0,0,60.19,1399491,266.886,36.2,10.014,28763.071,228.467,10.97,0.784,0
192,129,11,210,0,8,0,0,60.19,1399491,266.886,36.2,10.014,28763.071,228.467,10.97,0.784,0
192,130,15,225,0,8,0,0,60.19,1399491,266.886,36.2,10.014,28763.071,228.467,10.97,0.784,0
192,131,50,275,0,8,0,0,60.19,1399491,266.886,36.2,10.014,28763.071,228.467,10.97,0.784,0
192,132,4,279,0,8,0,0,60.19,1399491,266.886,36.2,10.014,28763.071,228.467,10.97,0.784,0
192,133,2,281,0,8,0,0,60.19,1399491,266.886,36.2,10.014,28763.071,228.467,10.97,0.784,0
192,134,14,295,0,8,0,0,60.19,1399491,266.886,36.2,10.014,28763.071,228.467,10.97,0.784,0
192,135,31,326,0,8,0,0,60.19,1399491,266.886,36.2,10.014,28763.071,228.467,10.97,0.784,0
192,136,78,404,0,8,0,0,60.19,1399491,266.886,36.2,10.014,28763.071,228.467,10.97,0.784,0
192,137,8,412,0,8,0,0,60.19,1399491,266.886,36.2,10.014,28763.071,228.467,10.97,0.784,0
192,138,62,474,2,10,0,0,60.19,1399491,266.886,36.2,10.014,28763.071,228.467,10.97,0.784,0
192,139,78,552,1,11,0,0,80.56,1399491,266.886,36.2,10.014,28763.071,228.467,10.97,0.784,0
192,140,0,552,0,11,0,0,80.56,1399491,266.886,36.2,10.014,28763.071,228.467,10.97,0.784,0
192,141,77,629,1,12,0,0,80.56,1399491,266.886,36.2,10.014,28763.071,228.467,10.97,0.784,0
192,142,57,686,0,12,0,0,80.56,1399491,266.886,36.2,10.014,28763.071,228.467,10.97,0.784,0
192,143,81,767,0,12,0,0,80.56,1399491,266.886,36.2,10.014,28763.071,228.467,10.97,0.784,0
192,144,97,864,0,12,0,0,80.56,1399491,266.886,36.2,10.014,28763.071,228.467,10.97,0.784,0
192,145,66,930,1,13,0,0,80.56,1399491,266.886,36.2,10.014,28763.071,228.467,10.97,0.784,0
192,146,77,1007,1,14,0,0,80.56,1399491,266.886,36.2,10.014,28763.071,228.467,10.97,0.784,0
192,147,92,1099,1,15,0,0,80.56,1399491,266.886,36.2,10.014,28763.071,228.467,10.97,0.784,0
192,148,153,1252,0,15,0,0,80.56,1399491,266.886,36.2,10.014,28763.071,228.467,10.97,0.784,0
192,149,159,1411,0,15,0,0,80.56,1399491,266.886,36.2,10.014,28763.071,228.467,10.97,0.784,0
192,150,65,1476,0,15,0,0,80.56,1399491,266.886,36.2,10.014,28763.071,228.467,10.97,0.784,0
192,151,78,1554,4,19,0,0,80.56,1399491,266.886,36.2,10.014,28763.071,228.467,10.97,0.784,0
192,152,91,1645,0,19,0,0,80.56,1399491,266.886,36.2,10.014,28763.071,228.467,10.97,0.784,0
192,153,38,1683,2,21,0,0,80.56,1399491,266.886,36.2,10.014,28763.071,228.467,10.97,0.784,0
192,154,76,1759,1,22,0,0,80.56,1399491,266.886,36.2,10.014,28763.071,228.467,10.97,0.784,0
192,155,38,1797,5,27,0,0,80.56,1399491,266.886,36.2,10.014,28763.071,228.467,10.97,0.784,0
192,156,123,1920,1,28,0,0,80.56,1399491,266.886,36.2,10.014,28763.071,228.467,10.97,0.784,0
192,157,64,1984,1,29,0,0,80.56,1399491,266.886,36.2,10.014,28763.071,228.467,10.97,0.784,0
192,158,56,2040,2,31,0,0,80.56,1399491,266.886,36.2,10.014,28763.071,228.467,10.97,0.784,0
192,159,190,2230,2,33,0,0,80.56,1399491,266.886,36.2,10.014,28763.071,228.467,10.97,0.784,0
192,160,20,2250,1,34,0,0,80.56,1399491,266.886,36.2,10.014,28763.071,228.467,10.97,0.784,0
192,161,27,2277,3,37,0,0,80.56,1399491,266.886,36.2,10.014,28763.071,228.467,10.97,0.784,0
192,162,114,2391,2,39,0,0,80.56,1399491,266.886,36.2,10.014,28763.071,228.467,10.97,0.784,0
192,163,197,2588,0,39,0,0,80.56,1399491,266.886,36.2,10.014,28763.071,228.467,10.97,0.784,0
192,164,110,2698,4,43,0,0,80.56,1399491,266.886,36.2,10.014,28763.071,228.467,10.97,0.784,0
192,165,127,2825,7,50,0,0,80.56,1399491,266.886,36.2,10.014,28763.071,228.467,10.97,0.784,0
192,166,168,2993,1,51,0,0,80.56,1399491,266.886,36.2,10.014,28763.071,228.467,10.97,0.784,0
192,167,49,3042,2,53,0,0,80.56,1399491,266.886,36.2,10.014,28763.071,228.467,10.97,0.784,0
192,168,99,3141,2,55,0,0,80.56,1399491,266.886,36.2,10.014,28763.071,228.467,10.97,0.784,0
192,169,82,3223,1,56,0,0,80.56,1399491,266.886,36.2,10.014,28763.071,228.467,10.97,0.784,0
192,170,104,3327,2,58,0,0,80.56,1399491,266.886,36.2,10.014,28763.071,228.467,10.97,0.784,0
192,171,107,3434,2,60,0,0,80.56,1399491,266.886,36.2,10.014,28763.071,228.467,10.97,0.784,0
192,172,217,3651,0,60,0,0,80.56,1399491,266.886,36.2,10.014,28763.071,228.467,10.97,0.784,0
192,173,202,3853,1,61,0,0,80.56,1399491,266.886,36.2,10.014,28763.071,228.467,10.97,0.784,0
192,174,48,3901,4,65,0,0,80.56,1399491,266.886,36.2,10.014,28763.071,228.467,10.97,0.784,0
192,175,44,3945,0,65,0,0,80.56,1399491,266.886,36.2,10.014,28763.071,228.467,10.97,0.784,0
192,176,81,4026,0,65,0,0,80.56,1399491,266.886,36.2,10.014,28763.071,228.467,10.97,0.784,0
192,177,110,4136,2,67,0,0,80.56,1399491,266.886,36.2,10.014,28763.071,228.467,10.97,0.784,0
192,178,99,4235,0,67,0,0,80.56,1399491,266.886,36.2,10.014,28763.071,228.467,10.97,0.784,0
192,179,42,4277,3,70,0,0,80.56,1399491,266.886,36.2,10.014,28763.071,228.467,10.97,0.784,0
192,180,35,4312,0,70,0,0,80.56,1399491,266.886,36.2,10.014,28763.071,228.467,10.97,0.784,0
192,181,50,4362,1,71,0,0,80.56,1399491,266.886,36.2,10.014,28763.071,228.467,10.97,0.784,0
192,182,24,4386,1,72,0,0,80.56,1399491,266.886,36.2,10.014,28763.071,228.467,10.97,0.784,0
192,183,77,4463,2,74,0,0,80.56,1399491,266.886,36.2,10.014,28763.071,228.467,10.97,0.784,0
192,184,68,4531,2,76,0,0,80.56,1399491,266.886,36.2,10.014,28763.071,228.467,10.97,0.784,0
192,185,39,4570,0,76,0,0,80.56,1399491,266.886,36.2,10.014,28763.071,228.467,10.97,0.784,0
192,186,59,4629,0,76,0,0,80.56,1399491,266.886,36.2,10.014,28763.071,228.467,10.97,0.784,0
192,187,80,4709,2,78,0,0,80.56,1399491,266.886,36.2,10.014,28763.071,228.467,10.97,0.784,0
192,188,54,4763,3,81,0,0,80.56,1399491,266.886,36.2,10.014,28763.071,228.467,10.97,0.784,0
192,189,4,4767,1,82,0,0,80.56,1399491,266.886,36.2,10.014,28763.071,228.467,10.97,0.784,0
192,190,79,4846,1,83,0,0,80.56,1399491,266.886,36.2,10.014,28763.071,228.467,10.97,0.784,0
192,191,41,4887,1,84,0,0,80.56,1399491,266.886,36.2,10.014,28763.071,228.467,10.97,0.784,0
192,192,76,4963,2,86,0,0,80.56,1399491,266.886,36.2,10.014,28763.071,228.467,10.97,0.784,0
192,193,58,5021,3,89,0,0,77.78,1399491,266.886,36.2,10.014,28763.071,228.467,10.97,0.784,0
192,194,22,5043,1,90,0,0,77.78,1399491,266.886,36.2,10.014,28763.071,228.467,10.97,0.784,0
192,195,58,5101,0,90,0,0,77.78,1399491,266.886,36.2,10.014,28763.071,228.467,10.97,0.784,0
192,196,15,5116,2,92,0,0,77.78,1399491,266.886,36.2,10.014,28763.071,228.467,10.97,0.784,0
192,197,11,5127,1,93,0,0,77.78,1399491,266.886,36.2,10.014,28763.071,228.467,10.97,0.784,0
192,198,27,5154,0,93,0,0,77.78,1399491,266.886,36.2,10.014,28763.071,228.467,10.97,0.784,0
192,199,40,5194,0,93,0,0,77.78,1399491,266.886,36.2,10.014,28763.071,228.467,10.97,0.784,0
192,200,47,5241,2,95,0,0,77.78,1399491,266.886,36.2,10.014,28763.071,228.467,10.97,0.784,0
192,201,40,5281,0,95,0,0,77.78,1399491,266.886,36.2,10.014,28763.071,228.467,10.97,0.784,0
192,202,16,5297,1,96,0,0,77.78,1399491,266.886,36.2,10.014,28763.071,228.467,10.97,0.784,0
192,203,1,5298,1,97,0,0,77.78,1399491,266.886,36.2,10.014,28763.071,228.467,10.97,0.784,0
192,204,35,5333,1,98,0,0,77.78,1399491,266.886,36.2,10.014,28763.071,228.467,10.97,0.784,0
193,1,50,362,1,9,386,5130,90.74,11818618,74.228,32.7,8.001,10849.297,318.991,8.52,0.735,0
193,2,32,394,1,10,606,5736,90.74,11818618,74.228,32.7,8.001,10849.297,318.991,8.52,0.735,0
193,3,61,455,3,13,749,6485,90.74,11818618,74.228,32.7,8.001,10849.297,318.991,8.52,0.735,0
193,4,0,455,0,13,660,7145,90.74,11818618,74.228,32.7,8.001,10849.297,318.991,8.52,0.735,0
193,5,40,495,5,18,1129,8274,90.74,11818618,74.228,32.7,8.001,10849.297,318.991,8.52,0.735,0
193,6,58,553,1,19,604,8878,90.74,11818618,74.228,32.7,8.001,10849.297,318.991,8.52,0.735,0
193,7,21,574,3,22,692,9570,90.74,11818618,74.228,32.7,8.001,10849.297,318.991,8.52,0.735,0
193,8,22,596,0,22,517,10087,90.74,11818618,74.228,32.7,8.001,10849.297,318.991,8.52,0.735,0
193,9,27,623,1,23,589,10676,90.74,11818618,74.228,32.7,8.001,10849.297,318.991,8.52,0.735,0
193,10,20,643,2,25,562,11238,90.74,11818618,74.228,32.7,8.001,10849.297,318.991,8.52,0.735,0
193,11,28,671,0,25,587,11825,90.74,11818618,74.228,32.7,8.001,10849.297,318.991,8.52,0.735,0
193,12,14,685,3,28,590,12415,90.74,11818618,74.228,32.7,8.001,10849.297,318.991,8.52,0.735,0
193,13,22,707,3,31,722,13137,90.74,11818618,74.228,32.7,8.001,10849.297,318.991,8.52,0.735,0
193,14,19,726,3,34,793,13930,90.74,11818618,74.228,32.7,8.001,10849.297,318.991,8.52,0.735,0
193,15,21,747,0,34,710,14640,90.74,11818618,74.228,32.7,8.001,10849.297,318.991,8.52,0.735,0
193,16,33,780,1,35,692,15332,90.74,11818618,74.228,32.7,8.001,10849.297,318.991,8.52,0.735,0
193,17,42,822,2,37,766,16098,90.74,11818618,74.228,32.7,8.001,10849.297,318.991,8.52,0.735,0
193,18,42,864,0,37,1189,17287,90.74,11818618,74.228,32.7,8.001,10849.297,318.991,8.52,0.735,0
193,19,2,866,0,37,878,18165,90.74,11818618,74.228,32.7,8.001,10849.297,318.991,8.52,0.735,0
193,20,13,879,1,38,696,18861,90.74,11818618,74.228,32.7,8.001,10849.297,318.991,8.52,0.735,0
193,21,5,884,0,38,550,19411,90.74,11818618,74.228,32.7,8.001,10849.297,318.991,8.52,0.735,0
193,22,17,901,0,38,438,19849,90.74,11818618,74.228,32.7,8.001,10849.297,318.991,8.52,0.735,0
193,23,0,901,0,38,559,20408,90.74,11818618,74.228,32.7,8.001,10849.297,318.991,8.52,0.735,0
193,24,17,918,0,38,410,20818,90.74,11818618,74.228,32.7,8.001,10849.297,318.991,8.52,0.735,0
193,25,4,922,0,38,263,21081,90.74,11818618,74.228,32.7,8.001,10849.297,318.991,8.52,0.735,0
193,26,17,939,0,38,396,21477,90.74,11818618,74.228,32.7,8.001,10849.297,318.991,8.52,0.735,0
193,27,10,949,0,38,585,22062,90.74,11818618,74.228,32.7,8.001,10849.297,318.991,8.52,0.735,0
193,28,18,967,1,39,895,22957,90.74,11818618,74.228,32.7,8.001,10849.297,318.991,8.52,0.735,0
193,29,8,975,1,40,569,23526,90.74,11818618,74.228,32.7,8.001,10849.297,318.991,8.52,0.735,0
193,30,5,980,0,40,529,24055,90.74,11818618,74.228,32.7,8.001,10849.297,318.991,8.52,0.735,0
193,31,14,994,0,40,351,24406,90.74,11818618,74.228,32.7,8.001,10849.297,318.991,8.52,0.735,0
193,32,4,998,1,41,447,24853,90.74,11818618,74.228,32.7,8.001,10849.297,318.991,8.52,0.735,0
193,33,11,1009,1,42,312,25165,90.74,11818618,74.228,32.7,8.001,10849.297,318.991,8.52,0.735,0
193,34,4,1013,0,42,390,25555,87.04,11818618,74.228,32.7,8.001,10849.297,318.991,8.52,0.735,0
193,35,5,1018,1,43,412,25967,87.04,11818618,74.228,32.7,8.001,10849.297,318.991,8.52,0.735,0
193,36,4,1022,0,43,1453,27420,87.04,11818618,74.228,32.7,8.001,10849.297,318.991,8.52,0.735,0
193,37,3,1025,0,43,1877,29297,87.04,11818618,74.228,32.7,8.001,10849.297,318.991,8.52,0.735,0
193,38,1,1026,1,44,3521,32818,87.04,11818618,74.228,32.7,8.001,10849.297,318.991,8.52,0.735,0
193,39,4,1030,1,45,448,33266,87.04,11818618,74.228,32.7,8.001,10849.297,318.991,8.52,0.735,0
193,40,2,1032,0,45,614,33880,87.04,11818618,74.228,32.7,8.001,10849.297,318.991,8.52,0.735,0
193,41,0,1032,0,45,443,34323,87.04,11818618,74.228,32.7,8.001,10849.297,318.991,8.52,0.735,0
193,42,0,1032,0,45,2200,36523,87.04,11818618,74.228,32.7,8.001,10849.297,318.991,8.52,0.735,0
193,43,0,1032,0,45,1339,37862,87.04,11818618,74.228,32.7,8.001,10849.297,318.991,8.52,0.735,0
193,44,0,1032,0,45,1916,39778,87.04,11818618,74.228,32.7,8.001,10849.297,318.991,8.52,0.735,0
193,45,0,1032,0,45,781,40559,83.33,11818618,74.228,32.7,8.001,10849.297,318.991,8.52,0.735,0
193,46,3,1035,0,45,1061,41620,83.33,11818618,74.228,32.7,8.001,10849.297,318.991,8.52,0.735,0
193,47,0,1035,0,45,869,42489,83.33,11818618,74.228,32.7,8.001,10849.297,318.991,8.52,0.735,0
193,48,2,1037,0,45,1234,43723,83.33,11818618,74.228,32.7,8.001,10849.297,318.991,8.52,0.735,0
193,49,6,1043,1,46,1585,45308,83.33,11818618,74.228,32.7,8.001,10849.297,318.991,8.52,0.735,0
193,50,1,1044,1,47,1320,46628,83.33,11818618,74.228,32.7,8.001,10849.297,318.991,8.52,0.735,0
193,51,1,1045,0,47,1021,47649,83.33,11818618,74.228,32.7,8.001,10849.297,318.991,8.52,0.735,0
193,52,1,1046,0,47,167,47816,83.33,11818618,74.228,32.7,8.001,10849.297,318.991,8.52,0.735,0
193,53,2,1048,0,47,660,48476,83.33,11818618,74.228,32.7,8.001,10849.297,318.991,8.52,0.735,0
193,54,0,1048,1,48,637,49113,83.33,11818618,74.228,32.7,8.001,10849.297,318.991,8.52,0.735,0
193,55,3,1051,0,48,838,49951,83.33,11818618,74.228,32.7,8.001,10849.297,318.991,8.52,0.735,0
193,56,0,1051,0,48,429,50380,83.33,11818618,74.228,32.7,8.001,10849.297,318.991,8.52,0.735,0
193,57,0,1051,0,48,791,51171,83.33,11818618,74.228,32.7,8.001,10849.297,318.991,8.52,0.735,0
193,58,0,1051,0,48,710,51881,79.63,11818618,74.228,32.7,8.001,10849.297,318.991,8.52,0.735,0
193,59,17,1068,0,48,622,52503,79.63,11818618,74.228,32.7,8.001,10849.297,318.991,8.52,0.735,0
193,60,3,1071,0,48,371,52874,79.63,11818618,74.228,32.7,8.001,10849.297,318.991,8.52,0.735,0
193,61,5,1076,0,48,287,53161,79.63,11818618,74.228,32.7,8.001,10849.297,318.991,8.52,0.735,0
193,62,1,1077,0,48,378,53539,79.63,11818618,74.228,32.7,8.001,10849.297,318.991,8.52,0.735,0
193,63,7,1084,0,48,611,54150,79.63,11818618,74.228,32.7,8.001,10849.297,318.991,8.52,0.735,0
193,64,2,1086,0,48,503,54653,79.63,11818618,74.228,32.7,8.001,10849.297,318.991,8.52,0.735,0
193,65,1,1087,1,49,705,55358,68.52,11818618,74.228,32.7,8.001,10849.297,318.991,8.52,0.735,0
193,66,0,1087,0,49,61,55419,68.52,11818618,74.228,32.7,8.001,10849.297,318.991,8.52,0.735,0
193,67,0,1087,0,49,160,55579,68.52,11818618,74.228,32.7,8.001,10849.297,318.991,8.52,0.735,0
193,68,0,1087,0,49,312,55891,68.52,11818618,74.228,32.7,8.001,10849.297,318.991,8.52,0.735,0
193,69,0,1087,0,49,319,56210,29.63,11818618,74.228,32.7,8.001,10849.297,318.991,8.52,0.735,0
193,70,0,1087,0,49,1063,57273,29.63,11818618,74.228,32.7,8.001,10849.297,318.991,8.52,0.735,0
193,71,0,1087,0,49,1497,58770,29.63,11818618,74.228,32.7,8.001,10849.297,318.991,8.52,0.735,0
193,72,0,1087,0,49,1117,59887,29.63,11818618,74.228,32.7,8.001,10849.297,318.991,8.52,0.735,0
193,73,0,1087,0,49,985,60872,29.63,11818618,74.228,32.7,8.001,10849.297,318.991,8.52,0.735,0
193,74,6,1093,0,49,558,61430,29.63,11818618,74.228,32.7,8.001,10849.297,318.991,8.52,0.735,0
193,75,1,1094,0,49,1492,62922,29.63,11818618,74.228,32.7,8.001,10849.297,318.991,8.52,0.735,0
193,76,2,1096,0,49,709,63631,29.63,11818618,74.228,32.7,8.001,10849.297,318.991,8.52,0.735,0
193,77,14,1110,0,49,1279,64910,29.63,11818618,74.228,32.7,8.001,10849.297,318.991,8.52,0.735,0
193,78,15,1125,0,49,605,65515,29.63,11818618,74.228,32.7,8.001,10849.297,318.991,8.52,0.735,0
193,79,3,1128,1,50,1530,67045,29.63,11818618,74.228,32.7,8.001,10849.297,318.991,8.52,0.735,0
193,80,4,1132,0,50,189,67234,29.63,11818618,74.228,32.7,8.001,10849.297,318.991,8.52,0.735,0
193,81,14,1146,0,50,222,67456,29.63,11818618,74.228,32.7,8.001,10849.297,318.991,8.52,0.735,0
193,82,10,1156,0,50,648,68104,29.63,11818618,74.228,32.7,8.001,10849.297,318.991,8.52,0.735,0
193,83,1,1157,0,50,217,68321,29.63,11818618,74.228,32.7,8.001,10849.297,318.991,8.52,0.735,0
193,84,2,1159,0,50,221,68542,29.63,11818618,74.228,32.7,8.001,10849.297,318.991,8.52,0.735,0
193,85,0,1159,0,50,242,68784,29.63,11818618,74.228,32.7,8.001,10849.297,318.991,8.52,0.735,0
193,86,1,1160,0,50,353,69137,29.63,11818618,74.228,32.7,8.001,10849.297,318.991,8.52,0.735,0
193,87,2,1162,0,50,82,69219,29.63,11818618,74.228,32.7,8.001,10849.297,318.991,8.52,0.735,0
193,88,2,1164,0,50,308,69527,26.85,11818618,74.228,32.7,8.001,10849.297,318.991,8.52,0.735,0
193,89,4,1168,0,50,513,70040,26.85,11818618,74.228,32.7,8.001,10849.297,318.991,8.52,0.735,0
193,90,1,1169,0,50,574,70614,26.85,11818618,74.228,32.7,8.001,10849.297,318.991,8.52,0.735,0
193,91,3,1172,0,50,584,71198,26.85,11818618,74.228,32.7,8.001,10849.297,318.991,8.52,0.735,0
193,92,2,1174,0,50,491,71689,26.85,11818618,74.228,32.7,8.001,10849.297,318.991,8.52,0.735,0
193,93,1,1175,0,50,1213,72902,26.85,11818618,74.228,32.7,8.001,10849.297,318.991,8.52,0.735,0
193,94,3,1178,0,50,450,73352,26.85,11818618,74.228,32.7,8.001,10849.297,318.991,8.52,0.735,0
193,95,3,1181,0,50,258,73610,26.85,11818618,74.228,32.7,8.001,10849.297,318.991,8.52,0.735,0
193,96,5,1186,0,50,798,74408,26.85,11818618,74.228,32.7,8.001,10849.297,318.991,8.52,0.735,0
193,97,2,1188,0,50,1131,75539,26.85,11818618,74.228,32.7,8.001,10849.297,318.991,8.52,0.735,0
193,98,11,1199,0,50,879,76418,26.85,11818618,74.228,32.7,8.001,10849.297,318.991,8.52,0.735,0
193,99,6,1205,0,50,1175,77593,26.85,11818618,74.228,32.7,8.001,10849.297,318.991,8.52,0.735,0
193,100,16,1221,0,50,974,78567,26.85,11818618,74.228,32.7,8.001,10849.297,318.991,8.52,0.735,0
193,101,10,1231,0,50,577,79144,26.85,11818618,74.228,32.7,8.001,10849.297,318.991,8.52,0.735,0
193,102,9,1240,0,50,603,79747,26.85,11818618,74.228,32.7,8.001,10849.297,318.991,8.52,0.735,0
193,103,5,1245,0,50,791,80538,26.85,11818618,74.228,32.7,8.001,10849.297,318.991,8.52,0.735,0
193,104,18,1263,0,50,743,81281,26.85,11818618,74.228,32.7,8.001,10849.297,318.991,8.52,0.735,0
193,105,39,1302,0,50,1137,82418,26.85,11818618,74.228,32.7,8.001,10849.297,318.991,8.52,0.735,0
193,106,4,1306,0,50,636,83054,26.85,11818618,74.228,32.7,8.001,10849.297,318.991,8.52,0.735,0
193,107,13,1319,0,50,769,83823,26.85,11818618,74.228,32.7,8.001,10849.297,318.991,8.52,0.735,0
193,108,8,1327,0,50,422,84245,26.85,11818618,74.228,32.7,8.001,10849.297,318.991,8.52,0.735,0
193,109,9,1336,0,50,846,85091,26.85,11818618,74.228,32.7,8.001,10849.297,318.991,8.52,0.735,0
193,110,12,1348,0,50,826,85917,26.85,11818618,74.228,32.7,8.001,10849.297,318.991,8.52,0.735,0
193,111,26,1374,0,50,945,86862,26.85,11818618,74.228,32.7,8.001,10849.297,318.991,8.52,0.735,0
193,112,7,1381,0,50,999,87861,26.85,11818618,74.228,32.7,8.001,10849.297,318.991,8.52,0.735,0
193,113,8,1389,0,50,1457,89318,26.85,11818618,74.228,32.7,8.001,10849.297,318.991,8.52,0.735,0
193,114,5,1394,0,50,530,89848,26.85,11818618,74.228,32.7,8.001,10849.297,318.991,8.52,0.735,0
193,115,12,1406,0,50,327,90175,26.85,11818618,74.228,32.7,8.001,10849.297,318.991,8.52,0.735,0
193,116,19,1425,0,50,1081,91256,26.85,11818618,74.228,32.7,8.001,10849.297,318.991,8.52,0.735,0
193,117,18,1443,0,50,1454,92710,26.85,11818618,74.228,32.7,8.001,10849.297,318.991,8.52,0.735,0
193,118,9,1452,0,50,1561,94271,26.85,11818618,74.228,32.7,8.001,10849.297,318.991,8.52,0.735,0
193,119,3,1455,0,50,1587,95858,26.85,11818618,74.228,32.7,8.001,10849.297,318.991,8.52,0.735,0
193,120,13,1468,0,50,331,96189,26.85,11818618,74.228,32.7,8.001,10849.297,318.991,8.52,0.735,0
193,121,20,1488,0,50,99,96288,26.85,11818618,74.228,32.7,8.001,10849.297,318.991,8.52,0.735,0
193,122,26,1514,0,50,249,96537,26.85,11818618,74.228,32.7,8.001,10849.297,318.991,8.52,0.735,0
193,123,21,1535,0,50,708,97245,26.85,11818618,74.228,32.7,8.001,10849.297,318.991,8.52,0.735,0
193,124,17,1552,1,51,1578,98823,26.85,11818618,74.228,32.7,8.001,10849.297,318.991,8.52,0.735,0
193,125,9,1561,0,51,1475,100298,26.85,11818618,74.228,32.7,8.001,10849.297,318.991,8.52,0.735,0
193,126,4,1565,0,51,1743,102041,26.85,11818618,74.228,32.7,8.001,10849.297,318.991,8.52,0.735,0
193,127,19,1584,0,51,1382,103423,26.85,11818618,74.228,32.7,8.001,10849.297,318.991,8.52,0.735,0
193,128,17,1601,0,51,1283,104706,26.85,11818618,74.228,32.7,8.001,10849.297,318.991,8.52,0.735,0
193,129,41,1642,0,51,650,105356,24.07,11818618,74.228,32.7,8.001,10849.297,318.991,8.52,0.735,0
193,130,14,1656,0,51,976,106332,24.07,11818618,74.228,32.7,8.001,10849.297,318.991,8.52,0.735,0
193,131,22,1678,0,51,1202,107534,24.07,11818618,74.228,32.7,8.001,10849.297,318.991,8.52,0.735,0
193,132,19,1697,0,51,1289,108823,24.07,11818618,74.228,32.7,8.001,10849.297,318.991,8.52,0.735,0
193,133,20,1717,0,51,1200,110023,24.07,11818618,74.228,32.7,8.001,10849.297,318.991,8.52,0.735,0
193,134,21,1738,1,52,1494,111517,24.07,11818618,74.228,32.7,8.001,10849.297,318.991,8.52,0.735,0
193,135,42,1780,0,52,1508,113025,24.07,11818618,74.228,32.7,8.001,10849.297,318.991,8.52,0.735,0
193,136,67,1847,1,53,947,113972,24.07,11818618,74.228,32.7,8.001,10849.297,318.991,8.52,0.735,0
193,137,56,1903,0,53,1404,115376,24.07,11818618,74.228,32.7,8.001,10849.297,318.991,8.52,0.735,0
193,138,120,2023,1,54,1710,117086,24.07,11818618,74.228,32.7,8.001,10849.297,318.991,8.52,0.735,0
193,139,84,2107,0,54,2107,119193,24.07,11818618,74.228,32.7,8.001,10849.297,318.991,8.52,0.735,0
193,140,78,2185,2,56,1699,120892,24.07,11818618,74.228,32.7,8.001,10849.297,318.991,8.52,0.735,0
193,141,0,2185,0,56,2007,122899,24.07,11818618,74.228,32.7,8.001,10849.297,318.991,8.52,0.735,0
193,142,242,2427,4,60,2236,125135,24.07,11818618,74.228,32.7,8.001,10849.297,318.991,8.52,0.735,0
193,143,116,2543,3,63,1461,126596,24.07,11818618,74.228,32.7,8.001,10849.297,318.991,8.52,0.735,0
193,144,64,2607,1,64,2508,129104,24.07,11818618,74.228,32.7,8.001,10849.297,318.991,8.52,0.735,0
193,145,131,2738,4,68,2251,131355,24.07,11818618,74.228,32.7,8.001,10849.297,318.991,8.52,0.735,0
193,146,0,2738,0,68,2589,133944,24.07,11818618,74.228,32.7,8.001,10849.297,318.991,8.52,0.735,0
193,147,155,2893,3,71,2997,136941,24.07,11818618,74.228,32.7,8.001,10849.297,318.991,8.52,0.735,0
193,148,176,3069,0,71,2586,139527,24.07,11818618,74.228,32.7,8.001,10849.297,318.991,8.52,0.735,0
193,149,137,3206,0,71,2667,142194,24.07,11818618,74.228,32.7,8.001,10849.297,318.991,8.52,0.735,0
193,150,117,3323,2,73,1848,144042,24.07,11818618,74.228,32.7,8.001,10849.297,318.991,8.52,0.735,0
193,151,138,3461,1,74,2265,146307,26.85,11818618,74.228,32.7,8.001,10849.297,318.991,8.52,0.735,0
193,152,111,3572,2,76,1905,148212,26.85,11818618,74.228,32.7,8.001,10849.297,318.991,8.52,0.735,0
193,153,113,3685,0,76,2583,150795,26.85,11818618,74.228,32.7,8.001,10849.297,318.991,8.52,0.735,0
193,154,118,3803,1,77,2597,153392,26.85,11818618,74.228,32.7,8.001,10849.297,318.991,8.52,0.735,0
193,155,0,3803,0,77,2470,155862,26.85,11818618,74.228,32.7,8.001,10849.297,318.991,8.52,0.735,0
193,156,393,4196,4,81,2817,158679,26.85,11818618,74.228,32.7,8.001,10849.297,318.991,8.52,0.735,0
193,157,198,4394,3,84,918,159597,26.85,11818618,74.228,32.7,8.001,10849.297,318.991,8.52,0.735,0
193,158,0,4394,0,84,2603,162200,26.85,11818618,74.228,32.7,8.001,10849.297,318.991,8.52,0.735,0
193,159,148,4542,3,87,3223,165423,26.85,11818618,74.228,32.7,8.001,10849.297,318.991,8.52,0.735,0
193,160,234,4776,6,93,3052,168475,26.85,11818618,74.228,32.7,8.001,10849.297,318.991,8.52,0.735,0
193,161,348,5124,0,93,3311,171786,26.85,11818618,74.228,32.7,8.001,10849.297,318.991,8.52,0.735,0
193,162,293,5417,3,96,6118,177904,26.85,11818618,74.228,32.7,8.001,10849.297,318.991,8.52,0.735,0
193,163,0,5417,0,96,1131,179035,26.85,11818618,74.228,32.7,8.001,10849.297,318.991,8.52,0.735,0
193,164,465,5882,3,99,0,179035,26.85,11818618,74.228,32.7,8.001,10849.297,318.991,8.52,0.735,0
193,165,377,6259,4,103,0,179035,26.85,11818618,74.228,32.7,8.001,10849.297,318.991,8.52,0.735,0
193,166,376,6635,4,107,0,190241,26.85,11818618,74.228,32.7,8.001,10849.297,318.991,8.52,0.735,0
193,167,0,6635,0,107,3886,194127,26.85,11818618,74.228,32.7,8.001,10849.297,318.991,8.52,0.735,0
193,168,747,7382,10,117,6332,200459,26.85,11818618,74.228,32.7,8.001,10849.297,318.991,8.52,0.735,0
193,169,241,7623,6,123,2592,203051,26.85,11818618,74.228,32.7,8.001,10849.297,318.991,8.52,0.735,0
193,170,477,8100,6,129,0,203051,26.85,11818618,74.228,32.7,8.001,10849.297,318.991,8.52,0.735,0
193,171,470,8570,4,133,0,203051,26.85,11818618,74.228,32.7,8.001,10849.297,318.991,8.52,0.735,0
193,172,0,8570,0,133,0,203051,26.85,11818618,74.228,32.7,8.001,10849.297,318.991,8.52,0.735,0
193,173,1166,9736,22,155,0,203051,26.85,11818618,74.228,32.7,8.001,10849.297,318.991,8.52,0.735,0
193,174,996,10732,4,159,0,203051,26.85,11818618,74.228,32.7,8.001,10849.297,318.991,8.52,0.735,0
193,175,528,11260,5,164,0,203051,26.85,11818618,74.228,32.7,8.001,10849.297,318.991,8.52,0.735,0
193,176,0,11260,0,164,0,203051,26.85,11818618,74.228,32.7,8.001,10849.297,318.991,8.52,0.735,0
193,177,1219,12479,10,174,0,203051,26.85,11818618,74.228,32.7,8.001,10849.297,318.991,8.52,0.735,0
193,178,826,13305,6,180,0,225033,26.85,11818618,74.228,32.7,8.001,10849.297,318.991,8.52,0.735,0
193,179,1087,14392,11,191,0,225033,24.07,11818618,74.228,32.7,8.001,10849.297,318.991,8.52,0.735,0
193,180,786,15178,16,207,0,225033,24.07,11818618,74.228,32.7,8.001,10849.297,318.991,8.52,0.735,0
193,181,936,16114,7,214,0,225033,24.07,11818618,74.228,32.7,8.001,10849.297,318.991,8.52,0.735,0
193,182,0,16114,0,214,0,225033,24.07,11818618,74.228,32.7,8.001,10849.297,318.991,8.52,0.735,0
193,183,1291,17405,32,246,0,225033,24.07,11818618,74.228,32.7,8.001,10849.297,318.991,8.52,0.735,0
193,184,1008,18413,19,265,0,225033,24.07,11818618,74.228,32.7,8.001,10849.297,318.991,8.52,0.735,0
193,185,0,18413,0,265,0,225033,24.07,11818618,74.228,32.7,8.001,10849.297,318.991,8.52,0.735,0
193,186,1308,19721,6,271,0,225033,40.74,11818618,74.228,32.7,8.001,10849.297,318.991,8.52,0.735,0
193,187,1223,20944,5,276,0,225033,40.74,11818618,74.228,32.7,8.001,10849.297,318.991,8.52,0.735,0
193,188,2509,23453,45,321,0,225033,40.74,11818618,74.228,32.7,8.001,10849.297,318.991,8.52,0.735,0
193,189,0,23453,0,321,0,225033,40.74,11818618,74.228,32.7,8.001,10849.297,318.991,8.52,0.735,0
193,190,0,23453,0,321,0,225033,40.74,11818618,74.228,32.7,8.001,10849.297,318.991,8.52,0.735,0
193,191,2312,25765,43,364,0,225033,40.74,11818618,74.228,32.7,8.001,10849.297,318.991,8.52,0.735,0
193,192,0,25765,0,364,0,225033,40.74,11818618,74.228,32.7,8.001,10849.297,318.991,8.52,0.735,0
193,193,2357,28122,45,409,0,225033,40.74,11818618,74.228,32.7,8.001,10849.297,318.991,8.52,0.735,0
193,194,3137,31259,47,456,0,225033,40.74,11818618,74.228,32.7,8.001,10849.297,318.991,8.52,0.735,0
193,195,0,31259,0,456,0,225033,40.74,11818618,74.228,32.7,8.001,10849.297,318.991,8.52,0.735,0
193,196,1297,32556,22,478,0,225033,40.74,11818618,74.228,32.7,8.001,10849.297,318.991,8.52,0.735,0
193,197,0,32556,0,478,0,225033,40.74,11818618,74.228,32.7,8.001,10849.297,318.991,8.52,0.735,0
193,198,2234,34790,34,512,0,225033,40.74,11818618,74.228,32.7,8.001,10849.297,318.991,8.52,0.735,0
193,199,0,34790,0,512,0,225033,40.74,11818618,74.228,32.7,8.001,10849.297,318.991,8.52,0.735,0
193,200,0,34790,0,512,0,225033,40.74,11818618,74.228,32.7,8.001,10849.297,318.991,8.52,0.735,0
193,201,5752,40542,114,626,0,225033,40.74,11818618,74.228,32.7,8.001,10849.297,318.991,8.52,0.735,0
193,202,0,40542,0,626,0,225033,40.74,11818618,74.228,32.7,8.001,10849.297,318.991,8.52,0.735,0
193,203,2185,42727,61,687,0,225033,40.74,11818618,74.228,32.7,8.001,10849.297,318.991,8.52,0.735,0
193,204,1723,44450,24,711,0,225033,40.74,11818618,74.228,32.7,8.001,10849.297,318.991,8.52,0.735,0
194,1,2704,13531,46,214,14396,106799,75.93,84339067,104.914,31.6,8.153,25129.341,171.285,12.13,0.791,3
194,2,2148,15679,63,277,18757,125556,75.93,84339067,104.914,31.6,8.153,25129.341,171.285,12.13,0.791,3
194,3,2456,18135,79,356,16160,141716,75.93,84339067,104.914,31.6,8.153,25129.341,171.285,12.13,0.791,3
194,4,2786,20921,69,425,19664,161380,75.93,84339067,104.914,31.6,8.153,25129.341,171.285,12.13,0.791,3
194,5,3013,23934,76,501,20065,181445,75.93,84339067,104.914,31.6,8.153,25129.341,171.285,12.13,0.791,3
194,6,3135,27069,73,574,21400,202845,75.93,84339067,104.914,31.6,8.153,25129.341,171.285,12.13,0.791,3
194,7,3148,30217,75,649,20023,222868,75.93,84339067,104.914,31.6,8.153,25129.341,171.285,12.13,0.791,3
194,8,3892,34109,76,725,24900,247768,75.93,84339067,104.914,31.6,8.153,25129.341,171.285,12.13,0.791,3
194,9,4117,38226,87,812,28578,276346,75.93,84339067,104.914,31.6,8.153,25129.341,171.285,12.13,0.791,3
194,10,4056,42282,96,908,30864,307210,75.93,84339067,104.914,31.6,8.153,25129.341,171.285,12.13,0.791,3
194,11,4747,47029,98,1006,33170,340380,77.78,84339067,104.914,31.6,8.153,25129.341,171.285,12.13,0.791,3
194,12,5138,52167,95,1101,35720,376100,77.78,84339067,104.914,31.6,8.153,25129.341,171.285,12.13,0.791,3
194,13,4789,56956,97,1198,34456,410556,75.93,84339067,104.914,31.6,8.153,25129.341,171.285,12.13,0.791,3
194,14,4093,61049,98,1296,33070,443626,75.93,84339067,104.914,31.6,8.153,25129.341,171.285,12.13,0.791,3
194,15,4062,65111,107,1403,34090,477716,75.93,84339067,104.914,31.6,8.153,25129.341,171.285,12.13,0.791,3
194,16,4281,69392,115,1518,40427,518143,75.93,84339067,104.914,31.6,8.153,25129.341,171.285,12.13,0.791,3
194,17,4801,74193,125,1643,40270,558413,75.93,84339067,104.914,31.6,8.153,25129.341,171.285,12.13,0.791,3
194,18,4353,78546,126,1769,40520,598933,77.78,84339067,104.914,31.6,8.153,25129.341,171.285,12.13,0.791,3
194,19,3783,82329,121,1890,35344,634277,77.78,84339067,104.914,31.6,8.153,25129.341,171.285,12.13,0.791,3
194,20,3977,86306,127,2017,39703,673980,75.93,84339067,104.914,31.6,8.153,25129.341,171.285,12.13,0.791,3
194,21,4674,90980,123,2140,39429,713409,75.93,84339067,104.914,31.6,8.153,25129.341,171.285,12.13,0.791,3
194,22,4611,95591,119,2259,37535,750944,75.93,84339067,104.914,31.6,8.153,25129.341,171.285,12.13,0.791,3
194,23,3083,98674,117,2376,40962,791906,75.93,84339067,104.914,31.6,8.153,25129.341,171.285,12.13,0.791,3
194,24,3116,101790,115,2491,38351,830257,75.93,84339067,104.914,31.6,8.153,25129.341,171.285,12.13,0.791,3
194,25,3122,104912,109,2600,38308,868565,75.93,84339067,104.914,31.6,8.153,25129.341,171.285,12.13,0.791,3
194,26,2861,107773,106,2706,30177,898742,75.93,84339067,104.914,31.6,8.153,25129.341,171.285,12.13,0.791,3
194,27,2357,110130,99,2805,20143,918885,75.93,84339067,104.914,31.6,8.153,25129.341,171.285,12.13,0.791,3
194,28,2131,112261,95,2900,29230,948115,75.93,84339067,104.914,31.6,8.153,25129.341,171.285,12.13,0.791,3
194,29,2392,114653,92,2992,43498,991613,75.93,84339067,104.914,31.6,8.153,25129.341,171.285,12.13,0.791,3
194,30,2936,117589,89,3081,42004,1033617,75.93,84339067,104.914,31.6,8.153,25129.341,171.285,12.13,0.791,3
194,31,2615,120204,93,3174,41431,1075048,75.93,84339067,104.914,31.6,8.153,25129.341,171.285,12.13,0.791,3
194,32,2188,122392,84,3258,36318,1111366,75.93,84339067,104.914,31.6,8.153,25129.341,171.285,12.13,0.791,3
194,33,1983,124375,78,3336,24001,1135367,75.93,84339067,104.914,31.6,8.153,25129.341,171.285,12.13,0.791,3
194,34,1670,126045,61,3397,35771,1171138,75.93,84339067,104.914,31.6,8.153,25129.341,171.285,12.13,0.791,3
194,35,1614,127659,64,3461,33283,1204421,75.93,84339067,104.914,31.6,8.153,25129.341,171.285,12.13,0.791,3
194,36,1832,129491,59,3520,30303,1234724,75.93,84339067,104.914,31.6,8.153,25129.341,171.285,12.13,0.791,3
194,37,2253,131744,64,3584,30395,1265119,75.93,84339067,104.914,31.6,8.153,25129.341,171.285,12.13,0.791,3
194,38,1977,133721,57,3641,33687,1298806,75.93,84339067,104.914,31.6,8.153,25129.341,171.285,12.13,0.791,3
194,39,1848,135569,48,3689,35605,1334411,75.93,84339067,104.914,31.6,8.153,25129.341,171.285,12.13,0.791,3
194,40,1546,137115,50,3739,36187,1370598,75.93,84339067,104.914,31.6,8.153,25129.341,171.285,12.13,0.791,3
194,41,1542,138657,47,3786,32722,1403320,75.93,84339067,104.914,31.6,8.153,25129.341,171.285,12.13,0.791,3
194,42,1114,139771,55,3841,37351,1440671,75.93,84339067,104.914,31.6,8.153,25129.341,171.285,12.13,0.791,3
194,43,1704,141475,53,3894,33332,1474003,75.93,84339067,104.914,31.6,8.153,25129.341,171.285,12.13,0.791,3
194,44,1639,143114,58,3952,34821,1508824,75.93,84339067,104.914,31.6,8.153,25129.341,171.285,12.13,0.791,3
194,45,1635,144749,55,4007,38565,1547389,75.93,84339067,104.914,31.6,8.153,25129.341,171.285,12.13,0.791,3
194,46,1708,146457,48,4055,42236,1589625,75.93,84339067,104.914,31.6,8.153,25129.341,171.285,12.13,0.791,3
194,47,1610,148067,41,4096,35369,1624994,75.93,84339067,104.914,31.6,8.153,25129.341,171.285,12.13,0.791,3
194,48,1368,149435,44,4140,25141,1650135,75.93,84339067,104.914,31.6,8.153,25129.341,171.285,12.13,0.791,3
194,49,1158,150593,31,4171,25382,1675517,75.93,84339067,104.914,31.6,8.153,25129.341,171.285,12.13,0.791,3
194,50,1022,151615,28,4199,20838,1696355,75.93,84339067,104.914,31.6,8.153,25129.341,171.285,12.13,0.791,3
194,51,972,152587,23,4222,33633,1729988,75.93,84339067,104.914,31.6,8.153,25129.341,171.285,12.13,0.791,3
194,52,961,153548,27,4249,37507,1767495,75.93,84339067,104.914,31.6,8.153,25129.341,171.285,12.13,0.791,3
194,53,952,154500,27,4276,40178,1807673,75.93,84339067,104.914,31.6,8.153,25129.341,171.285,12.13,0.791,3
194,54,1186,155686,32,4308,24589,1832262,75.93,84339067,104.914,31.6,8.153,25129.341,171.285,12.13,0.791,3
194,55,1141,156827,32,4340,21492,1853754,75.93,84339067,104.914,31.6,8.153,25129.341,171.285,12.13,0.791,3
194,56,987,157814,29,4369,19853,1873607,75.93,84339067,104.914,31.6,8.153,25129.341,171.285,12.13,0.791,3
194,57,948,158762,28,4397,21043,1894650,75.93,84339067,104.914,31.6,8.153,25129.341,171.285,12.13,0.791,3
194,58,1035,159797,34,4431,33559,1928209,75.93,84339067,104.914,31.6,8.153,25129.341,171.285,12.13,0.791,3
194,59,1182,160979,30,4461,36155,1964364,75.93,84339067,104.914,31.6,8.153,25129.341,171.285,12.13,0.791,3
194,60,1141,162120,28,4489,39230,2003594,75.93,84339067,104.914,31.6,8.153,25129.341,171.285,12.13,0.791,3
194,61,983,163103,26,4515,35600,2039194,75.93,84339067,104.914,31.6,8.153,25129.341,171.285,12.13,0.791,3
194,62,839,163942,25,4540,31525,2070719,63.89,84339067,104.914,31.6,8.153,25129.341,171.285,12.13,0.791,3
194,63,827,164769,23,4563,32325,2103044,63.89,84339067,104.914,31.6,8.153,25129.341,171.285,12.13,0.791,3
194,64,786,165555,22,4585,52305,2155349,63.89,84339067,104.914,31.6,8.153,25129.341,171.285,12.13,0.791,3
194,65,867,166422,24,4609,54234,2209583,63.89,84339067,104.914,31.6,8.153,25129.341,171.285,12.13,0.791,3
194,66,988,167410,21,4630,57829,2267412,63.89,84339067,104.914,31.6,8.153,25129.341,171.285,12.13,0.791,3
194,67,930,168340,18,4648,35846,2303258,63.89,84339067,104.914,31.6,8.153,25129.341,171.285,12.13,0.791,3
194,68,878,169218,21,4669,35335,2338593,63.89,84339067,104.914,31.6,8.153,25129.341,171.285,12.13,0.791,3
194,69,914,170132,23,4692,39361,2377954,63.89,84339067,104.914,31.6,8.153,25129.341,171.285,12.13,0.791,3
194,70,989,171121,19,4711,37225,2415179,63.89,84339067,104.914,31.6,8.153,25129.341,171.285,12.13,0.791,3
194,71,993,172114,18,4729,36521,2451700,63.89,84339067,104.914,31.6,8.153,25129.341,171.285,12.13,0.791,3
194,72,922,173036,17,4746,49190,2500890,63.89,84339067,104.914,31.6,8.153,25129.341,171.285,12.13,0.791,3
194,73,987,174023,17,4763,41013,2541903,63.89,84339067,104.914,31.6,8.153,25129.341,171.285,12.13,0.791,3
194,74,1195,175218,15,4778,45092,2586995,63.89,84339067,104.914,31.6,8.153,25129.341,171.285,12.13,0.791,3
194,75,1459,176677,14,4792,45176,2632171,63.89,84339067,104.914,31.6,8.153,25129.341,171.285,12.13,0.791,3
194,76,1562,178239,15,4807,42032,2674203,63.89,84339067,104.914,31.6,8.153,25129.341,171.285,12.13,0.791,3
194,77,1592,179831,18,4825,46800,2721003,63.89,84339067,104.914,31.6,8.153,25129.341,171.285,12.13,0.791,3
194,78,1467,181298,17,4842,52901,2773904,63.89,84339067,104.914,31.6,8.153,25129.341,171.285,12.13,0.791,3
194,79,1429,182727,19,4861,48412,2822316,63.89,84339067,104.914,31.6,8.153,25129.341,171.285,12.13,0.791,3
194,80,1304,184031,21,4882,41316,2863632,63.89,84339067,104.914,31.6,8.153,25129.341,171.285,12.13,0.791,3
194,81,1214,185245,23,4905,41112,2904744,63.89,84339067,104.914,31.6,8.153,25129.341,171.285,12.13,0.791,3
194,82,1248,186493,22,4927,40496,2945240,63.89,84339067,104.914,31.6,8.153,25129.341,171.285,12.13,0.791,3
194,83,1192,187685,23,4950,41413,2986653,63.89,84339067,104.914,31.6,8.153,25129.341,171.285,12.13,0.791,3
194,84,1212,188897,24,4974,42982,3029635,63.89,84339067,104.914,31.6,8.153,25129.341,171.285,12.13,0.791,3
194,85,1268,190165,27,5001,53486,3083121,63.89,84339067,104.914,31.6,8.153,25129.341,171.285,12.13,0.791,3
194,86,1492,191657,24,5025,52303,3135424,63.89,84339067,104.914,31.6,8.153,25129.341,171.285,12.13,0.791,3
194,87,1458,193115,21,5046,51198,3186622,63.89,84339067,104.914,31.6,8.153,25129.341,171.285,12.13,0.791,3
194,88,1396,194511,19,5065,45213,3231835,63.89,84339067,104.914,31.6,8.153,25129.341,171.285,12.13,0.791,3
194,89,1372,195883,17,5082,48309,3280144,63.89,84339067,104.914,31.6,8.153,25129.341,171.285,12.13,0.791,3
194,90,1356,197239,15,5097,51014,3331158,63.89,84339067,104.914,31.6,8.153,25129.341,171.285,12.13,0.791,3
194,91,1374,198613,18,5115,50492,3381650,63.89,84339067,104.914,31.6,8.153,25129.341,171.285,12.13,0.791,3
194,92,1293,199906,16,5131,52313,3433963,63.89,84339067,104.914,31.6,8.153,25129.341,171.285,12.13,0.791,3
194,93,1192,201098,19,5150,49714,3483677,63.89,84339067,104.914,31.6,8.153,25129.341,171.285,12.13,0.791,3
194,94,1186,202284,17,5167,52141,3535818,63.89,84339067,104.914,31.6,8.153,25129.341,171.285,12.13,0.791,3
194,95,1172,203456,19,5186,48248,3584066,63.89,84339067,104.914,31.6,8.153,25129.341,171.285,12.13,0.791,3
194,96,1154,204610,20,5206,46414,3630480,63.89,84339067,104.914,31.6,8.153,25129.341,171.285,12.13,0.791,3
194,97,1148,205758,19,5225,52193,3682673,63.89,84339067,104.914,31.6,8.153,25129.341,171.285,12.13,0.791,3
194,98,1086,206844,16,5241,50545,3733218,63.89,84339067,104.914,31.6,8.153,25129.341,171.285,12.13,0.791,3
194,99,1053,207897,19,5260,49302,3782520,63.89,84339067,104.914,31.6,8.153,25129.341,171.285,12.13,0.791,3
194,100,1041,208938,22,5282,50103,3832623,63.89,84339067,104.914,31.6,8.153,25129.341,171.285,12.13,0.791,3
194,101,1024,209962,18,5300,48787,3881410,63.89,84339067,104.914,31.6,8.153,25129.341,171.285,12.13,0.791,3
194,102,1003,210965,23,5323,48813,3930223,63.89,84339067,104.914,31.6,8.153,25129.341,171.285,12.13,0.791,3
194,103,1016,211981,21,5344,45232,3975455,63.89,84339067,104.914,31.6,8.153,25129.341,171.285,12.13,0.791,3
194,104,1012,212993,19,5363,46492,4021947,63.89,84339067,104.914,31.6,8.153,25129.341,171.285,12.13,0.791,3
194,105,1008,214001,19,5382,43231,4065178,63.89,84339067,104.914,31.6,8.153,25129.341,171.285,12.13,0.791,3
194,106,992,214993,20,5402,42320,4107498,63.89,84339067,104.914,31.6,8.153,25129.341,171.285,12.13,0.791,3
194,107,947,215940,17,5419,42411,4149909,63.89,84339067,104.914,31.6,8.153,25129.341,171.285,12.13,0.791,3
194,108,933,216873,21,5440,41215,4191124,63.89,84339067,104.914,31.6,8.153,25129.341,171.285,12.13,0.791,3
194,109,926,217799,18,5458,40943,4232067,63.89,84339067,104.914,31.6,8.153,25129.341,171.285,12.13,0.791,3
194,110,918,218717,17,5475,41310,4273377,63.89,84339067,104.914,31.6,8.153,25129.341,171.285,12.13,0.791,3
194,111,924,219641,16,5491,43404,4316781,63.89,84339067,104.914,31.6,8.153,25129.341,171.285,12.13,0.791,3
194,112,931,220572,17,5508,42846,4359627,63.89,84339067,104.914,31.6,8.153,25129.341,171.285,12.13,0.791,3
194,113,928,221500,18,5526,43404,4403031,42.59,84339067,104.914,31.6,8.153,25129.341,171.285,12.13,0.791,3
194,114,902,222402,19,5545,43343,4446374,42.59,84339067,104.914,31.6,8.153,25129.341,171.285,12.13,0.791,3
194,115,913,223315,18,5563,42986,4489360,42.59,84339067,104.914,31.6,8.153,25129.341,171.285,12.13,0.791,3
194,116,937,224252,17,5580,43312,4532672,42.59,84339067,104.914,31.6,8.153,25129.341,171.285,12.13,0.791,3
194,117,921,225173,16,5596,40016,4572688,42.59,84339067,104.914,31.6,8.153,25129.341,171.285,12.13,0.791,3
194,118,927,226100,17,5613,45283,4617971,42.59,84339067,104.914,31.6,8.153,25129.341,171.285,12.13,0.791,3
194,119,919,227019,17,5630,47412,4665383,42.59,84339067,104.914,31.6,8.153,25129.341,171.285,12.13,0.791,3
194,120,963,227982,15,5645,45712,4711095,42.59,84339067,104.914,31.6,8.153,25129.341,171.285,12.13,0.791,3
194,121,942,228924,14,5659,43236,4754331,42.59,84339067,104.914,31.6,8.153,25129.341,171.285,12.13,0.791,3
194,122,967,229891,15,5674,46492,4800823,42.59,84339067,104.914,31.6,8.153,25129.341,171.285,12.13,0.791,3
194,123,982,230873,17,5691,44846,4845669,42.59,84339067,104.914,31.6,8.153,25129.341,171.285,12.13,0.791,3
194,124,996,231869,19,5710,40247,4885916,42.59,84339067,104.914,31.6,8.153,25129.341,171.285,12.13,0.791,3
194,125,987,232856,18,5728,41301,4927217,42.59,84339067,104.914,31.6,8.153,25129.341,171.285,12.13,0.791,3
194,126,995,233851,19,5747,46249,4973466,42.59,84339067,104.914,31.6,8.153,25129.341,171.285,12.13,0.791,3
194,127,1083,234934,18,5765,53842,5027308,48.15,84339067,104.914,31.6,8.153,25129.341,171.285,12.13,0.791,3
194,128,1178,236112,19,5784,54494,5081802,48.15,84339067,104.914,31.6,8.153,25129.341,171.285,12.13,0.791,3
194,129,1153,237265,14,5798,56726,5138528,48.15,84339067,104.914,31.6,8.153,25129.341,171.285,12.13,0.791,3
194,130,1185,238450,15,5813,63842,5202370,48.15,84339067,104.914,31.6,8.153,25129.341,171.285,12.13,0.791,3
194,131,1172,239622,16,5829,61446,5263816,48.15,84339067,104.914,31.6,8.153,25129.341,171.285,12.13,0.791,3
194,132,1182,240804,15,5844,62219,5326035,48.15,84339067,104.914,31.6,8.153,25129.341,171.285,12.13,0.791,3
194,133,1193,241997,14,5858,61716,5387751,48.15,84339067,104.914,31.6,8.153,25129.341,171.285,12.13,0.791,3
194,134,1183,243180,15,5873,67237,5454988,48.15,84339067,104.914,31.6,8.153,25129.341,171.285,12.13,0.791,3
194,135,1212,244392,18,5891,66892,5521880,48.15,84339067,104.914,31.6,8.153,25129.341,171.285,12.13,0.791,3
194,136,1243,245635,21,5912,70192,5592072,48.15,84339067,104.914,31.6,8.153,25129.341,171.285,12.13,0.791,3
194,137,1226,246861,22,5934,67214,5659286,48.15,84339067,104.914,31.6,8.153,25129.341,171.285,12.13,0.791,3
194,138,1256,248117,21,5955,65956,5725242,48.15,84339067,104.914,31.6,8.153,25129.341,171.285,12.13,0.791,3
194,139,1192,249309,19,5974,74846,5800088,48.15,84339067,104.914,31.6,8.153,25129.341,171.285,12.13,0.791,3
194,140,1233,250542,22,5996,82318,5882406,48.15,84339067,104.914,31.6,8.153,25129.341,171.285,12.13,0.791,3
194,141,1263,251805,20,6016,87223,5969629,48.15,84339067,104.914,31.6,8.153,25129.341,171.285,12.13,0.791,3
194,142,1303,253108,23,6039,92301,6061930,48.15,84339067,104.914,31.6,8.153,25129.341,171.285,12.13,0.791,3
194,143,1412,254520,19,6058,92227,6154157,48.15,84339067,104.914,31.6,8.153,25129.341,171.285,12.13,0.791,3
194,144,1203,255723,22,6080,93007,6247164,48.15,84339067,104.914,31.6,8.153,25129.341,171.285,12.13,0.791,3
194,145,1309,257032,22,6102,80302,6327466,48.15,84339067,104.914,31.6,8.153,25129.341,171.285,12.13,0.791,3
194,146,1217,258249,19,6121,95943,6423409,48.15,84339067,104.914,31.6,8.153,25129.341,171.285,12.13,0.791,3
194,147,1443,259692,18,6139,98231,6521640,48.15,84339067,104.914,31.6,8.153,25129.341,171.285,12.13,0.791,3
194,148,1502,261194,24,6163,100109,6621749,48.15,84339067,104.914,31.6,8.153,25129.341,171.285,12.13,0.791,3
194,149,1313,262507,20,6183,106111,6727860,48.15,84339067,104.914,31.6,8.153,25129.341,171.285,12.13,0.791,3
194,150,1491,263998,26,6209,107814,6835674,48.15,84339067,104.914,31.6,8.153,25129.341,171.285,12.13,0.791,3
194,151,1517,265515,36,6245,101414,6937088,48.15,84339067,104.914,31.6,8.153,25129.341,171.285,12.13,0.791,3
194,152,1549,267064,39,6284,91302,7028390,48.15,84339067,104.914,31.6,8.153,25129.341,171.285,12.13,0.791,3
194,153,1482,268546,42,6326,110102,7138492,48.15,84339067,104.914,31.6,8.153,25129.341,171.285,12.13,0.791,3
194,154,1587,270133,44,6370,109443,7247935,44.44,84339067,104.914,31.6,8.153,25129.341,171.285,12.13,0.791,3
194,155,1572,271705,47,6417,107927,7355862,44.44,84339067,104.914,31.6,8.153,25129.341,171.285,12.13,0.791,3
194,156,1596,273301,45,6462,110225,7466087,44.44,84339067,104.914,31.6,8.153,25129.341,171.285,12.13,0.791,3
194,157,1642,274943,49,6511,117113,7583200,47.22,84339067,104.914,31.6,8.153,25129.341,171.285,12.13,0.791,3
194,158,1612,276555,53,6564,99497,7682697,47.22,84339067,104.914,31.6,8.153,25129.341,171.285,12.13,0.791,3
194,159,1673,278228,56,6620,96842,7779539,47.22,84339067,104.914,31.6,8.153,25129.341,171.285,12.13,0.791,3
194,160,1578,279806,53,6673,103925,7883464,47.22,84339067,104.914,31.6,8.153,25129.341,171.285,12.13,0.791,3
194,161,1703,281509,57,6730,110565,7994029,47.22,84339067,104.914,31.6,8.153,25129.341,171.285,12.13,0.791,3
194,162,1761,283270,52,6782,111193,8105222,52.78,84339067,104.914,31.6,8.153,25129.341,171.285,12.13,0.791,3
194,163,1673,284943,55,6837,107702,8212924,63.89,84339067,104.914,31.6,8.153,25129.341,171.285,12.13,0.791,3
194,164,1512,286455,58,6895,112213,8325137,63.89,84339067,104.914,31.6,8.153,25129.341,171.285,12.13,0.791,3
194,165,1671,288126,56,6951,98326,8423463,73.61,84339067,104.914,31.6,8.153,25129.341,171.285,12.13,0.791,3
194,166,1509,289635,48,6999,96097,8519560,73.61,84339067,104.914,31.6,8.153,25129.341,171.285,12.13,0.791,3
194,167,1527,291162,57,7056,112563,8632123,73.61,84339067,104.914,31.6,8.153,25129.341,171.285,12.13,0.791,3
194,168,1716,292878,63,7119,110412,8742535,73.61,84339067,104.914,31.6,8.153,25129.341,171.285,12.13,0.791,3
194,169,1742,294620,67,7186,112645,8855180,73.61,84339067,104.914,31.6,8.153,25129.341,171.285,12.13,0.791,3
194,170,1771,296391,63,7249,109985,8965165,73.61,84339067,104.914,31.6,8.153,25129.341,171.285,12.13,0.791,3
194,171,1648,298039,66,7315,111113,9076278,73.61,84339067,104.914,31.6,8.153,25129.341,171.285,12.13,0.791,3
194,172,1771,299810,62,7377,97416,9173694,73.61,84339067,104.914,31.6,8.153,25129.341,171.285,12.13,0.791,3
194,173,1538,301348,68,7445,95321,9269015,73.61,84339067,104.914,31.6,8.153,25129.341,171.285,12.13,0.791,3
194,174,1519,302867,61,7506,112942,9381957,69.91,84339067,104.914,31.6,8.153,25129.341,171.285,12.13,0.791,3
194,175,1743,304610,68,7574,114311,9496268,69.91,84339067,104.914,31.6,8.153,25129.341,171.285,12.13,0.791,3
194,176,1692,306302,65,7639,112102,9608370,69.91,84339067,104.914,31.6,8.153,25129.341,171.285,12.13,0.791,3
194,177,1767,308069,72,7711,113317,9721687,69.91,84339067,104.914,31.6,8.153,25129.341,171.285,12.13,0.791,3
194,178,1721,309790,74,7785,112885,9834572,69.91,84339067,104.914,31.6,8.153,25129.341,171.285,12.13,0.791,3
194,179,1665,311455,73,7858,102009,9936581,69.91,84339067,104.914,31.6,8.153,25129.341,171.285,12.13,0.791,3
194,180,1511,312966,71,7929,101119,10037700,69.91,84339067,104.914,31.6,8.153,25129.341,171.285,12.13,0.791,3
194,181,1467,314433,68,7997,115523,10153223,69.91,84339067,104.914,31.6,8.153,25129.341,171.285,12.13,0.791,3
194,182,1412,315845,65,8062,114940,10268163,69.91,84339067,104.914,31.6,8.153,25129.341,171.285,12.13,0.791,3
194,183,1427,317272,68,8130,112098,10380261,69.91,84339067,104.914,31.6,8.153,25129.341,171.285,12.13,0.791,3
194,184,1391,318663,65,8195,113546,10493807,69.91,84339067,104.914,31.6,8.153,25129.341,171.285,12.13,0.791,3
194,185,1407,320070,67,8262,114857,10608664,69.91,84339067,104.914,31.6,8.153,25129.341,171.285,12.13,0.791,3
194,186,1442,321512,63,8325,103219,10711883,69.91,84339067,104.914,31.6,8.153,25129.341,171.285,12.13,0.791,3
194,187,1502,323014,59,8384,104402,10816285,69.91,84339067,104.914,31.6,8.153,25129.341,171.285,12.13,0.791,3
194,188,1429,324443,57,8441,115632,10931917,69.91,84339067,104.914,31.6,8.153,25129.341,171.285,12.13,0.791,3
194,189,1603,326046,57,8498,112421,11044338,69.91,84339067,104.914,31.6,8.153,25129.341,171.285,12.13,0.791,3
194,190,1511,327557,55,8553,116608,11160946,69.91,84339067,104.914,31.6,8.153,25129.341,171.285,12.13,0.791,3
194,191,1581,329138,56,8609,117101,11278047,69.91,84339067,104.914,31.6,8.153,25129.341,171.285,12.13,0.791,3
194,192,1615,330753,58,8667,115295,11393342,69.91,84339067,104.914,31.6,8.153,25129.341,171.285,12.13,0.791,3
194,193,1629,332382,55,8722,113102,11506444,69.91,84339067,104.914,31.6,8.153,25129.341,171.285,12.13,0.791,3
194,194,1649,334031,56,8778,109301,11615745,69.91,84339067,104.914,31.6,8.153,25129.341,171.285,12.13,0.791,3
194,195,1502,335533,59,8837,115605,11731350,69.91,84339067,104.914,31.6,8.153,25129.341,171.285,12.13,0.791,3
194,196,1614,337147,58,8895,114992,11846342,69.91,84339067,104.914,31.6,8.153,25129.341,171.285,12.13,0.791,3
194,197,1632,338779,62,8957,115328,11961670,69.91,84339067,104.914,31.6,8.153,25129.341,171.285,12.13,0.791,3
194,198,1671,340450,57,9014,116103,12077773,69.91,84339067,104.914,31.6,8.153,25129.341,171.285,12.13,0.791,3
194,199,1693,342143,66,9080,117005,12194778,69.91,84339067,104.914,31.6,8.153,25129.341,171.285,12.13,0.791,3
194,200,1812,343955,73,9153,112131,12306909,69.91,84339067,104.914,31.6,8.153,25129.341,171.285,12.13,0.791,3
194,201,1723,345678,71,9224,101403,12408312,69.91,84339067,104.914,31.6,8.153,25129.341,171.285,12.13,0.791,3
194,202,1815,347493,72,9296,116249,12524561,69.91,84339067,104.914,31.6,8.153,25129.341,171.285,12.13,0.791,3
194,203,2026,349519,75,9371,0,12524561,69.91,84339067,104.914,31.6,8.153,25129.341,171.285,12.13,0.791,3
194,204,1894,351413,74,9445,0,12524561,69.91,84339067,104.914,31.6,8.153,25129.341,171.285,12.13,0.791,3
196,1,11,44,0,0,23,1510,93.52,45741000,213.759,16.4,2.168,1697.707,213.333,2.5,0.516,4
196,2,0,44,0,0,0,1510,93.52,45741000,213.759,16.4,2.168,1697.707,213.333,2.5,0.516,4
196,3,1,45,0,0,0,1510,93.52,45741000,213.759,16.4,2.168,1697.707,213.333,2.5,0.516,4
196,4,3,48,0,0,0,1510,93.52,45741000,213.759,16.4,2.168,1697.707,213.333,2.5,0.516,4
196,5,0,48,0,0,0,1510,93.52,45741000,213.759,16.4,2.168,1697.707,213.333,2.5,0.516,4
196,6,4,52,0,0,231,3160,93.52,45741000,213.759,16.4,2.168,1697.707,213.333,2.5,0.516,4
196,7,0,52,0,0,150,3310,93.52,45741000,213.759,16.4,2.168,1697.707,213.333,2.5,0.516,4
196,8,0,52,0,0,214,3524,93.52,45741000,213.759,16.4,2.168,1697.707,213.333,2.5,0.516,4
196,9,1,53,0,0,338,3862,93.52,45741000,213.759,16.4,2.168,1697.707,213.333,2.5,0.516,4
196,10,0,53,0,0,439,4301,93.52,45741000,213.759,16.4,2.168,1697.707,213.333,2.5,0.516,4
196,11,0,53,0,0,0,4301,93.52,45741000,213.759,16.4,2.168,1697.707,213.333,2.5,0.516,4
196,12,0,53,0,0,169,5025,93.52,45741000,213.759,16.4,2.168,1697.707,213.333,2.5,0.516,4
196,13,1,54,0,0,639,5664,93.52,45741000,213.759,16.4,2.168,1697.707,213.333,2.5,0.516,4
196,14,0,54,0,0,625,6661,93.52,45741000,213.759,16.4,2.168,1697.707,213.333,2.5,0.516,4
196,15,1,55,0,0,0,6661,93.52,45741000,213.759,16.4,2.168,1697.707,213.333,2.5,0.516,4
196,16,0,55,0,0,0,6661,93.52,45741000,213.759,16.4,2.168,1697.707,213.333,2.5,0.516,4
196,17,0,55,0,0,0,6661,93.52,45741000,213.759,16.4,2.168,1697.707,213.333,2.5,0.516,4
196,18,0,55,0,0,0,6661,93.52,45741000,213.759,16.4,2.168,1697.707,213.333,2.5,0.516,4
196,19,0,55,0,0,0,6661,93.52,45741000,213.759,16.4,2.168,1697.707,213.333,2.5,0.516,4
196,20,0,55,0,0,0,6661,93.52,45741000,213.759,16.4,2.168,1697.707,213.333,2.5,0.516,4
196,21,1,56,0,0,0,6661,93.52,45741000,213.759,16.4,2.168,1697.707,213.333,2.5,0.516,4
196,22,2,58,0,0,0,6661,93.52,45741000,213.759,16.4,2.168,1697.707,213.333,2.5,0.516,4
196,23,3,61,0,0,0,6661,93.52,45741000,213.759,16.4,2.168,1697.707,213.333,2.5,0.516,4
196,24,13,74,0,0,0,6661,93.52,45741000,213.759,16.4,2.168,1697.707,213.333,2.5,0.516,4
196,25,1,75,0,0,0,6661,93.52,45741000,213.759,16.4,2.168,1697.707,213.333,2.5,0.516,4
196,26,0,75,0,0,0,6661,93.52,45741000,213.759,16.4,2.168,1697.707,213.333,2.5,0.516,4
196,27,4,79,0,0,0,6661,93.52,45741000,213.759,16.4,2.168,1697.707,213.333,2.5,0.516,4
196,28,0,79,0,0,0,6661,93.52,45741000,213.759,16.4,2.168,1697.707,213.333,2.5,0.516,4
196,29,0,79,0,0,0,6661,93.52,45741000,213.759,16.4,2.168,1697.707,213.333,2.5,0.516,4
196,30,2,81,0,0,0,6661,93.52,45741000,213.759,16.4,2.168,1697.707,213.333,2.5,0.516,4
196,31,2,83,0,0,0,6661,93.52,45741000,213.759,16.4,2.168,1697.707,213.333,2.5,0.516,4
196,32,2,85,0,0,0,6661,93.52,45741000,213.759,16.4,2.168,1697.707,213.333,2.5,0.516,4
196,33,3,88,0,0,0,6661,93.52,45741000,213.759,16.4,2.168,1697.707,213.333,2.5,0.516,4
196,34,1,89,0,0,0,6661,93.52,45741000,213.759,16.4,2.168,1697.707,213.333,2.5,0.516,4
196,35,8,97,0,0,0,6661,93.52,45741000,213.759,16.4,2.168,1697.707,213.333,2.5,0.516,4
196,36,1,98,0,0,0,6661,89.81,45741000,213.759,16.4,2.168,1697.707,213.333,2.5,0.516,4
196,37,0,98,0,0,0,6661,89.81,45741000,213.759,16.4,2.168,1697.707,213.333,2.5,0.516,4
196,38,3,101,0,0,0,6661,89.81,45741000,213.759,16.4,2.168,1697.707,213.333,2.5,0.516,4
196,39,0,101,0,0,0,6661,89.81,45741000,213.759,16.4,2.168,1697.707,213.333,2.5,0.516,4
196,40,15,116,0,0,0,6661,89.81,45741000,213.759,16.4,2.168,1697.707,213.333,2.5,0.516,4
196,41,5,121,0,0,0,6661,89.81,45741000,213.759,16.4,2.168,1697.707,213.333,2.5,0.516,4
196,42,1,122,0,0,0,6661,89.81,45741000,213.759,16.4,2.168,1697.707,213.333,2.5,0.516,4
196,43,4,126,0,0,0,6661,89.81,45741000,213.759,16.4,2.168,1697.707,213.333,2.5,0.516,4
196,44,13,139,0,0,0,6661,89.81,45741000,213.759,16.4,2.168,1697.707,213.333,2.5,0.516,4
196,45,21,160,0,0,0,6661,89.81,45741000,213.759,16.4,2.168,1697.707,213.333,2.5,0.516,4
196,46,43,203,0,0,0,6661,89.81,45741000,213.759,16.4,2.168,1697.707,213.333,2.5,0.516,4
196,47,24,227,0,0,0,6661,89.81,45741000,213.759,16.4,2.168,1697.707,213.333,2.5,0.516,4
196,48,0,227,0,0,0,6661,86.11,45741000,213.759,16.4,2.168,1697.707,213.333,2.5,0.516,4
196,49,33,260,0,0,0,6661,86.11,45741000,213.759,16.4,2.168,1697.707,213.333,2.5,0.516,4
196,50,0,260,0,0,0,6661,86.11,45741000,213.759,16.4,2.168,1697.707,213.333,2.5,0.516,4
196,51,-115,145,0,0,0,6661,86.11,45741000,213.759,16.4,2.168,1697.707,213.333,2.5,0.516,4
196,52,15,160,0,0,0,6661,86.11,45741000,213.759,16.4,2.168,1697.707,213.333,2.5,0.516,4
196,53,15,175,0,0,0,6661,86.11,45741000,213.759,16.4,2.168,1697.707,213.333,2.5,0.516,4
196,54,23,198,0,0,0,6661,86.11,45741000,213.759,16.4,2.168,1697.707,213.333,2.5,0.516,4
196,55,14,212,0,0,0,6661,86.11,45741000,213.759,16.4,2.168,1697.707,213.333,2.5,0.516,4
196,56,10,222,0,0,0,6661,80.56,45741000,213.759,16.4,2.168,1697.707,213.333,2.5,0.516,4
196,57,31,253,0,0,0,6661,80.56,45741000,213.759,16.4,2.168,1697.707,213.333,2.5,0.516,4
196,58,28,281,0,0,0,6661,80.56,45741000,213.759,16.4,2.168,1697.707,213.333,2.5,0.516,4
196,59,36,317,0,0,0,6661,80.56,45741000,213.759,16.4,2.168,1697.707,213.333,2.5,0.516,4
196,60,12,329,0,0,0,6661,80.56,45741000,213.759,16.4,2.168,1697.707,213.333,2.5,0.516,4
196,61,84,413,0,0,0,6661,80.56,45741000,213.759,16.4,2.168,1697.707,213.333,2.5,0.516,4
196,62,45,458,0,0,0,6661,80.56,45741000,213.759,16.4,2.168,1697.707,213.333,2.5,0.516,4
196,63,-1,457,0,0,0,6661,80.56,45741000,213.759,16.4,2.168,1697.707,213.333,2.5,0.516,4
196,64,32,489,0,0,0,6661,80.56,45741000,213.759,16.4,2.168,1697.707,213.333,2.5,0.516,4
196,65,18,507,0,0,0,6661,77.78,45741000,213.759,16.4,2.168,1697.707,213.333,2.5,0.516,4
196,66,15,522,0,0,0,6661,77.78,45741000,213.759,16.4,2.168,1697.707,213.333,2.5,0.516,4
196,67,35,557,0,0,0,6661,77.78,45741000,213.759,16.4,2.168,1697.707,213.333,2.5,0.516,4
196,68,36,593,0,0,0,6661,77.78,45741000,213.759,16.4,2.168,1697.707,213.333,2.5,0.516,4
196,69,23,616,0,0,0,6661,77.78,45741000,213.759,16.4,2.168,1697.707,213.333,2.5,0.516,4
196,70,30,646,0,0,0,6661,77.78,45741000,213.759,16.4,2.168,1697.707,213.333,2.5,0.516,4
196,71,11,657,0,0,0,6661,77.78,45741000,213.759,16.4,2.168,1697.707,213.333,2.5,0.516,4
196,72,8,665,0,0,0,6661,77.78,45741000,213.759,16.4,2.168,1697.707,213.333,2.5,0.516,4
196,73,14,679,0,0,0,6661,84.26,45741000,213.759,16.4,2.168,1697.707,213.333,2.5,0.516,4
196,74,6,685,0,0,0,6661,84.26,45741000,213.759,16.4,2.168,1697.707,213.333,2.5,0.516,4
196,75,0,685,0,0,0,6661,84.26,45741000,213.759,16.4,2.168,1697.707,213.333,2.5,0.516,4
196,76,11,696,0,0,0,6661,84.26,45741000,213.759,16.4,2.168,1697.707,213.333,2.5,0.516,4
196,77,9,705,0,0,0,6661,84.26,45741000,213.759,16.4,2.168,1697.707,213.333,2.5,0.516,4
196,78,19,724,0,0,0,6661,84.26,45741000,213.759,16.4,2.168,1697.707,213.333,2.5,0.516,4
196,79,8,732,0,0,0,6661,84.26,45741000,213.759,16.4,2.168,1697.707,213.333,2.5,0.516,4
196,80,9,741,0,0,0,6661,84.26,45741000,213.759,16.4,2.168,1697.707,213.333,2.5,0.516,4
196,81,14,755,0,0,0,6661,84.26,45741000,213.759,16.4,2.168,1697.707,213.333,2.5,0.516,4
196,82,0,755,0,0,0,6661,84.26,45741000,213.759,16.4,2.168,1697.707,213.333,2.5,0.516,4
196,83,15,770,0,0,0,6661,87.04,45741000,213.759,16.4,2.168,1697.707,213.333,2.5,0.516,4
196,84,4,774,0,0,0,6661,87.04,45741000,213.759,16.4,2.168,1697.707,213.333,2.5,0.516,4
196,85,23,797,0,0,0,6661,87.04,45741000,213.759,16.4,2.168,1697.707,213.333,2.5,0.516,4
196,86,8,805,0,0,0,6661,87.04,45741000,213.759,16.4,2.168,1697.707,213.333,2.5,0.516,4
196,87,16,821,0,0,0,6661,87.04,45741000,213.759,16.4,2.168,1697.707,213.333,2.5,0.516,4
196,88,12,833,0,0,0,6661,87.04,45741000,213.759,16.4,2.168,1697.707,213.333,2.5,0.516,4
196,89,15,848,0,0,0,6661,87.04,45741000,213.759,16.4,2.168,1697.707,213.333,2.5,0.516,4
196,90,11,859,0,0,0,6661,87.04,45741000,213.759,16.4,2.168,1697.707,213.333,2.5,0.516,4
196,91,11,870,0,0,2059,194872,87.04,45741000,213.759,16.4,2.168,1697.707,213.333,2.5,0.516,4
196,92,19,889,0,0,0,194872,87.04,45741000,213.759,16.4,2.168,1697.707,213.333,2.5,0.516,4
196,93,4,893,0,0,3349,200179,87.04,45741000,213.759,16.4,2.168,1697.707,213.333,2.5,0.516,4
196,94,9,902,0,0,0,200179,87.04,45741000,213.759,16.4,2.168,1697.707,213.333,2.5,0.516,4
196,95,9,911,0,0,0,200179,87.04,45741000,213.759,16.4,2.168,1697.707,213.333,2.5,0.516,4
196,96,16,927,0,0,3103,210446,87.04,45741000,213.759,16.4,2.168,1697.707,213.333,2.5,0.516,4
196,97,12,939,0,0,2414,212860,87.04,45741000,213.759,16.4,2.168,1697.707,213.333,2.5,0.516,4
196,98,14,953,0,0,3451,216311,87.04,45741000,213.759,16.4,2.168,1697.707,213.333,2.5,0.516,4
196,99,18,971,0,0,3316,219627,87.04,45741000,213.759,16.4,2.168,1697.707,213.333,2.5,0.516,4
196,100,6,977,0,0,2048,221675,87.04,45741000,213.759,16.4,2.168,1697.707,213.333,2.5,0.516,4
196,101,23,1000,0,0,0,221675,81.48,45741000,213.759,16.4,2.168,1697.707,213.333,2.5,0.516,4
196,102,6,1006,0,0,0,221675,81.48,45741000,213.759,16.4,2.168,1697.707,213.333,2.5,0.516,4
196,103,7,1013,0,0,1702,228105,81.48,45741000,213.759,16.4,2.168,1697.707,213.333,2.5,0.516,4
196,104,12,1025,0,0,2575,230680,81.48,45741000,213.759,16.4,2.168,1697.707,213.333,2.5,0.516,4
196,105,4,1029,0,0,0,230680,81.48,45741000,213.759,16.4,2.168,1697.707,213.333,2.5,0.516,4
196,106,11,1040,0,0,2405,235015,81.48,45741000,213.759,16.4,2.168,1697.707,213.333,2.5,0.516,4
196,107,3,1043,0,0,3696,238709,81.48,45741000,213.759,16.4,2.168,1697.707,213.333,2.5,0.516,4
196,108,8,1051,0,0,0,238709,79.63,45741000,213.759,16.4,2.168,1697.707,213.333,2.5,0.516,4
196,109,5,1056,0,0,0,238709,79.63,45741000,213.759,16.4,2.168,1697.707,213.333,2.5,0.516,4
196,110,6,1062,0,0,2196,247646,79.63,45741000,213.759,16.4,2.168,1697.707,213.333,2.5,0.516,4
196,111,3,1065,0,0,2383,250029,79.63,45741000,213.759,16.4,2.168,1697.707,213.333,2.5,0.516,4
196,112,4,1069,0,0,2098,252127,79.63,45741000,213.759,16.4,2.168,1697.707,213.333,2.5,0.516,4
196,113,3,1072,0,0,2128,254255,79.63,45741000,213.759,16.4,2.168,1697.707,213.333,2.5,0.516,4
196,114,3,1075,0,0,1785,256040,79.63,45741000,213.759,16.4,2.168,1697.707,213.333,2.5,0.516,4
196,115,0,1075,0,0,0,256040,79.63,45741000,213.759,16.4,2.168,1697.707,213.333,2.5,0.516,4
196,116,14,1089,1,1,1937,260465,79.63,45741000,213.759,16.4,2.168,1697.707,213.333,2.5,0.516,4
196,117,14,1103,0,1,1812,262277,79.63,45741000,213.759,16.4,2.168,1697.707,213.333,2.5,0.516,4
196,118,12,1115,1,2,1885,264162,76.85,45741000,213.759,16.4,2.168,1697.707,213.333,2.5,0.516,4
196,119,13,1128,0,2,2694,266856,76.85,45741000,213.759,16.4,2.168,1697.707,213.333,2.5,0.516,4
196,120,7,1135,0,2,0,266856,76.85,45741000,213.759,16.4,2.168,1697.707,213.333,2.5,0.516,4
196,121,5,1140,0,2,3229,272805,76.85,45741000,213.759,16.4,2.168,1697.707,213.333,2.5,0.516,4
196,122,7,1147,0,2,2550,275355,76.85,45741000,213.759,16.4,2.168,1697.707,213.333,2.5,0.516,4
196,123,7,1154,1,3,0,275355,76.85,45741000,213.759,16.4,2.168,1697.707,213.333,2.5,0.516,4
196,124,22,1176,1,4,2485,280747,76.85,45741000,213.759,16.4,2.168,1697.707,213.333,2.5,0.516,4
196,125,6,1182,0,4,1765,282512,76.85,45741000,213.759,16.4,2.168,1697.707,213.333,2.5,0.516,4
196,126,13,1195,1,5,2278,284790,76.85,45741000,213.759,16.4,2.168,1697.707,213.333,2.5,0.516,4
196,127,8,1203,0,5,3577,288367,76.85,45741000,213.759,16.4,2.168,1697.707,213.333,2.5,0.516,4
196,128,10,1213,0,5,2334,290701,76.85,45741000,213.759,16.4,2.168,1697.707,213.333,2.5,0.516,4
196,129,10,1223,0,5,0,290701,76.85,45741000,213.759,16.4,2.168,1697.707,213.333,2.5,0.516,4
196,130,31,1254,1,6,3204,296601,76.85,45741000,213.759,16.4,2.168,1697.707,213.333,2.5,0.516,4
196,131,13,1267,0,6,2435,299036,76.85,45741000,213.759,16.4,2.168,1697.707,213.333,2.5,0.516,4
196,132,16,1283,1,7,2250,301286,81.48,45741000,213.759,16.4,2.168,1697.707,213.333,2.5,0.516,4
196,133,14,1297,2,9,3199,304485,81.48,45741000,213.759,16.4,2.168,1697.707,213.333,2.5,0.516,4
196,134,16,1313,0,9,4108,308503,81.48,45741000,213.759,16.4,2.168,1697.707,213.333,2.5,0.516,4
196,135,19,1332,0,9,4289,312792,81.48,45741000,213.759,16.4,2.168,1697.707,213.333,2.5,0.516,4
196,136,21,1353,2,11,0,312792,81.48,45741000,213.759,16.4,2.168,1697.707,213.333,2.5,0.516,4
196,137,32,1385,1,12,0,312792,81.48,45741000,213.759,16.4,2.168,1697.707,213.333,2.5,0.516,4
196,138,49,1434,1,13,4261,325637,81.48,45741000,213.759,16.4,2.168,1697.707,213.333,2.5,0.516,4
196,139,66,1500,0,13,3905,329542,81.48,45741000,213.759,16.4,2.168,1697.707,213.333,2.5,0.516,4
196,140,60,1560,2,15,4125,333667,81.48,45741000,213.759,16.4,2.168,1697.707,213.333,2.5,0.516,4
196,141,43,1603,0,15,3046,336713,81.48,45741000,213.759,16.4,2.168,1697.707,213.333,2.5,0.516,4
196,142,0,1603,0,15,4131,340844,81.48,45741000,213.759,16.4,2.168,1697.707,213.333,2.5,0.516,4
196,143,147,1750,4,19,0,340844,81.48,45741000,213.759,16.4,2.168,1697.707,213.333,2.5,0.516,4
196,144,98,1848,0,19,0,340844,81.48,45741000,213.759,16.4,2.168,1697.707,213.333,2.5,0.516,4
196,145,0,1848,0,19,3457,351845,81.48,45741000,213.759,16.4,2.168,1697.707,213.333,2.5,0.516,4
196,146,415,2263,0,19,3212,355057,81.48,45741000,213.759,16.4,2.168,1697.707,213.333,2.5,0.516,4
196,147,99,2362,3,22,4232,359289,81.48,45741000,213.759,16.4,2.168,1697.707,213.333,2.5,0.516,4
196,148,64,2426,3,25,4513,363802,81.48,45741000,213.759,16.4,2.168,1697.707,213.333,2.5,0.516,4
196,149,98,2524,1,26,3621,367423,81.48,45741000,213.759,16.4,2.168,1697.707,213.333,2.5,0.516,4
196,150,155,2679,2,28,0,367423,81.48,45741000,213.759,16.4,2.168,1697.707,213.333,2.5,0.516,4
196,151,77,2756,0,28,0,367423,81.48,45741000,213.759,16.4,2.168,1697.707,213.333,2.5,0.516,4
196,152,91,2847,1,29,2397,378185,81.48,45741000,213.759,16.4,2.168,1697.707,213.333,2.5,0.516,4
196,153,81,2928,1,30,3564,381749,81.48,45741000,213.759,16.4,2.168,1697.707,213.333,2.5,0.516,4
196,154,44,2972,2,32,4133,385882,81.48,45741000,213.759,16.4,2.168,1697.707,213.333,2.5,0.516,4
196,155,65,3037,0,32,5453,391335,81.48,45741000,213.759,16.4,2.168,1697.707,213.333,2.5,0.516,4
196,156,75,3112,0,32,4540,395875,81.48,45741000,213.759,16.4,2.168,1697.707,213.333,2.5,0.516,4
196,157,176,3288,1,33,0,395875,81.48,45741000,213.759,16.4,2.168,1697.707,213.333,2.5,0.516,4
196,158,65,3353,2,35,0,395875,81.48,45741000,213.759,16.4,2.168,1697.707,213.333,2.5,0.516,4
196,159,186,3539,4,39,6439,411666,81.48,45741000,213.759,16.4,2.168,1697.707,213.333,2.5,0.516,4
196,160,128,3667,2,41,4242,415908,81.48,45741000,213.759,16.4,2.168,1697.707,213.333,2.5,0.516,4
196,161,109,3776,3,44,1989,417897,81.48,45741000,213.759,16.4,2.168,1697.707,213.333,2.5,0.516,4
196,162,124,3900,2,46,2301,420198,81.48,45741000,213.759,16.4,2.168,1697.707,213.333,2.5,0.516,4
196,163,201,4101,0,46,3016,423214,81.48,45741000,213.759,16.4,2.168,1697.707,213.333,2.5,0.516,4
196,164,190,4291,2,48,0,423214,81.48,45741000,213.759,16.4,2.168,1697.707,213.333,2.5,0.516,4
196,165,86,4377,1,49,0,423214,81.48,45741000,213.759,16.4,2.168,1697.707,213.333,2.5,0.516,4
196,166,326,4703,3,52,3473,434243,81.48,45741000,213.759,16.4,2.168,1697.707,213.333,2.5,0.516,4
196,167,96,4799,3,55,2003,436246,81.48,45741000,213.759,16.4,2.168,1697.707,213.333,2.5,0.516,4
196,168,0,4799,0,55,2849,439025,81.48,45741000,213.759,16.4,2.168,1697.707,213.333,2.5,0.516,4
196,169,324,5123,3,58,2685,441710,81.48,45741000,213.759,16.4,2.168,1697.707,213.333,2.5,0.516,4
196,170,143,5266,2,60,2636,444346,81.48,45741000,213.759,16.4,2.168,1697.707,213.333,2.5,0.516,4
196,171,114,5380,0,60,0,444346,81.48,45741000,213.759,16.4,2.168,1697.707,213.333,2.5,0.516,4
196,172,214,5594,1,61,0,451737,81.48,45741000,213.759,16.4,2.168,1697.707,213.333,2.5,0.516,4
196,173,423,6017,2,63,0,453593,78.7,45741000,213.759,16.4,2.168,1697.707,213.333,2.5,0.516,4
196,174,270,6287,0,63,0,457128,78.7,45741000,213.759,16.4,2.168,1697.707,213.333,2.5,0.516,4
196,175,181,6468,0,63,0,460690,78.7,45741000,213.759,16.4,2.168,1697.707,213.333,2.5,0.516,4
196,176,244,6712,1,64,0,463618,78.7,45741000,213.759,16.4,2.168,1697.707,213.333,2.5,0.516,4
196,177,167,6879,5,69,0,465600,78.7,45741000,213.759,16.4,2.168,1697.707,213.333,2.5,0.516,4
196,178,185,7064,1,70,0,469003,78.7,45741000,213.759,16.4,2.168,1697.707,213.333,2.5,0.516,4
196,179,154,7218,1,71,0,473456,73.15,45741000,213.759,16.4,2.168,1697.707,213.333,2.5,0.516,4
196,180,146,7364,0,71,0,477473,73.15,45741000,213.759,16.4,2.168,1697.707,213.333,2.5,0.516,4
196,181,166,7530,2,73,0,478687,73.15,45741000,213.759,16.4,2.168,1697.707,213.333,2.5,0.516,4
196,182,247,7777,2,75,0,480037,73.15,45741000,213.759,16.4,2.168,1697.707,213.333,2.5,0.516,4
196,183,240,8017,0,75,0,482658,73.15,45741000,213.759,16.4,2.168,1697.707,213.333,2.5,0.516,4
196,184,112,8129,0,75,0,486658,73.15,45741000,213.759,16.4,2.168,1697.707,213.333,2.5,0.516,4
196,185,158,8287,0,75,0,489264,73.15,45741000,213.759,16.4,2.168,1697.707,213.333,2.5,0.516,4
196,186,204,8491,4,79,0,491547,73.15,45741000,213.759,16.4,2.168,1697.707,213.333,2.5,0.516,4
196,187,171,8662,0,79,0,493595,73.15,45741000,213.759,16.4,2.168,1697.707,213.333,2.5,0.516,4
196,188,146,8808,2,81,0,495696,73.15,45741000,213.759,16.4,2.168,1697.707,213.333,2.5,0.516,4
196,189,157,8965,1,82,0,497498,73.15,45741000,213.759,16.4,2.168,1697.707,213.333,2.5,0.516,4
196,190,117,9082,2,84,0,501040,73.15,45741000,213.759,16.4,2.168,1697.707,213.333,2.5,0.516,4
196,191,178,9260,1,85,1789,502829,73.15,45741000,213.759,16.4,2.168,1697.707,213.333,2.5,0.516,4
196,192,182,9442,0,85,2833,505662,73.15,45741000,213.759,16.4,2.168,1697.707,213.333,2.5,0.516,4
196,193,96,9538,1,86,2197,507859,73.15,45741000,213.759,16.4,2.168,1697.707,213.333,2.5,0.516,4
196,194,163,9701,7,93,0,508899,73.15,45741000,213.759,16.4,2.168,1697.707,213.333,2.5,0.516,4
196,195,100,9801,0,93,2257,511156,73.15,45741000,213.759,16.4,2.168,1697.707,213.333,2.5,0.516,4
196,196,63,9864,1,94,2258,513414,73.15,45741000,213.759,16.4,2.168,1697.707,213.333,2.5,0.516,4
196,197,81,9945,1,95,1509,514923,73.15,45741000,213.759,16.4,2.168,1697.707,213.333,2.5,0.516,4
196,198,124,10069,0,95,3635,518558,69.44,45741000,213.759,16.4,2.168,1697.707,213.333,2.5,0.516,4
196,199,48,10117,1,96,1892,520450,69.44,45741000,213.759,16.4,2.168,1697.707,213.333,2.5,0.516,4
196,200,217,10334,0,96,1836,522286,69.44,45741000,213.759,16.4,2.168,1697.707,213.333,2.5,0.516,4
196,201,121,10455,0,96,0,522286,69.44,45741000,213.759,16.4,2.168,1697.707,213.333,2.5,0.516,4
196,202,135,10590,1,97,0,522286,69.44,45741000,213.759,16.4,2.168,1697.707,213.333,2.5,0.516,4
196,203,101,10691,0,97,0,522286,69.44,45741000,213.759,16.4,2.168,1697.707,213.333,2.5,0.516,4
196,204,97,10788,0,97,0,522286,69.44,45741000,213.759,16.4,2.168,1697.707,213.333,2.5,0.516,4
197,1,69,549,2,13,0,0,88.89,43733759,77.39,41.4,16.462,7894.393,539.849,7.11,0.751,4
197,2,245,794,7,20,0,0,88.89,43733759,77.39,41.4,16.462,7894.393,539.849,7.11,0.751,4
197,3,103,897,2,22,0,0,88.89,43733759,77.39,41.4,16.462,7894.393,539.849,7.11,0.751,4
197,4,175,1072,5,27,0,0,88.89,43733759,77.39,41.4,16.462,7894.393,539.849,7.11,0.751,4
197,5,153,1225,5,32,0,0,88.89,43733759,77.39,41.4,16.462,7894.393,539.849,7.11,0.751,4
197,6,83,1308,5,37,0,0,88.89,43733759,77.39,41.4,16.462,7894.393,539.849,7.11,0.751,4
197,7,11,1319,1,38,0,0,88.89,43733759,77.39,41.4,16.462,7894.393,539.849,7.11,0.751,4
197,8,143,1462,7,45,0,0,88.89,43733759,77.39,41.4,16.462,7894.393,539.849,7.11,0.751,4
197,9,206,1668,7,52,0,20608,88.89,43733759,77.39,41.4,16.462,7894.393,539.849,7.11,0.751,4
197,10,224,1892,5,57,2914,23522,88.89,43733759,77.39,41.4,16.462,7894.393,539.849,7.11,0.751,4
197,11,311,2203,12,69,0,23522,88.89,43733759,77.39,41.4,16.462,7894.393,539.849,7.11,0.751,4
197,12,308,2511,4,73,0,23522,88.89,43733759,77.39,41.4,16.462,7894.393,539.849,7.11,0.751,4
197,13,266,2777,10,83,0,35153,88.89,43733759,77.39,41.4,16.462,7894.393,539.849,7.11,0.751,4
197,14,325,3102,10,93,0,35153,88.89,43733759,77.39,41.4,16.462,7894.393,539.849,7.11,0.751,4
197,15,270,3372,5,98,0,35153,88.89,43733759,77.39,41.4,16.462,7894.393,539.849,7.11,0.751,4
197,16,392,3764,10,108,0,42823,88.89,43733759,77.39,41.4,16.462,7894.393,539.849,7.11,0.751,4
197,17,397,4161,8,116,4273,47096,88.89,43733759,77.39,41.4,16.462,7894.393,539.849,7.11,0.751,4
197,18,301,4462,9,125,0,47096,88.89,43733759,77.39,41.4,16.462,7894.393,539.849,7.11,0.751,4
197,19,644,5106,8,133,0,57111,88.89,43733759,77.39,41.4,16.462,7894.393,539.849,7.11,0.751,4
197,20,343,5449,8,141,0,57111,88.89,43733759,77.39,41.4,16.462,7894.393,539.849,7.11,0.751,4
197,21,261,5710,10,151,0,57111,88.89,43733759,77.39,41.4,16.462,7894.393,539.849,7.11,0.751,4
197,22,415,6125,10,161,0,57111,88.89,43733759,77.39,41.4,16.462,7894.393,539.849,7.11,0.751,4
197,23,467,6592,13,174,0,72296,88.89,43733759,77.39,41.4,16.462,7894.393,539.849,7.11,0.751,4
197,24,578,7170,13,187,0,72296,88.89,43733759,77.39,41.4,16.462,7894.393,539.849,7.11,0.751,4
197,25,477,7647,6,193,0,72296,88.89,43733759,77.39,41.4,16.462,7894.393,539.849,7.11,0.751,4
197,26,478,8125,8,201,0,89373,88.89,43733759,77.39,41.4,16.462,7894.393,539.849,7.11,0.751,4
197,27,492,8617,8,209,4146,93519,88.89,43733759,77.39,41.4,16.462,7894.393,539.849,7.11,0.751,4
197,28,392,9009,11,220,5200,98719,88.89,43733759,77.39,41.4,16.462,7894.393,539.849,7.11,0.751,4
197,29,401,9410,19,239,5825,104544,88.89,43733759,77.39,41.4,16.462,7894.393,539.849,7.11,0.751,4
197,30,456,9866,11,250,7315,111859,88.89,43733759,77.39,41.4,16.462,7894.393,539.849,7.11,0.751,4
197,31,540,10406,11,261,6686,118545,88.89,43733759,77.39,41.4,16.462,7894.393,539.849,7.11,0.751,4
197,32,455,10861,11,272,4207,122752,88.89,43733759,77.39,41.4,16.462,7894.393,539.849,7.11,0.751,4
197,33,550,11411,7,279,6971,129723,88.89,43733759,77.39,41.4,16.462,7894.393,539.849,7.11,0.751,4
197,34,502,11913,9,288,4869,134592,88.89,43733759,77.39,41.4,16.462,7894.393,539.849,7.11,0.751,4
197,35,418,12331,15,303,5167,139759,88.89,43733759,77.39,41.4,16.462,7894.393,539.849,7.11,0.751,4
197,36,366,12697,13,316,4524,144283,88.89,43733759,77.39,41.4,16.462,7894.393,539.849,7.11,0.751,4
197,37,487,13184,11,327,7286,151569,88.89,43733759,77.39,41.4,16.462,7894.393,539.849,7.11,0.751,4
197,38,507,13691,13,340,7586,159155,88.89,43733759,77.39,41.4,16.462,7894.393,539.849,7.11,0.751,4
197,39,504,14195,21,361,7952,167107,88.89,43733759,77.39,41.4,16.462,7894.393,539.849,7.11,0.751,4
197,40,515,14710,15,376,9296,176403,88.89,43733759,77.39,41.4,16.462,7894.393,539.849,7.11,0.751,4
197,41,522,15232,15,391,5149,181552,88.89,43733759,77.39,41.4,16.462,7894.393,539.849,7.11,0.751,4
197,42,416,15648,17,408,5755,187307,88.89,43733759,77.39,41.4,16.462,7894.393,539.849,7.11,0.751,4
197,43,375,16023,17,425,4940,192247,88.89,43733759,77.39,41.4,16.462,7894.393,539.849,7.11,0.751,4
197,44,402,16425,14,439,10248,202495,88.89,43733759,77.39,41.4,16.462,7894.393,539.849,7.11,0.751,4
197,45,422,16847,17,456,9119,211614,88.89,43733759,77.39,41.4,16.462,7894.393,539.849,7.11,0.751,4
197,46,483,17330,20,476,9024,220638,88.89,43733759,77.39,41.4,16.462,7894.393,539.849,7.11,0.751,4
197,47,528,17858,21,497,7163,227801,88.89,43733759,77.39,41.4,16.462,7894.393,539.849,7.11,0.751,4
197,48,433,18291,17,514,5098,232899,88.89,43733759,77.39,41.4,16.462,7894.393,539.849,7.11,0.751,4
197,49,325,18616,21,535,7062,239961,88.89,43733759,77.39,41.4,16.462,7894.393,539.849,7.11,0.751,4
197,50,260,18876,13,548,8568,248529,88.89,43733759,77.39,41.4,16.462,7894.393,539.849,7.11,0.751,4
197,51,354,19230,16,564,0,248529,88.89,43733759,77.39,41.4,16.462,7894.393,539.849,7.11,0.751,4
197,52,476,19706,15,579,0,267185,83.33,43733759,77.39,41.4,16.462,7894.393,539.849,7.11,0.751,4
197,53,442,20148,9,588,10527,277712,83.33,43733759,77.39,41.4,16.462,7894.393,539.849,7.11,0.751,4
197,54,432,20580,17,605,7914,285626,83.33,43733759,77.39,41.4,16.462,7894.393,539.849,7.11,0.751,4
197,55,406,20986,12,617,6242,291868,79.63,43733759,77.39,41.4,16.462,7894.393,539.849,7.11,0.751,4
197,56,259,21245,6,623,9868,301736,79.63,43733759,77.39,41.4,16.462,7894.393,539.849,7.11,0.751,4
197,57,339,21584,21,644,10796,312532,79.63,43733759,77.39,41.4,16.462,7894.393,539.849,7.11,0.751,4
197,58,321,21905,14,658,10214,322746,79.63,43733759,77.39,41.4,16.462,7894.393,539.849,7.11,0.751,4
197,59,477,22382,11,669,14572,337318,79.63,43733759,77.39,41.4,16.462,7894.393,539.849,7.11,0.751,4
197,60,429,22811,10,679,10961,348279,79.63,43733759,77.39,41.4,16.462,7894.393,539.849,7.11,0.751,4
197,61,393,23204,17,696,0,348279,79.63,43733759,77.39,41.4,16.462,7894.393,539.849,7.11,0.751,4
197,62,468,23672,12,708,0,356187,72.69,43733759,77.39,41.4,16.462,7894.393,539.849,7.11,0.751,4
197,63,340,24012,10,718,15481,371668,72.69,43733759,77.39,41.4,16.462,7894.393,539.849,7.11,0.751,4
197,64,328,24340,9,727,9884,381552,72.69,43733759,77.39,41.4,16.462,7894.393,539.849,7.11,0.751,4
197,65,483,24823,8,735,10764,392316,72.69,43733759,77.39,41.4,16.462,7894.393,539.849,7.11,0.751,4
197,66,588,25411,12,747,11235,403551,72.69,43733759,77.39,41.4,16.462,7894.393,539.849,7.11,0.751,4
197,67,553,25964,15,762,10991,414542,72.69,43733759,77.39,41.4,16.462,7894.393,539.849,7.11,0.751,4
197,68,550,26514,15,777,9504,424046,72.69,43733759,77.39,41.4,16.462,7894.393,539.849,7.11,0.751,4
197,69,485,26999,11,788,7039,431085,72.69,43733759,77.39,41.4,16.462,7894.393,539.849,7.11,0.751,4
197,70,463,27462,9,797,6359,437444,72.69,43733759,77.39,41.4,16.462,7894.393,539.849,7.11,0.751,4
197,71,394,27856,13,810,8496,445940,72.69,43733759,77.39,41.4,16.462,7894.393,539.849,7.11,0.751,4
197,72,525,28381,23,833,10569,456509,72.69,43733759,77.39,41.4,16.462,7894.393,539.849,7.11,0.751,4
197,73,689,29070,21,854,11663,468172,72.69,43733759,77.39,41.4,16.462,7894.393,539.849,7.11,0.751,4
197,74,683,29753,16,870,10939,479111,72.69,43733759,77.39,41.4,16.462,7894.393,539.849,7.11,0.751,4
197,75,753,30506,10,880,10223,489334,72.69,43733759,77.39,41.4,16.462,7894.393,539.849,7.11,0.751,4
197,76,648,31154,9,889,7950,497284,64.35,43733759,77.39,41.4,16.462,7894.393,539.849,7.11,0.751,4
197,77,656,31810,12,901,9967,507251,64.35,43733759,77.39,41.4,16.462,7894.393,539.849,7.11,0.751,4
197,78,666,32476,11,912,0,507251,64.35,43733759,77.39,41.4,16.462,7894.393,539.849,7.11,0.751,4
197,79,758,33234,31,943,0,530442,64.35,43733759,77.39,41.4,16.462,7894.393,539.849,7.11,0.751,4
197,80,829,34063,23,966,11805,542247,64.35,43733759,77.39,41.4,16.462,7894.393,539.849,7.11,0.751,4
197,81,921,34984,19,985,11490,553737,64.35,43733759,77.39,41.4,16.462,7894.393,539.849,7.11,0.751,4
197,82,841,35825,9,994,9457,563194,64.35,43733759,77.39,41.4,16.462,7894.393,539.849,7.11,0.751,4
197,83,735,36560,8,1002,6395,569589,37.96,43733759,77.39,41.4,16.462,7894.393,539.849,7.11,0.751,4
197,84,681,37241,10,1012,11225,580814,37.96,43733759,77.39,41.4,16.462,7894.393,539.849,7.11,0.751,4
197,85,833,38074,23,1035,13188,594002,37.96,43733759,77.39,41.4,16.462,7894.393,539.849,7.11,0.751,4
197,86,940,39014,16,1051,12764,606766,37.96,43733759,77.39,41.4,16.462,7894.393,539.849,7.11,0.751,4
197,87,994,40008,16,1067,0,606766,37.96,43733759,77.39,41.4,16.462,7894.393,539.849,7.11,0.751,4
197,88,1109,41117,19,1086,0,631966,37.96,43733759,77.39,41.4,16.462,7894.393,539.849,7.11,0.751,4
197,89,948,42065,24,1110,9945,641911,37.96,43733759,77.39,41.4,16.462,7894.393,539.849,7.11,0.751,4
197,90,917,42982,19,1129,7239,649150,37.96,43733759,77.39,41.4,16.462,7894.393,539.849,7.11,0.751,4
197,91,646,43628,18,1147,6972,656122,37.96,43733759,77.39,41.4,16.462,7894.393,539.849,7.11,0.751,4
197,92,706,44334,12,1159,10025,666147,37.96,43733759,77.39,41.4,16.462,7894.393,539.849,7.11,0.751,4
197,93,664,44998,14,1173,11110,677257,37.96,43733759,77.39,41.4,16.462,7894.393,539.849,7.11,0.751,4
197,94,889,45887,12,1185,13696,690953,37.96,43733759,77.39,41.4,16.462,7894.393,539.849,7.11,0.751,4
197,95,876,46763,27,1212,0,690953,37.96,43733759,77.39,41.4,16.462,7894.393,539.849,7.11,0.751,4
197,96,914,47677,15,1227,0,715770,37.96,43733759,77.39,41.4,16.462,7894.393,539.849,7.11,0.751,4
197,97,823,48500,22,1249,6743,722513,37.96,43733759,77.39,41.4,16.462,7894.393,539.849,7.11,0.751,4
197,98,543,49043,13,1262,9345,731858,37.96,43733759,77.39,41.4,16.462,7894.393,539.849,7.11,0.751,4
197,99,564,49607,21,1283,13455,745313,37.96,43733759,77.39,41.4,16.462,7894.393,539.849,7.11,0.751,4
197,100,807,50414,23,1306,14934,760247,37.96,43733759,77.39,41.4,16.462,7894.393,539.849,7.11,0.751,4
197,101,810,51224,21,1327,13584,773831,37.96,43733759,77.39,41.4,16.462,7894.393,539.849,7.11,0.751,4
197,102,819,52043,18,1345,13012,786843,37.96,43733759,77.39,41.4,16.462,7894.393,539.849,7.11,0.751,4
197,103,800,52843,27,1372,9837,796680,37.96,43733759,77.39,41.4,16.462,7894.393,539.849,7.11,0.751,4
197,104,678,53521,11,1383,6977,803657,37.96,43733759,77.39,41.4,16.462,7894.393,539.849,7.11,0.751,4
197,105,612,54133,15,1398,9739,813396,37.96,43733759,77.39,41.4,16.462,7894.393,539.849,7.11,0.751,4
197,106,638,54771,14,1412,13761,827157,37.96,43733759,77.39,41.4,16.462,7894.393,539.849,7.11,0.751,4
197,107,836,55607,15,1427,13175,840332,37.96,43733759,77.39,41.4,16.462,7894.393,539.849,7.11,0.751,4
197,108,848,56455,18,1445,13732,854064,37.96,43733759,77.39,41.4,16.462,7894.393,539.849,7.11,0.751,4
197,109,809,57264,11,1456,10532,864596,37.96,43733759,77.39,41.4,16.462,7894.393,539.849,7.11,0.751,4
197,110,847,58111,21,1477,12666,877262,37.96,43733759,77.39,41.4,16.462,7894.393,539.849,7.11,0.751,4
197,111,731,58842,8,1485,4735,881997,37.96,43733759,77.39,41.4,16.462,7894.393,539.849,7.11,0.751,4
197,112,651,59493,13,1498,12396,894393,37.96,43733759,77.39,41.4,16.462,7894.393,539.849,7.11,0.751,4
197,113,673,60166,20,1518,12967,907360,37.96,43733759,77.39,41.4,16.462,7894.393,539.849,7.11,0.751,4
197,114,829,60995,16,1534,14498,921858,37.96,43733759,77.39,41.4,16.462,7894.393,539.849,7.11,0.751,4
197,115,856,61851,17,1551,15148,937006,37.96,43733759,77.39,41.4,16.462,7894.393,539.849,7.11,0.751,4
197,116,972,62823,20,1571,14076,951082,37.96,43733759,77.39,41.4,16.462,7894.393,539.849,7.11,0.751,4
197,117,1106,63929,19,1590,12559,963641,37.96,43733759,77.39,41.4,16.462,7894.393,539.849,7.11,0.751,4
197,118,920,64849,15,1605,7064,970705,37.96,43733759,77.39,41.4,16.462,7894.393,539.849,7.11,0.751,4
197,119,807,65656,11,1616,12645,983350,37.96,43733759,77.39,41.4,16.462,7894.393,539.849,7.11,0.751,4
197,120,919,66575,13,1629,14949,998299,37.96,43733759,77.39,41.4,16.462,7894.393,539.849,7.11,0.751,4
197,121,1022,67597,21,1650,15494,1013793,37.96,43733759,77.39,41.4,16.462,7894.393,539.849,7.11,0.751,4
197,122,1197,68794,23,1673,15427,1029220,37.96,43733759,77.39,41.4,16.462,7894.393,539.849,7.11,0.751,4
197,123,1090,69884,20,1693,16860,1046080,44.91,43733759,77.39,41.4,16.462,7894.393,539.849,7.11,0.751,4
197,124,1172,71056,16,1709,12303,1058383,44.91,43733759,77.39,41.4,16.462,7894.393,539.849,7.11,0.751,4
197,125,1112,72168,16,1725,8623,1067006,54.17,43733759,77.39,41.4,16.462,7894.393,539.849,7.11,0.751,4
197,126,990,73158,13,1738,0,1067006,54.17,43733759,77.39,41.4,16.462,7894.393,539.849,7.11,0.751,4
197,127,1061,74219,26,1764,0,1098665,54.17,43733759,77.39,41.4,16.462,7894.393,539.849,7.11,0.751,4
197,128,1271,75490,24,1788,17976,1116641,54.17,43733759,77.39,41.4,16.462,7894.393,539.849,7.11,0.751,4
197,129,1318,76808,31,1819,18410,1135051,54.17,43733759,77.39,41.4,16.462,7894.393,539.849,7.11,0.751,4
197,130,1453,78261,33,1852,19327,1154378,54.17,43733759,77.39,41.4,16.462,7894.393,539.849,7.11,0.751,4
197,131,1489,79750,27,1879,14973,1169351,54.17,43733759,77.39,41.4,16.462,7894.393,539.849,7.11,0.751,4
197,132,2207,81957,43,1922,10083,1179434,54.17,43733759,77.39,41.4,16.462,7894.393,539.849,7.11,0.751,4
197,133,1158,83115,29,1951,16127,1195561,54.17,43733759,77.39,41.4,16.462,7894.393,539.849,7.11,0.751,4
197,134,1433,84548,19,1970,19380,1214941,54.17,43733759,77.39,41.4,16.462,7894.393,539.849,7.11,0.751,4
197,135,1592,86140,22,1992,18984,1233925,54.17,43733759,77.39,41.4,16.462,7894.393,539.849,7.11,0.751,4
197,136,1732,87872,19,2011,18917,1252842,54.17,43733759,77.39,41.4,16.462,7894.393,539.849,7.11,0.751,4
197,137,0,87872,0,2011,20979,1273821,54.17,43733759,77.39,41.4,16.462,7894.393,539.849,7.11,0.751,4
197,138,1847,89719,33,2044,15768,1289589,54.17,43733759,77.39,41.4,16.462,7894.393,539.849,7.11,0.751,4
197,139,3101,92820,45,2089,10700,1300289,54.17,43733759,77.39,41.4,16.462,7894.393,539.849,7.11,0.751,4
197,140,1616,94436,27,2116,15120,1315409,54.17,43733759,77.39,41.4,16.462,7894.393,539.849,7.11,0.751,4
197,141,0,94436,0,2116,19591,1335000,54.17,43733759,77.39,41.4,16.462,7894.393,539.849,7.11,0.751,4
197,142,1967,96403,28,2144,21698,1356698,54.17,43733759,77.39,41.4,16.462,7894.393,539.849,7.11,0.751,4
197,143,2134,98537,40,2184,21821,1378519,54.17,43733759,77.39,41.4,16.462,7894.393,539.849,7.11,0.751,4
197,144,2106,100643,23,2207,22207,1400726,54.17,43733759,77.39,41.4,16.462,7894.393,539.849,7.11,0.751,4
197,145,2328,102971,37,2244,15275,1416001,54.17,43733759,77.39,41.4,16.462,7894.393,539.849,7.11,0.751,4
197,146,1987,104958,27,2271,9350,1425351,54.17,43733759,77.39,41.4,16.462,7894.393,539.849,7.11,0.751,4
197,147,1796,106754,22,2293,10855,1436206,54.17,43733759,77.39,41.4,16.462,7894.393,539.849,7.11,0.751,4
197,148,3331,110085,25,2318,15800,1452006,54.17,43733759,77.39,41.4,16.462,7894.393,539.849,7.11,0.751,4
197,149,1974,112059,85,2403,20730,1472736,54.17,43733759,77.39,41.4,16.462,7894.393,539.849,7.11,0.751,4
197,150,0,112059,0,2403,21507,1494243,62.5,43733759,77.39,41.4,16.462,7894.393,539.849,7.11,0.751,4
197,151,2438,114497,35,2438,22469,1516712,62.5,43733759,77.39,41.4,16.462,7894.393,539.849,7.11,0.751,4
197,152,2481,116978,54,2492,19459,1536171,62.5,43733759,77.39,41.4,16.462,7894.393,539.849,7.11,0.751,4
197,153,2096,119074,35,2527,14109,1550280,62.5,43733759,77.39,41.4,16.462,7894.393,539.849,7.11,0.751,4
197,154,2141,121215,30,2557,6375,1556655,62.5,43733759,77.39,41.4,16.462,7894.393,539.849,7.11,0.751,4
197,155,2088,123303,48,2605,41052,1597707,62.5,43733759,77.39,41.4,16.462,7894.393,539.849,7.11,0.751,4
197,156,2486,125789,51,2656,23990,1621697,62.5,43733759,77.39,41.4,16.462,7894.393,539.849,7.11,0.751,4
197,157,2439,128228,54,2710,0,1621697,62.5,43733759,77.39,41.4,16.462,7894.393,539.849,7.11,0.751,4
197,158,2723,130951,13,2723,0,1673316,62.5,43733759,77.39,41.4,16.462,7894.393,539.849,7.11,0.751,4
197,159,2836,133787,88,2811,20477,1693793,62.5,43733759,77.39,41.4,16.462,7894.393,539.849,7.11,0.751,4
197,160,2107,135894,0,2811,15224,1709017,51.39,43733759,77.39,41.4,16.462,7894.393,539.849,7.11,0.751,4
197,161,2174,138068,66,2877,22860,1731877,62.5,43733759,77.39,41.4,16.462,7894.393,539.849,7.11,0.751,4
197,162,4962,143030,102,2979,20054,1751931,62.5,43733759,77.39,41.4,16.462,7894.393,539.849,7.11,0.751,4
197,163,2582,145612,0,2979,26552,1778483,62.5,43733759,77.39,41.4,16.462,7894.393,539.849,7.11,0.751,4
197,164,3144,148756,97,3076,27945,1806428,62.5,43733759,77.39,41.4,16.462,7894.393,539.849,7.11,0.751,4
197,165,0,148756,0,3076,27737,1834165,62.5,43733759,77.39,41.4,16.462,7894.393,539.849,7.11,0.751,4
197,166,3103,151859,27,3103,22302,1856467,62.5,43733759,77.39,41.4,16.462,7894.393,539.849,7.11,0.751,4
197,167,2476,154335,75,3178,14323,1870790,64.35,43733759,77.39,41.4,16.462,7894.393,539.849,7.11,0.751,4
197,168,2462,156797,33,3211,26898,1897688,64.35,43733759,77.39,41.4,16.462,7894.393,539.849,7.11,0.751,4
197,169,5863,162660,129,3340,27794,1925482,64.35,43733759,77.39,41.4,16.462,7894.393,539.849,7.11,0.751,4
197,170,0,162660,0,3340,29729,1955211,64.35,43733759,77.39,41.4,16.462,7894.393,539.849,7.11,0.751,4
197,171,3584,166244,60,3400,30591,1985802,64.35,43733759,77.39,41.4,16.462,7894.393,539.849,7.11,0.751,4
197,172,3228,169472,68,3468,29121,2014923,64.35,43733759,77.39,41.4,16.462,7894.393,539.849,7.11,0.751,4
197,173,3240,172712,48,3516,23927,2038850,64.35,43733759,77.39,41.4,16.462,7894.393,539.849,7.11,0.751,4
197,174,2966,175678,41,3557,19788,2058638,64.35,43733759,77.39,41.4,16.462,7894.393,539.849,7.11,0.751,4
197,175,2675,178353,26,3583,20844,2079482,64.35,43733759,77.39,41.4,16.462,7894.393,539.849,7.11,0.751,4
197,176,2884,181237,59,3642,22895,2102377,64.35,43733759,77.39,41.4,16.462,7894.393,539.849,7.11,0.751,4
197,177,3497,184734,63,3705,26779,2129156,64.35,43733759,77.39,41.4,16.462,7894.393,539.849,7.11,0.751,4
197,178,3372,188106,52,3757,27497,2156653,64.35,43733759,77.39,41.4,16.462,7894.393,539.849,7.11,0.751,4
197,179,3565,191671,70,3827,33273,2189926,64.35,43733759,77.39,41.4,16.462,7894.393,539.849,7.11,0.751,4
197,180,3833,195504,76,3903,20049,2209975,64.35,43733759,77.39,41.4,16.462,7894.393,539.849,7.11,0.751,4
197,181,3130,198634,56,3959,16533,2226508,64.35,43733759,77.39,41.4,16.462,7894.393,539.849,7.11,0.751,4
197,182,2671,201305,37,3996,24168,2250676,58.8,43733759,77.39,41.4,16.462,7894.393,539.849,7.11,0.751,4
197,183,3627,204932,69,4065,27572,2278248,58.8,43733759,77.39,41.4,16.462,7894.393,539.849,7.11,0.751,4
197,184,4027,208959,64,4129,30167,2308415,58.8,43733759,77.39,41.4,16.462,7894.393,539.849,7.11,0.751,4
197,185,0,208959,64,4193,29527,2337942,58.8,43733759,77.39,41.4,16.462,7894.393,539.849,7.11,0.751,4
197,186,8702,217661,68,4261,0,2337942,58.8,43733759,77.39,41.4,16.462,7894.393,539.849,7.11,0.751,4
197,187,4571,222232,92,4353,0,2382259,58.8,43733759,77.39,41.4,16.462,7894.393,539.849,7.11,0.751,4
197,188,4230,226462,44,4397,15646,2397905,58.8,43733759,77.39,41.4,16.462,7894.393,539.849,7.11,0.751,4
197,189,3774,230236,33,4430,25126,2423031,58.8,43733759,77.39,41.4,16.462,7894.393,539.849,7.11,0.751,4
197,190,4348,234584,90,4520,32376,2455407,58.8,43733759,77.39,41.4,16.462,7894.393,539.849,7.11,0.751,4
197,191,4753,239337,77,4597,34295,2489702,58.8,43733759,77.39,41.4,16.462,7894.393,539.849,7.11,0.751,4
197,192,5397,244734,93,4690,32658,2522360,58.8,43733759,77.39,41.4,16.462,7894.393,539.849,7.11,0.751,4
197,193,0,244734,0,4690,60408,2582768,58.8,43733759,77.39,41.4,16.462,7894.393,539.849,7.11,0.751,4
197,194,11532,256266,197,4887,0,2582768,58.8,43733759,77.39,41.4,16.462,7894.393,539.849,7.11,0.751,4
197,195,4768,261034,85,4972,0,2602635,58.8,43733759,77.39,41.4,16.462,7894.393,539.849,7.11,0.751,4
197,196,4420,265454,43,5015,28353,2630988,58.8,43733759,77.39,41.4,16.462,7894.393,539.849,7.11,0.751,4
197,197,5133,270587,118,5133,64500,2695488,58.8,43733759,77.39,41.4,16.462,7894.393,539.849,7.11,0.751,4
197,198,5590,276177,96,5229,0,2695488,58.8,43733759,77.39,41.4,16.462,7894.393,539.849,7.11,0.751,4
197,199,5062,281239,73,5302,0,2729496,58.8,43733759,77.39,41.4,16.462,7894.393,539.849,7.11,0.751,4
197,200,5992,287231,106,5408,36291,2765787,58.8,43733759,77.39,41.4,16.462,7894.393,539.849,7.11,0.751,4
197,201,6410,293641,109,5517,0,2765787,58.8,43733759,77.39,41.4,16.462,7894.393,539.849,7.11,0.751,4
197,202,9997,303638,156,5673,0,2815833,58.8,43733759,77.39,41.4,16.462,7894.393,539.849,7.11,0.751,4
197,203,5469,309107,113,5786,31543,2847376,58.8,43733759,77.39,41.4,16.462,7894.393,539.849,7.11,0.751,4
197,204,0,309107,0,5786,0,2847376,58.8,43733759,77.39,41.4,16.462,7894.393,539.849,7.11,0.751,4
198,1,53,664,1,6,20480,240480,84.26,9890400,112.442,34,1.144,67293.483,317.84,17.26,0.863,0
198,2,150,814,2,8,22433,262913,84.26,9890400,112.442,34,1.144,67293.483,317.84,17.26,0.863,0
198,3,210,1024,0,8,31402,294315,84.26,9890400,112.442,34,1.144,67293.483,317.84,17.26,0.863,0
198,4,240,1264,1,9,39950,334265,89.81,9890400,112.442,34,1.144,67293.483,317.84,17.26,0.863,0
198,5,241,1505,1,10,58348,392613,89.81,9890400,112.442,34,1.144,67293.483,317.84,17.26,0.863,0
198,6,278,1783,0,10,39870,432483,89.81,9890400,112.442,34,1.144,67293.483,317.84,17.26,0.863,0
198,7,262,2045,1,11,58294,490777,89.81,9890400,112.442,34,1.144,67293.483,317.84,17.26,0.863,0
198,8,268,2313,1,12,48418,539195,89.81,9890400,112.442,34,1.144,67293.483,317.84,17.26,0.863,0
198,9,284,2597,0,12,40000,579195,89.81,9890400,112.442,34,1.144,67293.483,317.84,17.26,0.863,0
198,10,313,2910,2,14,49000,628195,89.81,9890400,112.442,34,1.144,67293.483,317.84,17.26,0.863,0
198,11,350,3260,2,16,20000,648195,89.81,9890400,112.442,34,1.144,67293.483,317.84,17.26,0.863,0
198,12,356,3616,4,20,22000,670195,89.81,9890400,112.442,34,1.144,67293.483,317.84,17.26,0.863,0
198,13,366,3982,2,22,23380,693575,89.81,9890400,112.442,34,1.144,67293.483,317.84,17.26,0.863,0
198,14,377,4359,3,25,32000,725575,89.81,9890400,112.442,34,1.144,67293.483,317.84,17.26,0.863,0
198,15,390,4749,3,28,41425,767000,89.81,9890400,112.442,34,1.144,67293.483,317.84,17.26,0.863,0
198,16,409,5158,5,33,25000,792000,89.81,9890400,112.442,34,1.144,67293.483,317.84,17.26,0.863,0
198,17,435,5593,2,35,24000,816000,87.04,9890400,112.442,34,1.144,67293.483,317.84,17.26,0.863,0
198,18,452,6045,2,37,21806,837806,87.04,9890400,112.442,34,1.144,67293.483,317.84,17.26,0.863,0
198,19,445,6490,0,37,25795,863601,87.04,9890400,112.442,34,1.144,67293.483,317.84,17.26,0.863,0
198,20,453,6943,4,41,22807,886408,87.04,9890400,112.442,34,1.144,67293.483,317.84,17.26,0.863,0
198,21,458,7401,2,43,20165,906573,87.04,9890400,112.442,34,1.144,67293.483,317.84,17.26,0.863,0
198,22,464,7865,3,46,23053,929626,87.04,9890400,112.442,34,1.144,67293.483,317.84,17.26,0.863,0
198,23,457,8322,6,52,25506,955132,87.04,9890400,112.442,34,1.144,67293.483,317.84,17.26,0.863,0
198,24,490,8812,4,56,26274,981406,87.04,9890400,112.442,34,1.144,67293.483,317.84,17.26,0.863,0
198,25,497,9309,8,64,21984,1003390,87.04,9890400,112.442,34,1.144,67293.483,317.84,17.26,0.863,0
198,26,504,9813,7,71,25086,1028476,87.04,9890400,112.442,34,1.144,67293.483,317.84,17.26,0.863,0
198,27,536,10349,5,76,26195,1054671,87.04,9890400,112.442,34,1.144,67293.483,317.84,17.26,0.863,0
198,28,490,10839,6,82,27905,1082576,87.04,9890400,112.442,34,1.144,67293.483,317.84,17.26,0.863,0
198,29,541,11380,7,89,26524,1109100,81.48,9890400,112.442,34,1.144,67293.483,317.84,17.26,0.863,0
198,30,549,11929,9,98,36266,1145366,81.48,9890400,112.442,34,1.144,67293.483,317.84,17.26,0.863,0
198,31,552,12481,7,105,26677,1172043,81.48,9890400,112.442,34,1.144,67293.483,317.84,17.26,0.863,0
198,32,557,13038,6,111,18428,1190471,77.78,9890400,112.442,34,1.144,67293.483,317.84,17.26,0.863,0
198,33,561,13599,8,119,28039,1218510,77.78,9890400,112.442,34,1.144,67293.483,317.84,17.26,0.863,0
198,34,564,14163,7,126,25231,1243741,77.78,9890400,112.442,34,1.144,67293.483,317.84,17.26,0.863,0
198,35,567,14730,11,137,33994,1277735,77.78,9890400,112.442,34,1.144,67293.483,317.84,17.26,0.863,0
198,36,462,15192,9,146,41134,1318869,75.93,9890400,112.442,34,1.144,67293.483,317.84,17.26,0.863,0
198,37,546,15738,11,157,33153,1352022,75.93,9890400,112.442,34,1.144,67293.483,317.84,17.26,0.863,0
198,38,502,16240,8,165,29866,1381888,75.93,9890400,112.442,34,1.144,67293.483,317.84,17.26,0.863,0
198,39,553,16793,9,174,26763,1408651,75.93,9890400,112.442,34,1.144,67293.483,317.84,17.26,0.863,0
198,40,624,17417,11,185,32597,1441248,75.93,9890400,112.442,34,1.144,67293.483,317.84,17.26,0.863,0
198,41,781,18198,13,198,34869,1476117,75.93,9890400,112.442,34,1.144,67293.483,317.84,17.26,0.863,0
198,42,680,18878,3,201,37112,1513229,75.93,9890400,112.442,34,1.144,67293.483,317.84,17.26,0.863,0
198,43,783,19661,2,203,38477,1551706,75.93,9890400,112.442,34,1.144,67293.483,317.84,17.26,0.863,0
198,44,725,20386,3,206,35735,1587441,74.07,9890400,112.442,34,1.144,67293.483,317.84,17.26,0.863,0
198,45,698,21084,2,208,40720,1628161,74.07,9890400,112.442,34,1.144,67293.483,317.84,17.26,0.863,0
198,46,747,21831,2,210,37844,1666005,74.07,9890400,112.442,34,1.144,67293.483,317.84,17.26,0.863,0
198,47,796,22627,4,214,38904,1704909,74.07,9890400,112.442,34,1.144,67293.483,317.84,17.26,0.863,0
198,48,731,23358,6,220,43732,1748641,72.22,9890400,112.442,34,1.144,67293.483,317.84,17.26,0.863,0
198,49,832,24190,4,224,43993,1792634,72.22,9890400,112.442,34,1.144,67293.483,317.84,17.26,0.863,0
198,50,873,25063,3,227,50377,1843011,72.22,9890400,112.442,34,1.144,67293.483,317.84,17.26,0.863,0
198,51,941,26004,6,233,39791,1882802,72.22,9890400,112.442,34,1.144,67293.483,317.84,17.26,0.863,0
198,52,894,26898,4,237,35686,1918488,72.22,9890400,112.442,34,1.144,67293.483,317.84,17.26,0.863,0
198,53,994,27892,4,241,41202,1959690,72.22,9890400,112.442,34,1.144,67293.483,317.84,17.26,0.863,0
198,54,812,28704,3,244,28282,1987972,72.22,9890400,112.442,34,1.144,67293.483,317.84,17.26,0.863,0
198,55,781,29485,1,245,27540,2015512,72.22,9890400,112.442,34,1.144,67293.483,317.84,17.26,0.863,0
198,56,822,30307,3,248,38628,2054140,72.22,9890400,112.442,34,1.144,67293.483,317.84,17.26,0.863,0
198,57,779,31086,5,253,36131,2090271,72.22,9890400,112.442,34,1.144,67293.483,317.84,17.26,0.863,0
198,58,883,31969,2,255,42624,2132895,72.22,9890400,112.442,34,1.144,67293.483,317.84,17.26,0.863,0
198,59,563,32532,3,258,37153,2170048,72.22,9890400,112.442,34,1.144,67293.483,317.84,17.26,0.863,0
198,60,638,33170,2,260,30147,2200195,72.22,9890400,112.442,34,1.144,67293.483,317.84,17.26,0.863,0
198,61,726,33896,2,262,35037,2235232,72.22,9890400,112.442,34,1.144,67293.483,317.84,17.26,0.863,0
198,62,661,34557,2,264,41762,2276994,72.22,9890400,112.442,34,1.144,67293.483,317.84,17.26,0.863,0
198,63,635,35192,2,266,54823,2331817,72.22,9890400,112.442,34,1.144,67293.483,317.84,17.26,0.863,0
198,64,596,35788,3,269,44241,2376058,72.22,9890400,112.442,34,1.144,67293.483,317.84,17.26,0.863,0
198,65,571,36359,1,270,52996,2429054,72.22,9890400,112.442,34,1.144,67293.483,317.84,17.26,0.863,0
198,66,659,37018,3,273,44201,2473255,72.22,9890400,112.442,34,1.144,67293.483,317.84,17.26,0.863,0
198,67,624,37642,1,274,32679,2505934,72.22,9890400,112.442,34,1.144,67293.483,317.84,17.26,0.863,0
198,68,626,38268,1,275,37640,2543574,72.22,9890400,112.442,34,1.144,67293.483,317.84,17.26,0.863,0
198,69,540,38808,1,276,47201,2590775,72.22,9890400,112.442,34,1.144,67293.483,317.84,17.26,0.863,0
198,70,568,39376,5,281,45378,2636153,72.22,9890400,112.442,34,1.144,67293.483,317.84,17.26,0.863,0
198,71,528,39904,2,283,44167,2680320,72.22,9890400,112.442,34,1.144,67293.483,317.84,17.26,0.863,0
198,72,603,40507,1,284,40724,2721044,72.22,9890400,112.442,34,1.144,67293.483,317.84,17.26,0.863,0
198,73,479,40986,2,286,43013,2764057,72.22,9890400,112.442,34,1.144,67293.483,317.84,17.26,0.863,0
198,74,513,41499,1,287,27041,2791098,72.22,9890400,112.442,34,1.144,67293.483,317.84,17.26,0.863,0
198,75,491,41990,1,288,38036,2829134,72.22,9890400,112.442,34,1.144,67293.483,317.84,17.26,0.863,0
198,76,304,42294,1,289,39887,2869021,72.22,9890400,112.442,34,1.144,67293.483,317.84,17.26,0.863,0
198,77,342,42636,2,291,40478,2909499,72.22,9890400,112.442,34,1.144,67293.483,317.84,17.26,0.863,0
198,78,346,42982,2,293,38502,2948001,72.22,9890400,112.442,34,1.144,67293.483,317.84,17.26,0.863,0
198,79,382,43364,2,295,34364,2982365,72.22,9890400,112.442,34,1.144,67293.483,317.84,17.26,0.863,0
198,80,388,43752,3,298,48524,3030889,72.22,9890400,112.442,34,1.144,67293.483,317.84,17.26,0.863,0
198,81,393,44145,2,300,40876,3071765,72.22,9890400,112.442,34,1.144,67293.483,317.84,17.26,0.863,0
198,82,388,44533,1,301,40956,3112721,72.22,9890400,112.442,34,1.144,67293.483,317.84,17.26,0.863,0
198,83,392,44925,1,302,44291,3157012,72.22,9890400,112.442,34,1.144,67293.483,317.84,17.26,0.863,0
198,84,378,45303,1,303,49650,3206662,72.22,9890400,112.442,34,1.144,67293.483,317.84,17.26,0.863,0
198,85,380,45683,2,305,49152,3255814,72.22,9890400,112.442,34,1.144,67293.483,317.84,17.26,0.863,0
198,86,450,46133,2,307,52527,3308341,72.22,9890400,112.442,34,1.144,67293.483,317.84,17.26,0.863,0
198,87,430,46563,1,308,58741,3367082,72.22,9890400,112.442,34,1.144,67293.483,317.84,17.26,0.863,0
198,88,410,46973,2,310,43551,3410633,72.22,9890400,112.442,34,1.144,67293.483,317.84,17.26,0.863,0
198,89,387,47360,1,311,63970,3474603,72.22,9890400,112.442,34,1.144,67293.483,317.84,17.26,0.863,0
198,90,437,47797,2,313,62028,3536631,72.22,9890400,112.442,34,1.144,67293.483,317.84,17.26,0.863,0
198,91,449,48246,1,314,56177,3592808,72.22,9890400,112.442,34,1.144,67293.483,317.84,17.26,0.863,0
198,92,421,48667,1,315,54358,3647166,72.22,9890400,112.442,34,1.144,67293.483,317.84,17.26,0.863,0
198,93,402,49069,1,316,71697,3718863,72.22,9890400,112.442,34,1.144,67293.483,317.84,17.26,0.863,0
198,94,400,49469,1,317,47930,3766793,52.78,9890400,112.442,34,1.144,67293.483,317.84,17.26,0.863,0
198,95,672,50141,1,318,28009,3794802,52.78,9890400,112.442,34,1.144,67293.483,317.84,17.26,0.863,0
198,96,716,50857,3,321,44192,3838994,43.52,9890400,112.442,34,1.144,67293.483,317.84,17.26,0.863,0
198,97,683,51540,2,323,51430,3890424,43.52,9890400,112.442,34,1.144,67293.483,317.84,17.26,0.863,0
198,98,528,52068,1,324,49777,3940201,43.52,9890400,112.442,34,1.144,67293.483,317.84,17.26,0.863,0
198,99,532,52600,2,326,47322,3987523,43.52,9890400,112.442,34,1.144,67293.483,317.84,17.26,0.863,0
198,100,445,53045,1,327,58504,4046027,43.52,9890400,112.442,34,1.144,67293.483,317.84,17.26,0.863,0
198,101,532,53577,1,328,50139,4096166,43.52,9890400,112.442,34,1.144,67293.483,317.84,17.26,0.863,0
198,102,473,54050,2,330,34478,4130644,43.52,9890400,112.442,34,1.144,67293.483,317.84,17.26,0.863,0
198,103,403,54453,1,331,50325,4180969,43.52,9890400,112.442,34,1.144,67293.483,317.84,17.26,0.863,0
198,104,401,54854,2,333,34478,4215447,43.52,9890400,112.442,34,1.144,67293.483,317.84,17.26,0.863,0
198,105,344,55198,1,334,52782,4268229,43.52,9890400,112.442,34,1.144,67293.483,317.84,17.26,0.863,0
198,106,375,55573,1,335,48534,4316763,43.52,9890400,112.442,34,1.144,67293.483,317.84,17.26,0.863,0
198,107,275,55848,0,335,48931,4365694,43.52,9890400,112.442,34,1.144,67293.483,317.84,17.26,0.863,0
198,108,281,56129,0,335,48561,4414255,43.52,9890400,112.442,34,1.144,67293.483,317.84,17.26,0.863,0
198,109,293,56422,2,337,46950,4461205,43.52,9890400,112.442,34,1.144,67293.483,317.84,17.26,0.863,0
198,110,289,56711,1,338,47723,4508928,43.52,9890400,112.442,34,1.144,67293.483,317.84,17.26,0.863,0
198,111,211,56922,1,339,27224,4536152,43.52,9890400,112.442,34,1.144,67293.483,317.84,17.26,0.863,0
198,112,271,57193,1,340,40050,4576202,43.52,9890400,112.442,34,1.144,67293.483,317.84,17.26,0.863,0
198,113,305,57498,1,341,47014,4623216,43.52,9890400,112.442,34,1.144,67293.483,317.84,17.26,0.863,0
198,114,236,57734,1,342,54096,4677312,43.52,9890400,112.442,34,1.144,67293.483,317.84,17.26,0.863,0
198,115,254,57988,0,342,46965,4724277,43.52,9890400,112.442,34,1.144,67293.483,317.84,17.26,0.863,0
198,116,261,58249,1,343,52627,4776904,43.52,9890400,112.442,34,1.144,67293.483,317.84,17.26,0.863,0
198,117,313,58562,0,343,51162,4828066,43.52,9890400,112.442,34,1.144,67293.483,317.84,17.26,0.863,0
198,118,351,58913,1,344,47229,4875295,43.52,9890400,112.442,34,1.144,67293.483,317.84,17.26,0.863,0
198,119,264,59177,1,345,43622,4918917,43.52,9890400,112.442,34,1.144,67293.483,317.84,17.26,0.863,0
198,120,369,59546,2,347,47483,4966400,43.52,9890400,112.442,34,1.144,67293.483,317.84,17.26,0.863,0
198,121,375,59921,0,347,55257,5021657,32.41,9890400,112.442,34,1.144,67293.483,317.84,17.26,0.863,0
198,122,585,60506,4,351,54727,5076384,43.52,9890400,112.442,34,1.144,67293.483,317.84,17.26,0.863,0
198,123,0,60506,0,351,43268,5119652,43.52,9890400,112.442,34,1.144,67293.483,317.84,17.26,0.863,0
198,124,254,60760,0,351,42428,5162080,43.52,9890400,112.442,34,1.144,67293.483,317.84,17.26,0.863,0
198,125,239,60999,0,351,27811,5189891,43.52,9890400,112.442,34,1.144,67293.483,317.84,17.26,0.863,0
198,126,164,61163,0,351,29398,5219289,43.52,9890400,112.442,34,1.144,67293.483,317.84,17.26,0.863,0
198,127,189,61352,0,351,43369,5262658,43.52,9890400,112.442,34,1.144,67293.483,317.84,17.26,0.863,0
198,128,254,61606,2,353,50729,5313387,43.52,9890400,112.442,34,1.144,67293.483,317.84,17.26,0.863,0
198,129,239,61845,1,354,61978,5375365,43.52,9890400,112.442,34,1.144,67293.483,317.84,17.26,0.863,0
198,130,216,62061,2,356,63792,5439157,43.52,9890400,112.442,34,1.144,67293.483,317.84,17.26,0.863,0
198,131,239,62300,0,356,61544,5500701,43.52,9890400,112.442,34,1.144,67293.483,317.84,17.26,0.863,0
198,132,225,62525,1,357,58953,5559654,43.52,9890400,112.442,34,1.144,67293.483,317.84,17.26,0.863,0
198,133,179,62704,0,357,64110,5623764,43.52,9890400,112.442,34,1.144,67293.483,317.84,17.26,0.863,0
198,134,262,62966,0,357,72630,5696394,43.52,9890400,112.442,34,1.144,67293.483,317.84,17.26,0.863,0
198,135,246,63212,0,357,68964,5765358,43.52,9890400,112.442,34,1.144,67293.483,317.84,17.26,0.863,0
198,136,277,63489,1,358,82344,5847702,43.52,9890400,112.442,34,1.144,67293.483,317.84,17.26,0.863,0
198,137,330,63819,1,359,77640,5925342,43.52,9890400,112.442,34,1.144,67293.483,317.84,17.26,0.863,0
198,138,283,64102,2,361,65186,5990528,43.52,9890400,112.442,34,1.144,67293.483,317.84,17.26,0.863,0
198,139,210,64312,3,364,71322,6061850,43.52,9890400,112.442,34,1.144,67293.483,317.84,17.26,0.863,0
198,140,229,64541,0,364,59759,6121609,43.52,9890400,112.442,34,1.144,67293.483,317.84,17.26,0.863,0
198,141,365,64906,2,366,72026,6193635,43.52,9890400,112.442,34,1.144,67293.483,317.84,17.26,0.863,0
198,142,435,65341,1,367,72283,6265918,43.52,9890400,112.442,34,1.144,67293.483,317.84,17.26,0.863,0
198,143,461,65802,2,369,82191,6348109,43.52,9890400,112.442,34,1.144,67293.483,317.84,17.26,0.863,0
198,144,391,66193,1,370,70079,6418188,43.52,9890400,112.442,34,1.144,67293.483,317.84,17.26,0.863,0
198,145,424,66617,2,372,71216,6489404,43.52,9890400,112.442,34,1.144,67293.483,317.84,17.26,0.863,0
198,146,390,67007,3,375,71282,6560686,43.52,9890400,112.442,34,1.144,67293.483,317.84,17.26,0.863,0
198,147,275,67282,1,376,69309,6629995,43.52,9890400,112.442,34,1.144,67293.483,317.84,17.26,0.863,0
198,148,339,67621,1,377,57419,6687414,43.52,9890400,112.442,34,1.144,67293.483,317.84,17.26,0.863,0
198,149,399,68020,1,378,68043,6755457,43.52,9890400,112.442,34,1.144,67293.483,317.84,17.26,0.863,0
198,150,491,68511,0,378,79680,6835137,43.52,9890400,112.442,34,1.144,67293.483,317.84,17.26,0.863,0
198,151,390,68901,1,379,88803,6923940,43.52,9890400,112.442,34,1.144,67293.483,317.84,17.26,0.863,0
198,152,427,69328,0,379,87955,7011895,43.52,9890400,112.442,34,1.144,67293.483,317.84,17.26,0.863,0
198,153,362,69690,3,382,82763,7094658,43.52,9890400,112.442,34,1.144,67293.483,317.84,17.26,0.863,0
198,154,541,70231,2,384,82772,7177430,41.67,9890400,112.442,34,1.144,67293.483,317.84,17.26,0.863,0
198,155,574,70805,0,384,79623,7257053,41.67,9890400,112.442,34,1.144,67293.483,317.84,17.26,0.863,0
198,156,735,71540,3,387,67821,7324874,41.67,9890400,112.442,34,1.144,67293.483,317.84,17.26,0.863,0
198,157,614,72154,0,387,80935,7405809,41.67,9890400,112.442,34,1.144,67293.483,317.84,17.26,0.863,0
198,158,612,72766,0,387,82333,7488142,41.67,9890400,112.442,34,1.144,67293.483,317.84,17.26,0.863,0
198,159,705,73471,1,388,87336,7575478,41.67,9890400,112.442,34,1.144,67293.483,317.84,17.26,0.863,0
198,160,513,73984,0,388,57506,7632984,41.67,9890400,112.442,34,1.144,67293.483,317.84,17.26,0.863,0
198,161,470,74454,2,390,71334,7704318,41.67,9890400,112.442,34,1.144,67293.483,317.84,17.26,0.863,0
198,162,644,75098,1,391,85917,7790235,41.67,9890400,112.442,34,1.144,67293.483,317.84,17.26,0.863,0
198,163,883,75981,2,393,82076,7872311,41.67,9890400,112.442,34,1.144,67293.483,317.84,17.26,0.863,0
198,164,930,76911,5,398,75177,7947488,41.67,9890400,112.442,34,1.144,67293.483,317.84,17.26,0.863,0
198,165,931,77842,0,398,95287,8042775,41.67,9890400,112.442,34,1.144,67293.483,317.84,17.26,0.863,0
198,166,1007,78849,1,399,84642,8127417,47.22,9890400,112.442,34,1.144,67293.483,317.84,17.26,0.863,0
198,167,640,79489,0,399,61084,8188501,47.22,9890400,112.442,34,1.144,67293.483,317.84,17.26,0.863,0
198,168,777,80266,0,399,86879,8275380,47.22,9890400,112.442,34,1.144,67293.483,317.84,17.26,0.863,0
198,169,674,80940,2,401,93682,8369062,47.22,9890400,112.442,34,1.144,67293.483,317.84,17.26,0.863,0
198,170,842,81782,1,402,92912,8461974,47.22,9890400,112.442,34,1.144,67293.483,317.84,17.26,0.863,0
198,171,786,82568,0,402,97469,8559443,52.78,9890400,112.442,34,1.144,67293.483,317.84,17.26,0.863,0
198,172,865,83433,1,403,103124,8662567,52.78,9890400,112.442,34,1.144,67293.483,317.84,17.26,0.863,0
198,173,809,84242,1,404,97251,8759818,52.78,9890400,112.442,34,1.144,67293.483,317.84,17.26,0.863,0
198,174,674,84916,0,404,72388,8832206,52.78,9890400,112.442,34,1.144,67293.483,317.84,17.26,0.863,0
198,175,679,85595,1,405,98528,8930734,52.78,9890400,112.442,34,1.144,67293.483,317.84,17.26,0.863,0
198,176,852,86447,0,405,103199,9033933,52.78,9890400,112.442,34,1.144,67293.483,317.84,17.26,0.863,0
198,177,1083,87530,1,406,93618,9127551,52.78,9890400,112.442,34,1.144,67293.483,317.84,17.26,0.863,0
198,178,1002,88532,1,407,92058,9219609,52.78,9890400,112.442,34,1.144,67293.483,317.84,17.26,0.863,0
198,179,1008,89540,2,409,98168,9317777,52.78,9890400,112.442,34,1.144,67293.483,317.84,17.26,0.863,0
198,180,1078,90618,2,411,106034,9423811,52.78,9890400,112.442,34,1.144,67293.483,317.84,17.26,0.863,0
198,181,851,91469,1,412,76888,9500699,52.78,9890400,112.442,34,1.144,67293.483,317.84,17.26,0.863,0
198,182,626,92095,1,413,98412,9599111,52.78,9890400,112.442,34,1.144,67293.483,317.84,17.26,0.863,0
198,183,995,93090,3,416,105615,9704726,52.78,9890400,112.442,34,1.144,67293.483,317.84,17.26,0.863,0
198,184,1100,94190,3,419,91234,9795960,52.78,9890400,112.442,34,1.144,67293.483,317.84,17.26,0.863,0
198,185,1158,95348,2,421,107187,9903147,52.78,9890400,112.442,34,1.144,67293.483,317.84,17.26,0.863,0
198,186,1181,96529,3,424,117812,10020959,52.78,9890400,112.442,34,1.144,67293.483,317.84,17.26,0.863,0
198,187,1231,97760,2,426,108906,10129865,52.78,9890400,112.442,34,1.144,67293.483,317.84,17.26,0.863,0
198,188,1041,98801,0,426,87669,10217534,52.78,9890400,112.442,34,1.144,67293.483,317.84,17.26,0.863,0
198,189,932,99733,3,429,102379,10319913,52.78,9890400,112.442,34,1.144,67293.483,317.84,17.26,0.863,0
198,190,1061,100794,6,435,111882,10431795,52.78,9890400,112.442,34,1.144,67293.483,317.84,17.26,0.863,0
198,191,1046,101840,1,436,115258,10547053,52.78,9890400,112.442,34,1.144,67293.483,317.84,17.26,0.863,0
198,192,1089,102929,2,438,120665,10667718,52.78,9890400,112.442,34,1.144,67293.483,317.84,17.26,0.863,0
198,193,1075,104004,4,442,136430,10804148,52.78,9890400,112.442,34,1.144,67293.483,317.84,17.26,0.863,0
198,194,1129,105133,1,443,133935,10938083,52.78,9890400,112.442,34,1.144,67293.483,317.84,17.26,0.863,0
198,195,1096,106229,2,445,78483,11016566,52.78,9890400,112.442,34,1.144,67293.483,317.84,17.26,0.863,0
198,196,1064,107293,1,446,96989,11113555,52.78,9890400,112.442,34,1.144,67293.483,317.84,17.26,0.863,0
198,197,1315,108608,2,448,103132,11216687,52.78,9890400,112.442,34,1.144,67293.483,317.84,17.26,0.863,0
198,198,1431,110039,2,450,114147,11330834,52.78,9890400,112.442,34,1.144,67293.483,317.84,17.26,0.863,0
198,199,1398,111437,2,452,116470,11447304,52.78,9890400,112.442,34,1.144,67293.483,317.84,17.26,0.863,0
198,200,1412,112849,3,455,130567,11577871,52.78,9890400,112.442,34,1.144,67293.483,317.84,17.26,0.863,0
198,201,1538,114387,4,459,115293,11693164,52.78,9890400,112.442,34,1.144,67293.483,317.84,17.26,0.863,0
198,202,1215,115602,4,463,77291,11770455,52.78,9890400,112.442,34,1.144,67293.483,317.84,17.26,0.863,0
198,203,915,116517,3,466,112196,11882651,52.78,9890400,112.442,34,1.144,67293.483,317.84,17.26,0.863,0
198,204,1077,117594,4,470,0,11882651,52.78,9890400,112.442,34,1.144,67293.483,317.84,17.26,0.863,0
199,1,4273,33954,403,2453,11896,155174,79.63,67886004,272.898,40.8,18.517,39753.244,122.137,4.28,0.922,4
199,2,4514,38468,672,3125,11924,167098,79.63,67886004,272.898,40.8,18.517,39753.244,122.137,4.28,0.922,4
199,3,4913,43381,657,3782,13457,182047,79.63,67886004,272.898,40.8,18.517,39753.244,122.137,4.28,0.922,4
199,4,4868,48249,736,4518,14293,222937,79.63,67886004,272.898,40.8,18.517,39753.244,122.137,4.28,0.922,4
199,5,4911,53160,756,5274,15899,238836,79.63,67886004,272.898,40.8,18.517,39753.244,122.137,4.28,0.922,4
199,6,4020,57180,599,5873,12733,251569,79.63,67886004,272.898,40.8,18.517,39753.244,122.137,4.28,0.922,4
199,7,3592,60772,567,6440,13684,265885,79.63,67886004,272.898,40.8,18.517,39753.244,122.137,4.28,0.922,4
199,8,5282,66054,1105,7545,14419,280304,79.63,67886004,272.898,40.8,18.517,39753.244,122.137,4.28,0.922,4
199,9,5450,71504,1030,8575,16443,296747,79.63,67886004,272.898,40.8,18.517,39753.244,122.137,4.28,0.922,4
199,10,5131,76635,1116,9691,18843,315141,79.63,67886004,272.898,40.8,18.517,39753.244,122.137,4.28,0.922,4
199,11,4858,81493,1122,10813,17737,332925,79.63,67886004,272.898,40.8,18.517,39753.244,122.137,4.28,0.922,4
199,12,4313,85806,843,11656,17650,350575,79.63,67886004,272.898,40.8,18.517,39753.244,122.137,4.28,0.922,4
199,13,3579,89385,657,12313,14506,365081,79.63,67886004,272.898,40.8,18.517,39753.244,122.137,4.28,0.922,4
199,14,3489,92874,724,13037,14567,379649,79.63,67886004,272.898,40.8,18.517,39753.244,122.137,4.28,0.922,4
199,15,4178,97052,1076,14113,15991,395912,79.63,67886004,272.898,40.8,18.517,39753.244,122.137,4.28,0.922,4
199,16,4326,101378,880,14993,18489,414469,79.63,67886004,272.898,40.8,18.517,39753.244,122.137,4.28,0.922,4
199,17,5065,106443,1036,16029,20906,435389,79.63,67886004,272.898,40.8,18.517,39753.244,122.137,4.28,0.922,4
199,18,5292,111735,913,16942,21081,456527,79.63,67886004,272.898,40.8,18.517,39753.244,122.137,4.28,0.922,4
199,19,4956,116691,1105,18047,21249,477776,79.63,67886004,272.898,40.8,18.517,39753.244,122.137,4.28,0.922,4
199,20,4721,121412,432,18479,19316,497092,79.63,67886004,272.898,40.8,18.517,39753.244,122.137,4.28,0.922,4
199,21,3853,125265,570,19049,17365,532229,79.63,67886004,272.898,40.8,18.517,39753.244,122.137,4.28,0.922,4
199,22,4854,130119,1224,20273,22763,554992,79.63,67886004,272.898,40.8,18.517,39753.244,122.137,4.28,0.922,4
199,23,4760,134879,847,21120,23073,578066,79.63,67886004,272.898,40.8,18.517,39753.244,122.137,4.28,0.922,4
199,24,5487,140366,682,21802,28024,606093,79.63,67886004,272.898,40.8,18.517,39753.244,122.137,4.28,0.922,4
199,25,5158,145524,1010,22812,28225,634319,79.63,67886004,272.898,40.8,18.517,39753.244,122.137,4.28,0.922,4
199,26,4970,150494,815,23627,29058,663377,79.63,67886004,272.898,40.8,18.517,39753.244,122.137,4.28,0.922,4
199,27,3748,154242,364,23991,31610,694987,79.63,67886004,272.898,40.8,18.517,39753.244,122.137,4.28,0.922,4
199,28,3473,157715,320,24311,31453,726553,79.63,67886004,272.898,40.8,18.517,39753.244,122.137,4.28,0.922,4
199,29,4706,162421,969,25280,45263,771817,79.63,67886004,272.898,40.8,18.517,39753.244,122.137,4.28,0.922,4
199,30,4729,167150,769,26049,65643,839597,79.63,67886004,272.898,40.8,18.517,39753.244,122.137,4.28,0.922,4
199,31,5442,172592,634,26683,83143,922684,79.63,67886004,272.898,40.8,18.517,39753.244,122.137,4.28,0.922,4
199,32,4966,177558,698,27381,74142,996826,79.63,67886004,272.898,40.8,18.517,39753.244,122.137,4.28,0.922,4
199,33,4737,182295,584,27965,63559,1060387,79.63,67886004,272.898,40.8,18.517,39753.244,122.137,4.28,0.922,4
199,34,3229,185524,253,28218,68203,1128590,79.63,67886004,272.898,40.8,18.517,39753.244,122.137,4.28,0.922,4
199,35,2982,188506,272,28490,71764,1202251,79.63,67886004,272.898,40.8,18.517,39753.244,122.137,4.28,0.922,4
199,36,3389,191895,726,29216,65803,1268054,79.63,67886004,272.898,40.8,18.517,39753.244,122.137,4.28,0.922,4
199,37,3682,195577,647,29863,73277,1343722,79.63,67886004,272.898,40.8,18.517,39753.244,122.137,4.28,0.922,4
199,38,3827,199404,458,30321,76741,1420462,79.63,67886004,272.898,40.8,18.517,39753.244,122.137,4.28,0.922,4
199,39,3767,203171,579,30900,74836,1495302,79.63,67886004,272.898,40.8,18.517,39753.244,122.137,4.28,0.922,4
199,40,3063,206234,275,31175,74586,1569888,79.63,67886004,272.898,40.8,18.517,39753.244,122.137,4.28,0.922,4
199,41,2157,208391,217,31392,73541,1643429,77.78,67886004,272.898,40.8,18.517,39753.244,122.137,4.28,0.922,4
199,42,2329,210720,187,31579,67116,1710628,77.78,67886004,272.898,40.8,18.517,39753.244,122.137,4.28,0.922,4
199,43,3586,214306,614,32193,72368,1782996,71.3,67886004,272.898,40.8,18.517,39753.244,122.137,4.28,0.922,4
199,44,3402,217708,447,32640,80713,1864403,71.3,67886004,272.898,40.8,18.517,39753.244,122.137,4.28,0.922,4
199,45,3307,221015,352,32992,81595,1946011,71.3,67886004,272.898,40.8,18.517,39753.244,122.137,4.28,0.922,4
199,46,2628,223643,350,33342,88046,2034056,71.3,67886004,272.898,40.8,18.517,39753.244,122.137,4.28,0.922,4
199,47,2526,226169,411,33753,88262,2122318,71.3,67886004,272.898,40.8,18.517,39753.244,122.137,4.28,0.922,4
199,48,2079,228248,67,33820,75290,2197608,71.3,67886004,272.898,40.8,18.517,39753.244,122.137,4.28,0.922,4
199,49,1838,230086,146,33966,63028,2260688,71.3,67886004,272.898,40.8,18.517,39753.244,122.137,4.28,0.922,4
199,50,2589,232675,500,34466,79653,2332060,71.3,67886004,272.898,40.8,18.517,39753.244,122.137,4.28,0.922,4
199,51,3052,235727,328,34794,81403,2413462,71.3,67886004,272.898,40.8,18.517,39753.244,122.137,4.28,0.922,4
199,52,2718,238445,273,35067,93398,2506869,71.3,67886004,272.898,40.8,18.517,39753.244,122.137,4.28,0.922,4
199,53,2574,241019,291,35358,84060,2590930,71.3,67886004,272.898,40.8,18.517,39753.244,122.137,4.28,0.922,4
199,54,2062,243081,220,35578,79902,2670829,71.3,67886004,272.898,40.8,18.517,39753.244,122.137,4.28,0.922,4
199,55,1527,244608,379,35957,51844,2722676,71.3,67886004,272.898,40.8,18.517,39753.244,122.137,4.28,0.922,4
199,56,1364,245972,104,36061,69381,2859563,71.3,67886004,272.898,40.8,18.517,39753.244,122.137,4.28,0.922,4
199,57,1624,247596,131,36192,63765,2923504,71.3,67886004,272.898,40.8,18.517,39753.244,122.137,4.28,0.922,4
199,58,1672,249268,422,36614,70329,2993833,71.3,67886004,272.898,40.8,18.517,39753.244,122.137,4.28,0.922,4
199,59,1835,251103,343,36957,84634,3078468,69.44,67886004,272.898,40.8,18.517,39753.244,122.137,4.28,0.922,4
199,60,1760,252863,274,37231,95550,3174018,69.44,67886004,272.898,40.8,18.517,39753.244,122.137,4.28,0.922,4
199,61,1527,254390,154,37385,89867,3263888,69.44,67886004,272.898,40.8,18.517,39753.244,122.137,4.28,0.922,4
199,62,1125,255515,60,37445,75263,3339151,67.59,67886004,272.898,40.8,18.517,39753.244,122.137,4.28,0.922,4
199,63,1079,256594,86,37531,64763,3403873,67.59,67886004,272.898,40.8,18.517,39753.244,122.137,4.28,0.922,4
199,64,1441,258035,249,37780,86267,3490527,67.59,67886004,272.898,40.8,18.517,39753.244,122.137,4.28,0.922,4
199,65,1484,259519,254,38034,96674,3587330,67.59,67886004,272.898,40.8,18.517,39753.244,122.137,4.28,0.922,4
199,66,1356,260875,130,38164,95445,3682775,67.59,67886004,272.898,40.8,18.517,39753.244,122.137,4.28,0.922,4
199,67,1243,262118,258,38422,98667,3782412,67.59,67886004,272.898,40.8,18.517,39753.244,122.137,4.28,0.922,4
199,68,1120,263238,143,38565,90562,3873426,67.59,67886004,272.898,40.8,18.517,39753.244,122.137,4.28,0.922,4
199,69,801,264039,54,38619,83790,3957326,73.15,67886004,272.898,40.8,18.517,39753.244,122.137,4.28,0.922,4
199,70,721,264760,47,38666,66769,4059548,73.15,67886004,272.898,40.8,18.517,39753.244,122.137,4.28,0.922,4
199,71,1099,265859,195,38861,91606,4151154,73.15,67886004,272.898,40.8,18.517,39753.244,122.137,4.28,0.922,4
199,72,1158,267017,164,39025,97852,4249081,73.15,67886004,272.898,40.8,18.517,39753.244,122.137,4.28,0.922,4
199,73,1199,268216,76,39101,98913,4349254,73.15,67886004,272.898,40.8,18.517,39753.244,122.137,4.28,0.922,4
199,74,1017,269233,131,39232,95216,4445275,73.15,67886004,272.898,40.8,18.517,39753.244,122.137,4.28,0.922,4
199,75,1052,270285,107,39339,96044,4542174,73.15,67886004,272.898,40.8,18.517,39753.244,122.137,4.28,0.922,4
199,76,890,271175,27,39366,66688,4609714,71.3,67886004,272.898,40.8,18.517,39753.244,122.137,4.28,0.922,4
199,77,822,271997,29,39395,67808,4677522,71.3,67886004,272.898,40.8,18.517,39753.244,122.137,4.28,0.922,4
199,78,1043,273040,120,39515,78962,4756484,71.3,67886004,272.898,40.8,18.517,39753.244,122.137,4.28,0.922,4
199,79,1102,274142,110,39625,83864,4840348,71.3,67886004,272.898,40.8,18.517,39753.244,122.137,4.28,0.922,4
199,80,1013,275155,67,39692,86579,4930797,71.3,67886004,272.898,40.8,18.517,39753.244,122.137,4.28,0.922,4
199,81,1027,276182,84,39776,87191,5017988,71.3,67886004,272.898,40.8,18.517,39753.244,122.137,4.28,0.922,4
199,82,986,277168,71,39847,80564,5098834,71.3,67886004,272.898,40.8,18.517,39753.244,122.137,4.28,0.922,4
199,83,687,277855,31,39878,57102,5156119,71.3,67886004,272.898,40.8,18.517,39753.244,122.137,4.28,0.922,4
199,84,639,278494,14,39892,59942,5219161,71.3,67886004,272.898,40.8,18.517,39753.244,122.137,4.28,0.922,4
199,85,896,279390,94,39986,66756,5285917,71.3,67886004,272.898,40.8,18.517,39753.244,122.137,4.28,0.922,4
199,86,886,280276,87,40073,88040,5373957,71.3,67886004,272.898,40.8,18.517,39753.244,122.137,4.28,0.922,4
199,87,778,281054,99,40172,93173,5510701,71.3,67886004,272.898,40.8,18.517,39753.244,122.137,4.28,0.922,4
199,88,721,281775,77,40249,93392,5604093,71.3,67886004,272.898,40.8,18.517,39753.244,122.137,4.28,0.922,4
199,89,671,282446,40,40289,90897,5694990,71.3,67886004,272.898,40.8,18.517,39753.244,122.137,4.28,0.922,4
199,90,649,283095,31,40320,64453,5760203,71.3,67886004,272.898,40.8,18.517,39753.244,122.137,4.28,0.922,4
199,91,446,283541,21,40341,62572,5825239,71.3,67886004,272.898,40.8,18.517,39753.244,122.137,4.28,0.922,4
199,92,730,284271,53,40394,97367,5922583,71.3,67886004,272.898,40.8,18.517,39753.244,122.137,4.28,0.922,4
199,93,617,284888,97,40491,112636,6035588,71.3,67886004,272.898,40.8,18.517,39753.244,122.137,4.28,0.922,4
199,94,651,285539,41,40532,112130,6147681,71.3,67886004,272.898,40.8,18.517,39753.244,122.137,4.28,0.922,4
199,95,602,286141,49,40581,114178,6262114,69.91,67886004,272.898,40.8,18.517,39753.244,122.137,4.28,0.922,4
199,96,579,286720,32,40613,93173,6355415,69.91,67886004,272.898,40.8,18.517,39753.244,122.137,4.28,0.922,4
199,97,401,287121,19,40632,76984,6433120,64.35,67886004,272.898,40.8,18.517,39753.244,122.137,4.28,0.922,4
199,98,555,287676,11,40643,63533,6496653,64.35,67886004,272.898,40.8,18.517,39753.244,122.137,4.28,0.922,4
199,99,704,288380,54,40697,100689,6597342,64.35,67886004,272.898,40.8,18.517,39753.244,122.137,4.28,0.922,4
199,100,597,288977,57,40754,120318,6717480,64.35,67886004,272.898,40.8,18.517,39753.244,122.137,4.28,0.922,4
199,101,693,289670,31,40785,131848,6849508,64.35,67886004,272.898,40.8,18.517,39753.244,122.137,4.28,0.922,4
199,102,715,290385,34,40819,128125,6977736,64.35,67886004,272.898,40.8,18.517,39753.244,122.137,4.28,0.922,4
199,103,565,290950,17,40836,124094,7101830,64.35,67886004,272.898,40.8,18.517,39753.244,122.137,4.28,0.922,4
199,104,442,291392,9,40845,86609,7188816,64.35,67886004,272.898,40.8,18.517,39753.244,122.137,4.28,0.922,4
199,105,361,291753,10,40855,74760,7262633,64.35,67886004,272.898,40.8,18.517,39753.244,122.137,4.28,0.922,4
199,106,726,292479,44,40899,112495,7375594,64.35,67886004,272.898,40.8,18.517,39753.244,122.137,4.28,0.922,4
199,107,685,293164,26,40925,129616,7508695,64.35,67886004,272.898,40.8,18.517,39753.244,122.137,4.28,0.922,4
199,108,772,293936,24,40949,149215,7658207,64.35,67886004,272.898,40.8,18.517,39753.244,122.137,4.28,0.922,4
199,109,704,294640,26,40975,157256,7815903,64.35,67886004,272.898,40.8,18.517,39753.244,122.137,4.28,0.922,4
199,110,569,295209,9,40984,131697,7947599,64.35,67886004,272.898,40.8,18.517,39753.244,122.137,4.28,0.922,4
199,111,493,295702,11,40995,102572,8050171,64.35,67886004,272.898,40.8,18.517,39753.244,122.137,4.28,0.922,4
199,112,413,296115,10,41005,84093,8135242,64.35,67886004,272.898,40.8,18.517,39753.244,122.137,4.28,0.922,4
199,113,793,296908,25,41030,121694,8256935,64.35,67886004,272.898,40.8,18.517,39753.244,122.137,4.28,0.922,4
199,114,751,297659,17,41047,131462,8388397,64.35,67886004,272.898,40.8,18.517,39753.244,122.137,4.28,0.922,4
199,115,773,298432,9,41056,134293,8522679,64.35,67886004,272.898,40.8,18.517,39753.244,122.137,4.28,0.922,4
199,116,731,299163,32,41088,140779,8663993,64.35,67886004,272.898,40.8,18.517,39753.244,122.137,4.28,0.922,4
199,117,667,299830,15,41103,134045,8798036,64.35,67886004,272.898,40.8,18.517,39753.244,122.137,4.28,0.922,4
199,118,421,300251,8,41111,104549,8904608,64.35,67886004,272.898,40.8,18.517,39753.244,122.137,4.28,0.922,4
199,119,371,300622,3,41114,82265,8986873,64.35,67886004,272.898,40.8,18.517,39753.244,122.137,4.28,0.922,4
199,120,70,300692,21,41135,130611,9117483,64.35,67886004,272.898,40.8,18.517,39753.244,122.137,4.28,0.922,4
199,121,763,301455,34,41169,143319,9260989,64.35,67886004,272.898,40.8,18.517,39753.244,122.137,4.28,0.922,4
199,122,846,302301,0,41169,154034,9415384,64.35,67886004,272.898,40.8,18.517,39753.244,122.137,4.28,0.922,4
199,123,880,303181,20,41189,147002,9562383,69.91,67886004,272.898,40.8,18.517,39753.244,122.137,4.28,0.922,4
199,124,771,303952,13,41202,130999,9693382,69.91,67886004,272.898,40.8,18.517,39753.244,122.137,4.28,0.922,4
199,125,743,304695,5,41207,124088,9818696,69.91,67886004,272.898,40.8,18.517,39753.244,122.137,4.28,0.922,4
199,126,928,305623,1,41208,123291,9941987,69.91,67886004,272.898,40.8,18.517,39753.244,122.137,4.28,0.922,4
199,127,670,306293,18,41226,140745,10083427,69.91,67886004,272.898,40.8,18.517,39753.244,122.137,4.28,0.922,4
199,128,891,307184,14,41240,152551,10236970,69.91,67886004,272.898,40.8,18.517,39753.244,122.137,4.28,0.922,4
199,129,950,308134,18,41258,162713,10400408,69.91,67886004,272.898,40.8,18.517,39753.244,122.137,4.28,0.922,4
199,130,871,309005,12,41270,156140,10556548,69.91,67886004,272.898,40.8,18.517,39753.244,122.137,4.28,0.922,4
199,131,758,309763,3,41273,146826,10703374,69.91,67886004,272.898,40.8,18.517,39753.244,122.137,4.28,0.922,4
199,132,1062,310825,5,41278,153214,10857124,69.91,67886004,272.898,40.8,18.517,39753.244,122.137,4.28,0.922,4
199,133,816,311641,18,41296,135827,10993551,69.91,67886004,272.898,40.8,18.517,39753.244,122.137,4.28,0.922,4
199,134,1148,312789,13,41309,147534,11141214,69.91,67886004,272.898,40.8,18.517,39753.244,122.137,4.28,0.922,4
199,135,1009,313798,20,41329,167983,11310805,66.2,67886004,272.898,40.8,18.517,39753.244,122.137,4.28,0.922,4
199,136,1129,314927,18,41347,159433,11471425,66.2,67886004,272.898,40.8,18.517,39753.244,122.137,4.28,0.922,4
199,137,1440,316367,11,41358,167759,11639184,66.2,67886004,272.898,40.8,18.517,39753.244,122.137,4.28,0.922,4
199,138,1077,317444,3,41361,174914,11814098,66.2,67886004,272.898,40.8,18.517,39753.244,122.137,4.28,0.922,4
199,139,1040,318484,5,41366,162256,11978298,66.2,67886004,272.898,40.8,18.517,39753.244,122.137,4.28,0.922,4
199,140,713,319197,3,41369,140608,12118924,66.2,67886004,272.898,40.8,18.517,39753.244,122.137,4.28,0.922,4
199,141,1089,320286,12,41381,153225,12272157,66.2,67886004,272.898,40.8,18.517,39753.244,122.137,4.28,0.922,4
199,142,812,321098,16,41397,175916,12446595,66.2,67886004,272.898,40.8,18.517,39753.244,122.137,4.28,0.922,4
199,143,1182,322280,6,41403,170627,12618033,66.2,67886004,272.898,40.8,18.517,39753.244,122.137,4.28,0.922,4
199,144,1033,323313,2,41405,180335,12798368,66.2,67886004,272.898,40.8,18.517,39753.244,122.137,4.28,0.922,4
199,145,1288,324601,18,41423,171385,12969753,66.2,67886004,272.898,40.8,18.517,39753.244,122.137,4.28,0.922,4
199,146,1041,325642,6,41429,155871,13126236,66.2,67886004,272.898,40.8,18.517,39753.244,122.137,4.28,0.922,4
199,147,972,326614,4,41433,137013,13263262,66.2,67886004,272.898,40.8,18.517,39753.244,122.137,4.28,0.922,4
199,148,1184,327798,16,41449,163158,13447568,66.2,67886004,272.898,40.8,18.517,39753.244,122.137,4.28,0.922,4
199,149,1048,328846,16,41465,184461,13633416,66.2,67886004,272.898,40.8,18.517,39753.244,122.137,4.28,0.922,4
199,150,1522,330368,12,41477,178203,13823629,66.2,67886004,272.898,40.8,18.517,39753.244,122.137,4.28,0.922,4
199,151,1276,331644,9,41486,168684,13992972,66.2,67886004,272.898,40.8,18.517,39753.244,122.137,4.28,0.922,4
199,152,1108,332752,12,41498,170574,14163546,66.2,67886004,272.898,40.8,18.517,39753.244,122.137,4.28,0.922,4
199,153,1715,334467,1,41499,166871,14330417,66.2,67886004,272.898,40.8,18.517,39753.244,122.137,4.28,0.922,4
199,154,1406,335873,2,41501,158554,14488971,64.35,67886004,272.898,40.8,18.517,39753.244,122.137,4.28,0.922,4
199,155,1295,337168,3,41504,164358,14653196,64.35,67886004,272.898,40.8,18.517,39753.244,122.137,4.28,0.922,4
199,156,1508,338676,10,41514,181772,14835199,64.35,67886004,272.898,40.8,18.517,39753.244,122.137,4.28,0.922,4
199,157,1735,340411,13,41527,181359,15017553,64.35,67886004,272.898,40.8,18.517,39753.244,122.137,4.28,0.922,4
199,158,1940,342351,10,41537,188783,15205285,64.35,67886004,272.898,40.8,18.517,39753.244,122.137,4.28,0.922,4
199,159,1813,344164,12,41549,166119,15371404,64.35,67886004,272.898,40.8,18.517,39753.244,122.137,4.28,0.922,4
199,160,2988,347152,2,41551,169930,15541294,64.35,67886004,272.898,40.8,18.517,39753.244,122.137,4.28,0.922,4
199,161,2948,350100,3,41554,179252,15720561,64.35,67886004,272.898,40.8,18.517,39753.244,122.137,4.28,0.922,4
199,162,2460,352560,32,41586,186851,15934869,64.35,67886004,272.898,40.8,18.517,39753.244,122.137,4.28,0.922,4
199,163,2659,355219,8,41594,205659,16145887,64.35,67886004,272.898,40.8,18.517,39753.244,122.137,4.28,0.922,4
199,164,2919,358138,14,41608,222448,16377083,64.35,67886004,272.898,40.8,18.517,39753.244,122.137,4.28,0.922,4
199,165,3539,361677,6,41614,238640,16655346,64.35,67886004,272.898,40.8,18.517,39753.244,122.137,4.28,0.922,4
199,166,3497,365174,9,41623,221166,16876512,64.35,67886004,272.898,40.8,18.517,39753.244,122.137,4.28,0.922,4
199,167,3330,368504,5,41628,213173,17089685,65.74,67886004,272.898,40.8,18.517,39753.244,122.137,4.28,0.922,4
199,168,2621,371125,9,41637,207718,17297403,65.74,67886004,272.898,40.8,18.517,39753.244,122.137,4.28,0.922,4
199,169,3103,374228,27,41664,223146,17521680,65.74,67886004,272.898,40.8,18.517,39753.244,122.137,4.28,0.922,4
199,170,3991,378219,20,41684,236219,17761017,65.74,67886004,272.898,40.8,18.517,39753.244,122.137,4.28,0.922,4
199,171,3395,381614,21,41705,233199,17995470,65.74,67886004,272.898,40.8,18.517,39753.244,122.137,4.28,0.922,4
199,172,4322,385936,27,41732,252509,18248877,65.74,67886004,272.898,40.8,18.517,39753.244,122.137,4.28,0.922,4
199,173,4422,390358,27,41759,239885,18488762,65.74,67886004,272.898,40.8,18.517,39753.244,122.137,4.28,0.922,4
199,174,3899,394257,18,41777,219723,18708484,65.74,67886004,272.898,40.8,18.517,39753.244,122.137,4.28,0.922,4
199,175,4368,398625,11,41788,188865,18897349,65.74,67886004,272.898,40.8,18.517,39753.244,122.137,4.28,0.922,4
199,176,4926,403551,37,41825,218360,19091955,65.74,67886004,272.898,40.8,18.517,39753.244,122.137,4.28,0.922,4
199,177,6178,409729,37,41862,232268,19325203,67.59,67886004,272.898,40.8,18.517,39753.244,122.137,4.28,0.922,4
199,178,6634,416363,40,41902,245363,19583360,67.59,67886004,272.898,40.8,18.517,39753.244,122.137,4.28,0.922,4
199,179,6873,423236,34,41936,258220,19842919,67.59,67886004,272.898,40.8,18.517,39753.244,122.137,4.28,0.922,4
199,180,6041,429277,35,41971,234489,20077408,67.59,67886004,272.898,40.8,18.517,39753.244,122.137,4.28,0.922,4
199,181,5692,434969,17,41988,226900,20304308,67.59,67886004,272.898,40.8,18.517,39753.244,122.137,4.28,0.922,4
199,182,4044,439013,13,42001,198402,20503188,67.59,67886004,272.898,40.8,18.517,39753.244,122.137,4.28,0.922,4
199,183,7143,446156,71,42072,210927,20727837,67.59,67886004,272.898,40.8,18.517,39753.244,122.137,4.28,0.922,4
199,184,7108,453264,71,42143,233861,20964429,67.59,67886004,272.898,40.8,18.517,39753.244,122.137,4.28,0.922,4
199,185,6914,460178,59,42202,239098,21208723,67.59,67886004,272.898,40.8,18.517,39753.244,122.137,4.28,0.922,4
199,186,6968,467146,66,42268,249600,21458497,67.59,67886004,272.898,40.8,18.517,39753.244,122.137,4.28,0.922,4
199,187,12871,480017,49,42317,252983,21711480,67.59,67886004,272.898,40.8,18.517,39753.244,122.137,4.28,0.922,4
199,188,22961,502978,33,42350,223470,21934950,67.59,67886004,272.898,40.8,18.517,39753.244,122.137,4.28,0.922,4
199,189,12593,515571,19,42369,232638,22167851,67.59,67886004,272.898,40.8,18.517,39753.244,122.137,4.28,0.922,4
199,190,14542,530113,76,42445,240116,22409225,67.59,67886004,272.898,40.8,18.517,39753.244,122.137,4.28,0.922,4
199,191,14162,544275,70,42515,238461,22649175,67.59,67886004,272.898,40.8,18.517,39753.244,122.137,4.28,0.922,4
199,192,17540,561815,77,42592,270921,22938406,67.59,67886004,272.898,40.8,18.517,39753.244,122.137,4.28,0.922,4
199,193,13864,575679,87,42679,277261,23215667,67.59,67886004,272.898,40.8,18.517,39753.244,122.137,4.28,0.922,4
199,194,15165,590844,81,42760,256190,23471856,67.59,67886004,272.898,40.8,18.517,39753.244,122.137,4.28,0.922,4
199,195,12872,603716,65,42825,237638,23709494,60.19,67886004,272.898,40.8,18.517,39753.244,122.137,4.28,0.922,4
199,196,13972,617688,50,42875,199211,23910761,60.19,67886004,272.898,40.8,18.517,39753.244,122.137,4.28,0.922,4
199,197,17232,634920,143,43018,249883,24198274,60.19,67886004,272.898,40.8,18.517,39753.244,122.137,4.28,0.922,4
199,198,19724,654644,137,43155,273794,24477883,60.19,67886004,272.898,40.8,18.517,39753.244,122.137,4.28,0.922,4
199,199,18978,673622,138,43293,278713,24756972,60.19,67886004,272.898,40.8,18.517,39753.244,122.137,4.28,0.922,4
199,200,15635,689257,136,43429,289429,25046375,60.19,67886004,272.898,40.8,18.517,39753.244,122.137,4.28,0.922,4
199,201,16171,705428,150,43579,277577,25323952,60.19,67886004,272.898,40.8,18.517,39753.244,122.137,4.28,0.922,4
199,202,16981,722409,67,43646,280884,25604836,65.74,67886004,272.898,40.8,18.517,39753.244,122.137,4.28,0.922,4
199,203,18803,741212,80,43726,0,25604836,65.74,67886004,272.898,40.8,18.517,39753.244,122.137,4.28,0.922,4
199,204,21330,762542,241,43967,0,25604836,65.74,67886004,272.898,40.8,18.517,39753.244,122.137,4.28,0.922,4
200,1,24998,189618,909,4079,135805,1499045,72.69,331002647,35.608,38.3,15.413,54225.446,151.089,10.79,0.924,2
200,2,27103,216721,1059,5138,142681,1641726,72.69,331002647,35.608,38.3,15.413,54225.446,151.089,10.79,0.924,2
200,3,28819,245540,915,6053,151241,1792967,72.69,331002647,35.608,38.3,15.413,54225.446,151.089,10.79,0.924,2
200,4,32425,277965,1104,7157,135224,1928191,72.69,331002647,35.608,38.3,15.413,54225.446,151.089,10.79,0.924,2
200,5,34272,312237,1344,8501,128200,2056391,72.69,331002647,35.608,38.3,15.413,54225.446,151.089,10.79,0.924,2
200,6,25398,337635,1146,9647,131154,2187545,72.69,331002647,35.608,38.3,15.413,54225.446,151.089,10.79,0.924,2
200,7,30561,368196,1342,10989,151635,2339180,72.69,331002647,35.608,38.3,15.413,54225.446,151.089,10.79,0.924,2
200,8,30613,398809,1906,12895,346650,2685830,72.69,331002647,35.608,38.3,15.413,54225.446,151.089,10.79,0.924,2
200,9,33323,432132,1922,14817,167079,2852909,72.69,331002647,35.608,38.3,15.413,54225.446,151.089,10.79,0.924,2
200,10,33901,466033,1873,16690,172564,3025473,72.69,331002647,35.608,38.3,15.413,54225.446,151.089,10.79,0.924,2
200,11,35527,501560,2087,18777,207285,3232758,72.69,331002647,35.608,38.3,15.413,54225.446,151.089,10.79,0.924,2
200,12,28391,529951,1831,20608,116384,3349142,72.69,331002647,35.608,38.3,15.413,54225.446,151.089,10.79,0.924,2
200,13,27620,557571,1500,22108,109075,3458217,72.69,331002647,35.608,38.3,15.413,54225.446,151.089,10.79,0.924,2
200,14,25023,582594,1541,23649,150288,3608505,72.69,331002647,35.608,38.3,15.413,54225.446,151.089,10.79,0.924,2
200,15,26922,609516,2408,26057,182262,3790767,72.69,331002647,35.608,38.3,15.413,54225.446,151.089,10.79,0.924,2
200,16,30148,639664,4928,30985,178835,3969602,72.69,331002647,35.608,38.3,15.413,54225.446,151.089,10.79,0.924,2
200,17,31667,671331,2299,33284,178326,4147928,72.69,331002647,35.608,38.3,15.413,54225.446,151.089,10.79,0.924,2
200,18,30833,702164,3770,37054,175250,4323178,72.69,331002647,35.608,38.3,15.413,54225.446,151.089,10.79,0.924,2
200,19,32922,735086,1856,38910,133646,4456824,72.69,331002647,35.608,38.3,15.413,54225.446,151.089,10.79,0.924,2
200,20,24601,759687,1772,40682,157467,4614291,72.69,331002647,35.608,38.3,15.413,54225.446,151.089,10.79,0.924,2
200,21,28065,787752,1857,42539,218543,4832834,72.69,331002647,35.608,38.3,15.413,54225.446,151.089,10.79,0.924,2
200,22,37289,825041,2524,45063,225583,5058417,72.69,331002647,35.608,38.3,15.413,54225.446,151.089,10.79,0.924,2
200,23,17588,842629,1721,46784,218486,5276903,72.69,331002647,35.608,38.3,15.413,54225.446,151.089,10.79,0.924,2
200,24,26543,869172,3179,49963,248708,5525611,72.69,331002647,35.608,38.3,15.413,54225.446,151.089,10.79,0.924,2
200,25,21352,890524,1054,51017,217054,5742665,72.69,331002647,35.608,38.3,15.413,54225.446,151.089,10.79,0.924,2
200,26,48529,939053,2172,53189,198661,5941326,72.69,331002647,35.608,38.3,15.413,54225.446,151.089,10.79,0.924,2
200,27,26857,965910,1687,54876,218257,6159583,72.69,331002647,35.608,38.3,15.413,54225.446,151.089,10.79,0.924,2
200,28,22541,988451,1369,56245,248896,6408479,72.69,331002647,35.608,38.3,15.413,54225.446,151.089,10.79,0.924,2
200,29,24132,1012583,2110,58355,293795,6702274,72.69,331002647,35.608,38.3,15.413,54225.446,151.089,10.79,0.924,2
200,30,27326,1039909,2611,60966,310572,7012846,72.69,331002647,35.608,38.3,15.413,54225.446,151.089,10.79,0.924,2
200,31,29917,1069826,2040,63006,296075,7308921,72.69,331002647,35.608,38.3,15.413,54225.446,151.089,10.79,0.924,2
200,32,33955,1103781,2062,65068,282348,7591269,72.69,331002647,35.608,38.3,15.413,54225.446,151.089,10.79,0.924,2
200,33,29288,1133069,1317,66385,190662,7781931,72.69,331002647,35.608,38.3,15.413,54225.446,151.089,10.79,0.924,2
200,34,24972,1158041,1297,67682,214641,7996572,72.69,331002647,35.608,38.3,15.413,54225.446,151.089,10.79,0.924,2
200,35,22593,1180634,1252,68934,352268,8348840,72.69,331002647,35.608,38.3,15.413,54225.446,151.089,10.79,0.924,2
200,36,23841,1204475,2144,71078,313992,8662832,72.69,331002647,35.608,38.3,15.413,54225.446,151.089,10.79,0.924,2
200,37,24128,1228603,2353,73431,370109,9032941,72.69,331002647,35.608,38.3,15.413,54225.446,151.089,10.79,0.924,2
200,38,28369,1256972,2239,75670,399326,9432267,72.69,331002647,35.608,38.3,15.413,54225.446,151.089,10.79,0.924,2
200,39,26957,1283929,1510,77180,319303,9751570,72.69,331002647,35.608,38.3,15.413,54225.446,151.089,10.79,0.924,2
200,40,25612,1309541,1614,78794,215688,9967258,72.69,331002647,35.608,38.3,15.413,54225.446,151.089,10.79,0.924,2
200,41,20258,1329799,734,79528,353546,10320804,72.69,331002647,35.608,38.3,15.413,54225.446,151.089,10.79,0.924,2
200,42,18117,1347916,1156,80684,408393,10729197,72.69,331002647,35.608,38.3,15.413,54225.446,151.089,10.79,0.924,2
200,43,22048,1369964,1703,82387,425708,11154905,72.69,331002647,35.608,38.3,15.413,54225.446,151.089,10.79,0.924,2
200,44,20782,1390746,1746,84133,437516,11592421,72.69,331002647,35.608,38.3,15.413,54225.446,151.089,10.79,0.924,2
200,45,27143,1417889,1773,85906,430266,12022687,72.69,331002647,35.608,38.3,15.413,54225.446,151.089,10.79,0.924,2
200,46,25508,1443397,1662,87568,363953,12386640,72.69,331002647,35.608,38.3,15.413,54225.446,151.089,10.79,0.924,2
200,47,24487,1467884,1186,88754,305253,12691893,72.69,331002647,35.608,38.3,15.413,54225.446,151.089,10.79,0.924,2
200,48,18873,1486757,808,89562,332014,13023907,72.69,331002647,35.608,38.3,15.413,54225.446,151.089,10.79,0.924,2
200,49,21841,1508598,791,90353,448074,13471981,72.69,331002647,35.608,38.3,15.413,54225.446,151.089,10.79,0.924,2
200,50,19970,1528568,1568,91921,403116,13875097,72.69,331002647,35.608,38.3,15.413,54225.446,151.089,10.79,0.924,2
200,51,23285,1551853,1518,93439,505274,14380371,72.69,331002647,35.608,38.3,15.413,54225.446,151.089,10.79,0.924,2
200,52,25434,1577287,1263,94702,484281,14864652,72.69,331002647,35.608,38.3,15.413,54225.446,151.089,10.79,0.924,2
200,53,24147,1601434,1305,96007,375213,15239865,72.69,331002647,35.608,38.3,15.413,54225.446,151.089,10.79,0.924,2
200,54,21236,1622670,1080,97087,293932,15533797,72.69,331002647,35.608,38.3,15.413,54225.446,151.089,10.79,0.924,2
200,55,20568,1643238,633,97720,398319,15932116,72.69,331002647,35.608,38.3,15.413,54225.446,151.089,10.79,0.924,2
200,56,19064,1662302,500,98220,464466,16396582,72.69,331002647,35.608,38.3,15.413,54225.446,151.089,10.79,0.924,2
200,57,18910,1681212,696,98916,523907,16920489,72.69,331002647,35.608,38.3,15.413,54225.446,151.089,10.79,0.924,2
200,58,18721,1699933,1526,100442,535358,17455847,72.69,331002647,35.608,38.3,15.413,54225.446,151.089,10.79,0.924,2
200,59,21817,1721750,1175,101617,513771,17969618,72.69,331002647,35.608,38.3,15.413,54225.446,151.089,10.79,0.924,2
200,60,25337,1747087,1219,102836,468927,18438545,72.69,331002647,35.608,38.3,15.413,54225.446,151.089,10.79,0.924,2
200,61,23297,1770384,945,103781,370189,18808734,72.69,331002647,35.608,38.3,15.413,54225.446,151.089,10.79,0.924,2
200,62,19807,1790191,602,104383,431676,19240410,72.69,331002647,35.608,38.3,15.413,54225.446,151.089,10.79,0.924,2
200,63,21086,1811277,764,105147,465527,19705937,72.69,331002647,35.608,38.3,15.413,54225.446,151.089,10.79,0.924,2
200,64,20544,1831821,1034,106181,624051,20329988,72.69,331002647,35.608,38.3,15.413,54225.446,151.089,10.79,0.924,2
200,65,19699,1851520,994,107175,603114,20933102,72.69,331002647,35.608,38.3,15.413,54225.446,151.089,10.79,0.924,2
200,66,21140,1872660,1036,108211,553107,21486209,72.69,331002647,35.608,38.3,15.413,54225.446,151.089,10.79,0.924,2
200,67,25178,1897838,932,109143,505682,21991891,72.69,331002647,35.608,38.3,15.413,54225.446,151.089,10.79,0.924,2
200,68,22223,1920061,659,109802,354301,22346192,72.69,331002647,35.608,38.3,15.413,54225.446,151.089,10.79,0.924,2
200,69,22302,1942363,712,110514,683849,23030041,72.69,331002647,35.608,38.3,15.413,54225.446,151.089,10.79,0.924,2
200,70,18822,1961185,493,111007,589472,23619513,72.69,331002647,35.608,38.3,15.413,54225.446,151.089,10.79,0.924,2
200,71,18665,1979850,999,112006,643633,24263146,72.69,331002647,35.608,38.3,15.413,54225.446,151.089,10.79,0.924,2
200,72,20614,2000464,918,112924,533835,24796981,72.69,331002647,35.608,38.3,15.413,54225.446,151.089,10.79,0.924,2
200,73,22883,2023347,896,113820,541975,25338956,72.69,331002647,35.608,38.3,15.413,54225.446,151.089,10.79,0.924,2
200,74,25639,2048986,849,114669,619641,25958597,72.69,331002647,35.608,38.3,15.413,54225.446,151.089,10.79,0.924,2
200,75,25540,2074526,767,115436,356835,26315432,72.69,331002647,35.608,38.3,15.413,54225.446,151.089,10.79,0.924,2
200,76,19543,2094069,296,115732,569930,26885362,68.98,331002647,35.608,38.3,15.413,54225.446,151.089,10.79,0.924,2
200,77,19957,2114026,395,116127,649451,27534813,68.98,331002647,35.608,38.3,15.413,54225.446,151.089,10.79,0.924,2
200,78,23705,2137731,836,116963,708752,28243565,68.98,331002647,35.608,38.3,15.413,54225.446,151.089,10.79,0.924,2
200,79,25559,2163290,754,117717,705290,28948855,68.98,331002647,35.608,38.3,15.413,54225.446,151.089,10.79,0.924,2
200,80,27762,2191052,717,118434,825604,29774459,68.98,331002647,35.608,38.3,15.413,54225.446,151.089,10.79,0.924,2
200,81,29909,2220961,678,119112,615687,30390146,68.98,331002647,35.608,38.3,15.413,54225.446,151.089,10.79,0.924,2
200,82,34158,2255119,607,119719,452678,30842824,68.98,331002647,35.608,38.3,15.413,54225.446,151.089,10.79,0.924,2
200,83,25793,2280912,256,119975,590634,31433458,68.98,331002647,35.608,38.3,15.413,54225.446,151.089,10.79,0.924,2
200,84,31390,2312302,427,120402,791846,32225304,68.98,331002647,35.608,38.3,15.413,54225.446,151.089,10.79,0.924,2
200,85,34720,2347022,826,121228,733844,32959148,68.98,331002647,35.608,38.3,15.413,54225.446,151.089,10.79,0.924,2
200,86,34339,2381361,751,121979,743295,33702443,68.98,331002647,35.608,38.3,15.413,54225.446,151.089,10.79,0.924,2
200,87,40949,2422310,2437,124416,781062,34483505,68.98,331002647,35.608,38.3,15.413,54225.446,151.089,10.79,0.924,2
200,88,45527,2467837,623,125039,668909,35152414,68.98,331002647,35.608,38.3,15.413,54225.446,151.089,10.79,0.924,2
200,89,42486,2510323,500,125539,493732,35646146,68.98,331002647,35.608,38.3,15.413,54225.446,151.089,10.79,0.924,2
200,90,38673,2548996,265,125804,766612,36412758,68.98,331002647,35.608,38.3,15.413,54225.446,151.089,10.79,0.924,2
200,91,41556,2590552,336,126140,871910,37284668,68.98,331002647,35.608,38.3,15.413,54225.446,151.089,10.79,0.924,2
200,92,43880,2634432,1270,127410,932551,38217219,68.98,331002647,35.608,38.3,15.413,54225.446,151.089,10.79,0.924,2
200,93,52048,2686480,652,128062,751109,38968328,68.98,331002647,35.608,38.3,15.413,54225.446,151.089,10.79,0.924,2
200,94,53399,2739879,678,128740,766534,39734862,68.98,331002647,35.608,38.3,15.413,54225.446,151.089,10.79,0.924,2
200,95,54442,2794321,694,129434,537871,40272733,68.98,331002647,35.608,38.3,15.413,54225.446,151.089,10.79,0.924,2
200,96,45221,2839542,242,129676,448920,40721653,68.98,331002647,35.608,38.3,15.413,54225.446,151.089,10.79,0.924,2
200,97,49093,2888635,271,129947,896950,41618603,68.98,331002647,35.608,38.3,15.413,54225.446,151.089,10.79,0.924,2
200,98,49990,2938625,359,130306,864742,42483345,68.98,331002647,35.608,38.3,15.413,54225.446,151.089,10.79,0.924,2
200,99,57473,2996098,1174,131480,939593,43422938,68.98,331002647,35.608,38.3,15.413,54225.446,151.089,10.79,0.924,2
200,100,58906,3055004,829,132309,951231,44374169,68.98,331002647,35.608,38.3,15.413,54225.446,151.089,10.79,0.924,2
200,101,63004,3118008,982,133291,953079,45327248,68.98,331002647,35.608,38.3,15.413,54225.446,151.089,10.79,0.924,2
200,102,66625,3184633,806,134097,831885,46159133,68.98,331002647,35.608,38.3,15.413,54225.446,151.089,10.79,0.924,2
200,103,63051,3247684,717,134814,724258,46883391,68.98,331002647,35.608,38.3,15.413,54225.446,151.089,10.79,0.924,2
200,104,57258,3304942,391,135205,839574,47722965,68.98,331002647,35.608,38.3,15.413,54225.446,151.089,10.79,0.924,2
200,105,58114,3363056,400,135605,929483,48652448,68.98,331002647,35.608,38.3,15.413,54225.446,151.089,10.79,0.924,2
200,106,68518,3431574,861,136466,883826,49536274,68.98,331002647,35.608,38.3,15.413,54225.446,151.089,10.79,0.924,2
200,107,67717,3499291,953,137419,1123204,50659478,68.98,331002647,35.608,38.3,15.413,54225.446,151.089,10.79,0.924,2
200,108,76930,3576221,939,138358,1024045,51683523,68.98,331002647,35.608,38.3,15.413,54225.446,151.089,10.79,0.924,2
200,109,71494,3647715,908,139266,874453,52557976,68.98,331002647,35.608,38.3,15.413,54225.446,151.089,10.79,0.924,2
200,110,63749,3711464,853,140119,614025,53172001,68.98,331002647,35.608,38.3,15.413,54225.446,151.089,10.79,0.924,2
200,111,61796,3773260,415,140534,756350,53928351,67.13,331002647,35.608,38.3,15.413,54225.446,151.089,10.79,0.924,2
200,112,56750,3830010,372,140906,1247767,55176118,67.13,331002647,35.608,38.3,15.413,54225.446,151.089,10.79,0.924,2
200,113,72048,3902058,1160,142066,1067399,56243517,67.13,331002647,35.608,38.3,15.413,54225.446,151.089,10.79,0.924,2
200,114,68848,3970906,1124,143190,1054598,57298115,67.13,331002647,35.608,38.3,15.413,54225.446,151.089,10.79,0.924,2
200,115,63196,4034102,1052,144242,911791,58209906,67.13,331002647,35.608,38.3,15.413,54225.446,151.089,10.79,0.924,2
200,116,78427,4112529,1304,145546,946734,59156640,67.13,331002647,35.608,38.3,15.413,54225.446,151.089,10.79,0.924,2
200,117,65498,4178027,914,146460,647718,59804358,67.13,331002647,35.608,38.3,15.413,54225.446,151.089,10.79,0.924,2
200,118,55993,4234020,475,146935,734456,60538814,67.13,331002647,35.608,38.3,15.413,54225.446,151.089,10.79,0.924,2
200,119,56243,4290263,1076,148011,883689,61422503,67.13,331002647,35.608,38.3,15.413,54225.446,151.089,10.79,0.924,2
200,120,61734,4351997,1245,149256,877458,62299961,67.13,331002647,35.608,38.3,15.413,54225.446,151.089,10.79,0.924,2
200,121,74985,4426982,1457,150713,1013928,63313889,67.13,331002647,35.608,38.3,15.413,54225.446,151.089,10.79,0.924,2
200,122,68032,4495014,1357,152070,981568,64295457,67.13,331002647,35.608,38.3,15.413,54225.446,151.089,10.79,0.924,2
200,123,67023,4562037,1244,153314,783532,65078989,67.13,331002647,35.608,38.3,15.413,54225.446,151.089,10.79,0.924,2
200,124,58407,4620444,1133,154447,589060,65668049,67.13,331002647,35.608,38.3,15.413,54225.446,151.089,10.79,0.924,2
200,125,47511,4667955,413,154860,696971,66365020,67.13,331002647,35.608,38.3,15.413,54225.446,151.089,10.79,0.924,2
200,126,45607,4713562,543,155403,794123,67159143,67.13,331002647,35.608,38.3,15.413,54225.446,151.089,10.79,0.924,2
200,127,57525,4771087,1403,156806,896494,68055637,67.13,331002647,35.608,38.3,15.413,54225.446,151.089,10.79,0.924,2
200,128,52804,4823891,1450,158256,917834,68973471,67.13,331002647,35.608,38.3,15.413,54225.446,151.089,10.79,0.924,2
200,129,59755,4883646,1848,160104,927640,69901111,67.13,331002647,35.608,38.3,15.413,54225.446,151.089,10.79,0.924,2
200,130,58150,4941796,1252,161356,829776,70730887,67.13,331002647,35.608,38.3,15.413,54225.446,151.089,10.79,0.924,2
200,131,56221,4998017,1069,162425,722549,71453436,67.13,331002647,35.608,38.3,15.413,54225.446,151.089,10.79,0.924,2
200,132,46847,5044864,513,162938,800313,72253749,67.13,331002647,35.608,38.3,15.413,54225.446,151.089,10.79,0.924,2
200,133,49530,5094394,523,163461,974362,73228111,67.13,331002647,35.608,38.3,15.413,54225.446,151.089,10.79,0.924,2
200,134,46813,5141207,1076,164537,973619,74201730,67.13,331002647,35.608,38.3,15.413,54225.446,151.089,10.79,0.924,2
200,135,55941,5197148,1490,166027,1059368,75261098,67.13,331002647,35.608,38.3,15.413,54225.446,151.089,10.79,0.924,2
200,136,51094,5248242,1083,167110,991653,76252751,67.13,331002647,35.608,38.3,15.413,54225.446,151.089,10.79,0.924,2
200,137,64838,5313080,1336,168446,853942,77106693,67.13,331002647,35.608,38.3,15.413,54225.446,151.089,10.79,0.924,2
200,138,48085,5361165,1035,169481,633362,77740055,67.13,331002647,35.608,38.3,15.413,54225.446,151.089,10.79,0.924,2
200,139,42104,5403269,571,170052,681529,78421584,67.13,331002647,35.608,38.3,15.413,54225.446,151.089,10.79,0.924,2
200,140,35056,5438325,445,170497,868128,79289712,67.13,331002647,35.608,38.3,15.413,54225.446,151.089,10.79,0.924,2
200,141,44091,5482416,1324,171821,975761,80265473,67.13,331002647,35.608,38.3,15.413,54225.446,151.089,10.79,0.924,2
200,142,47426,5529842,1356,173177,981612,81247085,67.13,331002647,35.608,38.3,15.413,54225.446,151.089,10.79,0.924,2
200,143,44005,5573847,1078,174255,948563,82195648,67.13,331002647,35.608,38.3,15.413,54225.446,151.089,10.79,0.924,2
200,144,49880,5623727,1151,175406,795347,82990995,67.13,331002647,35.608,38.3,15.413,54225.446,151.089,10.79,0.924,2
200,145,44378,5668105,956,176362,619574,83610569,67.13,331002647,35.608,38.3,15.413,54225.446,151.089,10.79,0.924,2
200,146,34506,5702611,444,176806,657346,84267915,67.13,331002647,35.608,38.3,15.413,54225.446,151.089,10.79,0.924,2
200,147,38298,5740909,473,177279,890541,85158456,67.13,331002647,35.608,38.3,15.413,54225.446,151.089,10.79,0.924,2
200,148,38119,5779028,1207,178486,943840,86102296,67.13,331002647,35.608,38.3,15.413,54225.446,151.089,10.79,0.924,2
200,149,42848,5821876,1228,179714,872648,86974944,67.13,331002647,35.608,38.3,15.413,54225.446,151.089,10.79,0.924,2
200,150,45909,5867785,1110,180824,1138062,88113006,67.13,331002647,35.608,38.3,15.413,54225.446,151.089,10.79,0.924,2
200,151,49654,5917439,949,181773,866850,88979856,67.13,331002647,35.608,38.3,15.413,54225.446,151.089,10.79,0.924,2
200,152,44143,5961582,1006,182779,631167,89611023,67.13,331002647,35.608,38.3,15.413,54225.446,151.089,10.79,0.924,2
200,153,35581,5997163,290,183069,737191,90348214,67.13,331002647,35.608,38.3,15.413,54225.446,151.089,10.79,0.924,2
200,154,33850,6031013,529,183598,882356,91230570,67.13,331002647,35.608,38.3,15.413,54225.446,151.089,10.79,0.924,2
200,155,44639,6075652,1091,184689,987193,92217763,67.13,331002647,35.608,38.3,15.413,54225.446,151.089,10.79,0.924,2
200,156,38754,6114406,1055,185744,1006581,93224344,67.13,331002647,35.608,38.3,15.413,54225.446,151.089,10.79,0.924,2
200,157,36249,6150655,1053,186797,1041142,94265486,67.13,331002647,35.608,38.3,15.413,54225.446,151.089,10.79,0.924,2
200,158,51071,6201726,968,187765,832185,95097671,67.13,331002647,35.608,38.3,15.413,54225.446,151.089,10.79,0.924,2
200,159,44140,6245866,773,188538,599483,95697154,67.13,331002647,35.608,38.3,15.413,54225.446,151.089,10.79,0.924,2
200,160,30555,6276421,403,188941,452894,96150048,67.13,331002647,35.608,38.3,15.413,54225.446,151.089,10.79,0.924,2
200,161,24250,6300671,267,189208,620531,96770579,67.13,331002647,35.608,38.3,15.413,54225.446,151.089,10.79,0.924,2
200,162,27122,6327793,471,189679,848655,97619234,67.13,331002647,35.608,38.3,15.413,54225.446,151.089,10.79,0.924,2
200,163,31927,6359720,1136,190815,986659,98605893,67.13,331002647,35.608,38.3,15.413,54225.446,151.089,10.79,0.924,2
200,164,37507,6397227,974,191789,1082254,99688147,67.13,331002647,35.608,38.3,15.413,54225.446,151.089,10.79,0.924,2
200,165,48061,6445288,1227,193016,865837,100553984,62.5,331002647,35.608,38.3,15.413,54225.446,151.089,10.79,0.924,2
200,166,40820,6486108,685,193701,665872,101219856,62.5,331002647,35.608,38.3,15.413,54225.446,151.089,10.79,0.924,2
200,167,33871,6519979,378,194079,703183,101923039,62.5,331002647,35.608,38.3,15.413,54225.446,151.089,10.79,0.924,2
200,168,34841,6554820,451,194530,939677,102862716,62.5,331002647,35.608,38.3,15.413,54225.446,151.089,10.79,0.924,2
200,169,51473,6606293,1407,195937,1032352,103895068,62.5,331002647,35.608,38.3,15.413,54225.446,151.089,10.79,0.924,2
200,170,24598,6630891,865,196802,1135774,105030842,62.5,331002647,35.608,38.3,15.413,54225.446,151.089,10.79,0.924,2
200,171,43567,6674458,831,197633,1240715,106271557,62.5,331002647,35.608,38.3,15.413,54225.446,151.089,10.79,0.924,2
200,172,50209,6724667,956,198589,951075,107222632,62.5,331002647,35.608,38.3,15.413,54225.446,151.089,10.79,0.924,2
200,173,40295,6764962,669,199258,669520,107892152,62.5,331002647,35.608,38.3,15.413,54225.446,151.089,10.79,0.924,2
200,174,39852,6804814,251,199509,733898,108626050,62.5,331002647,35.608,38.3,15.413,54225.446,151.089,10.79,0.924,2
200,175,53153,6857967,372,199881,953235,109579285,62.5,331002647,35.608,38.3,15.413,54225.446,151.089,10.79,0.924,2
200,176,38307,6896274,926,200807,1086638,110665923,62.5,331002647,35.608,38.3,15.413,54225.446,151.089,10.79,0.924,2
200,177,37930,6934204,1102,201909,1130339,111796262,62.5,331002647,35.608,38.3,15.413,54225.446,151.089,10.79,0.924,2
200,178,44213,6978417,901,202810,1119349,112915611,62.5,331002647,35.608,38.3,15.413,54225.446,151.089,10.79,0.924,2
200,179,55013,7033430,964,203774,974610,113890221,62.5,331002647,35.608,38.3,15.413,54225.446,151.089,10.79,0.924,2
200,180,45368,7078798,723,204497,689933,114580154,62.5,331002647,35.608,38.3,15.413,54225.446,151.089,10.79,0.924,2
200,181,36248,7115046,259,204756,735602,115315756,62.5,331002647,35.608,38.3,15.413,54225.446,151.089,10.79,0.924,2
200,182,32998,7148044,314,205070,993108,116308864,62.5,331002647,35.608,38.3,15.413,54225.446,151.089,10.79,0.924,2
200,183,43017,7191061,928,205998,1148425,117457289,62.5,331002647,35.608,38.3,15.413,54225.446,151.089,10.79,0.924,2
200,184,41982,7233043,930,206928,1171379,118628668,62.5,331002647,35.608,38.3,15.413,54225.446,151.089,10.79,0.924,2
200,185,44771,7277814,880,207808,1234740,119863408,62.5,331002647,35.608,38.3,15.413,54225.446,151.089,10.79,0.924,2
200,186,54471,7332285,908,208716,982660,120846068,62.5,331002647,35.608,38.3,15.413,54225.446,151.089,10.79,0.924,2
200,187,50659,7382944,678,209394,715927,121561995,62.5,331002647,35.608,38.3,15.413,54225.446,151.089,10.79,0.924,2
200,188,34901,7417845,400,209794,905735,122467730,62.5,331002647,35.608,38.3,15.413,54225.446,151.089,10.79,0.924,2
200,189,40705,7458550,398,210192,1091667,123559397,62.5,331002647,35.608,38.3,15.413,54225.446,151.089,10.79,0.924,2
200,190,43062,7501612,717,210909,1239782,124799179,62.5,331002647,35.608,38.3,15.413,54225.446,151.089,10.79,0.924,2
200,191,48182,7549794,892,211801,1311281,126110460,62.5,331002647,35.608,38.3,15.413,54225.446,151.089,10.79,0.924,2
200,192,56800,7606594,972,212773,1315469,127425929,62.5,331002647,35.608,38.3,15.413,54225.446,151.089,10.79,0.924,2
200,193,58082,7664676,1014,213787,1063835,128489764,62.5,331002647,35.608,38.3,15.413,54225.446,151.089,10.79,0.924,2
200,194,54271,7718947,590,214377,781981,129271745,62.5,331002647,35.608,38.3,15.413,54225.446,151.089,10.79,0.924,2
200,195,43597,7762544,394,214771,826461,130098206,62.5,331002647,35.608,38.3,15.413,54225.446,151.089,10.79,0.924,2
200,196,41653,7804197,314,215085,1029226,131127432,62.5,331002647,35.608,38.3,15.413,54225.446,151.089,10.79,0.924,2
200,197,52517,7856714,817,215902,1102740,132230172,62.5,331002647,35.608,38.3,15.413,54225.446,151.089,10.79,0.924,2
200,198,59386,7916100,970,216872,1084727,133314899,62.5,331002647,35.608,38.3,15.413,54225.446,151.089,10.79,0.924,2
200,199,63785,7979885,828,217700,812133,134127032,62.5,331002647,35.608,38.3,15.413,54225.446,151.089,10.79,0.924,2
200,200,70256,8050141,899,218599,631457,134758489,62.5,331002647,35.608,38.3,15.413,54225.446,151.089,10.79,0.924,2
200,201,56611,8106752,690,219289,0,134758489,62.5,331002647,35.608,38.3,15.413,54225.446,151.089,10.79,0.924,2
200,202,47843,8154595,385,219674,0,134758489,62.5,331002647,35.608,38.3,15.413,54225.446,151.089,10.79,0.924,2
200,203,60160,8214755,459,220133,0,134758489,62.5,331002647,35.608,38.3,15.413,54225.446,151.089,10.79,0.924,2
200,204,58549,8273304,933,221066,0,134758489,62.5,331002647,35.608,38.3,15.413,54225.446,151.089,10.79,0.924,2
202,1,6,330,0,1,289,4108,68.52,3473727,19.751,35.6,14.655,20551.409,160.708,6.93,0.804,0
202,2,11,341,1,2,356,4464,72.22,3473727,19.751,35.6,14.655,20551.409,160.708,6.93,0.804,0
202,3,18,359,2,4,322,4786,72.22,3473727,19.751,35.6,14.655,20551.409,160.708,6.93,0.804,0
202,4,12,371,0,4,277,5063,72.22,3473727,19.751,35.6,14.655,20551.409,160.708,6.93,0.804,0
202,5,19,390,1,5,145,5208,72.22,3473727,19.751,35.6,14.655,20551.409,160.708,6.93,0.804,0
202,6,17,407,1,6,177,5385,72.22,3473727,19.751,35.6,14.655,20551.409,160.708,6.93,0.804,0
202,7,4,411,0,6,342,5727,72.22,3473727,19.751,35.6,14.655,20551.409,160.708,6.93,0.804,0
202,8,6,417,1,7,448,6175,72.22,3473727,19.751,35.6,14.655,20551.409,160.708,6.93,0.804,0
202,9,9,426,0,7,681,6856,72.22,3473727,19.751,35.6,14.655,20551.409,160.708,6.93,0.804,0
202,10,7,433,0,7,640,7496,72.22,3473727,19.751,35.6,14.655,20551.409,160.708,6.93,0.804,0
202,11,13,446,0,7,618,8114,72.22,3473727,19.751,35.6,14.655,20551.409,160.708,6.93,0.804,0
202,12,7,453,0,7,660,8774,72.22,3473727,19.751,35.6,14.655,20551.409,160.708,6.93,0.804,0
202,13,12,465,1,8,462,9236,62.96,3473727,19.751,35.6,14.655,20551.409,160.708,6.93,0.804,0
202,14,7,472,0,8,693,9929,62.96,3473727,19.751,35.6,14.655,20551.409,160.708,6.93,0.804,0
202,15,11,483,0,8,519,10448,62.96,3473727,19.751,35.6,14.655,20551.409,160.708,6.93,0.804,0
202,16,10,493,1,9,791,11239,62.96,3473727,19.751,35.6,14.655,20551.409,160.708,6.93,0.804,0
202,17,9,502,0,9,510,11749,62.96,3473727,19.751,35.6,14.655,20551.409,160.708,6.93,0.804,0
202,18,6,508,0,9,729,12478,62.96,3473727,19.751,35.6,14.655,20551.409,160.708,6.93,0.804,0
202,19,9,517,0,9,348,12826,62.96,3473727,19.751,35.6,14.655,20551.409,160.708,6.93,0.804,0
202,20,11,528,1,10,0,12826,62.96,3473727,19.751,35.6,14.655,20551.409,160.708,6.93,0.804,0
202,21,7,535,0,10,0,13396,62.96,3473727,19.751,35.6,14.655,20551.409,160.708,6.93,0.804,0
202,22,8,543,2,12,527,13923,61.11,3473727,19.751,35.6,14.655,20551.409,160.708,6.93,0.804,0
202,23,6,549,0,12,609,14532,61.11,3473727,19.751,35.6,14.655,20551.409,160.708,6.93,0.804,0
202,24,8,557,0,12,610,15142,61.11,3473727,19.751,35.6,14.655,20551.409,160.708,6.93,0.804,0
202,25,6,563,0,12,692,15834,61.11,3473727,19.751,35.6,14.655,20551.409,160.708,6.93,0.804,0
202,26,33,596,2,14,662,16496,61.11,3473727,19.751,35.6,14.655,20551.409,160.708,6.93,0.804,0
202,27,10,606,1,15,567,17063,61.11,3473727,19.751,35.6,14.655,20551.409,160.708,6.93,0.804,0
202,28,14,620,0,15,442,17505,61.11,3473727,19.751,35.6,14.655,20551.409,160.708,6.93,0.804,0
202,29,5,625,0,15,635,18140,61.11,3473727,19.751,35.6,14.655,20551.409,160.708,6.93,0.804,0
202,30,5,630,0,15,876,19016,61.11,3473727,19.751,35.6,14.655,20551.409,160.708,6.93,0.804,0
202,31,13,643,2,17,731,19747,61.11,3473727,19.751,35.6,14.655,20551.409,160.708,6.93,0.804,0
202,32,5,648,0,17,807,20554,61.11,3473727,19.751,35.6,14.655,20551.409,160.708,6.93,0.804,0
202,33,4,652,0,17,610,21164,61.11,3473727,19.751,35.6,14.655,20551.409,160.708,6.93,0.804,0
202,34,3,655,0,17,775,21939,61.11,3473727,19.751,35.6,14.655,20551.409,160.708,6.93,0.804,0
202,35,2,657,0,17,866,22805,61.11,3473727,19.751,35.6,14.655,20551.409,160.708,6.93,0.804,0
202,36,13,670,0,17,1006,23811,61.11,3473727,19.751,35.6,14.655,20551.409,160.708,6.93,0.804,0
202,37,3,673,0,17,845,24656,61.11,3473727,19.751,35.6,14.655,20551.409,160.708,6.93,0.804,0
202,38,11,684,0,17,1042,25698,61.11,3473727,19.751,35.6,14.655,20551.409,160.708,6.93,0.804,0
202,39,10,694,1,18,1140,26838,61.11,3473727,19.751,35.6,14.655,20551.409,160.708,6.93,0.804,0
202,40,8,702,0,18,623,27461,61.11,3473727,19.751,35.6,14.655,20551.409,160.708,6.93,0.804,0
202,41,5,707,1,19,1236,28697,61.11,3473727,19.751,35.6,14.655,20551.409,160.708,6.93,0.804,0
202,42,4,711,0,19,0,28697,61.11,3473727,19.751,35.6,14.655,20551.409,160.708,6.93,0.804,0
202,43,6,717,0,19,0,29500,61.11,3473727,19.751,35.6,14.655,20551.409,160.708,6.93,0.804,0
202,44,2,719,0,19,709,30209,61.11,3473727,19.751,35.6,14.655,20551.409,160.708,6.93,0.804,0
202,45,5,724,0,19,1000,31209,61.11,3473727,19.751,35.6,14.655,20551.409,160.708,6.93,0.804,0
202,46,8,732,0,19,1016,32225,61.11,3473727,19.751,35.6,14.655,20551.409,160.708,6.93,0.804,0
202,47,1,733,0,19,811,33036,61.11,3473727,19.751,35.6,14.655,20551.409,160.708,6.93,0.804,0
202,48,1,734,1,20,825,33861,61.11,3473727,19.751,35.6,14.655,20551.409,160.708,6.93,0.804,0
202,49,3,737,0,20,523,34384,61.11,3473727,19.751,35.6,14.655,20551.409,160.708,6.93,0.804,0
202,50,1,738,0,20,410,34794,61.11,3473727,19.751,35.6,14.655,20551.409,160.708,6.93,0.804,0
202,51,8,746,0,20,0,34794,61.11,3473727,19.751,35.6,14.655,20551.409,160.708,6.93,0.804,0
202,52,3,749,0,20,0,35537,61.11,3473727,19.751,35.6,14.655,20551.409,160.708,6.93,0.804,0
202,53,4,753,0,20,1641,37178,61.11,3473727,19.751,35.6,14.655,20551.409,160.708,6.93,0.804,0
202,54,11,764,2,22,0,37178,61.11,3473727,19.751,35.6,14.655,20551.409,160.708,6.93,0.804,0
202,55,5,769,0,22,0,38146,61.11,3473727,19.751,35.6,14.655,20551.409,160.708,6.93,0.804,0
202,56,18,787,0,22,549,38695,61.11,3473727,19.751,35.6,14.655,20551.409,160.708,6.93,0.804,0
202,57,2,789,0,22,774,39469,61.11,3473727,19.751,35.6,14.655,20551.409,160.708,6.93,0.804,0
202,58,14,803,0,22,760,40229,61.11,3473727,19.751,35.6,14.655,20551.409,160.708,6.93,0.804,0
202,59,8,811,0,22,1240,41469,61.11,3473727,19.751,35.6,14.655,20551.409,160.708,6.93,0.804,0
202,60,5,816,0,22,1155,42624,61.11,3473727,19.751,35.6,14.655,20551.409,160.708,6.93,0.804,0
202,61,5,821,0,22,855,43479,61.11,3473727,19.751,35.6,14.655,20551.409,160.708,6.93,0.804,0
202,62,2,823,0,22,0,43479,57.41,3473727,19.751,35.6,14.655,20551.409,160.708,6.93,0.804,0
202,63,2,825,1,23,0,44511,57.41,3473727,19.751,35.6,14.655,20551.409,160.708,6.93,0.804,0
202,64,1,826,0,23,715,45226,57.41,3473727,19.751,35.6,14.655,20551.409,160.708,6.93,0.804,0
202,65,2,828,0,23,551,45777,57.41,3473727,19.751,35.6,14.655,20551.409,160.708,6.93,0.804,0
202,66,4,832,0,23,735,46512,57.41,3473727,19.751,35.6,14.655,20551.409,160.708,6.93,0.804,0
202,67,2,834,0,23,921,47433,57.41,3473727,19.751,35.6,14.655,20551.409,160.708,6.93,0.804,0
202,68,11,845,0,23,596,48029,57.41,3473727,19.751,35.6,14.655,20551.409,160.708,6.93,0.804,0
202,69,0,845,0,23,403,48432,57.41,3473727,19.751,35.6,14.655,20551.409,160.708,6.93,0.804,0
202,70,0,845,0,23,464,48896,57.41,3473727,19.751,35.6,14.655,20551.409,160.708,6.93,0.804,0
202,71,1,846,0,23,757,49653,57.41,3473727,19.751,35.6,14.655,20551.409,160.708,6.93,0.804,0
202,72,1,847,0,23,820,50473,57.41,3473727,19.751,35.6,14.655,20551.409,160.708,6.93,0.804,0
202,73,0,847,0,23,840,51313,57.41,3473727,19.751,35.6,14.655,20551.409,160.708,6.93,0.804,0
202,74,0,847,0,23,765,52078,57.41,3473727,19.751,35.6,14.655,20551.409,160.708,6.93,0.804,0
202,75,0,847,0,23,784,52862,57.41,3473727,19.751,35.6,14.655,20551.409,160.708,6.93,0.804,0
202,76,1,848,0,23,403,53265,57.41,3473727,19.751,35.6,14.655,20551.409,160.708,6.93,0.804,0
202,77,0,848,0,23,460,53725,57.41,3473727,19.751,35.6,14.655,20551.409,160.708,6.93,0.804,0
202,78,1,849,1,24,761,54486,57.41,3473727,19.751,35.6,14.655,20551.409,160.708,6.93,0.804,0
202,79,0,849,0,24,1410,55896,57.41,3473727,19.751,35.6,14.655,20551.409,160.708,6.93,0.804,0
202,80,1,850,0,24,338,56234,57.41,3473727,19.751,35.6,14.655,20551.409,160.708,6.93,0.804,0
202,81,3,853,0,24,643,56877,57.41,3473727,19.751,35.6,14.655,20551.409,160.708,6.93,0.804,0
202,82,6,859,1,25,412,57289,57.41,3473727,19.751,35.6,14.655,20551.409,160.708,6.93,0.804,0
202,83,17,876,0,25,398,57687,57.41,3473727,19.751,35.6,14.655,20551.409,160.708,6.93,0.804,0
202,84,6,882,0,25,1158,58845,57.41,3473727,19.751,35.6,14.655,20551.409,160.708,6.93,0.804,0
202,85,3,885,0,25,1473,60318,57.41,3473727,19.751,35.6,14.655,20551.409,160.708,6.93,0.804,0
202,86,17,902,1,26,1290,61608,57.41,3473727,19.751,35.6,14.655,20551.409,160.708,6.93,0.804,0
202,87,5,907,0,26,1157,62765,57.41,3473727,19.751,35.6,14.655,20551.409,160.708,6.93,0.804,0
202,88,12,919,0,26,1418,64183,46.3,3473727,19.751,35.6,14.655,20551.409,160.708,6.93,0.804,0
202,89,5,924,0,26,403,64586,46.3,3473727,19.751,35.6,14.655,20551.409,160.708,6.93,0.804,0
202,90,5,929,1,27,1040,65626,46.3,3473727,19.751,35.6,14.655,20551.409,160.708,6.93,0.804,0
202,91,3,932,0,27,674,66300,46.3,3473727,19.751,35.6,14.655,20551.409,160.708,6.93,0.804,0
202,92,4,936,0,27,0,66300,46.3,3473727,19.751,35.6,14.655,20551.409,160.708,6.93,0.804,0
202,93,7,943,1,28,0,68449,46.3,3473727,19.751,35.6,14.655,20551.409,160.708,6.93,0.804,0
202,94,4,947,0,28,0,68449,46.3,3473727,19.751,35.6,14.655,20551.409,160.708,6.93,0.804,0
202,95,5,952,0,28,0,68449,43.52,3473727,19.751,35.6,14.655,20551.409,160.708,6.93,0.804,0
202,96,3,955,0,28,0,68449,43.52,3473727,19.751,35.6,14.655,20551.409,160.708,6.93,0.804,0
202,97,1,956,0,28,0,72553,43.52,3473727,19.751,35.6,14.655,20551.409,160.708,6.93,0.804,0
202,98,4,960,1,29,1056,73609,43.52,3473727,19.751,35.6,14.655,20551.409,160.708,6.93,0.804,0
202,99,5,965,0,29,959,74568,43.52,3473727,19.751,35.6,14.655,20551.409,160.708,6.93,0.804,0
202,100,9,974,0,29,1467,76035,43.52,3473727,19.751,35.6,14.655,20551.409,160.708,6.93,0.804,0
202,101,3,977,0,29,1224,77259,25,3473727,19.751,35.6,14.655,20551.409,160.708,6.93,0.804,0
202,102,8,985,0,29,858,78117,23.15,3473727,19.751,35.6,14.655,20551.409,160.708,6.93,0.804,0
202,103,1,986,1,30,469,78586,23.15,3473727,19.751,35.6,14.655,20551.409,160.708,6.93,0.804,0
202,104,1,987,1,31,1377,79963,23.15,3473727,19.751,35.6,14.655,20551.409,160.708,6.93,0.804,0
202,105,2,989,0,31,1483,81446,23.15,3473727,19.751,35.6,14.655,20551.409,160.708,6.93,0.804,0
202,106,8,997,0,31,0,81446,23.15,3473727,19.751,35.6,14.655,20551.409,160.708,6.93,0.804,0
202,107,12,1009,0,31,0,82772,23.15,3473727,19.751,35.6,14.655,20551.409,160.708,6.93,0.804,0
202,108,0,1009,0,31,0,82772,23.15,3473727,19.751,35.6,14.655,20551.409,160.708,6.93,0.804,0
202,109,28,1037,1,32,0,82772,23.15,3473727,19.751,35.6,14.655,20551.409,160.708,6.93,0.804,0
202,110,7,1044,1,33,0,88616,23.15,3473727,19.751,35.6,14.655,20551.409,160.708,6.93,0.804,0
202,111,10,1054,0,33,2033,90649,23.15,3473727,19.751,35.6,14.655,20551.409,160.708,6.93,0.804,0
202,112,10,1064,0,33,1407,92056,23.15,3473727,19.751,35.6,14.655,20551.409,160.708,6.93,0.804,0
202,113,32,1096,0,33,3100,95156,23.15,3473727,19.751,35.6,14.655,20551.409,160.708,6.93,0.804,0
202,114,21,1117,1,34,2316,97472,23.15,3473727,19.751,35.6,14.655,20551.409,160.708,6.93,0.804,0
202,115,24,1141,0,34,2100,99572,23.15,3473727,19.751,35.6,14.655,20551.409,160.708,6.93,0.804,0
202,116,25,1166,0,34,1488,101060,23.15,3473727,19.751,35.6,14.655,20551.409,160.708,6.93,0.804,0
202,117,8,1174,0,34,1943,103003,23.15,3473727,19.751,35.6,14.655,20551.409,160.708,6.93,0.804,0
202,118,18,1192,0,34,1955,104958,23.15,3473727,19.751,35.6,14.655,20551.409,160.708,6.93,0.804,0
202,119,10,1202,1,35,2363,107321,23.15,3473727,19.751,35.6,14.655,20551.409,160.708,6.93,0.804,0
202,120,16,1218,0,35,1990,109311,23.15,3473727,19.751,35.6,14.655,20551.409,160.708,6.93,0.804,0
202,121,19,1237,0,35,1640,110951,23.15,3473727,19.751,35.6,14.655,20551.409,160.708,6.93,0.804,0
202,122,6,1243,0,35,2586,113537,23.15,3473727,19.751,35.6,14.655,20551.409,160.708,6.93,0.804,0
202,123,21,1264,0,35,1663,115200,23.15,3473727,19.751,35.6,14.655,20551.409,160.708,6.93,0.804,0
202,124,14,1278,0,35,1853,117053,23.15,3473727,19.751,35.6,14.655,20551.409,160.708,6.93,0.804,0
202,125,8,1286,1,36,1989,119042,26.85,3473727,19.751,35.6,14.655,20551.409,160.708,6.93,0.804,0
202,126,5,1291,0,36,0,119042,26.85,3473727,19.751,35.6,14.655,20551.409,160.708,6.93,0.804,0
202,127,9,1300,1,37,0,124098,26.85,3473727,19.751,35.6,14.655,20551.409,160.708,6.93,0.804,0
202,128,9,1309,0,37,0,124098,26.85,3473727,19.751,35.6,14.655,20551.409,160.708,6.93,0.804,0
202,129,9,1318,0,37,0,128814,26.85,3473727,19.751,35.6,14.655,20551.409,160.708,6.93,0.804,0
202,130,7,1325,0,37,1953,130767,26.85,3473727,19.751,35.6,14.655,20551.409,160.708,6.93,0.804,0
202,131,10,1335,0,37,0,130767,26.85,3473727,19.751,35.6,14.655,20551.409,160.708,6.93,0.804,0
202,132,18,1353,0,37,0,133237,26.85,3473727,19.751,35.6,14.655,20551.409,160.708,6.93,0.804,0
202,133,11,1364,0,37,2192,135429,26.85,3473727,19.751,35.6,14.655,20551.409,160.708,6.93,0.804,0
202,134,21,1385,0,37,1757,137186,26.85,3473727,19.751,35.6,14.655,20551.409,160.708,6.93,0.804,0
202,135,8,1393,0,37,1514,138700,26.85,3473727,19.751,35.6,14.655,20551.409,160.708,6.93,0.804,0
202,136,16,1409,0,37,3899,142599,26.85,3473727,19.751,35.6,14.655,20551.409,160.708,6.93,0.804,0
202,137,12,1421,1,38,1629,144228,26.85,3473727,19.751,35.6,14.655,20551.409,160.708,6.93,0.804,0
202,138,13,1434,0,38,2038,146266,26.85,3473727,19.751,35.6,14.655,20551.409,160.708,6.93,0.804,0
202,139,6,1440,0,38,0,146266,32.41,3473727,19.751,35.6,14.655,20551.409,160.708,6.93,0.804,0
202,140,17,1457,2,40,0,147594,32.41,3473727,19.751,35.6,14.655,20551.409,160.708,6.93,0.804,0
202,141,28,1485,0,40,4527,152121,32.41,3473727,19.751,35.6,14.655,20551.409,160.708,6.93,0.804,0
202,142,8,1493,0,40,2310,154431,32.41,3473727,19.751,35.6,14.655,20551.409,160.708,6.93,0.804,0
202,143,13,1506,1,41,0,154431,32.41,3473727,19.751,35.6,14.655,20551.409,160.708,6.93,0.804,0
202,144,10,1516,1,42,0,158702,32.41,3473727,19.751,35.6,14.655,20551.409,160.708,6.93,0.804,0
202,145,5,1521,0,42,1514,160216,32.41,3473727,19.751,35.6,14.655,20551.409,160.708,6.93,0.804,0
202,146,6,1527,0,42,0,160216,36.11,3473727,19.751,35.6,14.655,20551.409,160.708,6.93,0.804,0
202,147,6,1533,0,42,0,163129,32.41,3473727,19.751,35.6,14.655,20551.409,160.708,6.93,0.804,0
202,148,3,1536,1,43,1609,164738,32.41,3473727,19.751,35.6,14.655,20551.409,160.708,6.93,0.804,0
202,149,7,1543,0,43,1379,166117,32.41,3473727,19.751,35.6,14.655,20551.409,160.708,6.93,0.804,0
202,150,8,1551,0,43,1599,167716,32.41,3473727,19.751,35.6,14.655,20551.409,160.708,6.93,0.804,0
202,151,5,1556,0,43,3521,171237,32.41,3473727,19.751,35.6,14.655,20551.409,160.708,6.93,0.804,0
202,152,14,1570,1,44,844,172081,32.41,3473727,19.751,35.6,14.655,20551.409,160.708,6.93,0.804,0
202,153,15,1585,0,44,1106,173187,32.41,3473727,19.751,35.6,14.655,20551.409,160.708,6.93,0.804,0
202,154,10,1595,0,44,1893,175080,32.41,3473727,19.751,35.6,14.655,20551.409,160.708,6.93,0.804,0
202,155,16,1611,0,44,0,175080,32.41,3473727,19.751,35.6,14.655,20551.409,160.708,6.93,0.804,0
202,156,15,1626,0,44,0,178629,32.41,3473727,19.751,35.6,14.655,20551.409,160.708,6.93,0.804,0
202,157,10,1636,0,44,0,178629,32.41,3473727,19.751,35.6,14.655,20551.409,160.708,6.93,0.804,0
202,158,17,1653,1,45,0,178629,32.41,3473727,19.751,35.6,14.655,20551.409,160.708,6.93,0.804,0
202,159,16,1669,0,45,0,178629,32.41,3473727,19.751,35.6,14.655,20551.409,160.708,6.93,0.804,0
202,160,10,1679,0,45,0,178629,32.41,3473727,19.751,35.6,14.655,20551.409,160.708,6.93,0.804,0
202,161,14,1693,0,45,0,188636,32.41,3473727,19.751,35.6,14.655,20551.409,160.708,6.93,0.804,0
202,162,19,1712,0,45,1720,190356,32.41,3473727,19.751,35.6,14.655,20551.409,160.708,6.93,0.804,0
202,163,29,1741,0,45,2222,192578,32.41,3473727,19.751,35.6,14.655,20551.409,160.708,6.93,0.804,0
202,164,18,1759,0,45,2621,195199,32.41,3473727,19.751,35.6,14.655,20551.409,160.708,6.93,0.804,0
202,165,14,1773,0,45,1693,196892,32.41,3473727,19.751,35.6,14.655,20551.409,160.708,6.93,0.804,0
202,166,7,1780,0,45,1149,198041,32.41,3473727,19.751,35.6,14.655,20551.409,160.708,6.93,0.804,0
202,167,28,1808,0,45,3394,201435,32.41,3473727,19.751,35.6,14.655,20551.409,160.708,6.93,0.804,0
202,168,4,1812,0,45,1797,203232,32.41,3473727,19.751,35.6,14.655,20551.409,160.708,6.93,0.804,0
202,169,15,1827,0,45,2046,205278,43.52,3473727,19.751,35.6,14.655,20551.409,160.708,6.93,0.804,0
202,170,29,1856,0,45,3015,208293,43.52,3473727,19.751,35.6,14.655,20551.409,160.708,6.93,0.804,0
202,171,20,1876,1,46,1906,210199,43.52,3473727,19.751,35.6,14.655,20551.409,160.708,6.93,0.804,0
202,172,14,1890,0,46,0,210199,43.52,3473727,19.751,35.6,14.655,20551.409,160.708,6.93,0.804,0
202,173,14,1904,0,46,0,212901,43.52,3473727,19.751,35.6,14.655,20551.409,160.708,6.93,0.804,0
202,174,13,1917,0,46,3457,216358,43.52,3473727,19.751,35.6,14.655,20551.409,160.708,6.93,0.804,0
202,175,10,1927,0,46,1881,218239,43.52,3473727,19.751,35.6,14.655,20551.409,160.708,6.93,0.804,0
202,176,7,1934,0,46,3074,221313,43.52,3473727,19.751,35.6,14.655,20551.409,160.708,6.93,0.804,0
202,177,12,1946,1,47,3009,224322,43.52,3473727,19.751,35.6,14.655,20551.409,160.708,6.93,0.804,0
202,178,13,1959,0,47,1481,225803,43.52,3473727,19.751,35.6,14.655,20551.409,160.708,6.93,0.804,0
202,179,8,1967,0,47,2532,228335,43.52,3473727,19.751,35.6,14.655,20551.409,160.708,6.93,0.804,0
202,180,31,1998,0,47,1183,229518,43.52,3473727,19.751,35.6,14.655,20551.409,160.708,6.93,0.804,0
202,181,10,2008,0,47,2841,232359,43.52,3473727,19.751,35.6,14.655,20551.409,160.708,6.93,0.804,0
202,182,2,2010,0,47,1543,233902,43.52,3473727,19.751,35.6,14.655,20551.409,160.708,6.93,0.804,0
202,183,23,2033,1,48,2353,236255,43.52,3473727,19.751,35.6,14.655,20551.409,160.708,6.93,0.804,0
202,184,13,2046,0,48,2661,238916,43.52,3473727,19.751,35.6,14.655,20551.409,160.708,6.93,0.804,0
202,185,15,2061,0,48,3220,242136,43.52,3473727,19.751,35.6,14.655,20551.409,160.708,6.93,0.804,0
202,186,36,2097,0,48,3061,245197,43.52,3473727,19.751,35.6,14.655,20551.409,160.708,6.93,0.804,0
202,187,25,2122,0,48,1569,246766,43.52,3473727,19.751,35.6,14.655,20551.409,160.708,6.93,0.804,0
202,188,23,2145,0,48,0,246766,43.52,3473727,19.751,35.6,14.655,20551.409,160.708,6.93,0.804,0
202,189,10,2155,0,48,0,251361,43.52,3473727,19.751,35.6,14.655,20551.409,160.708,6.93,0.804,0
202,190,22,2177,1,49,2819,254180,43.52,3473727,19.751,35.6,14.655,20551.409,160.708,6.93,0.804,0
202,191,29,2206,0,49,2597,256777,43.52,3473727,19.751,35.6,14.655,20551.409,160.708,6.93,0.804,0
202,192,20,2226,0,49,2995,259772,43.52,3473727,19.751,35.6,14.655,20551.409,160.708,6.93,0.804,0
202,193,25,2251,0,49,2720,262492,43.52,3473727,19.751,35.6,14.655,20551.409,160.708,6.93,0.804,0
202,194,17,2268,1,50,1595,264087,43.52,3473727,19.751,35.6,14.655,20551.409,160.708,6.93,0.804,0
202,195,26,2294,0,50,2340,266427,43.52,3473727,19.751,35.6,14.655,20551.409,160.708,6.93,0.804,0
202,196,19,2313,1,51,1813,268240,43.52,3473727,19.751,35.6,14.655,20551.409,160.708,6.93,0.804,0
202,197,24,2337,0,51,2540,270780,43.52,3473727,19.751,35.6,14.655,20551.409,160.708,6.93,0.804,0
202,198,1,2338,0,51,2825,273605,43.52,3473727,19.751,35.6,14.655,20551.409,160.708,6.93,0.804,0
202,199,79,2417,0,51,2954,276559,43.52,3473727,19.751,35.6,14.655,20551.409,160.708,6.93,0.804,0
202,200,33,2450,0,51,2601,279160,43.52,3473727,19.751,35.6,14.655,20551.409,160.708,6.93,0.804,0
202,201,51,2501,0,51,0,279160,43.52,3473727,19.751,35.6,14.655,20551.409,160.708,6.93,0.804,0
202,202,30,2531,0,51,0,283904,43.52,3473727,19.751,35.6,14.655,20551.409,160.708,6.93,0.804,0
202,203,29,2560,0,51,0,283904,43.52,3473727,19.751,35.6,14.655,20551.409,160.708,6.93,0.804,0
202,204,63,2623,1,52,0,283904,43.52,3473727,19.751,35.6,14.655,20551.409,160.708,6.93,0.804,0
203,1,24,173,0,2,0,0,90.74,33469199,76.134,28.2,4.469,6253.104,724.417,7.57,0.71,4
203,2,14,187,0,2,0,0,90.74,33469199,76.134,28.2,4.469,6253.104,724.417,7.57,0.71,4
203,3,3,190,0,2,0,0,90.74,33469199,76.134,28.2,4.469,6253.104,724.417,7.57,0.71,4
203,4,37,227,0,2,0,0,90.74,33469199,76.134,28.2,4.469,6253.104,724.417,7.57,0.71,4
203,5,39,266,0,2,0,0,90.74,33469199,76.134,28.2,4.469,6253.104,724.417,7.57,0.71,4
203,6,76,342,0,2,0,0,90.74,33469199,76.134,28.2,4.469,6253.104,724.417,7.57,0.71,4
203,7,55,397,0,2,0,0,90.74,33469199,76.134,28.2,4.469,6253.104,724.417,7.57,0.71,4
203,8,107,504,0,2,0,0,90.74,33469199,76.134,28.2,4.469,6253.104,724.417,7.57,0.71,4
203,9,51,555,1,3,0,0,90.74,33469199,76.134,28.2,4.469,6253.104,724.417,7.57,0.71,4
203,10,27,582,0,3,0,0,90.74,33469199,76.134,28.2,4.469,6253.104,724.417,7.57,0.71,4
203,11,42,624,0,3,0,0,90.74,33469199,76.134,28.2,4.469,6253.104,724.417,7.57,0.71,4
203,12,172,796,1,4,0,0,90.74,33469199,76.134,28.2,4.469,6253.104,724.417,7.57,0.71,4
203,13,69,865,0,4,0,0,90.74,33469199,76.134,28.2,4.469,6253.104,724.417,7.57,0.71,4
203,14,133,998,0,4,0,0,90.74,33469199,76.134,28.2,4.469,6253.104,724.417,7.57,0.71,4
203,15,167,1165,0,4,0,0,90.74,33469199,76.134,28.2,4.469,6253.104,724.417,7.57,0.71,4
203,16,137,1302,0,4,0,0,90.74,33469199,76.134,28.2,4.469,6253.104,724.417,7.57,0.71,4
203,17,78,1380,0,4,0,0,90.74,33469199,76.134,28.2,4.469,6253.104,724.417,7.57,0.71,4
203,18,70,1450,0,4,0,0,90.74,33469199,76.134,28.2,4.469,6253.104,724.417,7.57,0.71,4
203,19,45,1495,1,5,0,0,90.74,33469199,76.134,28.2,4.469,6253.104,724.417,7.57,0.71,4
203,20,70,1565,0,5,0,0,90.74,33469199,76.134,28.2,4.469,6253.104,724.417,7.57,0.71,4
203,21,92,1657,0,5,0,0,90.74,33469199,76.134,28.2,4.469,6253.104,724.417,7.57,0.71,4
203,22,35,1692,1,6,0,0,90.74,33469199,76.134,28.2,4.469,6253.104,724.417,7.57,0.71,4
203,23,24,1716,1,7,0,0,90.74,33469199,76.134,28.2,4.469,6253.104,724.417,7.57,0.71,4
203,24,62,1778,0,7,0,0,90.74,33469199,76.134,28.2,4.469,6253.104,724.417,7.57,0.71,4
203,25,58,1836,1,8,0,0,90.74,33469199,76.134,28.2,4.469,6253.104,724.417,7.57,0.71,4
203,26,29,1865,0,8,0,0,90.74,33469199,76.134,28.2,4.469,6253.104,724.417,7.57,0.71,4
203,27,22,1887,0,8,0,0,90.74,33469199,76.134,28.2,4.469,6253.104,724.417,7.57,0.71,4
203,28,17,1904,0,8,0,0,96.3,33469199,76.134,28.2,4.469,6253.104,724.417,7.57,0.71,4
203,29,35,1939,0,8,0,0,96.3,33469199,76.134,28.2,4.469,6253.104,724.417,7.57,0.71,4
203,30,63,2002,1,9,0,0,96.3,33469199,76.134,28.2,4.469,6253.104,724.417,7.57,0.71,4
203,31,44,2046,0,9,0,0,96.3,33469199,76.134,28.2,4.469,6253.104,724.417,7.57,0.71,4
203,32,48,2094,0,9,0,0,96.3,33469199,76.134,28.2,4.469,6253.104,724.417,7.57,0.71,4
203,33,33,2127,0,9,0,0,96.3,33469199,76.134,28.2,4.469,6253.104,724.417,7.57,0.71,4
203,34,22,2149,1,10,0,0,96.3,33469199,76.134,28.2,4.469,6253.104,724.417,7.57,0.71,4
203,35,40,2189,0,10,0,0,96.3,33469199,76.134,28.2,4.469,6253.104,724.417,7.57,0.71,4
203,36,18,2207,0,10,0,0,96.3,33469199,76.134,28.2,4.469,6253.104,724.417,7.57,0.71,4
203,37,26,2233,0,10,0,0,96.3,33469199,76.134,28.2,4.469,6253.104,724.417,7.57,0.71,4
203,38,65,2298,0,10,0,0,88.89,33469199,76.134,28.2,4.469,6253.104,724.417,7.57,0.71,4
203,39,38,2336,0,10,0,0,88.89,33469199,76.134,28.2,4.469,6253.104,724.417,7.57,0.71,4
203,40,51,2387,0,10,0,0,88.89,33469199,76.134,28.2,4.469,6253.104,724.417,7.57,0.71,4
203,41,31,2418,0,10,0,0,88.89,33469199,76.134,28.2,4.469,6253.104,724.417,7.57,0.71,4
203,42,91,2509,0,10,0,0,88.89,33469199,76.134,28.2,4.469,6253.104,724.417,7.57,0.71,4
203,43,38,2547,0,10,0,0,88.89,33469199,76.134,28.2,4.469,6253.104,724.417,7.57,0.71,4
203,44,65,2612,1,11,0,0,88.89,33469199,76.134,28.2,4.469,6253.104,724.417,7.57,0.71,4
203,45,33,2645,0,11,0,0,88.89,33469199,76.134,28.2,4.469,6253.104,724.417,7.57,0.71,4
203,46,46,2691,0,11,0,0,88.89,33469199,76.134,28.2,4.469,6253.104,724.417,7.57,0.71,4
203,47,50,2741,0,11,0,0,88.89,33469199,76.134,28.2,4.469,6253.104,724.417,7.57,0.71,4
203,48,12,2753,1,12,0,0,86.11,33469199,76.134,28.2,4.469,6253.104,724.417,7.57,0.71,4
203,49,49,2802,1,13,0,0,86.11,33469199,76.134,28.2,4.469,6253.104,724.417,7.57,0.71,4
203,50,78,2880,0,13,0,0,86.11,33469199,76.134,28.2,4.469,6253.104,724.417,7.57,0.71,4
203,51,70,2950,0,13,0,0,86.11,33469199,76.134,28.2,4.469,6253.104,724.417,7.57,0.71,4
203,52,56,3006,0,13,0,0,86.11,33469199,76.134,28.2,4.469,6253.104,724.417,7.57,0.71,4
203,53,72,3078,0,13,0,0,86.11,33469199,76.134,28.2,4.469,6253.104,724.417,7.57,0.71,4
203,54,54,3132,0,13,0,0,86.11,33469199,76.134,28.2,4.469,6253.104,724.417,7.57,0.71,4
203,55,32,3164,0,13,0,0,86.11,33469199,76.134,28.2,4.469,6253.104,724.417,7.57,0.71,4
203,56,97,3261,0,13,0,0,86.11,33469199,76.134,28.2,4.469,6253.104,724.417,7.57,0.71,4
203,57,72,3333,1,14,0,0,86.11,33469199,76.134,28.2,4.469,6253.104,724.417,7.57,0.71,4
203,58,0,3333,0,14,0,0,86.11,33469199,76.134,28.2,4.469,6253.104,724.417,7.57,0.71,4
203,59,111,3444,0,14,0,0,86.11,33469199,76.134,28.2,4.469,6253.104,724.417,7.57,0.71,4
203,60,69,3513,0,14,0,0,86.11,33469199,76.134,28.2,4.469,6253.104,724.417,7.57,0.71,4
203,61,41,3554,0,14,0,0,86.11,33469199,76.134,28.2,4.469,6253.104,724.417,7.57,0.71,4
203,62,108,3662,1,15,0,0,81.94,33469199,76.134,28.2,4.469,6253.104,724.417,7.57,0.71,4
203,63,56,3718,0,15,0,0,81.94,33469199,76.134,28.2,4.469,6253.104,724.417,7.57,0.71,4
203,64,51,3769,0,15,0,0,81.94,33469199,76.134,28.2,4.469,6253.104,724.417,7.57,0.71,4
203,65,105,3874,1,16,0,0,81.94,33469199,76.134,28.2,4.469,6253.104,724.417,7.57,0.71,4
203,66,91,3965,0,16,0,0,76.39,33469199,76.134,28.2,4.469,6253.104,724.417,7.57,0.71,4
203,67,57,4022,0,16,0,0,76.39,33469199,76.134,28.2,4.469,6253.104,724.417,7.57,0.71,4
203,68,159,4181,1,17,0,0,76.39,33469199,76.134,28.2,4.469,6253.104,724.417,7.57,0.71,4
203,69,171,4352,0,17,0,0,76.39,33469199,76.134,28.2,4.469,6253.104,724.417,7.57,0.71,4
203,70,96,4448,1,18,0,0,76.39,33469199,76.134,28.2,4.469,6253.104,724.417,7.57,0.71,4
203,71,99,4547,0,18,0,0,76.39,33469199,76.134,28.2,4.469,6253.104,724.417,7.57,0.71,4
203,72,148,4695,1,19,0,0,76.39,33469199,76.134,28.2,4.469,6253.104,724.417,7.57,0.71,4
203,73,124,4819,0,19,0,0,76.39,33469199,76.134,28.2,4.469,6253.104,724.417,7.57,0.71,4
203,74,82,4901,0,19,0,0,76.39,33469199,76.134,28.2,4.469,6253.104,724.417,7.57,0.71,4
203,75,93,4994,0,19,0,0,76.39,33469199,76.134,28.2,4.469,6253.104,724.417,7.57,0.71,4
203,76,109,5103,0,19,0,0,67.13,33469199,76.134,28.2,4.469,6253.104,724.417,7.57,0.71,4
203,77,190,5293,0,19,0,0,67.13,33469199,76.134,28.2,4.469,6253.104,724.417,7.57,0.71,4
203,78,268,5561,0,19,0,0,67.13,33469199,76.134,28.2,4.469,6253.104,724.417,7.57,0.71,4
203,79,136,5697,0,19,0,0,67.13,33469199,76.134,28.2,4.469,6253.104,724.417,7.57,0.71,4
203,80,158,5855,0,19,0,0,64.35,33469199,76.134,28.2,4.469,6253.104,724.417,7.57,0.71,4
203,81,170,6025,0,19,0,0,64.35,33469199,76.134,28.2,4.469,6253.104,724.417,7.57,0.71,4
203,82,191,6216,0,19,0,0,64.35,33469199,76.134,28.2,4.469,6253.104,724.417,7.57,0.71,4
203,83,142,6358,0,19,0,0,64.35,33469199,76.134,28.2,4.469,6253.104,724.417,7.57,0.71,4
203,84,142,6500,0,19,0,0,64.35,33469199,76.134,28.2,4.469,6253.104,724.417,7.57,0.71,4
203,85,255,6755,0,19,0,0,64.35,33469199,76.134,28.2,4.469,6253.104,724.417,7.57,0.71,4
203,86,235,6990,0,19,0,0,64.35,33469199,76.134,28.2,4.469,6253.104,724.417,7.57,0.71,4
203,87,238,7228,1,20,0,0,64.35,33469199,76.134,28.2,4.469,6253.104,724.417,7.57,0.71,4
203,88,262,7490,0,20,0,0,64.35,33469199,76.134,28.2,4.469,6253.104,724.417,7.57,0.71,4
203,89,235,7725,0,20,0,0,64.35,33469199,76.134,28.2,4.469,6253.104,724.417,7.57,0.71,4
203,90,306,8031,2,22,0,0,64.35,33469199,76.134,28.2,4.469,6253.104,724.417,7.57,0.71,4
203,91,267,8298,2,24,0,0,64.35,33469199,76.134,28.2,4.469,6253.104,724.417,7.57,0.71,4
203,92,329,8627,2,26,0,0,64.35,33469199,76.134,28.2,4.469,6253.104,724.417,7.57,0.71,4
203,93,277,8904,0,26,0,0,64.35,33469199,76.134,28.2,4.469,6253.104,724.417,7.57,0.71,4
203,94,295,9199,1,27,0,0,64.35,33469199,76.134,28.2,4.469,6253.104,724.417,7.57,0.71,4
203,95,301,9500,2,29,0,0,64.35,33469199,76.134,28.2,4.469,6253.104,724.417,7.57,0.71,4
203,96,329,9829,2,31,0,0,64.35,33469199,76.134,28.2,4.469,6253.104,724.417,7.57,0.71,4
203,97,314,10143,4,35,0,0,64.35,33469199,76.134,28.2,4.469,6253.104,724.417,7.57,0.71,4
203,98,316,10459,3,38,0,0,64.35,33469199,76.134,28.2,4.469,6253.104,724.417,7.57,0.71,4
203,99,379,10838,3,41,0,0,64.35,33469199,76.134,28.2,4.469,6253.104,724.417,7.57,0.71,4
203,100,421,11259,6,47,0,0,64.35,33469199,76.134,28.2,4.469,6253.104,724.417,7.57,0.71,4
203,101,464,11723,5,52,0,0,64.35,33469199,76.134,28.2,4.469,6253.104,724.417,7.57,0.71,4
203,102,483,12206,3,55,0,0,64.35,33469199,76.134,28.2,4.469,6253.104,724.417,7.57,0.71,4
203,103,307,12513,2,57,0,0,64.35,33469199,76.134,28.2,4.469,6253.104,724.417,7.57,0.71,4
203,104,680,13193,4,61,0,0,67.59,33469199,76.134,28.2,4.469,6253.104,724.417,7.57,0.71,4
203,105,679,13872,3,64,0,0,67.59,33469199,76.134,28.2,4.469,6253.104,724.417,7.57,0.71,4
203,106,421,14293,4,68,0,0,67.59,33469199,76.134,28.2,4.469,6253.104,724.417,7.57,0.71,4
203,107,494,14787,4,72,0,0,67.59,33469199,76.134,28.2,4.469,6253.104,724.417,7.57,0.71,4
203,108,562,15349,4,76,0,0,67.59,33469199,76.134,28.2,4.469,6253.104,724.417,7.57,0.71,4
203,109,547,15896,4,80,0,0,67.59,33469199,76.134,28.2,4.469,6253.104,724.417,7.57,0.71,4
203,110,533,16429,4,84,0,0,67.59,33469199,76.134,28.2,4.469,6253.104,724.417,7.57,0.71,4
203,111,537,16966,4,88,0,0,67.59,33469199,76.134,28.2,4.469,6253.104,724.417,7.57,0.71,4
203,112,624,17590,4,92,0,0,67.59,33469199,76.134,28.2,4.469,6253.104,724.417,7.57,0.71,4
203,113,581,18171,4,96,0,0,67.59,33469199,76.134,28.2,4.469,6253.104,724.417,7.57,0.71,4
203,114,360,18531,3,99,0,0,67.59,33469199,76.134,28.2,4.469,6253.104,724.417,7.57,0.71,4
203,115,455,18986,4,103,0,0,67.59,33469199,76.134,28.2,4.469,6253.104,724.417,7.57,0.71,4
203,116,667,19653,4,107,0,0,67.59,33469199,76.134,28.2,4.469,6253.104,724.417,7.57,0.71,4
203,117,573,20226,5,112,0,0,67.59,33469199,76.134,28.2,4.469,6253.104,724.417,7.57,0.71,4
203,118,594,20820,5,117,0,0,69.44,33469199,76.134,28.2,4.469,6253.104,724.417,7.57,0.71,4
203,119,686,21506,5,122,0,0,69.44,33469199,76.134,28.2,4.469,6253.104,724.417,7.57,0.71,4
203,120,663,22169,5,127,0,0,69.44,33469199,76.134,28.2,4.469,6253.104,724.417,7.57,0.71,4
203,121,703,22872,5,132,0,0,69.44,33469199,76.134,28.2,4.469,6253.104,724.417,7.57,0.71,4
203,122,686,23558,5,137,0,0,69.44,33469199,76.134,28.2,4.469,6253.104,724.417,7.57,0.71,4
203,123,746,24304,6,143,0,0,69.44,33469199,76.134,28.2,4.469,6253.104,724.417,7.57,0.71,4
203,124,736,25040,6,149,0,0,69.44,33469199,76.134,28.2,4.469,6253.104,724.417,7.57,0.71,4
203,125,788,25828,6,155,0,0,69.44,33469199,76.134,28.2,4.469,6253.104,724.417,7.57,0.71,4
203,126,722,26550,6,161,0,0,69.44,33469199,76.134,28.2,4.469,6253.104,724.417,7.57,0.71,4
203,127,764,27314,6,167,0,0,69.44,33469199,76.134,28.2,4.469,6253.104,724.417,7.57,0.71,4
203,128,755,28069,6,173,0,0,69.44,33469199,76.134,28.2,4.469,6253.104,724.417,7.57,0.71,4
203,129,740,28809,6,179,0,0,69.44,33469199,76.134,28.2,4.469,6253.104,724.417,7.57,0.71,4
203,130,650,29459,6,185,0,0,69.44,33469199,76.134,28.2,4.469,6253.104,724.417,7.57,0.71,4
203,131,738,30197,5,190,0,0,69.44,33469199,76.134,28.2,4.469,6253.104,724.417,7.57,0.71,4
203,132,623,30820,6,196,0,0,69.44,33469199,76.134,28.2,4.469,6253.104,724.417,7.57,0.71,4
203,133,725,31545,6,202,0,0,69.44,33469199,76.134,28.2,4.469,6253.104,724.417,7.57,0.71,4
203,134,670,32215,6,208,0,0,69.44,33469199,76.134,28.2,4.469,6253.104,724.417,7.57,0.71,4
203,135,622,32837,5,213,0,0,69.44,33469199,76.134,28.2,4.469,6253.104,724.417,7.57,0.71,4
203,136,724,33561,5,218,0,0,69.44,33469199,76.134,28.2,4.469,6253.104,724.417,7.57,0.71,4
203,137,690,34251,5,223,0,0,74.07,33469199,76.134,28.2,4.469,6253.104,724.417,7.57,0.71,4
203,138,693,34944,5,228,0,0,74.07,33469199,76.134,28.2,4.469,6253.104,724.417,7.57,0.71,4
203,139,0,34944,0,228,0,0,74.07,33469199,76.134,28.2,4.469,6253.104,724.417,7.57,0.71,4
203,140,1156,36100,12,240,0,0,74.07,33469199,76.134,28.2,4.469,6253.104,724.417,7.57,0.71,4
203,141,660,36760,5,245,0,0,74.07,33469199,76.134,28.2,4.469,6253.104,724.417,7.57,0.71,4
203,142,606,37366,5,250,0,0,68.52,33469199,76.134,28.2,4.469,6253.104,724.417,7.57,0.71,4
203,143,459,37825,6,256,0,0,68.52,33469199,76.134,28.2,4.469,6253.104,724.417,7.57,0.71,4
203,144,406,38231,6,262,0,0,68.52,33469199,76.134,28.2,4.469,6253.104,724.417,7.57,0.71,4
203,145,467,38698,7,269,0,0,68.52,33469199,76.134,28.2,4.469,6253.104,724.417,7.57,0.71,4
203,146,248,38946,4,273,0,0,68.52,33469199,76.134,28.2,4.469,6253.104,724.417,7.57,0.71,4
203,147,560,39506,9,282,0,0,68.52,33469199,76.134,28.2,4.469,6253.104,724.417,7.57,0.71,4
203,148,284,39790,7,289,0,0,68.52,33469199,76.134,28.2,4.469,6253.104,724.417,7.57,0.71,4
203,149,405,40195,6,295,0,0,68.52,33469199,76.134,28.2,4.469,6253.104,724.417,7.57,0.71,4
203,150,418,40613,5,300,0,0,68.52,33469199,76.134,28.2,4.469,6253.104,724.417,7.57,0.71,4
203,151,340,40953,5,305,0,0,68.52,33469199,76.134,28.2,4.469,6253.104,724.417,7.57,0.71,4
203,152,350,41303,6,311,0,0,68.52,33469199,76.134,28.2,4.469,6253.104,724.417,7.57,0.71,4
203,153,348,41651,6,317,0,0,68.52,33469199,76.134,28.2,4.469,6253.104,724.417,7.57,0.71,4
203,154,343,41994,5,322,0,0,68.52,33469199,76.134,28.2,4.469,6253.104,724.417,7.57,0.71,4
203,155,376,42370,4,326,0,0,68.52,33469199,76.134,28.2,4.469,6253.104,724.417,7.57,0.71,4
203,156,170,42540,3,329,0,0,68.52,33469199,76.134,28.2,4.469,6253.104,724.417,7.57,0.71,4
203,157,365,42905,7,336,0,0,68.52,33469199,76.134,28.2,4.469,6253.104,724.417,7.57,0.71,4
203,158,93,42998,2,338,0,0,68.52,33469199,76.134,28.2,4.469,6253.104,724.417,7.57,0.71,4
203,159,478,43476,7,345,0,0,68.52,33469199,76.134,28.2,4.469,6253.104,724.417,7.57,0.71,4
203,160,299,43775,5,350,0,0,68.52,33469199,76.134,28.2,4.469,6253.104,724.417,7.57,0.71,4
203,161,332,44107,6,356,0,0,68.52,33469199,76.134,28.2,4.469,6253.104,724.417,7.57,0.71,4
203,162,450,44557,6,362,0,0,68.52,33469199,76.134,28.2,4.469,6253.104,724.417,7.57,0.71,4
203,163,603,45160,6,368,0,0,68.52,33469199,76.134,28.2,4.469,6253.104,724.417,7.57,0.71,4
203,164,767,45927,7,375,0,0,68.52,33469199,76.134,28.2,4.469,6253.104,724.417,7.57,0.71,4
203,165,571,46498,7,382,0,0,68.52,33469199,76.134,28.2,4.469,6253.104,724.417,7.57,0.71,4
203,166,544,47042,6,388,0,0,68.52,33469199,76.134,28.2,4.469,6253.104,724.417,7.57,0.71,4
203,167,578,47620,6,394,0,0,62.96,33469199,76.134,28.2,4.469,6253.104,724.417,7.57,0.71,4
203,168,572,48192,6,400,0,0,62.96,33469199,76.134,28.2,4.469,6253.104,724.417,7.57,0.71,4
203,169,584,48776,5,405,0,0,62.96,33469199,76.134,28.2,4.469,6253.104,724.417,7.57,0.71,4
203,170,609,49385,6,411,0,0,62.96,33469199,76.134,28.2,4.469,6253.104,724.417,7.57,0.71,4
203,171,609,49994,6,417,0,0,62.96,33469199,76.134,28.2,4.469,6253.104,724.417,7.57,0.71,4
203,172,259,50253,2,419,0,0,62.96,33469199,76.134,28.2,4.469,6253.104,724.417,7.57,0.71,4
203,173,982,51235,10,429,0,0,62.96,33469199,76.134,28.2,4.469,6253.104,724.417,7.57,0.71,4
203,174,554,51789,6,435,0,0,62.96,33469199,76.134,28.2,4.469,6253.104,724.417,7.57,0.71,4
203,175,702,52491,5,440,0,0,62.96,33469199,76.134,28.2,4.469,6253.104,724.417,7.57,0.71,4
203,176,560,53051,3,443,0,0,62.96,33469199,76.134,28.2,4.469,6253.104,724.417,7.57,0.71,4
203,177,616,53667,2,445,0,0,62.96,33469199,76.134,28.2,4.469,6253.104,724.417,7.57,0.71,4
203,178,299,53966,2,447,0,0,62.96,33469199,76.134,28.2,4.469,6253.104,724.417,7.57,0.71,4
203,179,496,54462,3,450,0,0,62.96,33469199,76.134,28.2,4.469,6253.104,724.417,7.57,0.71,4
203,180,491,54953,4,454,0,0,62.96,33469199,76.134,28.2,4.469,6253.104,724.417,7.57,0.71,4
203,181,640,55593,6,460,0,0,62.96,33469199,76.134,28.2,4.469,6253.104,724.417,7.57,0.71,4
203,182,475,56068,3,463,0,0,62.96,33469199,76.134,28.2,4.469,6253.104,724.417,7.57,0.71,4
203,183,451,56519,5,468,0,0,62.96,33469199,76.134,28.2,4.469,6253.104,724.417,7.57,0.71,4
203,184,478,56997,3,471,0,0,62.96,33469199,76.134,28.2,4.469,6253.104,724.417,7.57,0.71,4
203,185,457,57454,1,472,0,0,62.96,33469199,76.134,28.2,4.469,6253.104,724.417,7.57,0.71,4
203,186,322,57776,3,475,0,0,62.96,33469199,76.134,28.2,4.469,6253.104,724.417,7.57,0.71,4
203,187,645,58421,4,479,0,0,62.96,33469199,76.134,28.2,4.469,6253.104,724.417,7.57,0.71,4
203,188,438,58859,4,483,0,0,62.96,33469199,76.134,28.2,4.469,6253.104,724.417,7.57,0.71,4
203,189,87,58946,2,485,0,0,62.96,33469199,76.134,28.2,4.469,6253.104,724.417,7.57,0.71,4
203,190,397,59343,4,489,0,0,62.96,33469199,76.134,28.2,4.469,6253.104,724.417,7.57,0.71,4
203,191,562,59905,5,494,0,0,62.96,33469199,76.134,28.2,4.469,6253.104,724.417,7.57,0.71,4
203,192,217,60122,2,496,0,0,62.96,33469199,76.134,28.2,4.469,6253.104,724.417,7.57,0.71,4
203,193,220,60342,2,498,0,0,62.96,33469199,76.134,28.2,4.469,6253.104,724.417,7.57,0.71,4
203,194,552,60894,5,503,0,0,62.96,33469199,76.134,28.2,4.469,6253.104,724.417,7.57,0.71,4
203,195,204,61098,2,505,0,0,62.96,33469199,76.134,28.2,4.469,6253.104,724.417,7.57,0.71,4
203,196,436,61534,5,510,0,0,62.96,33469199,76.134,28.2,4.469,6253.104,724.417,7.57,0.71,4
203,197,325,61859,2,512,0,0,62.96,33469199,76.134,28.2,4.469,6253.104,724.417,7.57,0.71,4
203,198,316,62175,4,516,0,0,62.96,33469199,76.134,28.2,4.469,6253.104,724.417,7.57,0.71,4
203,199,309,62484,3,519,0,0,62.96,33469199,76.134,28.2,4.469,6253.104,724.417,7.57,0.71,4
203,200,100,62584,1,520,0,0,62.96,33469199,76.134,28.2,4.469,6253.104,724.417,7.57,0.71,4
203,201,540,63124,5,525,0,0,62.96,33469199,76.134,28.2,4.469,6253.104,724.417,7.57,0.71,4
203,202,306,63430,4,529,0,0,62.96,33469199,76.134,28.2,4.469,6253.104,724.417,7.57,0.71,4
203,203,307,63737,4,533,0,0,62.96,33469199,76.134,28.2,4.469,6253.104,724.417,7.57,0.71,4
203,204,273,64010,1,534,0,0,62.96,33469199,76.134,28.2,4.469,6253.104,724.417,7.57,0.71,4
205,1,0,135,0,3,0,0,82.41,28435943,36.253,29,6.614,16745.022,204.85,6.47,0.761,4
205,2,8,143,0,3,0,0,82.41,28435943,36.253,29,6.614,16745.022,204.85,6.47,0.761,4
205,3,1,144,0,3,0,0,82.41,28435943,36.253,29,6.614,16745.022,204.85,6.47,0.761,4
205,4,0,144,0,3,0,0,82.41,28435943,36.253,29,6.614,16745.022,204.85,6.47,0.761,4
205,5,0,144,2,5,0,0,82.41,28435943,36.253,29,6.614,16745.022,204.85,6.47,0.761,4
205,6,4,148,0,5,0,0,82.41,28435943,36.253,29,6.614,16745.022,204.85,6.47,0.761,4
205,7,11,159,0,5,0,0,82.41,28435943,36.253,29,6.614,16745.022,204.85,6.47,0.761,4
205,8,7,166,2,7,0,0,82.41,28435943,36.253,29,6.614,16745.022,204.85,6.47,0.761,4
205,9,1,167,1,8,0,0,82.41,28435943,36.253,29,6.614,16745.022,204.85,6.47,0.761,4
205,10,4,171,1,9,0,0,82.41,28435943,36.253,29,6.614,16745.022,204.85,6.47,0.761,4
205,11,4,175,0,9,0,0,82.41,28435943,36.253,29,6.614,16745.022,204.85,6.47,0.761,4
205,12,0,175,0,9,0,0,82.41,28435943,36.253,29,6.614,16745.022,204.85,6.47,0.761,4
205,13,6,181,0,9,0,0,82.41,28435943,36.253,29,6.614,16745.022,204.85,6.47,0.761,4
205,14,8,189,0,9,0,0,82.41,28435943,36.253,29,6.614,16745.022,204.85,6.47,0.761,4
205,15,4,193,0,9,0,0,82.41,28435943,36.253,29,6.614,16745.022,204.85,6.47,0.761,4
205,16,4,197,0,9,0,0,82.41,28435943,36.253,29,6.614,16745.022,204.85,6.47,0.761,4
205,17,7,204,0,9,0,0,82.41,28435943,36.253,29,6.614,16745.022,204.85,6.47,0.761,4
205,18,23,227,0,9,0,0,82.41,28435943,36.253,29,6.614,16745.022,204.85,6.47,0.761,4
205,19,0,227,0,9,0,0,82.41,28435943,36.253,29,6.614,16745.022,204.85,6.47,0.761,4
205,20,29,256,0,9,0,0,82.41,28435943,36.253,29,6.614,16745.022,204.85,6.47,0.761,4
205,21,0,256,0,9,0,0,82.41,28435943,36.253,29,6.614,16745.022,204.85,6.47,0.761,4
205,22,29,285,1,10,0,0,82.41,28435943,36.253,29,6.614,16745.022,204.85,6.47,0.761,4
205,23,3,288,0,10,0,0,82.41,28435943,36.253,29,6.614,16745.022,204.85,6.47,0.761,4
205,24,10,298,0,10,0,0,82.41,28435943,36.253,29,6.614,16745.022,204.85,6.47,0.761,4
205,25,20,318,0,10,0,0,82.41,28435943,36.253,29,6.614,16745.022,204.85,6.47,0.761,4
205,26,5,323,0,10,0,0,82.41,28435943,36.253,29,6.614,16745.022,204.85,6.47,0.761,4
205,27,2,325,0,10,0,0,82.41,28435943,36.253,29,6.614,16745.022,204.85,6.47,0.761,4
205,28,4,329,0,10,0,0,82.41,28435943,36.253,29,6.614,16745.022,204.85,6.47,0.761,4
205,29,0,329,0,10,0,0,82.41,28435943,36.253,29,6.614,16745.022,204.85,6.47,0.761,4
205,30,2,331,0,10,0,0,82.41,28435943,36.253,29,6.614,16745.022,204.85,6.47,0.761,4
205,31,2,333,0,10,0,0,82.41,28435943,36.253,29,6.614,16745.022,204.85,6.47,0.761,4
205,32,2,335,0,10,0,0,82.41,28435943,36.253,29,6.614,16745.022,204.85,6.47,0.761,4
205,33,10,345,0,10,0,0,82.41,28435943,36.253,29,6.614,16745.022,204.85,6.47,0.761,4
205,34,12,357,0,10,0,0,82.41,28435943,36.253,29,6.614,16745.022,204.85,6.47,0.761,4
205,35,4,361,0,10,0,0,82.41,28435943,36.253,29,6.614,16745.022,204.85,6.47,0.761,4
205,36,6,367,0,10,0,0,82.41,28435943,36.253,29,6.614,16745.022,204.85,6.47,0.761,4
205,37,12,379,0,10,0,0,82.41,28435943,36.253,29,6.614,16745.022,204.85,6.47,0.761,4
205,38,2,381,0,10,0,0,82.41,28435943,36.253,29,6.614,16745.022,204.85,6.47,0.761,4
205,39,7,388,0,10,0,0,82.41,28435943,36.253,29,6.614,16745.022,204.85,6.47,0.761,4
205,40,14,402,0,10,0,0,82.41,28435943,36.253,29,6.614,16745.022,204.85,6.47,0.761,4
205,41,12,414,0,10,0,0,82.41,28435943,36.253,29,6.614,16745.022,204.85,6.47,0.761,4
205,42,8,422,0,10,0,0,82.41,28435943,36.253,29,6.614,16745.022,204.85,6.47,0.761,4
205,43,1,423,0,10,0,0,85.19,28435943,36.253,29,6.614,16745.022,204.85,6.47,0.761,4
205,44,17,440,0,10,0,0,85.19,28435943,36.253,29,6.614,16745.022,204.85,6.47,0.761,4
205,45,15,455,0,10,0,0,85.19,28435943,36.253,29,6.614,16745.022,204.85,6.47,0.761,4
205,46,4,459,0,10,0,0,85.19,28435943,36.253,29,6.614,16745.022,204.85,6.47,0.761,4
205,47,45,504,0,10,0,0,85.19,28435943,36.253,29,6.614,16745.022,204.85,6.47,0.761,4
205,48,37,541,0,10,0,0,85.19,28435943,36.253,29,6.614,16745.022,204.85,6.47,0.761,4
205,49,77,618,0,10,0,0,85.19,28435943,36.253,29,6.614,16745.022,204.85,6.47,0.761,4
205,50,131,749,0,10,0,0,85.19,28435943,36.253,29,6.614,16745.022,204.85,6.47,0.761,4
205,51,75,824,0,10,0,0,85.19,28435943,36.253,29,6.614,16745.022,204.85,6.47,0.761,4
205,52,58,882,0,10,0,0,85.19,28435943,36.253,29,6.614,16745.022,204.85,6.47,0.761,4
205,53,62,944,0,10,0,0,85.19,28435943,36.253,29,6.614,16745.022,204.85,6.47,0.761,4
205,54,0,944,0,10,0,0,85.19,28435943,36.253,29,6.614,16745.022,204.85,6.47,0.761,4
205,55,177,1121,0,10,0,0,85.19,28435943,36.253,29,6.614,16745.022,204.85,6.47,0.761,4
205,56,56,1177,0,10,0,0,85.19,28435943,36.253,29,6.614,16745.022,204.85,6.47,0.761,4
205,57,34,1211,1,11,0,0,85.19,28435943,36.253,29,6.614,16745.022,204.85,6.47,0.761,4
205,58,34,1245,0,11,0,0,85.19,28435943,36.253,29,6.614,16745.022,204.85,6.47,0.761,4
205,59,82,1327,0,11,0,0,85.19,28435943,36.253,29,6.614,16745.022,204.85,6.47,0.761,4
205,60,42,1369,3,14,0,0,85.19,28435943,36.253,29,6.614,16745.022,204.85,6.47,0.761,4
205,61,90,1459,0,14,0,0,85.19,28435943,36.253,29,6.614,16745.022,204.85,6.47,0.761,4
205,62,51,1510,0,14,0,0,85.19,28435943,36.253,29,6.614,16745.022,204.85,6.47,0.761,4
205,63,152,1662,3,17,0,0,81.48,28435943,36.253,29,6.614,16745.022,204.85,6.47,0.761,4
205,64,157,1819,1,18,0,0,81.48,28435943,36.253,29,6.614,16745.022,204.85,6.47,0.761,4
205,65,133,1952,2,20,0,0,81.48,28435943,36.253,29,6.614,16745.022,204.85,6.47,0.761,4
205,66,135,2087,0,20,0,0,81.48,28435943,36.253,29,6.614,16745.022,204.85,6.47,0.761,4
205,67,58,2145,0,20,0,0,81.48,28435943,36.253,29,6.614,16745.022,204.85,6.47,0.761,4
205,68,171,2316,2,22,0,0,81.48,28435943,36.253,29,6.614,16745.022,204.85,6.47,0.761,4
205,69,61,2377,0,22,0,0,81.48,28435943,36.253,29,6.614,16745.022,204.85,6.47,0.761,4
205,70,96,2473,0,22,0,0,81.48,28435943,36.253,29,6.614,16745.022,204.85,6.47,0.761,4
205,71,159,2632,1,23,0,0,81.48,28435943,36.253,29,6.614,16745.022,204.85,6.47,0.761,4
205,72,106,2738,0,23,0,0,81.48,28435943,36.253,29,6.614,16745.022,204.85,6.47,0.761,4
205,73,76,2814,0,23,0,0,81.48,28435943,36.253,29,6.614,16745.022,204.85,6.47,0.761,4
205,74,65,2879,0,23,0,0,81.48,28435943,36.253,29,6.614,16745.022,204.85,6.47,0.761,4
205,75,25,2904,1,24,0,0,81.48,28435943,36.253,29,6.614,16745.022,204.85,6.47,0.761,4
205,76,74,2978,1,25,0,0,72.22,28435943,36.253,29,6.614,16745.022,204.85,6.47,0.761,4
205,77,84,3062,1,26,0,0,72.22,28435943,36.253,29,6.614,16745.022,204.85,6.47,0.761,4
205,78,88,3150,1,27,0,0,72.22,28435943,36.253,29,6.614,16745.022,204.85,6.47,0.761,4
205,79,,3150,,27,0,0,72.22,28435943,36.253,29,6.614,16745.022,204.85,6.47,0.761,4
205,80,334,3484,1,28,0,0,72.22,28435943,36.253,29,6.614,16745.022,204.85,6.47,0.761,4
205,81,107,3591,2,30,0,0,72.22,28435943,36.253,29,6.614,16745.022,204.85,6.47,0.761,4
205,82,199,3790,3,33,0,0,72.22,28435943,36.253,29,6.614,16745.022,204.85,6.47,0.761,4
205,83,128,3918,0,33,0,0,87.04,28435943,36.253,29,6.614,16745.022,204.85,6.47,0.761,4
205,84,130,4048,2,35,0,0,87.04,28435943,36.253,29,6.614,16745.022,204.85,6.47,0.761,4
205,85,138,4186,0,35,0,0,87.04,28435943,36.253,29,6.614,16745.022,204.85,6.47,0.761,4
205,86,179,4365,3,38,0,0,87.04,28435943,36.253,29,6.614,16745.022,204.85,6.47,0.761,4
205,87,198,4563,1,39,0,0,87.04,28435943,36.253,29,6.614,16745.022,204.85,6.47,0.761,4
205,88,216,4779,2,41,0,0,87.04,28435943,36.253,29,6.614,16745.022,204.85,6.47,0.761,4
205,89,351,5130,1,42,0,0,87.04,28435943,36.253,29,6.614,16745.022,204.85,6.47,0.761,4
205,90,167,5297,2,44,0,0,87.04,28435943,36.253,29,6.614,16745.022,204.85,6.47,0.761,4
205,91,233,5530,4,48,0,0,87.04,28435943,36.253,29,6.614,16745.022,204.85,6.47,0.761,4
205,92,302,5832,3,51,0,0,87.04,28435943,36.253,29,6.614,16745.022,204.85,6.47,0.761,4
205,93,230,6062,3,54,0,0,87.04,28435943,36.253,29,6.614,16745.022,204.85,6.47,0.761,4
205,94,211,6273,3,57,0,0,87.04,28435943,36.253,29,6.614,16745.022,204.85,6.47,0.761,4
205,95,264,6537,2,59,0,0,87.04,28435943,36.253,29,6.614,16745.022,204.85,6.47,0.761,4
205,96,213,6750,3,62,0,0,87.04,28435943,36.253,29,6.614,16745.022,204.85,6.47,0.761,4
205,97,419,7169,2,64,0,0,87.04,28435943,36.253,29,6.614,16745.022,204.85,6.47,0.761,4
205,98,242,7411,4,68,0,0,87.04,28435943,36.253,29,6.614,16745.022,204.85,6.47,0.761,4
205,99,282,7693,3,71,0,0,87.04,28435943,36.253,29,6.614,16745.022,204.85,6.47,0.761,4
205,100,317,8010,4,75,0,0,87.04,28435943,36.253,29,6.614,16745.022,204.85,6.47,0.761,4
205,101,362,8372,5,80,0,0,87.04,28435943,36.253,29,6.614,16745.022,204.85,6.47,0.761,4
205,102,431,8803,3,83,0,0,87.04,28435943,36.253,29,6.614,16745.022,204.85,6.47,0.761,4
205,103,375,9178,2,85,0,0,87.04,28435943,36.253,29,6.614,16745.022,204.85,6.47,0.761,4
205,104,287,9465,4,89,0,0,87.04,28435943,36.253,29,6.614,16745.022,204.85,6.47,0.761,4
205,105,242,9707,4,93,0,0,87.04,28435943,36.253,29,6.614,16745.022,204.85,6.47,0.761,4
205,106,303,10010,3,96,0,0,87.04,28435943,36.253,29,6.614,16745.022,204.85,6.47,0.761,4
205,107,418,10428,4,100,0,0,87.04,28435943,36.253,29,6.614,16745.022,204.85,6.47,0.761,4
205,108,426,10854,4,104,0,0,87.04,28435943,36.253,29,6.614,16745.022,204.85,6.47,0.761,4
205,109,337,11191,3,107,0,0,87.04,28435943,36.253,29,6.614,16745.022,204.85,6.47,0.761,4
205,110,292,11483,3,110,0,0,87.04,28435943,36.253,29,6.614,16745.022,204.85,6.47,0.761,4
205,111,408,11891,2,112,0,0,87.04,28435943,36.253,29,6.614,16745.022,204.85,6.47,0.761,4
205,112,443,12334,4,116,0,0,87.04,28435943,36.253,29,6.614,16745.022,204.85,6.47,0.761,4
205,113,440,12774,4,120,0,0,86.11,28435943,36.253,29,6.614,16745.022,204.85,6.47,0.761,4
205,114,0,12774,0,120,0,0,86.11,28435943,36.253,29,6.614,16745.022,204.85,6.47,0.761,4
205,115,839,13613,9,129,0,0,86.11,28435943,36.253,29,6.614,16745.022,204.85,6.47,0.761,4
205,116,650,14263,5,134,0,0,86.11,28435943,36.253,29,6.614,16745.022,204.85,6.47,0.761,4
205,117,0,14263,0,134,0,0,86.11,28435943,36.253,29,6.614,16745.022,204.85,6.47,0.761,4
205,118,1200,15463,8,142,0,0,86.11,28435943,36.253,29,6.614,16745.022,204.85,6.47,0.761,4
205,119,525,15988,4,146,0,0,86.11,28435943,36.253,29,6.614,16745.022,204.85,6.47,0.761,4
205,120,583,16571,5,151,0,0,86.11,28435943,36.253,29,6.614,16745.022,204.85,6.47,0.761,4
205,121,0,16571,0,151,0,0,86.11,28435943,36.253,29,6.614,16745.022,204.85,6.47,0.761,4
205,122,1288,17859,7,158,0,0,86.11,28435943,36.253,29,6.614,16745.022,204.85,6.47,0.761,4
205,123,715,18574,6,164,0,0,86.11,28435943,36.253,29,6.614,16745.022,204.85,6.47,0.761,4
205,124,869,19443,5,169,0,0,86.11,28435943,36.253,29,6.614,16745.022,204.85,6.47,0.761,4
205,125,763,20206,5,174,0,0,86.11,28435943,36.253,29,6.614,16745.022,204.85,6.47,0.761,4
205,126,0,20206,0,174,0,0,86.11,28435943,36.253,29,6.614,16745.022,204.85,6.47,0.761,4
205,127,1232,21438,13,187,0,0,86.11,28435943,36.253,29,6.614,16745.022,204.85,6.47,0.761,4
205,128,861,22299,8,195,0,0,86.11,28435943,36.253,29,6.614,16745.022,204.85,6.47,0.761,4
205,129,981,23280,7,202,0,0,86.11,28435943,36.253,29,6.614,16745.022,204.85,6.47,0.761,4
205,130,886,24166,6,208,0,0,86.11,28435943,36.253,29,6.614,16745.022,204.85,6.47,0.761,4
205,131,0,24166,0,208,0,0,86.11,28435943,36.253,29,6.614,16745.022,204.85,6.47,0.761,4
205,132,1639,25805,15,223,0,0,86.11,28435943,36.253,29,6.614,16745.022,204.85,6.47,0.761,4
205,133,0,25805,0,223,0,0,86.11,28435943,36.253,29,6.614,16745.022,204.85,6.47,0.761,4
205,134,2133,27938,15,238,0,0,86.11,28435943,36.253,29,6.614,16745.022,204.85,6.47,0.761,4
205,135,1150,29088,9,247,0,0,86.11,28435943,36.253,29,6.614,16745.022,204.85,6.47,0.761,4
205,136,1281,30369,12,259,0,0,86.11,28435943,36.253,29,6.614,16745.022,204.85,6.47,0.761,4
205,137,1012,31381,7,266,0,0,86.11,28435943,36.253,29,6.614,16745.022,204.85,6.47,0.761,4
205,138,1226,32607,10,276,0,0,86.11,28435943,36.253,29,6.614,16745.022,204.85,6.47,0.761,4
205,139,1148,33755,5,281,0,0,86.11,28435943,36.253,29,6.614,16745.022,204.85,6.47,0.761,4
205,140,1047,34802,7,288,0,0,86.11,28435943,36.253,29,6.614,16745.022,204.85,6.47,0.761,4
205,141,895,35697,9,297,0,0,86.11,28435943,36.253,29,6.614,16745.022,204.85,6.47,0.761,4
205,142,1171,36868,6,303,0,0,86.11,28435943,36.253,29,6.614,16745.022,204.85,6.47,0.761,4
205,143,699,37567,8,311,0,0,86.11,28435943,36.253,29,6.614,16745.022,204.85,6.47,0.761,4
205,144,621,38188,6,317,0,0,86.11,28435943,36.253,29,6.614,16745.022,204.85,6.47,0.761,4
205,145,769,38957,6,323,0,0,82.41,28435943,36.253,29,6.614,16745.022,204.85,6.47,0.761,4
205,146,607,39564,6,329,0,0,82.41,28435943,36.253,29,6.614,16745.022,204.85,6.47,0.761,4
205,147,774,40338,8,337,0,0,82.41,28435943,36.253,29,6.614,16745.022,204.85,6.47,0.761,4
205,148,820,41158,6,343,0,0,82.41,28435943,36.253,29,6.614,16745.022,204.85,6.47,0.761,4
205,149,0,41158,0,343,0,0,82.41,28435943,36.253,29,6.614,16745.022,204.85,6.47,0.761,4
205,150,1740,42898,15,358,0,0,82.41,28435943,36.253,29,6.614,16745.022,204.85,6.47,0.761,4
205,151,981,43879,0,358,0,0,82.41,28435943,36.253,29,6.614,16745.022,204.85,6.47,0.761,4
205,152,1067,44946,17,375,0,0,82.41,28435943,36.253,29,6.614,16745.022,204.85,6.47,0.761,4
205,153,922,45868,6,381,0,0,82.41,28435943,36.253,29,6.614,16745.022,204.85,6.47,0.761,4
205,154,0,45868,0,381,0,0,82.41,28435943,36.253,29,6.614,16745.022,204.85,6.47,0.761,4
205,155,1888,47756,10,391,0,0,82.41,28435943,36.253,29,6.614,16745.022,204.85,6.47,0.761,4
205,156,1127,48883,7,398,0,0,82.41,28435943,36.253,29,6.614,16745.022,204.85,6.47,0.761,4
205,157,994,49877,4,402,0,0,82.41,28435943,36.253,29,6.614,16745.022,204.85,6.47,0.761,4
205,158,1096,50973,10,412,0,0,82.41,28435943,36.253,29,6.614,16745.022,204.85,6.47,0.761,4
205,159,1192,52165,8,420,0,0,82.41,28435943,36.253,29,6.614,16745.022,204.85,6.47,0.761,4
205,160,1124,53289,8,428,0,0,82.41,28435943,36.253,29,6.614,16745.022,204.85,6.47,0.761,4
205,161,1061,54350,8,436,0,0,82.41,28435943,36.253,29,6.614,16745.022,204.85,6.47,0.761,4
205,162,1213,55563,8,444,0,0,82.41,28435943,36.253,29,6.614,16745.022,204.85,6.47,0.761,4
205,163,1188,56751,8,452,0,0,82.41,28435943,36.253,29,6.614,16745.022,204.85,6.47,0.761,4
205,164,1072,57823,8,460,0,0,82.41,28435943,36.253,29,6.614,16745.022,204.85,6.47,0.761,4
205,165,840,58663,8,468,0,0,82.41,28435943,36.253,29,6.614,16745.022,204.85,6.47,0.761,4
205,166,967,59630,9,477,0,0,82.41,28435943,36.253,29,6.614,16745.022,204.85,6.47,0.761,4
205,167,910,60540,8,485,0,0,82.41,28435943,36.253,29,6.614,16745.022,204.85,6.47,0.761,4
205,168,1029,61569,9,494,0,0,82.41,28435943,36.253,29,6.614,16745.022,204.85,6.47,0.761,4
205,169,1086,62655,8,502,0,0,82.41,28435943,36.253,29,6.614,16745.022,204.85,6.47,0.761,4
205,170,761,63416,9,511,0,0,82.41,28435943,36.253,29,6.614,16745.022,204.85,6.47,0.761,4
205,171,868,64284,10,521,0,0,82.41,28435943,36.253,29,6.614,16745.022,204.85,6.47,0.761,4
205,172,890,65174,9,530,0,0,82.41,28435943,36.253,29,6.614,16745.022,204.85,6.47,0.761,4
205,173,775,65949,9,539,0,0,82.41,28435943,36.253,29,6.614,16745.022,204.85,6.47,0.761,4
205,174,707,66656,8,547,0,0,82.41,28435943,36.253,29,6.614,16745.022,204.85,6.47,0.761,4
205,175,787,67443,8,555,0,0,82.41,28435943,36.253,29,6.614,16745.022,204.85,6.47,0.761,4
205,176,1010,68453,9,564,0,0,82.41,28435943,36.253,29,6.614,16745.022,204.85,6.47,0.761,4
205,177,986,69439,10,574,0,0,82.41,28435943,36.253,29,6.614,16745.022,204.85,6.47,0.761,4
205,178,967,70406,7,581,0,0,82.41,28435943,36.253,29,6.614,16745.022,204.85,6.47,0.761,4
205,179,867,71273,10,591,0,0,82.41,28435943,36.253,29,6.614,16745.022,204.85,6.47,0.761,4
205,180,667,71940,9,600,0,0,82.41,28435943,36.253,29,6.614,16745.022,204.85,6.47,0.761,4
205,181,751,72691,6,606,0,0,87.96,28435943,36.253,29,6.614,16745.022,204.85,6.47,0.761,4
205,182,837,73528,8,614,0,0,87.96,28435943,36.253,29,6.614,16745.022,204.85,6.47,0.761,4
205,183,835,74363,7,621,0,0,87.96,28435943,36.253,29,6.614,16745.022,204.85,6.47,0.761,4
205,184,759,75122,7,628,0,0,87.96,28435943,36.253,29,6.614,16745.022,204.85,6.47,0.761,4
205,185,907,76029,7,635,0,0,87.96,28435943,36.253,29,6.614,16745.022,204.85,6.47,0.761,4
205,186,791,76820,8,643,0,0,87.96,28435943,36.253,29,6.614,16745.022,204.85,6.47,0.761,4
205,187,0,76820,0,643,0,0,87.96,28435943,36.253,29,6.614,16745.022,204.85,6.47,0.761,4
205,188,1614,78434,10,653,0,0,84.26,28435943,36.253,29,6.614,16745.022,204.85,6.47,0.761,4
205,189,683,79117,5,658,0,0,84.26,28435943,36.253,29,6.614,16745.022,204.85,6.47,0.761,4
205,190,679,79796,7,665,0,0,84.26,28435943,36.253,29,6.614,16745.022,204.85,6.47,0.761,4
205,191,608,80404,6,671,0,0,84.26,28435943,36.253,29,6.614,16745.022,204.85,6.47,0.761,4
205,192,615,81019,7,678,0,0,84.26,28435943,36.253,29,6.614,16745.022,204.85,6.47,0.761,4
205,193,677,81696,6,684,0,0,84.26,28435943,36.253,29,6.614,16745.022,204.85,6.47,0.761,4
205,194,757,82453,7,691,0,0,84.26,28435943,36.253,29,6.614,16745.022,204.85,6.47,0.761,4
205,195,684,83137,6,697,0,0,84.26,28435943,36.253,29,6.614,16745.022,204.85,6.47,0.761,4
205,196,619,83756,7,704,0,0,84.26,28435943,36.253,29,6.614,16745.022,204.85,6.47,0.761,4
205,197,635,84391,6,710,0,0,87.96,28435943,36.253,29,6.614,16745.022,204.85,6.47,0.761,4
205,198,614,85005,4,714,0,0,87.96,28435943,36.253,29,6.614,16745.022,204.85,6.47,0.761,4
205,199,464,85469,6,720,0,0,87.96,28435943,36.253,29,6.614,16745.022,204.85,6.47,0.761,4
205,200,0,85469,0,720,0,0,87.96,28435943,36.253,29,6.614,16745.022,204.85,6.47,0.761,4
205,201,289,85758,5,725,0,0,87.96,28435943,36.253,29,6.614,16745.022,204.85,6.47,0.761,4
205,202,878,86636,11,736,0,0,87.96,28435943,36.253,29,6.614,16745.022,204.85,6.47,0.761,4
205,203,0,86636,0,736,0,0,87.96,28435943,36.253,29,6.614,16745.022,204.85,6.47,0.761,4
205,204,1008,87644,11,747,0,0,87.96,28435943,36.253,29,6.614,16745.022,204.85,6.47,0.761,4
206,1,6,212,0,0,0,0,96.3,97338583,308.127,32.6,7.15,6171.884,245.465,6,0.694,3
206,2,21,233,0,0,0,0,96.3,97338583,308.127,32.6,7.15,6171.884,245.465,6,0.694,3
206,3,3,236,0,0,0,0,96.3,97338583,308.127,32.6,7.15,6171.884,245.465,6,0.694,3
206,4,4,240,0,0,0,0,96.3,97338583,308.127,32.6,7.15,6171.884,245.465,6,0.694,3
206,5,1,241,0,0,0,0,96.3,97338583,308.127,32.6,7.15,6171.884,245.465,6,0.694,3
206,6,4,245,0,0,0,88551,96.3,97338583,308.127,32.6,7.15,6171.884,245.465,6,0.694,3
206,7,6,251,0,0,17848,106399,96.3,97338583,308.127,32.6,7.15,6171.884,245.465,6,0.694,3
206,8,0,251,0,0,3725,110124,96.3,97338583,308.127,32.6,7.15,6171.884,245.465,6,0.694,3
206,9,4,255,0,0,4117,114241,96.3,97338583,308.127,32.6,7.15,6171.884,245.465,6,0.694,3
206,10,2,257,0,0,4566,118807,96.3,97338583,308.127,32.6,7.15,6171.884,245.465,6,0.694,3
206,11,1,258,0,0,3014,121821,96.3,97338583,308.127,32.6,7.15,6171.884,245.465,6,0.694,3
206,12,4,262,0,0,2669,124490,96.3,97338583,308.127,32.6,7.15,6171.884,245.465,6,0.694,3
206,13,2,264,0,0,3863,128353,96.3,97338583,308.127,32.6,7.15,6171.884,245.465,6,0.694,3
206,14,3,267,0,0,4418,132771,96.3,97338583,308.127,32.6,7.15,6171.884,245.465,6,0.694,3
206,15,1,268,0,0,0,132771,86.57,97338583,308.127,32.6,7.15,6171.884,245.465,6,0.694,3
206,16,0,268,0,0,0,132771,86.57,97338583,308.127,32.6,7.15,6171.884,245.465,6,0.694,3
206,17,0,268,0,0,0,157162,86.57,97338583,308.127,32.6,7.15,6171.884,245.465,6,0.694,3
206,18,0,268,0,0,1755,158917,86.57,97338583,308.127,32.6,7.15,6171.884,245.465,6,0.694,3
206,19,0,268,0,0,0,158917,86.57,97338583,308.127,32.6,7.15,6171.884,245.465,6,0.694,3
206,20,0,268,0,0,0,158917,86.57,97338583,308.127,32.6,7.15,6171.884,245.465,6,0.694,3
206,21,0,268,0,0,0,158917,86.57,97338583,308.127,32.6,7.15,6171.884,245.465,6,0.694,3
206,22,0,268,0,0,0,185203,77.78,97338583,308.127,32.6,7.15,6171.884,245.465,6,0.694,3
206,23,0,268,0,0,4050,189253,77.78,97338583,308.127,32.6,7.15,6171.884,245.465,6,0.694,3
206,24,2,270,0,0,21913,211166,77.78,97338583,308.127,32.6,7.15,6171.884,245.465,6,0.694,3
206,25,0,270,0,0,976,212142,72.22,97338583,308.127,32.6,7.15,6171.884,245.465,6,0.694,3
206,26,0,270,0,0,823,212965,75,97338583,308.127,32.6,7.15,6171.884,245.465,6,0.694,3
206,27,0,270,0,0,778,213743,75,97338583,308.127,32.6,7.15,6171.884,245.465,6,0.694,3
206,28,0,270,0,0,26152,239895,75,97338583,308.127,32.6,7.15,6171.884,245.465,6,0.694,3
206,29,0,270,0,0,0,239895,75,97338583,308.127,32.6,7.15,6171.884,245.465,6,0.694,3
206,30,0,270,0,0,0,239895,75,97338583,308.127,32.6,7.15,6171.884,245.465,6,0.694,3
206,31,0,270,0,0,0,239895,75,97338583,308.127,32.6,7.15,6171.884,245.465,6,0.694,3
206,32,0,270,0,0,0,239895,75,97338583,308.127,32.6,7.15,6171.884,245.465,6,0.694,3
206,33,0,270,0,0,0,239895,75,97338583,308.127,32.6,7.15,6171.884,245.465,6,0.694,3
206,34,1,271,0,0,0,239895,65.74,97338583,308.127,32.6,7.15,6171.884,245.465,6,0.694,3
206,35,0,271,0,0,0,239895,65.74,97338583,308.127,32.6,7.15,6171.884,245.465,6,0.694,3
206,36,0,271,0,0,0,239895,65.74,97338583,308.127,32.6,7.15,6171.884,245.465,6,0.694,3
206,37,0,271,0,0,0,239895,65.74,97338583,308.127,32.6,7.15,6171.884,245.465,6,0.694,3
206,38,17,288,0,0,0,239895,65.74,97338583,308.127,32.6,7.15,6171.884,245.465,6,0.694,3
206,39,0,288,0,0,0,239895,65.74,97338583,308.127,32.6,7.15,6171.884,245.465,6,0.694,3
206,40,0,288,0,0,0,239895,65.74,97338583,308.127,32.6,7.15,6171.884,245.465,6,0.694,3
206,41,0,288,0,0,0,239895,65.74,97338583,308.127,32.6,7.15,6171.884,245.465,6,0.694,3
206,42,0,288,0,0,0,239895,65.74,97338583,308.127,32.6,7.15,6171.884,245.465,6,0.694,3
206,43,0,288,0,0,0,239895,65.74,97338583,308.127,32.6,7.15,6171.884,245.465,6,0.694,3
206,44,0,288,0,0,0,239895,65.74,97338583,308.127,32.6,7.15,6171.884,245.465,6,0.694,3
206,45,24,312,0,0,0,239895,65.74,97338583,308.127,32.6,7.15,6171.884,245.465,6,0.694,3
206,46,1,313,0,0,0,239895,65.74,97338583,308.127,32.6,7.15,6171.884,245.465,6,0.694,3
206,47,5,318,0,0,0,239895,65.74,97338583,308.127,32.6,7.15,6171.884,245.465,6,0.694,3
206,48,2,320,0,0,0,239895,65.74,97338583,308.127,32.6,7.15,6171.884,245.465,6,0.694,3
206,49,4,324,0,0,0,239895,65.74,97338583,308.127,32.6,7.15,6171.884,245.465,6,0.694,3
206,50,0,324,0,0,0,239895,65.74,97338583,308.127,32.6,7.15,6171.884,245.465,6,0.694,3
206,51,0,324,0,0,0,239895,65.74,97338583,308.127,32.6,7.15,6171.884,245.465,6,0.694,3
206,52,0,324,0,0,0,239895,65.74,97338583,308.127,32.6,7.15,6171.884,245.465,6,0.694,3
206,53,0,324,0,0,0,239895,65.74,97338583,308.127,32.6,7.15,6171.884,245.465,6,0.694,3
206,54,0,324,0,0,0,239895,65.74,97338583,308.127,32.6,7.15,6171.884,245.465,6,0.694,3
206,55,1,325,0,0,0,239895,65.74,97338583,308.127,32.6,7.15,6171.884,245.465,6,0.694,3
206,56,1,326,0,0,0,239895,65.74,97338583,308.127,32.6,7.15,6171.884,245.465,6,0.694,3
206,57,1,327,0,0,0,239895,65.74,97338583,308.127,32.6,7.15,6171.884,245.465,6,0.694,3
206,58,0,327,0,0,0,239895,65.74,97338583,308.127,32.6,7.15,6171.884,245.465,6,0.694,3
206,59,0,327,0,0,0,239895,65.74,97338583,308.127,32.6,7.15,6171.884,245.465,6,0.694,3
206,60,0,327,0,0,0,239895,65.74,97338583,308.127,32.6,7.15,6171.884,245.465,6,0.694,3
206,61,0,327,0,0,0,239895,65.74,97338583,308.127,32.6,7.15,6171.884,245.465,6,0.694,3
206,62,1,328,0,0,0,239895,65.74,97338583,308.127,32.6,7.15,6171.884,245.465,6,0.694,3
206,63,0,328,0,0,0,239895,65.74,97338583,308.127,32.6,7.15,6171.884,245.465,6,0.694,3
206,64,0,328,0,0,0,239895,65.74,97338583,308.127,32.6,7.15,6171.884,245.465,6,0.694,3
206,65,0,328,0,0,0,239895,65.74,97338583,308.127,32.6,7.15,6171.884,245.465,6,0.694,3
206,66,0,328,0,0,0,239895,65.74,97338583,308.127,32.6,7.15,6171.884,245.465,6,0.694,3
206,67,1,329,0,0,0,239895,65.74,97338583,308.127,32.6,7.15,6171.884,245.465,6,0.694,3
206,68,0,329,0,0,0,239895,65.74,97338583,308.127,32.6,7.15,6171.884,245.465,6,0.694,3
206,69,2,331,0,0,0,239895,65.74,97338583,308.127,32.6,7.15,6171.884,245.465,6,0.694,3
206,70,1,332,0,0,0,239895,65.74,97338583,308.127,32.6,7.15,6171.884,245.465,6,0.694,3
206,71,0,332,0,0,0,239895,65.74,97338583,308.127,32.6,7.15,6171.884,245.465,6,0.694,3
206,72,0,332,0,0,0,239895,65.74,97338583,308.127,32.6,7.15,6171.884,245.465,6,0.694,3
206,73,0,332,0,0,0,239895,65.74,97338583,308.127,32.6,7.15,6171.884,245.465,6,0.694,3
206,74,1,333,0,0,0,239895,65.74,97338583,308.127,32.6,7.15,6171.884,245.465,6,0.694,3
206,75,1,334,0,0,0,239895,65.74,97338583,308.127,32.6,7.15,6171.884,245.465,6,0.694,3
206,76,0,334,0,0,0,239895,65.74,97338583,308.127,32.6,7.15,6171.884,245.465,6,0.694,3
206,77,0,334,0,0,0,239895,54.63,97338583,308.127,32.6,7.15,6171.884,245.465,6,0.694,3
206,78,1,335,0,0,0,239895,54.63,97338583,308.127,32.6,7.15,6171.884,245.465,6,0.694,3
206,79,0,335,0,0,0,239895,54.63,97338583,308.127,32.6,7.15,6171.884,245.465,6,0.694,3
206,80,7,342,0,0,0,239895,54.63,97338583,308.127,32.6,7.15,6171.884,245.465,6,0.694,3
206,81,7,349,0,0,0,239895,54.63,97338583,308.127,32.6,7.15,6171.884,245.465,6,0.694,3
206,82,0,349,0,0,0,239895,54.63,97338583,308.127,32.6,7.15,6171.884,245.465,6,0.694,3
206,83,0,349,0,0,0,239895,54.63,97338583,308.127,32.6,7.15,6171.884,245.465,6,0.694,3
206,84,0,349,0,0,0,239895,54.63,97338583,308.127,32.6,7.15,6171.884,245.465,6,0.694,3
206,85,0,349,0,0,0,239895,54.63,97338583,308.127,32.6,7.15,6171.884,245.465,6,0.694,3
206,86,3,352,0,0,0,239895,51.85,97338583,308.127,32.6,7.15,6171.884,245.465,6,0.694,3
206,87,0,352,0,0,0,239895,51.85,97338583,308.127,32.6,7.15,6171.884,245.465,6,0.694,3
206,88,1,353,0,0,0,239895,51.85,97338583,308.127,32.6,7.15,6171.884,245.465,6,0.694,3
206,89,1,354,0,0,0,239895,51.85,97338583,308.127,32.6,7.15,6171.884,245.465,6,0.694,3
206,90,1,355,0,0,0,239895,51.85,97338583,308.127,32.6,7.15,6171.884,245.465,6,0.694,3
206,91,0,355,0,0,0,239895,51.85,97338583,308.127,32.6,7.15,6171.884,245.465,6,0.694,3
206,92,0,355,0,0,0,239895,51.85,97338583,308.127,32.6,7.15,6171.884,245.465,6,0.694,3
206,93,0,355,0,0,0,239895,51.85,97338583,308.127,32.6,7.15,6171.884,245.465,6,0.694,3
206,94,0,355,0,0,0,239895,51.85,97338583,308.127,32.6,7.15,6171.884,245.465,6,0.694,3
206,95,0,355,0,0,0,379701,51.85,97338583,308.127,32.6,7.15,6171.884,245.465,6,0.694,3
206,96,0,355,0,0,0,379701,51.85,97338583,308.127,32.6,7.15,6171.884,245.465,6,0.694,3
206,97,0,355,0,0,0,379701,51.85,97338583,308.127,32.6,7.15,6171.884,245.465,6,0.694,3
206,98,14,369,0,0,0,379701,51.85,97338583,308.127,32.6,7.15,6171.884,245.465,6,0.694,3
206,99,0,369,0,0,0,379701,51.85,97338583,308.127,32.6,7.15,6171.884,245.465,6,0.694,3
206,100,0,369,0,0,0,379701,51.85,97338583,308.127,32.6,7.15,6171.884,245.465,6,0.694,3
206,101,0,369,0,0,0,379701,51.85,97338583,308.127,32.6,7.15,6171.884,245.465,6,0.694,3
206,102,1,370,0,0,0,379701,51.85,97338583,308.127,32.6,7.15,6171.884,245.465,6,0.694,3
206,103,0,370,0,0,0,379701,51.85,97338583,308.127,32.6,7.15,6171.884,245.465,6,0.694,3
206,104,2,372,0,0,0,379701,51.85,97338583,308.127,32.6,7.15,6171.884,245.465,6,0.694,3
206,105,1,373,0,0,0,379701,51.85,97338583,308.127,32.6,7.15,6171.884,245.465,6,0.694,3
206,106,0,373,0,0,0,379701,51.85,97338583,308.127,32.6,7.15,6171.884,245.465,6,0.694,3
206,107,0,373,0,0,0,379701,51.85,97338583,308.127,32.6,7.15,6171.884,245.465,6,0.694,3
206,108,0,373,0,0,0,379701,51.85,97338583,308.127,32.6,7.15,6171.884,245.465,6,0.694,3
206,109,0,373,0,0,0,379701,51.85,97338583,308.127,32.6,7.15,6171.884,245.465,6,0.694,3
206,110,0,373,0,0,0,379701,51.85,97338583,308.127,32.6,7.15,6171.884,245.465,6,0.694,3
206,111,0,373,0,0,0,379701,51.85,97338583,308.127,32.6,7.15,6171.884,245.465,6,0.694,3
206,112,0,373,0,0,0,379701,51.85,97338583,308.127,32.6,7.15,6171.884,245.465,6,0.694,3
206,113,28,401,0,0,0,379701,51.85,97338583,308.127,32.6,7.15,6171.884,245.465,6,0.694,3
206,114,7,408,0,0,0,379701,51.85,97338583,308.127,32.6,7.15,6171.884,245.465,6,0.694,3
206,115,4,412,0,0,0,379701,51.85,97338583,308.127,32.6,7.15,6171.884,245.465,6,0.694,3
206,116,3,415,0,0,0,379701,51.85,97338583,308.127,32.6,7.15,6171.884,245.465,6,0.694,3
206,117,0,415,0,0,0,379701,51.85,97338583,308.127,32.6,7.15,6171.884,245.465,6,0.694,3
206,118,5,420,0,0,0,379701,69.44,97338583,308.127,32.6,7.15,6171.884,245.465,6,0.694,3
206,119,11,431,0,0,0,379701,75,97338583,308.127,32.6,7.15,6171.884,245.465,6,0.694,3
206,120,2,433,0,0,0,443517,75,97338583,308.127,32.6,7.15,6171.884,245.465,6,0.694,3
206,121,26,459,0,0,6047,449564,75.46,97338583,308.127,32.6,7.15,6171.884,245.465,6,0.694,3
206,122,50,509,0,0,0,449564,75.46,97338583,308.127,32.6,7.15,6171.884,245.465,6,0.694,3
206,123,49,558,3,3,0,471410,75.46,97338583,308.127,32.6,7.15,6171.884,245.465,6,0.694,3
206,124,32,590,2,5,11046,482456,75.46,97338583,308.127,32.6,7.15,6171.884,245.465,6,0.694,3
206,125,31,621,1,6,11025,493481,75.46,97338583,308.127,32.6,7.15,6171.884,245.465,6,0.694,3
206,126,31,652,2,8,13148,506629,75.46,97338583,308.127,32.6,7.15,6171.884,245.465,6,0.694,3
206,127,20,672,0,8,0,506629,75.46,97338583,308.127,32.6,7.15,6171.884,245.465,6,0.694,3
206,128,45,717,1,9,0,506629,75.46,97338583,308.127,32.6,7.15,6171.884,245.465,6,0.694,3
206,129,33,750,1,10,0,506629,75.46,97338583,308.127,32.6,7.15,6171.884,245.465,6,0.694,3
206,130,39,789,0,10,0,506629,75.46,97338583,308.127,32.6,7.15,6171.884,245.465,6,0.694,3
206,131,23,812,0,10,0,506629,75.46,97338583,308.127,32.6,7.15,6171.884,245.465,6,0.694,3
206,132,29,841,3,13,0,506629,75.46,97338583,308.127,32.6,7.15,6171.884,245.465,6,0.694,3
206,133,5,846,0,13,0,506629,75.46,97338583,308.127,32.6,7.15,6171.884,245.465,6,0.694,3
206,134,20,866,4,17,0,506629,78.24,97338583,308.127,32.6,7.15,6171.884,245.465,6,0.694,3
206,135,17,883,1,18,0,669687,78.24,97338583,308.127,32.6,7.15,6171.884,245.465,6,0.694,3
206,136,28,911,3,21,0,669687,78.24,97338583,308.127,32.6,7.15,6171.884,245.465,6,0.694,3
206,137,19,930,0,21,0,723596,78.24,97338583,308.127,32.6,7.15,6171.884,245.465,6,0.694,3
206,138,4,934,1,22,0,723596,78.24,97338583,308.127,32.6,7.15,6171.884,245.465,6,0.694,3
206,139,30,964,2,24,0,723596,78.24,97338583,308.127,32.6,7.15,6171.884,245.465,6,0.694,3
206,140,19,983,1,25,0,723596,74.54,97338583,308.127,32.6,7.15,6171.884,245.465,6,0.694,3
206,141,6,989,0,25,0,723596,74.54,97338583,308.127,32.6,7.15,6171.884,245.465,6,0.694,3
206,142,5,994,0,25,0,843688,74.54,97338583,308.127,32.6,7.15,6171.884,245.465,6,0.694,3
206,143,13,1007,0,25,0,843688,74.54,97338583,308.127,32.6,7.15,6171.884,245.465,6,0.694,3
206,144,2,1009,0,25,0,843688,74.54,97338583,308.127,32.6,7.15,6171.884,245.465,6,0.694,3
206,145,5,1014,1,26,0,914416,74.54,97338583,308.127,32.6,7.15,6171.884,245.465,6,0.694,3
206,146,2,1016,1,27,0,914416,74.54,97338583,308.127,32.6,7.15,6171.884,245.465,6,0.694,3
206,147,6,1022,0,27,0,914416,74.54,97338583,308.127,32.6,7.15,6171.884,245.465,6,0.694,3
206,148,7,1029,0,27,0,950477,74.54,97338583,308.127,32.6,7.15,6171.884,245.465,6,0.694,3
206,149,5,1034,3,30,0,950477,74.54,97338583,308.127,32.6,7.15,6171.884,245.465,6,0.694,3
206,150,2,1036,0,30,0,950477,74.54,97338583,308.127,32.6,7.15,6171.884,245.465,6,0.694,3
206,151,2,1038,1,31,0,976384,74.54,97338583,308.127,32.6,7.15,6171.884,245.465,6,0.694,3
206,152,2,1040,1,32,5313,981697,74.54,97338583,308.127,32.6,7.15,6171.884,245.465,6,0.694,3
206,153,0,1040,0,32,0,981697,74.54,97338583,308.127,32.6,7.15,6171.884,245.465,6,0.694,3
206,154,4,1044,2,34,0,981697,74.54,97338583,308.127,32.6,7.15,6171.884,245.465,6,0.694,3
206,155,0,1044,0,34,0,981697,74.54,97338583,308.127,32.6,7.15,6171.884,245.465,6,0.694,3
206,156,2,1046,1,35,0,981697,74.54,97338583,308.127,32.6,7.15,6171.884,245.465,6,0.694,3
206,157,0,1046,0,35,0,981697,74.54,97338583,308.127,32.6,7.15,6171.884,245.465,6,0.694,3
206,158,0,1046,0,35,0,1025307,74.54,97338583,308.127,32.6,7.15,6171.884,245.465,6,0.694,3
206,159,3,1049,0,35,7983,1033290,74.54,97338583,308.127,32.6,7.15,6171.884,245.465,6,0.694,3
206,160,0,1049,0,35,8774,1042064,74.54,97338583,308.127,32.6,7.15,6171.884,245.465,6,0.694,3
206,161,0,1049,0,35,8158,1050222,74.54,97338583,308.127,32.6,7.15,6171.884,245.465,6,0.694,3
206,162,5,1054,0,35,7371,1057593,74.54,97338583,308.127,32.6,7.15,6171.884,245.465,6,0.694,3
206,163,5,1059,0,35,9571,1067164,74.54,97338583,308.127,32.6,7.15,6171.884,245.465,6,0.694,3
206,164,0,1059,0,35,0,1067164,74.54,97338583,308.127,32.6,7.15,6171.884,245.465,6,0.694,3
206,165,1,1060,0,35,0,1067164,74.54,97338583,308.127,32.6,7.15,6171.884,245.465,6,0.694,3
206,166,0,1060,0,35,0,1076762,74.54,97338583,308.127,32.6,7.15,6171.884,245.465,6,0.694,3
206,167,3,1063,0,35,3005,1079767,74.54,97338583,308.127,32.6,7.15,6171.884,245.465,6,0.694,3
206,168,0,1063,0,35,4031,1083798,74.54,97338583,308.127,32.6,7.15,6171.884,245.465,6,0.694,3
206,169,0,1063,0,35,5035,1088833,74.54,97338583,308.127,32.6,7.15,6171.884,245.465,6,0.694,3
206,170,0,1063,0,35,2134,1090967,74.54,97338583,308.127,32.6,7.15,6171.884,245.465,6,0.694,3
206,171,3,1066,0,35,92374,1183341,74.54,97338583,308.127,32.6,7.15,6171.884,245.465,6,0.694,3
206,172,2,1068,0,35,3911,1187252,74.54,97338583,308.127,32.6,7.15,6171.884,245.465,6,0.694,3
206,173,0,1068,0,35,764,1188016,74.54,97338583,308.127,32.6,7.15,6171.884,245.465,6,0.694,3
206,174,0,1068,0,35,5565,1193581,74.54,97338583,308.127,32.6,7.15,6171.884,245.465,6,0.694,3
206,175,0,1068,0,35,0,1193581,74.54,97338583,308.127,32.6,7.15,6171.884,245.465,6,0.694,3
206,176,0,1068,0,35,0,1193581,74.54,97338583,308.127,32.6,7.15,6171.884,245.465,6,0.694,3
206,177,1,1069,0,35,0,1193581,74.54,97338583,308.127,32.6,7.15,6171.884,245.465,6,0.694,3
206,178,0,1069,0,35,0,1193581,74.54,97338583,308.127,32.6,7.15,6171.884,245.465,6,0.694,3
206,179,0,1069,0,35,0,1193581,51.85,97338583,308.127,32.6,7.15,6171.884,245.465,6,0.694,3
206,180,0,1069,0,35,0,1193581,51.85,97338583,308.127,32.6,7.15,6171.884,245.465,6,0.694,3
206,181,5,1074,0,35,0,1193581,51.85,97338583,308.127,32.6,7.15,6171.884,245.465,6,0.694,3
206,182,3,1077,0,35,0,1216259,51.85,97338583,308.127,32.6,7.15,6171.884,245.465,6,0.694,3
206,183,17,1094,0,35,0,1216259,51.85,97338583,308.127,32.6,7.15,6171.884,245.465,6,0.694,3
206,184,0,1094,0,35,0,1216259,51.85,97338583,308.127,32.6,7.15,6171.884,245.465,6,0.694,3
206,185,1,1095,0,35,0,1216259,51.85,97338583,308.127,32.6,7.15,6171.884,245.465,6,0.694,3
206,186,1,1096,0,35,0,1216259,51.85,97338583,308.127,32.6,7.15,6171.884,245.465,6,0.694,3
206,187,0,1096,0,35,0,1234274,51.85,97338583,308.127,32.6,7.15,6171.884,245.465,6,0.694,3
206,188,0,1096,0,35,0,1234274,51.85,97338583,308.127,32.6,7.15,6171.884,245.465,6,0.694,3
206,189,1,1097,0,35,0,1234274,51.85,97338583,308.127,32.6,7.15,6171.884,245.465,6,0.694,3
206,190,1,1098,0,35,0,1234274,51.85,97338583,308.127,32.6,7.15,6171.884,245.465,6,0.694,3
206,191,1,1099,0,35,0,1234274,51.85,97338583,308.127,32.6,7.15,6171.884,245.465,6,0.694,3
206,192,1,1100,0,35,0,1246480,51.85,97338583,308.127,32.6,7.15,6171.884,245.465,6,0.694,3
206,193,5,1105,0,35,0,1246480,51.85,97338583,308.127,32.6,7.15,6171.884,245.465,6,0.694,3
206,194,2,1107,0,35,0,1251557,51.85,97338583,308.127,32.6,7.15,6171.884,245.465,6,0.694,3
206,195,2,1109,0,35,1824,1253381,51.85,97338583,308.127,32.6,7.15,6171.884,245.465,6,0.694,3
206,196,1,1110,0,35,0,1253381,51.85,97338583,308.127,32.6,7.15,6171.884,245.465,6,0.694,3
206,197,3,1113,0,35,0,1257790,51.85,97338583,308.127,32.6,7.15,6171.884,245.465,6,0.694,3
206,198,9,1122,0,35,3009,1260799,51.85,97338583,308.127,32.6,7.15,6171.884,245.465,6,0.694,3
206,199,2,1124,0,35,0,1260799,51.85,97338583,308.127,32.6,7.15,6171.884,245.465,6,0.694,3
206,200,0,1124,0,35,0,1260799,51.85,97338583,308.127,32.6,7.15,6171.884,245.465,6,0.694,3
206,201,2,1126,0,35,0,1260799,51.85,97338583,308.127,32.6,7.15,6171.884,245.465,6,0.694,3
206,202,8,1134,0,35,0,1260799,51.85,97338583,308.127,32.6,7.15,6171.884,245.465,6,0.694,3
206,203,6,1140,0,35,0,1260799,51.85,97338583,308.127,32.6,7.15,6171.884,245.465,6,0.694,3
206,204,1,1141,0,35,0,1260799,51.85,97338583,308.127,32.6,7.15,6171.884,245.465,6,0.694,3
208,1,0,35,0,0,120,640,47.22,18383956,22.995,17.7,2.48,3689.251,234.499,3.94,0.588,0
208,2,1,36,0,0,216,856,47.22,18383956,22.995,17.7,2.48,3689.251,234.499,3.94,0.588,0
208,3,3,39,1,1,0,856,47.22,18383956,22.995,17.7,2.48,3689.251,234.499,3.94,0.588,0
208,4,0,39,0,1,0,910,47.22,18383956,22.995,17.7,2.48,3689.251,234.499,3.94,0.588,0
208,5,0,39,0,1,54,964,47.22,18383956,22.995,17.7,2.48,3689.251,234.499,3.94,0.588,0
208,6,0,39,0,1,17,981,47.22,18383956,22.995,17.7,2.48,3689.251,234.499,3.94,0.588,0
208,7,0,39,0,1,106,1087,47.22,18383956,22.995,17.7,2.48,3689.251,234.499,3.94,0.588,0
208,8,0,39,0,1,135,1222,47.22,18383956,22.995,17.7,2.48,3689.251,234.499,3.94,0.588,0
208,9,0,39,0,1,92,1314,50.93,18383956,22.995,17.7,2.48,3689.251,234.499,3.94,0.588,0
208,10,0,39,0,1,29,1343,50.93,18383956,22.995,17.7,2.48,3689.251,234.499,3.94,0.588,0
208,11,1,40,1,2,111,1454,50.93,18383956,22.995,17.7,2.48,3689.251,234.499,3.94,0.588,0
208,12,0,40,0,2,71,1525,50.93,18383956,22.995,17.7,2.48,3689.251,234.499,3.94,0.588,0
208,13,3,43,0,2,125,1650,50.93,18383956,22.995,17.7,2.48,3689.251,234.499,3.94,0.588,0
208,14,2,45,0,2,45,1695,53.7,18383956,22.995,17.7,2.48,3689.251,234.499,3.94,0.588,0
208,15,0,45,0,2,184,1879,65.28,18383956,22.995,17.7,2.48,3689.251,234.499,3.94,0.588,0
208,16,3,48,0,2,128,2007,65.28,18383956,22.995,17.7,2.48,3689.251,234.499,3.94,0.588,0
208,17,0,48,0,2,218,2225,65.28,18383956,22.995,17.7,2.48,3689.251,234.499,3.94,0.588,0
208,18,4,52,0,2,120,2345,65.28,18383956,22.995,17.7,2.48,3689.251,234.499,3.94,0.588,0
208,19,5,57,0,2,410,2755,65.28,18383956,22.995,17.7,2.48,3689.251,234.499,3.94,0.588,0
208,20,4,61,1,3,481,3236,65.28,18383956,22.995,17.7,2.48,3689.251,234.499,3.94,0.588,0
208,21,4,65,0,3,479,3715,65.28,18383956,22.995,17.7,2.48,3689.251,234.499,3.94,0.588,0
208,22,0,65,0,3,325,4040,65.28,18383956,22.995,17.7,2.48,3689.251,234.499,3.94,0.588,0
208,23,9,74,0,3,205,4245,65.28,18383956,22.995,17.7,2.48,3689.251,234.499,3.94,0.588,0
208,24,2,76,0,3,420,4665,65.28,18383956,22.995,17.7,2.48,3689.251,234.499,3.94,0.588,0
208,25,8,84,0,3,230,4895,65.28,18383956,22.995,17.7,2.48,3689.251,234.499,3.94,0.588,0
208,26,0,84,0,3,389,5284,65.28,18383956,22.995,17.7,2.48,3689.251,234.499,3.94,0.588,0
208,27,4,88,0,3,0,5284,65.28,18383956,22.995,17.7,2.48,3689.251,234.499,3.94,0.588,0
208,28,1,89,0,3,0,6432,65.28,18383956,22.995,17.7,2.48,3689.251,234.499,3.94,0.588,0
208,29,6,95,0,3,182,6614,65.28,18383956,22.995,17.7,2.48,3689.251,234.499,3.94,0.588,0
208,30,2,97,0,3,214,6828,65.28,18383956,22.995,17.7,2.48,3689.251,234.499,3.94,0.588,0
208,31,9,106,0,3,54,6882,65.28,18383956,22.995,17.7,2.48,3689.251,234.499,3.94,0.588,0
208,32,3,109,0,3,395,7277,70.83,18383956,22.995,17.7,2.48,3689.251,234.499,3.94,0.588,0
208,33,10,119,0,3,926,8203,70.83,18383956,22.995,17.7,2.48,3689.251,234.499,3.94,0.588,0
208,34,5,124,0,3,433,8636,70.83,18383956,22.995,17.7,2.48,3689.251,234.499,3.94,0.588,0
208,35,13,137,0,3,1459,10095,70.83,18383956,22.995,17.7,2.48,3689.251,234.499,3.94,0.588,0
208,36,2,139,1,4,468,10563,70.83,18383956,22.995,17.7,2.48,3689.251,234.499,3.94,0.588,0
208,37,7,146,0,4,849,11412,70.83,18383956,22.995,17.7,2.48,3689.251,234.499,3.94,0.588,0
208,38,7,153,0,4,683,12095,43.52,18383956,22.995,17.7,2.48,3689.251,234.499,3.94,0.588,0
208,39,14,167,0,4,496,12591,43.52,18383956,22.995,17.7,2.48,3689.251,234.499,3.94,0.588,0
208,40,85,252,3,7,250,12841,43.52,18383956,22.995,17.7,2.48,3689.251,234.499,3.94,0.588,0
208,41,15,267,0,7,286,13127,43.52,18383956,22.995,17.7,2.48,3689.251,234.499,3.94,0.588,0
208,42,0,267,0,7,368,13495,43.52,18383956,22.995,17.7,2.48,3689.251,234.499,3.94,0.588,0
208,43,174,441,0,7,432,13927,43.52,18383956,22.995,17.7,2.48,3689.251,234.499,3.94,0.588,0
208,44,5,446,0,7,1560,15487,43.52,18383956,22.995,17.7,2.48,3689.251,234.499,3.94,0.588,0
208,45,208,654,0,7,324,15811,43.52,18383956,22.995,17.7,2.48,3689.251,234.499,3.94,0.588,0
208,46,14,668,0,7,667,16478,43.52,18383956,22.995,17.7,2.48,3689.251,234.499,3.94,0.588,0
208,47,11,679,0,7,876,17354,43.52,18383956,22.995,17.7,2.48,3689.251,234.499,3.94,0.588,0
208,48,74,753,0,7,521,17875,43.52,18383956,22.995,17.7,2.48,3689.251,234.499,3.94,0.588,0
208,49,8,761,0,7,644,18519,43.52,18383956,22.995,17.7,2.48,3689.251,234.499,3.94,0.588,0
208,50,11,772,0,7,495,19014,43.52,18383956,22.995,17.7,2.48,3689.251,234.499,3.94,0.588,0
208,51,60,832,0,7,418,19432,43.52,18383956,22.995,17.7,2.48,3689.251,234.499,3.94,0.588,0
208,52,34,866,0,7,579,20011,43.52,18383956,22.995,17.7,2.48,3689.251,234.499,3.94,0.588,0
208,53,54,920,0,7,0,20011,43.52,18383956,22.995,17.7,2.48,3689.251,234.499,3.94,0.588,0
208,54,0,920,0,7,0,20011,43.52,18383956,22.995,17.7,2.48,3689.251,234.499,3.94,0.588,0
208,55,0,920,0,7,0,20011,43.52,18383956,22.995,17.7,2.48,3689.251,234.499,3.94,0.588,0
208,56,0,920,0,7,0,20011,43.52,18383956,22.995,17.7,2.48,3689.251,234.499,3.94,0.588,0
208,57,0,920,0,7,0,24275,43.52,18383956,22.995,17.7,2.48,3689.251,234.499,3.94,0.588,0
208,58,137,1057,0,7,0,24275,43.52,18383956,22.995,17.7,2.48,3689.251,234.499,3.94,0.588,0
208,59,0,1057,0,7,0,24275,43.52,18383956,22.995,17.7,2.48,3689.251,234.499,3.94,0.588,0
208,60,0,1057,0,7,0,24275,43.52,18383956,22.995,17.7,2.48,3689.251,234.499,3.94,0.588,0
208,61,0,1057,0,7,0,24275,43.52,18383956,22.995,17.7,2.48,3689.251,234.499,3.94,0.588,0
208,62,0,1057,0,7,0,28236,39.81,18383956,22.995,17.7,2.48,3689.251,234.499,3.94,0.588,0
208,63,32,1089,0,7,0,28236,39.81,18383956,22.995,17.7,2.48,3689.251,234.499,3.94,0.588,0
208,64,0,1089,0,7,0,28236,39.81,18383956,22.995,17.7,2.48,3689.251,234.499,3.94,0.588,0
208,65,0,1089,0,7,0,28236,39.81,18383956,22.995,17.7,2.48,3689.251,234.499,3.94,0.588,0
208,66,22,1111,0,7,0,28236,39.81,18383956,22.995,17.7,2.48,3689.251,234.499,3.94,0.588,0
208,67,0,1111,0,7,0,34987,39.81,18383956,22.995,17.7,2.48,3689.251,234.499,3.94,0.588,0
208,68,43,1154,0,7,0,34987,39.81,18383956,22.995,17.7,2.48,3689.251,234.499,3.94,0.588,0
208,69,0,1154,0,7,0,34987,39.81,18383956,22.995,17.7,2.48,3689.251,234.499,3.94,0.588,0
208,70,46,1200,3,10,0,38448,39.81,18383956,22.995,17.7,2.48,3689.251,234.499,3.94,0.588,0
208,71,0,1200,0,10,542,38990,39.81,18383956,22.995,17.7,2.48,3689.251,234.499,3.94,0.588,0
208,72,52,1252,0,10,0,38990,39.81,18383956,22.995,17.7,2.48,3689.251,234.499,3.94,0.588,0
208,73,0,1252,0,10,0,42273,39.81,18383956,22.995,17.7,2.48,3689.251,234.499,3.94,0.588,0
208,74,69,1321,0,10,1853,44126,39.81,18383956,22.995,17.7,2.48,3689.251,234.499,3.94,0.588,0
208,75,36,1357,0,10,302,44428,39.81,18383956,22.995,17.7,2.48,3689.251,234.499,3.94,0.588,0
208,76,1,1358,1,11,0,44428,39.81,18383956,22.995,17.7,2.48,3689.251,234.499,3.94,0.588,0
208,77,24,1382,0,11,0,45425,39.81,18383956,22.995,17.7,2.48,3689.251,234.499,3.94,0.588,0
208,78,23,1405,0,11,749,46174,39.81,18383956,22.995,17.7,2.48,3689.251,234.499,3.94,0.588,0
208,79,7,1412,0,11,375,46549,39.81,18383956,22.995,17.7,2.48,3689.251,234.499,3.94,0.588,0
208,80,4,1416,0,11,1419,47968,39.81,18383956,22.995,17.7,2.48,3689.251,234.499,3.94,0.588,0
208,81,14,1430,0,11,804,48772,39.81,18383956,22.995,17.7,2.48,3689.251,234.499,3.94,0.588,0
208,82,0,1430,0,11,621,49393,39.81,18383956,22.995,17.7,2.48,3689.251,234.499,3.94,0.588,0
208,83,0,1430,0,11,0,49393,39.81,18383956,22.995,17.7,2.48,3689.251,234.499,3.94,0.588,0
208,84,0,1430,0,11,0,50771,39.81,18383956,22.995,17.7,2.48,3689.251,234.499,3.94,0.588,0
208,85,47,1477,7,18,855,51626,39.81,18383956,22.995,17.7,2.48,3689.251,234.499,3.94,0.588,0
208,86,12,1489,0,18,569,52195,50.93,18383956,22.995,17.7,2.48,3689.251,234.499,3.94,0.588,0
208,87,8,1497,0,18,1175,53370,50.93,18383956,22.995,17.7,2.48,3689.251,234.499,3.94,0.588,0
208,88,34,1531,3,21,653,54023,50.93,18383956,22.995,17.7,2.48,3689.251,234.499,3.94,0.588,0
208,89,0,1531,0,21,277,54300,50.93,18383956,22.995,17.7,2.48,3689.251,234.499,3.94,0.588,0
208,90,26,1557,1,22,363,54663,50.93,18383956,22.995,17.7,2.48,3689.251,234.499,3.94,0.588,0
208,91,11,1568,0,22,227,54890,50.93,18383956,22.995,17.7,2.48,3689.251,234.499,3.94,0.588,0
208,92,26,1594,2,24,1935,56825,50.93,18383956,22.995,17.7,2.48,3689.251,234.499,3.94,0.588,0
208,93,38,1632,6,30,330,57155,50.93,18383956,22.995,17.7,2.48,3689.251,234.499,3.94,0.588,0
208,94,0,1632,0,30,517,57672,50.93,18383956,22.995,17.7,2.48,3689.251,234.499,3.94,0.588,0
208,95,0,1632,0,30,1950,59622,50.93,18383956,22.995,17.7,2.48,3689.251,234.499,3.94,0.588,0
208,96,0,1632,0,30,628,60250,50.93,18383956,22.995,17.7,2.48,3689.251,234.499,3.94,0.588,0
208,97,0,1632,0,30,380,60630,50.93,18383956,22.995,17.7,2.48,3689.251,234.499,3.94,0.588,0
208,98,0,1632,0,30,674,61304,50.93,18383956,22.995,17.7,2.48,3689.251,234.499,3.94,0.588,0
208,99,263,1895,12,42,334,61638,50.93,18383956,22.995,17.7,2.48,3689.251,234.499,3.94,0.588,0
208,100,0,1895,0,42,523,62161,50.93,18383956,22.995,17.7,2.48,3689.251,234.499,3.94,0.588,0
208,101,0,1895,0,42,302,62463,50.93,18383956,22.995,17.7,2.48,3689.251,234.499,3.94,0.588,0
208,102,0,1895,0,42,1161,63624,50.93,18383956,22.995,17.7,2.48,3689.251,234.499,3.94,0.588,0
208,103,0,1895,0,42,515,64139,50.93,18383956,22.995,17.7,2.48,3689.251,234.499,3.94,0.588,0
208,104,0,1895,0,42,731,64870,50.93,18383956,22.995,17.7,2.48,3689.251,234.499,3.94,0.588,0
208,105,0,1895,0,42,938,65808,50.93,18383956,22.995,17.7,2.48,3689.251,234.499,3.94,0.588,0
208,106,388,2283,40,82,568,66376,50.93,18383956,22.995,17.7,2.48,3689.251,234.499,3.94,0.588,0
208,107,0,2283,0,82,720,67096,50.93,18383956,22.995,17.7,2.48,3689.251,234.499,3.94,0.588,0
208,108,0,2283,0,82,848,67944,50.93,18383956,22.995,17.7,2.48,3689.251,234.499,3.94,0.588,0
208,109,527,2810,27,109,1352,69296,50.93,18383956,22.995,17.7,2.48,3689.251,234.499,3.94,0.588,0
208,110,170,2980,0,109,1352,70648,50.93,18383956,22.995,17.7,2.48,3689.251,234.499,3.94,0.588,0
208,111,0,2980,0,109,959,71607,50.93,18383956,22.995,17.7,2.48,3689.251,234.499,3.94,0.588,0
208,112,346,3326,11,120,369,71976,50.93,18383956,22.995,17.7,2.48,3689.251,234.499,3.94,0.588,0
208,113,0,3326,0,120,844,72820,50.93,18383956,22.995,17.7,2.48,3689.251,234.499,3.94,0.588,0
208,114,257,3583,8,128,576,73396,50.93,18383956,22.995,17.7,2.48,3689.251,234.499,3.94,0.588,0
208,115,0,3583,0,128,835,74231,50.93,18383956,22.995,17.7,2.48,3689.251,234.499,3.94,0.588,0
208,116,273,3856,2,130,1841,76072,50.93,18383956,22.995,17.7,2.48,3689.251,234.499,3.94,0.588,0
208,117,472,4328,0,130,446,76518,50.93,18383956,22.995,17.7,2.48,3689.251,234.499,3.94,0.588,0
208,118,153,4481,9,139,209,76727,50.93,18383956,22.995,17.7,2.48,3689.251,234.499,3.94,0.588,0
208,119,71,4552,1,140,2542,79269,50.93,18383956,22.995,17.7,2.48,3689.251,234.499,3.94,0.588,0
208,120,450,5002,2,142,970,80239,50.93,18383956,22.995,17.7,2.48,3689.251,234.499,3.94,0.588,0
208,121,247,5249,4,146,1243,81482,50.93,18383956,22.995,17.7,2.48,3689.251,234.499,3.94,0.588,0
208,122,306,5555,3,149,1611,83093,50.93,18383956,22.995,17.7,2.48,3689.251,234.499,3.94,0.588,0
208,123,408,5963,2,151,1908,85001,50.93,18383956,22.995,17.7,2.48,3689.251,234.499,3.94,0.588,0
208,124,265,6228,14,165,559,85560,50.93,18383956,22.995,17.7,2.48,3689.251,234.499,3.94,0.588,0
208,125,119,6347,5,170,1820,87380,50.93,18383956,22.995,17.7,2.48,3689.251,234.499,3.94,0.588,0
208,126,233,6580,1,171,1091,88471,50.93,18383956,22.995,17.7,2.48,3689.251,234.499,3.94,0.588,0
208,127,0,6580,0,171,1112,89583,50.93,18383956,22.995,17.7,2.48,3689.251,234.499,3.94,0.588,0
208,128,442,7022,5,176,724,90307,50.93,18383956,22.995,17.7,2.48,3689.251,234.499,3.94,0.588,0
208,129,142,7164,23,199,2034,92341,50.93,18383956,22.995,17.7,2.48,3689.251,234.499,3.94,0.588,0
208,130,322,7486,1,200,1003,93344,50.93,18383956,22.995,17.7,2.48,3689.251,234.499,3.94,0.588,0
208,131,417,7903,3,203,651,93995,50.93,18383956,22.995,17.7,2.48,3689.251,234.499,3.94,0.588,0
208,132,182,8085,32,235,454,94449,50.93,18383956,22.995,17.7,2.48,3689.251,234.499,3.94,0.588,0
208,133,125,8210,6,241,362,94811,50.93,18383956,22.995,17.7,2.48,3689.251,234.499,3.94,0.588,0
208,134,65,8275,0,241,782,95593,50.93,18383956,22.995,17.7,2.48,3689.251,234.499,3.94,0.588,0
208,135,226,8501,5,246,1017,96610,50.93,18383956,22.995,17.7,2.48,3689.251,234.499,3.94,0.588,0
208,136,162,8663,0,246,1568,98178,50.93,18383956,22.995,17.7,2.48,3689.251,234.499,3.94,0.588,0
208,137,358,9021,10,256,588,98766,50.93,18383956,22.995,17.7,2.48,3689.251,234.499,3.94,0.588,0
208,138,165,9186,4,260,1069,99835,50.93,18383956,22.995,17.7,2.48,3689.251,234.499,3.94,0.588,0
208,139,157,9343,0,260,1549,101384,50.93,18383956,22.995,17.7,2.48,3689.251,234.499,3.94,0.588,0
208,140,496,9839,4,264,794,102178,50.93,18383956,22.995,17.7,2.48,3689.251,234.499,3.94,0.588,0
208,141,142,9981,0,264,845,103023,50.93,18383956,22.995,17.7,2.48,3689.251,234.499,3.94,0.588,0
208,142,237,10218,5,269,1155,104178,49.07,18383956,22.995,17.7,2.48,3689.251,234.499,3.94,0.588,0
208,143,154,10372,5,274,1486,105664,49.07,18383956,22.995,17.7,2.48,3689.251,234.499,3.94,0.588,0
208,144,255,10627,3,277,785,106449,49.07,18383956,22.995,17.7,2.48,3689.251,234.499,3.94,0.588,0
208,145,0,10627,0,277,1515,107964,49.07,18383956,22.995,17.7,2.48,3689.251,234.499,3.94,0.588,0
208,146,455,11082,3,280,346,108310,49.07,18383956,22.995,17.7,2.48,3689.251,234.499,3.94,0.588,0
208,147,66,11148,0,280,651,108961,49.07,18383956,22.995,17.7,2.48,3689.251,234.499,3.94,0.588,0
208,148,137,11285,2,282,599,109560,49.07,18383956,22.995,17.7,2.48,3689.251,234.499,3.94,0.588,0
208,149,91,11376,0,282,1400,110960,49.07,18383956,22.995,17.7,2.48,3689.251,234.499,3.94,0.588,0
208,150,225,11601,0,282,1224,112184,49.07,18383956,22.995,17.7,2.48,3689.251,234.499,3.94,0.588,0
208,151,178,11779,1,283,1171,113355,49.07,18383956,22.995,17.7,2.48,3689.251,234.499,3.94,0.588,0
208,152,123,11902,1,284,1046,114401,49.07,18383956,22.995,17.7,2.48,3689.251,234.499,3.94,0.588,0
208,153,123,12025,3,287,1169,115570,49.07,18383956,22.995,17.7,2.48,3689.251,234.499,3.94,0.588,0
208,154,72,12097,1,288,2191,117761,50.93,18383956,22.995,17.7,2.48,3689.251,234.499,3.94,0.588,0
208,155,284,12381,2,290,729,118490,50.93,18383956,22.995,17.7,2.48,3689.251,234.499,3.94,0.588,0
208,156,34,12415,2,292,1077,119567,50.93,18383956,22.995,17.7,2.48,3689.251,234.499,3.94,0.588,0
208,157,108,12523,0,292,1400,120967,50.93,18383956,22.995,17.7,2.48,3689.251,234.499,3.94,0.588,0
208,158,116,12639,0,292,0,120967,50.93,18383956,22.995,17.7,2.48,3689.251,234.499,3.94,0.588,0
208,159,70,12709,0,292,0,122234,50.93,18383956,22.995,17.7,2.48,3689.251,234.499,3.94,0.588,0
208,160,67,12776,3,295,1112,123346,50.93,18383956,22.995,17.7,2.48,3689.251,234.499,3.94,0.588,0
208,161,60,12836,0,295,1724,125070,50.93,18383956,22.995,17.7,2.48,3689.251,234.499,3.94,0.588,0
208,162,116,12952,1,296,1068,126138,50.93,18383956,22.995,17.7,2.48,3689.251,234.499,3.94,0.588,0
208,163,160,13112,4,300,1391,127529,50.93,18383956,22.995,17.7,2.48,3689.251,234.499,3.94,0.588,0
208,164,102,13214,0,300,1133,128662,50.93,18383956,22.995,17.7,2.48,3689.251,234.499,3.94,0.588,0
208,165,109,13323,6,306,1390,130052,50.93,18383956,22.995,17.7,2.48,3689.251,234.499,3.94,0.588,0
208,166,143,13466,6,312,982,131034,50.93,18383956,22.995,17.7,2.48,3689.251,234.499,3.94,0.588,0
208,167,73,13539,0,312,1608,132642,50.93,18383956,22.995,17.7,2.48,3689.251,234.499,3.94,0.588,0
208,168,181,13720,8,320,747,133389,50.93,18383956,22.995,17.7,2.48,3689.251,234.499,3.94,0.588,0
208,169,99,13819,4,324,847,134236,50.93,18383956,22.995,17.7,2.48,3689.251,234.499,3.94,0.588,0
208,170,68,13887,2,326,785,135021,50.93,18383956,22.995,17.7,2.48,3689.251,234.499,3.94,0.588,0
208,171,41,13928,0,326,1996,137017,50.93,18383956,22.995,17.7,2.48,3689.251,234.499,3.94,0.588,0
208,172,94,14022,3,329,1410,138427,50.93,18383956,22.995,17.7,2.48,3689.251,234.499,3.94,0.588,0
208,173,2,14024,0,329,1521,139948,50.93,18383956,22.995,17.7,2.48,3689.251,234.499,3.94,0.588,0
208,174,107,14131,1,330,1544,141492,43.52,18383956,22.995,17.7,2.48,3689.251,234.499,3.94,0.588,0
208,175,44,14175,1,331,1692,143184,43.52,18383956,22.995,17.7,2.48,3689.251,234.499,3.94,0.588,0
208,176,214,14389,0,331,1440,144624,43.52,18383956,22.995,17.7,2.48,3689.251,234.499,3.94,0.588,0
208,177,54,14443,1,332,1705,146329,43.52,18383956,22.995,17.7,2.48,3689.251,234.499,3.94,0.588,0
208,178,48,14491,0,332,1737,148066,43.52,18383956,22.995,17.7,2.48,3689.251,234.499,3.94,0.588,0
208,179,24,14515,0,332,1662,149728,44.44,18383956,22.995,17.7,2.48,3689.251,234.499,3.94,0.588,0
208,180,97,14612,0,332,1669,151397,44.44,18383956,22.995,17.7,2.48,3689.251,234.499,3.94,0.588,0
208,181,29,14641,0,332,1158,152555,44.44,18383956,22.995,17.7,2.48,3689.251,234.499,3.94,0.588,0
208,182,19,14660,0,332,1659,154214,44.44,18383956,22.995,17.7,2.48,3689.251,234.499,3.94,0.588,0
208,183,55,14715,0,332,1337,155551,44.44,18383956,22.995,17.7,2.48,3689.251,234.499,3.94,0.588,0
208,184,44,14759,0,332,1622,157173,44.44,18383956,22.995,17.7,2.48,3689.251,234.499,3.94,0.588,0
208,185,43,14802,1,333,1323,158496,44.44,18383956,22.995,17.7,2.48,3689.251,234.499,3.94,0.588,0
208,186,28,14830,0,333,1891,160387,44.44,18383956,22.995,17.7,2.48,3689.251,234.499,3.94,0.588,0
208,187,144,14974,0,333,2792,163179,44.44,18383956,22.995,17.7,2.48,3689.251,234.499,3.94,0.588,0
208,188,78,15052,0,333,1772,164951,44.44,18383956,22.995,17.7,2.48,3689.251,234.499,3.94,0.588,0
208,189,37,15089,0,333,2234,167185,41.67,18383956,22.995,17.7,2.48,3689.251,234.499,3.94,0.588,0
208,190,81,15170,1,334,5250,172435,41.67,18383956,22.995,17.7,2.48,3689.251,234.499,3.94,0.588,0
208,191,54,15224,0,334,3000,175435,41.67,18383956,22.995,17.7,2.48,3689.251,234.499,3.94,0.588,0
208,192,0,15224,0,334,3842,179277,41.67,18383956,22.995,17.7,2.48,3689.251,234.499,3.94,0.588,0
208,193,77,15301,1,335,3869,183146,41.67,18383956,22.995,17.7,2.48,3689.251,234.499,3.94,0.588,0
208,194,38,15339,1,336,2917,186063,41.67,18383956,22.995,17.7,2.48,3689.251,234.499,3.94,0.588,0
208,195,119,15458,0,336,2741,188804,41.67,18383956,22.995,17.7,2.48,3689.251,234.499,3.94,0.588,0
208,196,91,15549,9,345,4106,192910,41.67,18383956,22.995,17.7,2.48,3689.251,234.499,3.94,0.588,0
208,197,38,15587,0,345,2963,195873,41.67,18383956,22.995,17.7,2.48,3689.251,234.499,3.94,0.588,0
208,198,29,15616,0,345,2529,198402,41.67,18383956,22.995,17.7,2.48,3689.251,234.499,3.94,0.588,0
208,199,43,15659,1,346,3529,201931,41.67,18383956,22.995,17.7,2.48,3689.251,234.499,3.94,0.588,0
208,200,0,15659,0,346,3637,205568,41.67,18383956,22.995,17.7,2.48,3689.251,234.499,3.94,0.588,0
208,201,130,15789,0,346,4539,210107,41.67,18383956,22.995,17.7,2.48,3689.251,234.499,3.94,0.588,0
208,202,64,15853,0,346,2592,212699,41.67,18383956,22.995,17.7,2.48,3689.251,234.499,3.94,0.588,0
208,203,44,15897,0,346,0,212699,41.67,18383956,22.995,17.7,2.48,3689.251,234.499,3.94,0.588,0
208,204,85,15982,0,346,0,212699,41.67,18383956,22.995,17.7,2.48,3689.251,234.499,3.94,0.588,0
209,1,1,8,0,1,0,0,87.96,14862927,42.729,19.6,2.822,1899.775,307.846,1.82,0.535,0
209,2,0,8,0,1,0,0,87.96,14862927,42.729,19.6,2.822,1899.775,307.846,1.82,0.535,0
209,3,0,8,0,1,0,0,87.96,14862927,42.729,19.6,2.822,1899.775,307.846,1.82,0.535,0
209,4,1,9,0,1,0,0,87.96,14862927,42.729,19.6,2.822,1899.775,307.846,1.82,0.535,0
209,5,0,9,0,1,0,0,87.96,14862927,42.729,19.6,2.822,1899.775,307.846,1.82,0.535,0
209,6,0,9,0,1,0,0,87.96,14862927,42.729,19.6,2.822,1899.775,307.846,1.82,0.535,0
209,7,0,9,0,1,0,0,87.96,14862927,42.729,19.6,2.822,1899.775,307.846,1.82,0.535,0
209,8,1,10,0,1,0,0,87.96,14862927,42.729,19.6,2.822,1899.775,307.846,1.82,0.535,0
209,9,1,11,1,2,0,0,87.96,14862927,42.729,19.6,2.822,1899.775,307.846,1.82,0.535,0
209,10,0,11,1,3,0,0,87.96,14862927,42.729,19.6,2.822,1899.775,307.846,1.82,0.535,0
209,11,0,11,0,3,0,0,87.96,14862927,42.729,19.6,2.822,1899.775,307.846,1.82,0.535,0
209,12,3,14,0,3,0,0,87.96,14862927,42.729,19.6,2.822,1899.775,307.846,1.82,0.535,0
209,13,0,14,0,3,0,0,87.96,14862927,42.729,19.6,2.822,1899.775,307.846,1.82,0.535,0
209,14,3,17,0,3,0,0,87.96,14862927,42.729,19.6,2.822,1899.775,307.846,1.82,0.535,0
209,15,0,17,0,3,0,0,87.96,14862927,42.729,19.6,2.822,1899.775,307.846,1.82,0.535,0
209,16,6,23,0,3,0,0,87.96,14862927,42.729,19.6,2.822,1899.775,307.846,1.82,0.535,0
209,17,1,24,0,3,0,0,87.96,14862927,42.729,19.6,2.822,1899.775,307.846,1.82,0.535,0
209,18,0,24,0,3,0,0,87.96,14862927,42.729,19.6,2.822,1899.775,307.846,1.82,0.535,0
209,19,1,25,0,3,0,0,87.96,14862927,42.729,19.6,2.822,1899.775,307.846,1.82,0.535,0
209,20,0,25,0,3,0,0,87.96,14862927,42.729,19.6,2.822,1899.775,307.846,1.82,0.535,0
209,21,0,25,0,3,0,0,87.96,14862927,42.729,19.6,2.822,1899.775,307.846,1.82,0.535,0
209,22,3,28,0,3,0,0,87.96,14862927,42.729,19.6,2.822,1899.775,307.846,1.82,0.535,0
209,23,0,28,0,3,0,0,87.96,14862927,42.729,19.6,2.822,1899.775,307.846,1.82,0.535,0
209,24,1,29,0,3,0,0,87.96,14862927,42.729,19.6,2.822,1899.775,307.846,1.82,0.535,0
209,25,0,29,1,4,0,0,87.96,14862927,42.729,19.6,2.822,1899.775,307.846,1.82,0.535,0
209,26,2,31,0,4,0,0,87.96,14862927,42.729,19.6,2.822,1899.775,307.846,1.82,0.535,0
209,27,0,31,0,4,0,0,87.96,14862927,42.729,19.6,2.822,1899.775,307.846,1.82,0.535,0
209,28,1,32,0,4,0,0,87.96,14862927,42.729,19.6,2.822,1899.775,307.846,1.82,0.535,0
209,29,0,32,0,4,0,0,87.96,14862927,42.729,19.6,2.822,1899.775,307.846,1.82,0.535,0
209,30,2,34,0,4,0,0,87.96,14862927,42.729,19.6,2.822,1899.775,307.846,1.82,0.535,0
209,31,0,34,0,4,0,0,87.96,14862927,42.729,19.6,2.822,1899.775,307.846,1.82,0.535,0
209,32,0,34,0,4,0,0,87.96,14862927,42.729,19.6,2.822,1899.775,307.846,1.82,0.535,0
209,33,0,34,0,4,0,0,87.96,14862927,42.729,19.6,2.822,1899.775,307.846,1.82,0.535,0
209,34,0,34,0,4,0,0,87.96,14862927,42.729,19.6,2.822,1899.775,307.846,1.82,0.535,0
209,35,0,34,0,4,0,0,87.96,14862927,42.729,19.6,2.822,1899.775,307.846,1.82,0.535,0
209,36,0,34,0,4,0,7808,87.96,14862927,42.729,19.6,2.822,1899.775,307.846,1.82,0.535,0
209,37,0,34,0,4,333,8141,87.96,14862927,42.729,19.6,2.822,1899.775,307.846,1.82,0.535,0
209,38,0,34,0,4,600,8741,87.96,14862927,42.729,19.6,2.822,1899.775,307.846,1.82,0.535,0
209,39,1,35,0,4,852,9593,87.96,14862927,42.729,19.6,2.822,1899.775,307.846,1.82,0.535,0
209,40,1,36,0,4,279,9872,87.96,14862927,42.729,19.6,2.822,1899.775,307.846,1.82,0.535,0
209,41,0,36,0,4,726,10598,87.96,14862927,42.729,19.6,2.822,1899.775,307.846,1.82,0.535,0
209,42,1,37,0,4,460,11058,87.96,14862927,42.729,19.6,2.822,1899.775,307.846,1.82,0.535,0
209,43,0,37,0,4,133,11191,87.96,14862927,42.729,19.6,2.822,1899.775,307.846,1.82,0.535,0
209,44,0,37,0,4,0,11191,87.96,14862927,42.729,19.6,2.822,1899.775,307.846,1.82,0.535,0
209,45,0,37,0,4,0,11401,87.96,14862927,42.729,19.6,2.822,1899.775,307.846,1.82,0.535,0
209,46,5,42,0,4,874,12275,87.96,14862927,42.729,19.6,2.822,1899.775,307.846,1.82,0.535,0
209,47,2,44,0,4,289,12564,87.96,14862927,42.729,19.6,2.822,1899.775,307.846,1.82,0.535,0
209,48,2,46,0,4,540,13104,87.96,14862927,42.729,19.6,2.822,1899.775,307.846,1.82,0.535,0
209,49,0,46,0,4,1071,14175,87.96,14862927,42.729,19.6,2.822,1899.775,307.846,1.82,0.535,0
209,50,0,46,0,4,443,14618,87.96,14862927,42.729,19.6,2.822,1899.775,307.846,1.82,0.535,0
209,51,2,48,0,4,466,15084,87.96,14862927,42.729,19.6,2.822,1899.775,307.846,1.82,0.535,0
209,52,3,51,0,4,110,15194,87.96,14862927,42.729,19.6,2.822,1899.775,307.846,1.82,0.535,0
209,53,5,56,0,4,142,15336,87.96,14862927,42.729,19.6,2.822,1899.775,307.846,1.82,0.535,0
209,54,0,56,0,4,219,15555,87.96,14862927,42.729,19.6,2.822,1899.775,307.846,1.82,0.535,0
209,55,0,56,0,4,210,15765,87.96,14862927,42.729,19.6,2.822,1899.775,307.846,1.82,0.535,0
209,56,0,56,0,4,0,15765,87.96,14862927,42.729,19.6,2.822,1899.775,307.846,1.82,0.535,0
209,57,0,56,0,4,0,16254,87.96,14862927,42.729,19.6,2.822,1899.775,307.846,1.82,0.535,0
209,58,76,132,0,4,186,16440,87.96,14862927,42.729,19.6,2.822,1899.775,307.846,1.82,0.535,0
209,59,17,149,0,4,420,16860,87.96,14862927,42.729,19.6,2.822,1899.775,307.846,1.82,0.535,0
209,60,11,160,0,4,666,17526,87.96,14862927,42.729,19.6,2.822,1899.775,307.846,1.82,0.535,0
209,61,14,174,0,4,546,18072,87.96,14862927,42.729,19.6,2.822,1899.775,307.846,1.82,0.535,0
209,62,4,178,0,4,637,18709,87.96,14862927,42.729,19.6,2.822,1899.775,307.846,1.82,0.535,0
209,63,25,203,0,4,581,19290,87.96,14862927,42.729,19.6,2.822,1899.775,307.846,1.82,0.535,0
209,64,3,206,0,4,722,20012,87.96,14862927,42.729,19.6,2.822,1899.775,307.846,1.82,0.535,0
209,65,16,222,0,4,390,20402,87.96,14862927,42.729,19.6,2.822,1899.775,307.846,1.82,0.535,0
209,66,15,237,0,4,598,21000,70.37,14862927,42.729,19.6,2.822,1899.775,307.846,1.82,0.535,0
209,67,28,265,0,4,354,21354,70.37,14862927,42.729,19.6,2.822,1899.775,307.846,1.82,0.535,0
209,68,14,279,0,4,153,21507,70.37,14862927,42.729,19.6,2.822,1899.775,307.846,1.82,0.535,0
209,69,3,282,0,4,394,21901,70.37,14862927,42.729,19.6,2.822,1899.775,307.846,1.82,0.535,0
209,70,5,287,0,4,352,22253,70.37,14862927,42.729,19.6,2.822,1899.775,307.846,1.82,0.535,0
209,71,27,314,0,4,552,22805,70.37,14862927,42.729,19.6,2.822,1899.775,307.846,1.82,0.535,0
209,72,6,320,0,4,267,23072,70.37,14862927,42.729,19.6,2.822,1899.775,307.846,1.82,0.535,0
209,73,12,332,0,4,465,23537,70.37,14862927,42.729,19.6,2.822,1899.775,307.846,1.82,0.535,0
209,74,11,343,0,4,473,24010,70.37,14862927,42.729,19.6,2.822,1899.775,307.846,1.82,0.535,0
209,75,13,356,0,4,96,24106,70.37,14862927,42.729,19.6,2.822,1899.775,307.846,1.82,0.535,0
209,76,27,383,0,4,507,24613,70.37,14862927,42.729,19.6,2.822,1899.775,307.846,1.82,0.535,0
209,77,4,387,0,4,251,24864,70.37,14862927,42.729,19.6,2.822,1899.775,307.846,1.82,0.535,0
209,78,7,394,0,4,427,25291,70.37,14862927,42.729,19.6,2.822,1899.775,307.846,1.82,0.535,0
209,79,7,401,0,4,524,25815,70.37,14862927,42.729,19.6,2.822,1899.775,307.846,1.82,0.535,0
209,80,62,463,0,4,302,26117,70.37,14862927,42.729,19.6,2.822,1899.775,307.846,1.82,0.535,0
209,81,16,479,0,4,334,26451,70.37,14862927,42.729,19.6,2.822,1899.775,307.846,1.82,0.535,0
209,82,7,486,2,6,406,26857,70.37,14862927,42.729,19.6,2.822,1899.775,307.846,1.82,0.535,0
209,83,3,489,0,6,364,27221,70.37,14862927,42.729,19.6,2.822,1899.775,307.846,1.82,0.535,0
209,84,23,512,0,6,378,27599,70.37,14862927,42.729,19.6,2.822,1899.775,307.846,1.82,0.535,0
209,85,13,525,0,6,654,28253,70.37,14862927,42.729,19.6,2.822,1899.775,307.846,1.82,0.535,0
209,86,5,530,0,6,435,28688,70.37,14862927,42.729,19.6,2.822,1899.775,307.846,1.82,0.535,0
209,87,21,551,0,6,489,29177,70.37,14862927,42.729,19.6,2.822,1899.775,307.846,1.82,0.535,0
209,88,10,561,0,6,464,29641,70.37,14862927,42.729,19.6,2.822,1899.775,307.846,1.82,0.535,0
209,89,6,567,0,6,458,30099,70.37,14862927,42.729,19.6,2.822,1899.775,307.846,1.82,0.535,0
209,90,0,567,0,6,272,30371,70.37,14862927,42.729,19.6,2.822,1899.775,307.846,1.82,0.535,0
209,91,7,574,1,7,340,30711,70.37,14862927,42.729,19.6,2.822,1899.775,307.846,1.82,0.535,0
209,92,17,591,0,7,380,31091,70.37,14862927,42.729,19.6,2.822,1899.775,307.846,1.82,0.535,0
209,93,14,605,0,7,522,31613,70.37,14862927,42.729,19.6,2.822,1899.775,307.846,1.82,0.535,0
209,94,12,617,0,7,499,32112,70.37,14862927,42.729,19.6,2.822,1899.775,307.846,1.82,0.535,0
209,95,8,625,0,7,733,32845,70.37,14862927,42.729,19.6,2.822,1899.775,307.846,1.82,0.535,0
209,96,73,698,1,8,411,33256,70.37,14862927,42.729,19.6,2.822,1899.775,307.846,1.82,0.535,0
209,97,18,716,0,8,312,33568,70.37,14862927,42.729,19.6,2.822,1899.775,307.846,1.82,0.535,0
209,98,18,734,1,9,592,34160,70.37,14862927,42.729,19.6,2.822,1899.775,307.846,1.82,0.535,0
209,99,53,787,0,9,606,34766,76.85,14862927,42.729,19.6,2.822,1899.775,307.846,1.82,0.535,0
209,100,98,885,0,9,580,35346,76.85,14862927,42.729,19.6,2.822,1899.775,307.846,1.82,0.535,0
209,101,41,926,3,12,659,36005,76.85,14862927,42.729,19.6,2.822,1899.775,307.846,1.82,0.535,0
209,102,16,942,1,13,394,36399,76.85,14862927,42.729,19.6,2.822,1899.775,307.846,1.82,0.535,0
209,103,40,982,5,18,517,36916,76.85,14862927,42.729,19.6,2.822,1899.775,307.846,1.82,0.535,0
209,104,3,985,0,18,412,37328,76.85,14862927,42.729,19.6,2.822,1899.775,307.846,1.82,0.535,0
209,105,49,1034,1,19,693,38021,76.85,14862927,42.729,19.6,2.822,1899.775,307.846,1.82,0.535,0
209,106,0,1034,0,19,603,38624,76.85,14862927,42.729,19.6,2.822,1899.775,307.846,1.82,0.535,0
209,107,55,1089,1,20,492,39116,76.85,14862927,42.729,19.6,2.822,1899.775,307.846,1.82,0.535,0
209,108,273,1362,3,23,979,40095,76.85,14862927,42.729,19.6,2.822,1899.775,307.846,1.82,0.535,0
209,109,58,1420,1,24,541,40636,76.85,14862927,42.729,19.6,2.822,1899.775,307.846,1.82,0.535,0
209,110,58,1478,1,25,802,41438,76.85,14862927,42.729,19.6,2.822,1899.775,307.846,1.82,0.535,0
209,111,133,1611,0,25,502,41940,76.85,14862927,42.729,19.6,2.822,1899.775,307.846,1.82,0.535,0
209,112,102,1713,1,26,592,42532,76.85,14862927,42.729,19.6,2.822,1899.775,307.846,1.82,0.535,0
209,113,107,1820,0,26,1076,43608,80.56,14862927,42.729,19.6,2.822,1899.775,307.846,1.82,0.535,0
209,114,214,2034,0,26,1248,44856,80.56,14862927,42.729,19.6,2.822,1899.775,307.846,1.82,0.535,0
209,115,90,2124,2,28,5055,49911,80.56,14862927,42.729,19.6,2.822,1899.775,307.846,1.82,0.535,0
209,116,172,2296,4,32,2096,52007,80.56,14862927,42.729,19.6,2.822,1899.775,307.846,1.82,0.535,0
209,117,138,2434,2,34,1339,53346,80.56,14862927,42.729,19.6,2.822,1899.775,307.846,1.82,0.535,0
209,118,78,2512,0,34,1485,54831,80.56,14862927,42.729,19.6,2.822,1899.775,307.846,1.82,0.535,0
209,119,192,2704,2,36,1169,56000,80.56,14862927,42.729,19.6,2.822,1899.775,307.846,1.82,0.535,0
209,120,113,2817,4,40,1791,57791,80.56,14862927,42.729,19.6,2.822,1899.775,307.846,1.82,0.535,0
209,121,62,2879,1,41,1340,59131,80.56,14862927,42.729,19.6,2.822,1899.775,307.846,1.82,0.535,0
209,122,213,3092,12,53,1001,60132,80.56,14862927,42.729,19.6,2.822,1899.775,307.846,1.82,0.535,0
209,123,77,3169,14,67,1445,61577,80.56,14862927,42.729,19.6,2.822,1899.775,307.846,1.82,0.535,0
209,124,490,3659,2,69,1608,63185,80.56,14862927,42.729,19.6,2.822,1899.775,307.846,1.82,0.535,0
209,125,262,3921,1,70,1449,64634,80.56,14862927,42.729,19.6,2.822,1899.775,307.846,1.82,0.535,0
209,126,154,4075,10,80,1080,65714,80.56,14862927,42.729,19.6,2.822,1899.775,307.846,1.82,0.535,0
209,127,146,4221,1,81,1660,67374,80.56,14862927,42.729,19.6,2.822,1899.775,307.846,1.82,0.535,0
209,128,118,4339,3,84,768,68142,80.56,14862927,42.729,19.6,2.822,1899.775,307.846,1.82,0.535,0
209,129,56,4395,13,97,961,69103,80.56,14862927,42.729,19.6,2.822,1899.775,307.846,1.82,0.535,0
209,130,56,4451,5,102,1212,70315,80.56,14862927,42.729,19.6,2.822,1899.775,307.846,1.82,0.535,0
209,131,124,4575,0,102,1293,71608,80.56,14862927,42.729,19.6,2.822,1899.775,307.846,1.82,0.535,0
209,132,74,4649,2,104,2816,74424,80.56,14862927,42.729,19.6,2.822,1899.775,307.846,1.82,0.535,0
209,133,99,4748,0,104,1795,76219,80.56,14862927,42.729,19.6,2.822,1899.775,307.846,1.82,0.535,0
209,134,70,4818,0,104,1411,77630,80.56,14862927,42.729,19.6,2.822,1899.775,307.846,1.82,0.535,0
209,135,75,4893,18,122,1108,78738,80.56,14862927,42.729,19.6,2.822,1899.775,307.846,1.82,0.535,0
209,136,97,4990,6,128,1211,79949,80.56,14862927,42.729,19.6,2.822,1899.775,307.846,1.82,0.535,0
209,137,82,5072,0,128,1389,81338,80.56,14862927,42.729,19.6,2.822,1899.775,307.846,1.82,0.535,0
209,138,104,5176,2,130,1546,82884,80.56,14862927,42.729,19.6,2.822,1899.775,307.846,1.82,0.535,0
209,139,85,5261,2,132,898,83782,80.56,14862927,42.729,19.6,2.822,1899.775,307.846,1.82,0.535,0
209,140,47,5308,3,135,1229,85011,80.56,14862927,42.729,19.6,2.822,1899.775,307.846,1.82,0.535,0
209,141,70,5378,6,141,1618,86629,80.56,14862927,42.729,19.6,2.822,1899.775,307.846,1.82,0.535,0
209,142,265,5643,9,150,1256,87885,80.56,14862927,42.729,19.6,2.822,1899.775,307.846,1.82,0.535,0
209,143,102,5745,1,151,1810,89695,80.56,14862927,42.729,19.6,2.822,1899.775,307.846,1.82,0.535,0
209,144,70,5815,1,152,1001,90696,80.56,14862927,42.729,19.6,2.822,1899.775,307.846,1.82,0.535,0
209,145,78,5893,1,153,852,91548,80.56,14862927,42.729,19.6,2.822,1899.775,307.846,1.82,0.535,0
209,146,37,5930,2,155,770,92318,80.56,14862927,42.729,19.6,2.822,1899.775,307.846,1.82,0.535,0
209,147,140,6070,0,155,1574,93892,80.56,14862927,42.729,19.6,2.822,1899.775,307.846,1.82,0.535,0
209,148,126,6196,11,166,878,94770,80.56,14862927,42.729,19.6,2.822,1899.775,307.846,1.82,0.535,0
209,149,55,6251,13,179,951,95721,80.56,14862927,42.729,19.6,2.822,1899.775,307.846,1.82,0.535,0
209,150,41,6292,10,189,1551,97272,80.56,14862927,42.729,19.6,2.822,1899.775,307.846,1.82,0.535,0
209,151,96,6388,6,195,1114,98386,80.56,14862927,42.729,19.6,2.822,1899.775,307.846,1.82,0.535,0
209,152,18,6406,1,196,602,98988,80.56,14862927,42.729,19.6,2.822,1899.775,307.846,1.82,0.535,0
209,153,6,6412,0,196,836,99824,80.56,14862927,42.729,19.6,2.822,1899.775,307.846,1.82,0.535,0
209,154,85,6497,6,202,1013,100837,80.56,14862927,42.729,19.6,2.822,1899.775,307.846,1.82,0.535,0
209,155,62,6559,1,203,939,101776,80.56,14862927,42.729,19.6,2.822,1899.775,307.846,1.82,0.535,0
209,156,79,6638,3,206,1095,102871,80.56,14862927,42.729,19.6,2.822,1899.775,307.846,1.82,0.535,0
209,157,40,6678,0,206,919,103790,80.56,14862927,42.729,19.6,2.822,1899.775,307.846,1.82,0.535,0
209,158,159,6837,0,206,0,103790,80.56,14862927,42.729,19.6,2.822,1899.775,307.846,1.82,0.535,0
209,159,0,6837,0,206,0,104455,80.56,14862927,42.729,19.6,2.822,1899.775,307.846,1.82,0.535,0
209,160,140,6977,1,207,416,104871,80.56,14862927,42.729,19.6,2.822,1899.775,307.846,1.82,0.535,0
209,161,321,7298,3,210,521,105392,80.56,14862927,42.729,19.6,2.822,1899.775,307.846,1.82,0.535,0
209,162,90,7388,8,218,1053,106445,80.56,14862927,42.729,19.6,2.822,1899.775,307.846,1.82,0.535,0
209,163,41,7429,4,222,969,107414,80.56,14862927,42.729,19.6,2.822,1899.775,307.846,1.82,0.535,0
209,164,24,7453,0,222,1051,108465,80.56,14862927,42.729,19.6,2.822,1899.775,307.846,1.82,0.535,0
209,165,26,7479,2,224,1189,109654,80.56,14862927,42.729,19.6,2.822,1899.775,307.846,1.82,0.535,0
209,166,29,7508,0,224,367,110021,80.56,14862927,42.729,19.6,2.822,1899.775,307.846,1.82,0.535,0
209,167,18,7526,0,224,349,110370,76.85,14862927,42.729,19.6,2.822,1899.775,307.846,1.82,0.535,0
209,168,5,7531,0,224,404,110774,76.85,14862927,42.729,19.6,2.822,1899.775,307.846,1.82,0.535,0
209,169,45,7576,0,224,647,111421,76.85,14862927,42.729,19.6,2.822,1899.775,307.846,1.82,0.535,0
209,170,22,7598,0,224,1011,112432,76.85,14862927,42.729,19.6,2.822,1899.775,307.846,1.82,0.535,0
209,171,35,7633,0,224,755,113187,76.85,14862927,42.729,19.6,2.822,1899.775,307.846,1.82,0.535,0
209,172,14,7647,0,224,539,113726,76.85,14862927,42.729,19.6,2.822,1899.775,307.846,1.82,0.535,0
209,173,25,7672,1,225,628,114354,76.85,14862927,42.729,19.6,2.822,1899.775,307.846,1.82,0.535,0
209,174,11,7683,0,225,263,114617,76.85,14862927,42.729,19.6,2.822,1899.775,307.846,1.82,0.535,0
209,175,23,7706,1,226,637,115254,76.85,14862927,42.729,19.6,2.822,1899.775,307.846,1.82,0.535,0
209,176,5,7711,0,226,630,115884,76.85,14862927,42.729,19.6,2.822,1899.775,307.846,1.82,0.535,0
209,177,14,7725,1,227,721,116605,76.85,14862927,42.729,19.6,2.822,1899.775,307.846,1.82,0.535,0
209,178,27,7752,0,227,667,117272,76.85,14862927,42.729,19.6,2.822,1899.775,307.846,1.82,0.535,0
209,179,35,7787,0,227,543,117815,76.85,14862927,42.729,19.6,2.822,1899.775,307.846,1.82,0.535,0
209,180,16,7803,0,227,238,118053,76.85,14862927,42.729,19.6,2.822,1899.775,307.846,1.82,0.535,0
209,181,9,7812,0,227,504,118557,76.85,14862927,42.729,19.6,2.822,1899.775,307.846,1.82,0.535,0
209,182,4,7816,1,228,467,119024,76.85,14862927,42.729,19.6,2.822,1899.775,307.846,1.82,0.535,0
209,183,21,7837,0,228,467,119491,76.85,14862927,42.729,19.6,2.822,1899.775,307.846,1.82,0.535,0
209,184,1,7838,0,228,1039,120530,76.85,14862927,42.729,19.6,2.822,1899.775,307.846,1.82,0.535,0
209,185,12,7850,0,228,692,121222,76.85,14862927,42.729,19.6,2.822,1899.775,307.846,1.82,0.535,0
209,186,8,7858,0,228,421,121643,76.85,14862927,42.729,19.6,2.822,1899.775,307.846,1.82,0.535,0
209,187,27,7885,0,228,217,121860,76.85,14862927,42.729,19.6,2.822,1899.775,307.846,1.82,0.535,0
209,188,0,7885,0,228,929,122789,76.85,14862927,42.729,19.6,2.822,1899.775,307.846,1.82,0.535,0
209,189,13,7898,0,228,899,123688,76.85,14862927,42.729,19.6,2.822,1899.775,307.846,1.82,0.535,0
209,190,17,7915,1,229,759,124447,76.85,14862927,42.729,19.6,2.822,1899.775,307.846,1.82,0.535,0
209,191,4,7919,0,229,929,125376,76.85,14862927,42.729,19.6,2.822,1899.775,307.846,1.82,0.535,0
209,192,32,7951,0,229,123,125499,76.85,14862927,42.729,19.6,2.822,1899.775,307.846,1.82,0.535,0
209,193,43,7994,0,229,604,126103,76.85,14862927,42.729,19.6,2.822,1899.775,307.846,1.82,0.535,0
209,194,16,8010,1,230,597,126700,76.85,14862927,42.729,19.6,2.822,1899.775,307.846,1.82,0.535,0
209,195,1,8011,0,230,481,127181,76.85,14862927,42.729,19.6,2.822,1899.775,307.846,1.82,0.535,0
209,196,10,8021,0,230,588,127769,76.85,14862927,42.729,19.6,2.822,1899.775,307.846,1.82,0.535,0
209,197,15,8036,0,230,615,128384,76.85,14862927,42.729,19.6,2.822,1899.775,307.846,1.82,0.535,0
209,198,19,8055,1,231,818,129202,76.85,14862927,42.729,19.6,2.822,1899.775,307.846,1.82,0.535,0
209,199,20,8075,0,231,615,129817,76.85,14862927,42.729,19.6,2.822,1899.775,307.846,1.82,0.535,0
209,200,24,8099,0,231,804,130621,76.85,14862927,42.729,19.6,2.822,1899.775,307.846,1.82,0.535,0
209,201,11,8110,0,231,0,130621,76.85,14862927,42.729,19.6,2.822,1899.775,307.846,1.82,0.535,0
209,202,37,8147,0,231,0,130621,76.85,14862927,42.729,19.6,2.822,1899.775,307.846,1.82,0.535,0
209,203,12,8159,1,232,0,130621,76.85,14862927,42.729,19.6,2.822,1899.775,307.846,1.82,0.535,0
209,204,28,8187,1,233,0,130621,76.85,14862927,42.729,19.6,2.822,1899.775,307.846,1.82,0.535,0
